game_title	release_date	peak_players	positive_reviews	negative_reviews	total_reviews	rating
Pizza Tower	2023-01-26	4529	19807	227	4756	0.9639
Resident Evil 4	2023-03-24	168191	61752	1616	169807	0.9575
The Murder of Sonic the Hedgehog	2023-03-31	15543	12643	213	15756	0.9554
Pineapple on pizza	2023-03-28	1415	11717	209	1624	0.9539
Hi-Fi RUSH	2023-01-25	6132	14152	324	6456	0.9509000000000001
东北之夏	2023-01-09	8672	8891	165	8837	0.9508
Crab Champions	2023-04-01	8564	5129	81	8645	0.9476000000000001
Papa's Freezeria Deluxe	2023-03-31	1227	1832	20	1247	0.9384
A Space for the Unbound	2023-01-19	338	1917	27	365	0.9364
Handshakes	2023-01-13	195	1166	10	205	0.9329999999999999
候鸟	2023-01-11	162	1149	12	174	0.9312
Симулятор Побега от Военкомата	2023-04-03	775	1995	42	817	0.9309999999999999
I commissioned some bees 0	2023-01-12	374	1733	36	410	0.9292
Spin Rhythm XD	2023-03-14	313	2909	86	399	0.9289000000000001
OCTOPATH TRAVELER II	2023-02-24	17008	4403	158	17166	0.9285
Boneraiser Minions	2023-03-09	2029	3093	97	2126	0.9281999999999999
Bloody Hell	2023-01-27	395	1308	22	417	0.9279999999999999
DREDGE	2023-03-30	12686	5632	234	12920	0.9263
Your Only Move Is HUSTLE	2023-02-02	3405	5664	245	3650	0.925
Touhou Hero of Ice Fairy	2023-02-25	573	736	8	581	0.9224
Your Turn To Die -Death Game By Majority- 	2023-02-20	471	616	4	475	0.9223
DR LIVESEY ROM AND DEATH EDITION	2023-02-13	818	4397	221	1039	0.9165000000000001
Half-Life: MMod	2023-03-14	1027	1222	39	1066	0.9144
Hogwarts Legacy	2023-02-10	879308	179479	14684	893992	0.9135
Big Ambitions	2023-03-10	10961	3976	218	11179	0.9117000000000001
Apewar	2023-03-24	361	1313	50	411	0.9106000000000001
Meg's Monster	2023-03-02	195	484	7	202	0.9106000000000001
The Test: Secrets of the Soul	2023-02-20	16	527	9	25	0.9104000000000001
Barotrauma	2023-03-13	19655	41677	3286	22941	0.9098999999999999
觅长生	2023-01-13	26379	17906	1323	27702	0.9091
Birth	2023-02-17	183	442	7	190	0.9074
Contraband Police	2023-03-08	8124	4519	282	8406	0.9069
Bing in Wonderland	2023-01-13	977	1184	48	1025	0.9069
Luck be a Landlord	2023-01-06	2544	6625	459	3003	0.905
Durka Simulator	2023-03-21	48	1598	80	128	0.904
 Dead Space	2023-01-27	30925	21792	1820	32745	0.9025
PARANORMASIGHT: The Seven Mysteries of Honjo	2023-03-08	582	654	24	606	0.8993000000000001
Patch Quest	2023-03-02	2356	1357	72	2428	0.8992
Vertigo 2	2023-03-30	295	497	15	310	0.8987999999999999
Larcin Lazer	2023-01-24	38	223	1	39	0.8985
Fallen Hero: Retribution	2023-02-02	379	242	2	381	0.8979
Scarlet Maiden	2023-01-27	736	895	42	778	0.8972
Landfall Archives	2023-03-31	1247	695	29	1276	0.8966
Elong Plug	2023-02-25	34	231	2	36	0.8963
The Symbiant	2023-02-02	120	284	5	125	0.8951000000000001
Shogun Showdown: Prologue	2023-04-04	590	274	5	595	0.8937
流光易逝的夏末 - Fleeting Summer's End	2023-01-06	22	165	0	22	0.8926999999999999
Lake Haven - Chrysalis	2023-01-18	24	246	4	28	0.8923000000000001
The Legend of Heroes: Trails to Azure	2023-03-14	884	183	1	885	0.8918
Half-Life 2: VR Mod - Episode One	2023-03-17	193	237	4	197	0.8908
q.u.q.	2023-02-27	24	283	7	31	0.8896
The Last Spell	2023-03-09	6755	7268	659	7414	0.8889
EMPTY SHELL: PROLOGUE	2023-01-06	130	628	31	161	0.8887999999999999
Sifu	2023-03-28	3189	1727	125	3314	0.8876000000000001
方寸文明	2023-01-01	1414	787	45	1459	0.887
Crimson Snow	2023-03-29	103	758	43	146	0.8867
通神榜 Noobs Want to Live	2023-02-14	8622	3135	263	8885	0.8861
스테퍼 케이스: 초능력 추리 어드벤처	2023-03-10	134	242	6	140	0.8854000000000001
Ages of Conflict: World War Simulator	2023-02-17	312	442	20	332	0.8847
RHYTHM SPROUT	2023-02-01	204	311	11	215	0.8840000000000001
Mortal Sin	2023-03-15	191	280	9	200	0.8837999999999999
Figment 2: Creed Valley	2023-03-09	62	183	3	65	0.8837
Locke(d)	2023-01-23	30	470	23	53	0.8833
Cultivation Story: Reincarnation	2023-01-30	1626	1392	104	1730	0.8828
Gorilla Tag	2023-01-01	1679	26120	2876	4555	0.8826
SpongeBob SquarePants: The Cosmic Shake	2023-01-31	1949	1203	88	2037	0.8819
Can of Wormholes	2023-03-24	165	138	1	166	0.8815000000000001
Love Love School Days	2023-02-06	277	316	13	290	0.8801000000000001
Die in the Dungeon PROLOGUE	2023-01-12	379	311	13	392	0.8792
Season	2023-01-31	461	747	50	511	0.8788
Halls of Torment Prelude	2023-03-09	1080	597	37	1117	0.8783
挂机神话	2023-04-07	1142	1326	107	1249	0.8776
Demons Roots	2023-01-14	612	575	36	648	0.8772
24 Killers	2023-03-09	29	105	0	29	0.8772
Demonologist	2023-03-27	8806	2737	259	9065	0.8764000000000001
Mr. Saitou	2023-03-23	61	214	7	68	0.8762000000000001
Aliens After Ava	2023-01-13	14	119	1	15	0.8756
The Light Brigade	2023-02-22	156	445	26	182	0.8751000000000001
SkyIsland	2023-02-15	216	478	29	245	0.8749
HOPE LEFT ME	2023-03-10	14	150	3	17	0.8749
Creepy Tale 3: Ingrid Penance	2023-03-09	121	165	4	125	0.8748
VOYAGER	2023-03-25	9	116	1	10	0.8745999999999999
Plasma	2023-03-30	358	161	4	362	0.8736
NOeSIS Ⅱ-人间无常	2023-02-26	17	113	1	18	0.8734999999999999
memories	2023-02-03	38	376	21	59	0.8734000000000001
Pleh!	2023-03-17	124	315	16	140	0.873
Sun Haven	2023-03-11	12706	5357	587	13293	0.8719
Atelier Ryza 3: Alchemist of the End & the Secret Key	2023-03-24	7162	717	54	7216	0.8719
Above Snakes: Prologue	2023-03-24	3672	1116	95	3767	0.8718000000000001
Metroplex Zero	2023-03-31	16	91	0	16	0.8718000000000001
SimRail - The Railway Simulator	2023-01-13	1914	1253	110	2024	0.8715999999999999
SpunkStock: Music Festival	2023-01-26	277	165	5	282	0.8704999999999999
Farlanders	2023-01-17	251	313	17	268	0.8703000000000001
Clash: Artifacts of Chaos	2023-03-09	148	306	17	165	0.8689
Glory & Miserable Survivors DX	2023-03-16	776	390	26	802	0.8663
Soundodger 2	2023-04-10	53	109	2	55	0.8654999999999999
Caves of Lore	2023-01-21	103	148	5	108	0.8647
Lone Fungus	2023-04-07	214	194	9	223	0.8638
Passpartout 2: The Lost Artist	2023-04-04	591	272	16	607	0.8637
A Bavarian Tale - Totgeschwiegen	2023-02-02	57	144	5	62	0.8632
Coralina	2023-01-06	16	192	9	25	0.8631000000000001
King Of The Castle	2023-03-02	321	488	38	359	0.8629000000000001
ZED ZONE	2023-03-30	2569	1332	135	2704	0.8625
Omega Strikers	2023-04-27	19257	10006	1292	20549	0.8623999999999999
BETON BRUTAL	2023-03-31	147	129	4	151	0.8623999999999999
ENTROPOLY	2023-03-02	41	102	2	43	0.8623000000000001
ふりかけ☆スペイシー	2023-03-01	48	71	0	48	0.8620000000000001
Cannibal Abduction	2023-01-13	25	138	5	30	0.8609
Graze Counter GM	2023-01-18	72	84	1	73	0.8605
The Multi-Medium	2023-01-20	15	84	1	16	0.8605
Basements n' Basilisks: Storms of Sorcery	2023-02-27	20	98	2	22	0.8604
Partum Artifex	2023-02-26	17	83	1	18	0.86
Plan B: Terraform	2023-02-15	2352	1072	108	2460	0.8599
Dreams in the Witch House	2023-02-16	42	123	4	46	0.8598
Planet Cube: Edge	2023-02-23	14	97	2	16	0.8598
The Pale Beyond	2023-02-24	738	731	68	806	0.8593999999999999
Kujlevka	2023-04-06	73	82	1	74	0.8593999999999999
vivid/stasis	2023-03-07	53	109	3	56	0.8592000000000001
Aces and Adventures	2023-02-23	2455	879	87	2542	0.8582
Tower Tactics: Liberation	2023-02-06	808	751	72	880	0.8579000000000001
一起击碎吧	2023-04-06	28	62	0	28	0.8563
Time Wasters	2023-03-10	934	695	67	1001	0.8562000000000001
Kandria	2023-01-11	26	90	2	28	0.8561
Juno: New Origins	2023-01-26	780	1953	229	1009	0.856
Hell Of An Office	2023-03-14	26	76	1	27	0.8558
Confabulation	2023-01-13	13	61	0	13	0.8556999999999999
Good Pizza, Great Pizza	2023-01-06	145	1453	164	309	0.8555
Lords of Infinity	2023-03-02	270	114	4	274	0.8555
Apex Point	2023-03-05	385	604	57	442	0.8552
Looking Up I See Only A Ceiling	2023-03-09	12	147	7	19	0.855
Magic Tower & Maidens	2023-02-27	61	124	5	66	0.8547
Robolife2-Nova Duty	2023-03-11	892	313	24	916	0.8545
Revenant	2023-03-29	20	74	1	21	0.8545
Crafty Survivors	2023-03-15	374	198	12	386	0.8544
Emberfate: Tempest of Elements	2023-01-27	21	59	0	21	0.8542000000000001
DIG - Deep In Galaxies	2023-03-08	40	73	1	41	0.8539
與經紀人戀愛是絕對禁止2	2023-03-12	518	264	19	537	0.8538
It Comes In Waves	2023-04-05	19	86	2	21	0.8537
Weird and Unfortunate Things Are Happening	2023-02-06	29	58	0	29	0.8534999999999999
EVERSPACE™ 2	2023-04-06	9760	5400	732	10492	0.8531000000000001
SHUFFLE! Episode 2 ~Kami ni mo Akuma ni mo Nerawareteiru Otoko~	2023-03-10	89	120	5	94	0.8527
Handyman Legend	2023-03-10	1002	484	45	1047	0.8521
觅光：第一章 - Seeking Light : Chapter 1	2023-03-25	28	56	0	28	0.8520000000000001
Postmouse	2023-01-30	123	482	45	168	0.8518000000000001
Horny Warp	2023-02-17	218	210	14	232	0.8518000000000001
Corsair`s Madness Prologue: Jungle`s Island	2023-02-03	46	69	1	47	0.8511
Backfirewall_	2023-01-30	86	178	11	97	0.8508
Troublemaker	2023-03-31	374	458	43	417	0.8505
Zup! Q	2023-03-08	33	68	1	34	0.8504
Witch's Garden	2023-04-07	117	68	1	118	0.8504
Drawing From Memory	2023-02-08	134	147	8	142	0.8503000000000001
FATAL FRAME / PROJECT ZERO: Mask of the Lunar Eclipse	2023-03-09	1372	734	79	1451	0.8493
Temple Of Snek	2023-02-15	21	134	7	28	0.8490000000000001
我在终点线等你	2023-03-24	22	66	1	23	0.8489
上古传说	2023-04-02	126	219	16	142	0.8484999999999999
9 Childs Street	2023-02-16	30	235	18	48	0.8479000000000001
KOP KILLER 22XX	2023-03-07	6	51	0	6	0.8478
Souls of White Star	2023-03-30	86	88	3	89	0.8473
Organs Please	2023-04-05	62	150	9	71	0.8472
Selene ~Apoptosis~	2023-02-17	704	1527	192	896	0.8471
Ash of Gods: The Way Prologue	2023-03-09	747	250	20	767	0.8471
Zero-G Gunfight	2023-02-17	6	50	0	6	0.8469
In Sink: A Co-Op Escape Prologue	2023-02-25	1323	1167	142	1465	0.8464
Tower Escape	2023-02-15	283	213	16	299	0.8464
ITRP _ Aero Star	2023-03-09	91	75	2	93	0.8462999999999999
Aery - Calm Mind 3	2023-03-31	5	49	0	5	0.846
Fateweaver: The Alchemist's Quandary	2023-02-27	8	49	0	8	0.846
Tanky Tanks 2	2023-03-20	6	49	0	6	0.846
Girl & Gem Magic	2023-03-31	85	211	16	101	0.8456999999999999
Battle Ram	2023-01-06	4403	887	104	4507	0.8456
Relic Dudes	2023-02-03	86	173	12	98	0.8449
Let's Pet Pets	2023-01-17	12	61	1	13	0.8449
Final Profit: A Shop RPG	2023-03-06	34	73	2	36	0.8448000000000001
The Farmer Was Replaced	2023-02-10	23	47	0	23	0.8441
ARK and ADE	2023-03-02	13	72	2	15	0.8440000000000001
Aery VR - A Journey Beyond Time	2023-03-24	4	60	1	5	0.8440000000000001
Gone Rogue	2023-03-01	59	83	3	62	0.8439
Nebula	2023-01-25	67	82	3	70	0.8431000000000001
The Space-Eating Croc	2023-03-04	12	59	1	13	0.8431000000000001
Super Cakeboy	2023-03-16	23	46	0	23	0.8431000000000001
东方雪莲华 ～ Abyss Soul Lotus.	2023-02-02	290	309	29	319	0.8425
Crush the Industry	2023-03-31	112	70	2	114	0.8423999999999999
Robo Maestro	2023-01-20	12	58	1	13	0.8422000000000001
Powerful Courses	2023-03-06	7	45	0	7	0.8421
Cataclysm: Dark Days Ahead	2023-03-31	114	120	7	121	0.8416
WooLoop	2023-01-13	404	829	101	505	0.8414
8-Bit Adventures 2	2023-01-31	64	100	5	69	0.8412999999999999
POOSTALL Royale	2023-04-01	164	572	65	229	0.841
Deceive Inc.	2023-03-21	2310	1419	190	2500	0.8406
Waves of Steel	2023-02-06	112	278	26	138	0.8404
Methods: The Canada Files	2023-02-01	19	56	1	20	0.8403
Brave Soldier - Invasion of Cyborgs	2023-02-03	6	43	0	6	0.84
Breakers Collection	2023-01-12	78	67	2	80	0.8399
Loretta	2023-02-16	48	135	9	57	0.8397
Evacuation	2023-01-06	119	584	68	187	0.8395
Unbreakable Vr Runner	2023-03-06	5	55	1	6	0.8394
Terraformers	2023-03-09	1853	1435	195	2048	0.8393
Vengeful Guardian: Moonrider	2023-01-12	103	226	20	123	0.8390000000000001
江城创业记	2023-03-31	1126	334	34	1160	0.8388
LOUD	2023-02-23	13	42	0	13	0.8388
Girl Fantasy	2023-02-10	170	385	41	211	0.8386
Atomic Heart	2023-02-20	38469	17536	2941	41410	0.8384
Pocky & Rocky Reshrined	2023-02-24	34	65	2	36	0.8381000000000001
Elle: Portal	2023-02-17	46	114	7	53	0.838
STRANGER OF PARADISE FINAL FANTASY ORIGIN	2023-04-06	2544	454	51	2595	0.8378
Garden in!	2023-01-26	63	131	9	72	0.8375
Fears to Fathom - Episode 3	2023-01-09	383	627	76	459	0.8373999999999999
Tails: The Backbone Preludes	2023-02-02	55	113	7	62	0.8373999999999999
Breakout 13	2023-01-09	11996	4041	625	12621	0.8373
PARANOIA PLACE	2023-02-13	68	205	18	86	0.8371
Half-Life 2: VR Mod - Episode Two	2023-04-06	113	94	5	118	0.8371
Barbaria	2023-02-09	13	84	4	17	0.8369
Truxton	2023-02-14	30	40	0	30	0.8365
Slobbish Dragon Princess 3	2023-03-14	15	40	0	15	0.8365
Into The Flames	2023-01-10	212	755	97	309	0.8355
Children of Silentown	2023-01-11	285	365	40	325	0.8354
Have a Nice Death	2023-03-22	2510	5917	959	3469	0.8353
See You Later	2023-02-14	10	51	1	11	0.8353
Misericorde: Volume One	2023-03-24	17	39	0	17	0.8353
Miniland Adventure: Prologue	2023-03-13	525	303	32	557	0.8343
Future Radio	2023-02-17	97	142	11	108	0.8341
Conjury Revell	2023-02-07	25	125	9	34	0.8340000000000001
Rising Front	2023-01-14	663	860	115	778	0.8339
West Hunt	2023-03-23	449	662	85	534	0.8334999999999999
Zombie Admin	2023-01-13	8	49	1	9	0.833
My Girlfriend’s Special Place	2023-03-13	15	49	1	16	0.833
A War of a Madman's Making	2023-01-15	10	37	0	10	0.8327
Helpless	2023-03-10	34	88	5	39	0.8326000000000001
Siege of Dungeon	2023-01-12	95	155	13	108	0.8323999999999999
GunSuit Guardians	2023-03-31	85	59	2	87	0.8323
Diary of Lucie	2023-02-24	156	296	32	188	0.8321
MINDHACK	2023-04-05	195	48	1	196	0.8319
Phantom Tentacle	2023-03-31	19	337	38	57	0.8318000000000001
TitTok Kitty	2023-02-14	6	36	0	6	0.8314
Ghostland Yard	2023-03-28	16	36	0	16	0.8314
Interior Worlds	2023-04-07	35	36	0	35	0.8314
I commissioned some bunnies	2023-01-26	11	36	0	11	0.8314
Life After Magic	2023-03-23	16	36	0	16	0.8314
Flashback	2023-02-20	119	153	13	132	0.8312999999999999
銀斧 The Honest Elf	2023-03-05	17	58	2	19	0.8312999999999999
Swords and Sandals Immortals	2023-03-09	326	652	86	412	0.831
Ogu and the Secret Forest	2023-03-24	235	120	9	244	0.8308
Neptunia: Sisters VS Sisters	2023-01-24	417	374	44	461	0.8306
The Missing Parts of Maria Gwozdek	2023-02-10	12	57	2	14	0.8301999999999999
LoFi Hotel	2023-02-04	6	35	0	6	0.8300000000000001
Physical Layer	2023-03-16	43	35	0	43	0.8300000000000001
Broken Universe - Tower Defense	2023-02-05	387	210	21	408	0.8297
Dread Templar	2023-01-26	159	837	117	276	0.8295
YOLKED	2023-04-06	8	46	1	9	0.8295
Veil of Dust: A Homesteading Game	2023-04-02	14	46	1	15	0.8295
DESTRUCTURE: Among Debris	2023-02-27	15	46	1	16	0.8295
Rich Lady's Slave Role Play	2023-03-16	68	75	4	72	0.8292
Absinthia	2023-03-13	12	34	0	12	0.8285
XXX_CYBERRAT_XXX	2023-02-20	37	74	4	41	0.8283
Netherguild	2023-03-27	21	45	1	22	0.8281999999999999
Yggdra Union	2023-02-07	118	91	6	124	0.8279000000000001
Song Of The Prairie	2023-04-07	927	154	14	941	0.8277
大侠立志传	2023-03-08	28936	5218	898	29834	0.8276000000000001
HITLER: BDSM BUNKER	2023-02-11	403	90	6	409	0.8271
Finnish Army Simulator	2023-01-13	456	287	33	489	0.8270000000000001
DARK NIGHT WITH FLOPPA	2023-01-06	12	239	26	38	0.8270000000000001
Stuffo the Puzzle Bot	2023-03-02	9	33	0	9	0.8270000000000001
Low Oxygen	2023-03-16	46	63	3	49	0.8262999999999999
WW2 Rebuilder	2023-01-16	1219	608	84	1303	0.8258
Alien maze	2023-02-10	20	143	13	33	0.8257
枪神出击	2023-01-30	490	43	1	491	0.8255
Awakened Evil	2023-01-30	6	32	0	6	0.8255
The Pyramid Of Bones	2023-02-14	16	32	0	16	0.8255
乱世无双	2023-03-08	24	71	4	28	0.8254000000000001
Full Metal Sergeant	2023-04-03	151	52	2	153	0.8244
Spiritfall	2023-04-03	587	259	30	617	0.8243
Berry People	2023-02-14	11	61	3	14	0.8242
Mage Kanade's Futanari Dungeon Quest	2023-03-14	152	140	13	165	0.8239000000000001
Limbus Company	2023-02-26	30225	7546	1376	31601	0.8234
Beer Factory - Prologue	2023-03-13	1279	665	96	1375	0.8231
HELLCARD: Prologue	2023-01-30	482	282	34	516	0.8231
Dear Monster	2023-01-17	102	51	2	104	0.8231
Bumblebee - Little Bee Adventure	2023-02-10	6	51	2	8	0.8231
Scorchlands	2023-02-07	24	41	1	25	0.8227
Eggcelerate! to the Tropics	2023-03-30	15	41	1	16	0.8227
Tell Some Story: Foz	2023-02-02	9	30	0	9	0.8222
Gore Storm	2023-03-10	15	30	0	15	0.8222
TerraScape	2023-04-05	353	137	13	366	0.8220999999999999
TET	2023-01-31	5	59	3	8	0.8219
Unholy Angel	2023-01-16	11	50	2	13	0.8219
Pets Hotel: Prologue	2023-01-25	197	239	28	225	0.8217
Brave's Rage	2023-02-01	160	205	23	183	0.8214
Missing Hiker	2023-02-14	169	954	148	317	0.8212999999999999
NSFW Solitaire	2023-01-27	70	114	10	80	0.8212999999999999
Yihongyuan	2023-03-02	416	496	70	486	0.8205
Akka Arrh	2023-02-21	15	29	0	15	0.8204000000000001
Rustled Pete	2023-02-28	8	29	0	8	0.8204000000000001
ToriDori	2023-04-06	13	29	0	13	0.8204000000000001
柒愿传说	2023-04-01	8	29	0	8	0.8204000000000001
天外武林 (Traveler of Wuxia)	2023-01-06	5874	2093	359	6233	0.8199
The Sea-demon	2023-01-06	75	168	18	93	0.8197
Catch Me!	2023-01-24	24	39	1	25	0.8197
ハッピーライヴ ショウアップ！	2023-03-10	23	39	1	24	0.8197
The Secret of Darkwoods	2023-03-28	21	39	1	22	0.8197
Sunrider 4: The Captain's Return	2023-02-08	199	126	12	211	0.8195
Treason	2023-01-31	226	383	52	278	0.8194
The Black Grimoire: Cursebreaker	2023-03-10	137	89	7	144	0.8193000000000001
inhabit	2023-01-27	7	28	0	7	0.8186
DEFECTIVE	2023-02-03	4	28	0	4	0.8186
Tactical Command	2023-01-27	11	28	0	11	0.8186
Jury	2023-04-02	60	28	0	60	0.8186
Dusk of the Cage	2023-02-21	7	28	0	7	0.8186
Smalland: Survive the Wilds	2023-03-29	12741	2200	384	13125	0.8184
Sons Of The Forest	2023-02-23	414257	99696	20716	434973	0.8183
Outlanders	2023-03-07	147	95	8	155	0.818
Wretched Depths	2023-03-24	20	64	4	24	0.8178000000000001
File Destined	2023-02-25	32	171	19	51	0.8177
HELLCARD	2023-02-16	3539	916	147	3686	0.8173
Reshaping Mars	2023-03-30	642	568	85	727	0.8173
你农我农-Need Know What Know	2023-02-05	84	94	8	92	0.8170999999999999
Lunar Mirror:The Pavilion of Desire	2023-03-04	1331	605	92	1423	0.8167
One Night At Barneys 3	2023-01-05	24	86	7	31	0.8166
Joshua's Legs	2023-01-18	5	27	0	5	0.8166
QUALIA ~The Path of Promise~	2023-02-03	12	27	0	12	0.8166
Joe Wander	2023-02-03	12	27	0	12	0.8166
不可思异世界	2023-01-17	10	27	0	10	0.8166
Luckily, My Arm Is A Shotgun	2023-02-22	3	27	0	3	0.8166
Hydrofoil Generation	2023-02-16	39	37	1	40	0.8165000000000001
Ballistic Zen	2023-01-25	9	37	1	10	0.8165000000000001
Wall World	2023-04-05	4403	924	150	4553	0.8163
Wander Hero	2023-01-12	851	499	74	925	0.8161
Terra Nil	2023-03-28	5916	1732	305	6221	0.8149
UnderDungeon	2023-01-13	7	45	2	9	0.8148000000000001
Forrader Hero	2023-01-23	28	45	2	30	0.8148000000000001
Forest Of Relics	2023-01-25	10	45	2	12	0.8148000000000001
Helvetii	2023-02-03	21	36	1	22	0.8147
Deadnaut: Signal Lost	2023-03-28	56	36	1	57	0.8147
Mythargia	2023-02-20	7	26	0	7	0.8146
FUR Squadron	2023-03-16	5	26	0	5	0.8146
Iron Mandate	2023-03-11	42	69	5	47	0.8145
Dice Kingdoms	2023-04-03	110	53	3	113	0.8142
Ancient Saga: Vikings Journey - Resource Management Simulator	2023-03-10	20	53	3	23	0.8142
Puppet Master: The Game	2023-03-01	249	293	40	289	0.8138
SpaceBourne 2	2023-02-17	1241	1384	241	1482	0.8137000000000001
The Wreck	2023-03-14	20	68	5	25	0.8134
Paperback Adventures	2023-01-30	22	44	2	24	0.8133
Digimon World: Next Order	2023-02-21	1685	429	64	1749	0.813
World Of Mystery	2023-01-08	362	117	12	374	0.813
Toy Tactics	2023-03-17	12	35	1	13	0.813
Star Ring	2023-01-20	38	52	3	41	0.8129000000000001
山海灵妖录	2023-03-03	362	434	65	427	0.8128000000000001
Tactical Assault VR	2023-03-27	185	278	38	223	0.8127
The Director's Disorder: Pilot Episode	2023-01-19	57	162	19	76	0.8126000000000001
Agent in Depth	2023-01-20	20	103	10	30	0.8126000000000001
Buildest	2023-03-24	10	25	0	10	0.8125
BLACK★ACADEMY	2023-03-17	11	25	0	11	0.8125
No:Worse	2023-03-16	6	25	0	6	0.8125
Konkan Coast Pirate Solutions	2023-03-01	6	25	0	6	0.8125
I commissioned some cats	2023-02-16	11	25	0	11	0.8125
September 7th	2023-01-06	149	808	134	283	0.8122
Magic Research	2023-03-23	1109	59	4	1113	0.8117000000000001
Shiner	2023-03-18	28	59	4	32	0.8117000000000001
Nienix	2023-03-24	352	179	22	374	0.8115000000000001
2112TD: Tower Defense Survival	2023-01-19	332	172	21	353	0.8111
Lost Cartridge - Cold Read	2023-12-31	15	34	1	16	0.8111
Zedfest	2023-04-07	19	159	19	38	0.8107
Hero's Quest: Automatic Roguelite RPG	2023-03-16	137	80	7	144	0.8105
Belle Automata	2023-03-03	13	24	0	13	0.8103
Takara Cards	2023-03-28	5	24	0	5	0.8103
Chief Emoji Officer	2023-04-07	7	24	0	7	0.8103
Pipe Dreams	2023-03-31	5	24	0	5	0.8103
Citizens: Far Lands - Prologue	2023-03-07	145	100	10	155	0.81
SATUS	2023-02-10	13	42	2	15	0.81
Like a Dragon: Ishin!	2023-02-21	8461	2315	437	8898	0.8098000000000001
Spectator	2023-02-07	16	65	5	21	0.8098000000000001
The Wall Mustn't Fall	2023-01-09	43	33	1	44	0.8092
The Voidness - LIDAR Horror Survival Game	2023-04-07	23	33	1	24	0.8092
Bad cat Sam	2023-01-25	12	57	4	16	0.809
Lucie Adult Game HD	2023-01-10	120	92	9	129	0.8088
X Invader: Prologue	2023-02-01	549	451	71	620	0.8087000000000001
United heist	2023-02-12	335	732	124	459	0.8086
Monster Girl 1,000	2023-04-02	416	49	3	419	0.8084
Under Maintenance	2023-02-14	34	41	2	36	0.8083
Labyrinth of Galleria: The Moon Society	2023-02-14	859	197	26	885	0.8081999999999999
Sakura Succubus 7	2023-03-06	22	23	0	22	0.8079000000000001
Speedonauts	2023-02-21	5	23	0	5	0.8079000000000001
Gum Ball Run	2023-01-09	206	440	70	276	0.8072
Lovely Crush	2023-04-10	15	32	1	16	0.8072
The Test: Secrets of the Soul 2	2023-04-10	9	32	1	10	0.8072
Warman	2023-04-03	26	48	3	29	0.8069
Sorry We're Open	2023-02-18	19	40	2	21	0.8066
Athenian Rhapsody: Thunder Goober's Personality Dungeon	2023-03-23	13	40	2	15	0.8066
Earth's Shadow	2023-01-31	15	69	6	21	0.8059999999999999
Cold Shell	2023-02-28	5	22	0	5	0.8054000000000001
Oedo Trigger!!	2023-01-13	29	22	0	29	0.8054000000000001
TeamPunk	2023-01-20	8	22	0	8	0.8054000000000001
Museum of Monoliths	2023-02-28	3	22	0	3	0.8054000000000001
Apex Armor Swap Trainer	2023-04-07	15	22	0	15	0.8054000000000001
I Won't Forget Hue	2023-01-20	32	120	14	46	0.8052
Squirrel Launcher	2023-01-31	32	120	14	46	0.8052
HYPERBLADE	2023-02-01	9	31	1	10	0.8051
Deflector	2023-03-24	629	225	32	661	0.8049
Family curse	2023-03-31	23	39	2	25	0.8048000000000001
Horde Hunters	2023-02-16	47	39	2	49	0.8048000000000001
Bone Dust	2023-02-21	13	54	4	17	0.8047
LUNARK	2023-03-30	57	94	10	67	0.8044
Undead Horde 2: Necropolis	2023-03-30	839	177	24	863	0.8036
The Beast In The Cave	2023-02-07	21	46	3	24	0.8036
The Fernweh Saga: Book One	2023-01-05	114	67	6	120	0.8034
Nope Nope Nope Nurses	2023-01-20	20	53	4	24	0.8031999999999999
bearcycle	2023-03-03	11	30	1	12	0.8029999999999999
Wet Sand	2023-01-06	9	30	1	10	0.8029999999999999
Keep the Keep	2023-03-15	4	21	0	4	0.8028000000000001
First Racer	2023-04-05	10	21	0	10	0.8028000000000001
Super Greedy Cat	2023-03-29	4	21	0	4	0.8028000000000001
Endless Nesla	2023-01-24	4	21	0	4	0.8028000000000001
메스가키 영애님!	2023-01-20	22	66	6	28	0.8020999999999999
远征三国-策略卡牌	2023-02-17	49	104	12	61	0.802
The Simulacrum	2023-01-17	16	45	3	19	0.8019
Germinal	2023-03-09	10	37	2	12	0.8009000000000001
Offroad Mechanic Simulator: Prologue - First Job	2023-04-03	58	37	2	60	0.8009000000000001
三国真龙传	2023-02-13	12	37	2	14	0.8009000000000001
GunSoul Girl 2	2023-03-30	180	370	61	241	0.8008
Research Story	2023-02-21	96	65	6	102	0.8008
Hellscreen	2023-03-09	7	29	1	8	0.8007
Conur Life	2023-03-06	7	29	1	8	0.8007
A TAVERN FOR TEA	2023-03-24	8	29	1	9	0.8007
Verlet Ascend	2023-02-28	20	58	5	25	0.8004000000000001
Land of the Mage Lords	2023-01-29	18	51	4	22	0.8001
Joon Shining	2023-02-17	3	20	0	3	0.8
Elohim Eternal: The Babel Code	2023-01-30	9	20	0	9	0.8
Heartwood Heroes	2023-03-27	43	20	0	43	0.8
The Overlord Isn't Another Isekai Protagonist, Is He?	2023-02-17	8	20	0	8	0.8
奇谭文字游戏	2023-02-09	9	20	0	9	0.8
SokoChess White	2023-03-03	8	20	0	8	0.8
Shooting Saucer	2023-04-06	11	20	0	11	0.8
Hood Warfare	2023-01-26	25	64	6	31	0.7995000000000001
Dark Chess	2023-02-28	27	101	12	39	0.7992
Socrates Jones: Pro Philosopher	2023-03-28	15	36	2	17	0.7989
Striving for Light: Survival	2023-02-20	55	50	4	59	0.7984
BDSM Love	2023-01-06	10	43	3	13	0.7983
Finding Xavier	2023-01-20	5	43	3	8	0.7983
Snafu	2023-03-08	11	43	3	14	0.7983
WHALIEN - Unexpected Guests	2023-01-24	9	28	1	10	0.7983
Re:Call	2023-01-17	13	28	1	14	0.7983
Fairy Biography3 : Obsession	2023-03-24	166	167	24	190	0.7974
《奇门遁甲》	2023-01-01	137	172	25	162	0.7972
The Legend of Heroes: Kuro no Kiseki Ⅱ -CRIMSON SiN-	2023-01-25	1071	313	52	1123	0.7970999999999999
Drakkar Crew	2023-03-27	9	19	0	9	0.7970999999999999
Asfalia	2023-01-23	5	19	0	5	0.7970999999999999
Mega Mall Story 2	2023-03-06	67	19	0	67	0.7970999999999999
Linked Worlds	2023-03-29	10	19	0	10	0.7970999999999999
FAKE HEART	2023-03-25	9	19	0	9	0.7970999999999999
Memory Traces: Egypt	2023-02-17	6	19	0	6	0.7970999999999999
Brick Odyssey	2023-01-25	14	19	0	14	0.7970999999999999
Wind Up	2023-01-12	27	19	0	27	0.7970999999999999
Logic - Keypad	2023-03-10	3	19	0	3	0.7970999999999999
Ashes of War	2023-01-27	6	19	0	6	0.7970999999999999
Endless Dark	2023-02-22	6	19	0	6	0.7970999999999999
TRAUMA Broken Paradise	2023-03-03	4	19	0	4	0.7970999999999999
降妖散记	2023-04-03	883	272	44	927	0.797
District Steel	2023-02-16	8	35	2	10	0.7968000000000001
No Questions Asked	2023-01-09	4	35	2	6	0.7968000000000001
幻斋阴阳录 Genzai:Serialization	2023-01-20	45	110	14	59	0.7966
Mr. Hopp's Playhouse 3	2023-03-17	38	42	3	41	0.7965000000000001
Tokyo Necro	2023-03-13	76	68	7	83	0.7962
Spellmasons	2023-01-31	127	92	11	138	0.7961
The Tales of Bayun	2023-02-16	41	86	10	51	0.7959999999999999
Story of Animal Sprite	2023-04-07	26	27	1	27	0.7958
Black Reliquary	2023-03-24	542	247	40	582	0.7951
Within The Backrooms	2023-01-13	9	34	2	11	0.7946
Potion Brew: Co-op	2023-01-05	14	34	2	16	0.7946
Webcam Sex	2023-01-20	9	34	2	11	0.7946
Drop - System Breach	2023-03-28	54	41	3	57	0.7945000000000001
Chef Life: A Restaurant Simulator	2023-02-23	840	476	87	927	0.7942
Painting Werther	2023-02-14	4	18	0	4	0.7939
Palette Swap	2023-01-21	4	18	0	4	0.7939
Bullet Casters	2023-03-28	8	18	0	8	0.7939
За Закатом Неминуем Рассвет	2023-03-31	6	18	0	6	0.7939
Kairobotica	2023-01-16	21	18	0	21	0.7939
Zellige: The Tilemaker of Granada	2023-02-17	4	18	0	4	0.7939
FFF	2023-02-14	6	18	0	6	0.7939
Project Malice	2023-01-20	12	18	0	12	0.7939
呆呆大冒险	2023-02-22	20	18	0	20	0.7939
UnknownPyramid	2023-02-22	36	18	0	36	0.7939
ZaBaTa!	2023-03-28	19	18	0	19	0.7939
100 Keys To Your Heart	2023-01-16	3	18	0	3	0.7939
Hope	2023-01-27	3	18	0	3	0.7939
Pretend Cars Racing	2023-03-08	4	18	0	4	0.7939
Side Scape	2023-01-27	4	18	0	4	0.7939
The Castle Burns!	2023-03-03	6	18	0	6	0.7939
Yukiiro Sign	2023-03-24	11	18	0	11	0.7939
Vernal Edge	2023-03-14	208	249	41	249	0.7936
Locked In Mind	2023-01-04	82	244	40	122	0.7936
SGS Taipings	2023-01-19	89	101	13	102	0.7934000000000001
Belial Red	2023-03-11	218	47	4	222	0.7931999999999999
Project Astra Dominium	2023-03-29	12	26	1	13	0.7931999999999999
三國立志傳	2023-01-10	36	26	1	37	0.7931999999999999
The Adventures of LinShanHai	2023-02-01	13	26	1	14	0.7931999999999999
Chaos Galaxy 2	2023-01-06	107	171	26	133	0.7931
GRANDMA	2023-01-07	30	170	26	56	0.7925
Tropicalia	2023-02-28	14	53	5	19	0.7925
AlexanderBall: A Countryball Tale	2023-01-20	23	40	3	26	0.7925
Voltaire - The Vegan Vampire	2023-02-27	49	59	6	55	0.7922
Territory: Farming and Fighting	2023-01-12	122	153	23	145	0.7916
Redtape	2023-02-14	11	46	4	15	0.7914
Barista Simulator	2023-01-12	78	136	20	98	0.7906000000000001
Minigame Game	2023-02-03	8	17	0	8	0.7905
We Are Screwed!	2023-03-01	17	17	0	17	0.7905
Magirune 2	2023-01-11	12	17	0	12	0.7905
Temple of Starlight	2023-01-24	6	17	0	6	0.7905
Infested Fortress	2023-03-02	17	17	0	17	0.7905
Burg Wimmel	2023-03-06	5	17	0	5	0.7905
CucumbeRunner	2023-03-06	9	17	0	9	0.7905
Ibis AM	2023-02-17	5	17	0	5	0.7905
Frack the World	2023-03-01	8	17	0	8	0.7905
Beep's Escape	2023-02-16	5	17	0	5	0.7905
Spirit of Midnight: Prologue	2023-02-09	4	17	0	4	0.7905
Sagres	2023-04-03	145	39	3	148	0.7904000000000001
IDEA	2023-03-09	3	25	1	4	0.7904000000000001
Hentai EroCum	2023-02-24	5	25	1	6	0.7904000000000001
CosmoOdyssey 2: Comeback to origin	2023-02-17	3	25	1	4	0.7904000000000001
Meet Your Maker	2023-04-04	3308	1186	249	3557	0.7898999999999999
Attic Panic	2023-03-29	19	32	2	21	0.7898999999999999
Doomsday Robot Girl	2023-01-10	129	135	20	149	0.7898000000000001
Tanks in Labyrinth	2023-02-03	40	75	9	49	0.7897
METAL DOGS	2023-03-24	924	578	113	1037	0.7895000000000001
Castle Warriors	2023-02-23	45	45	4	49	0.7895000000000001
Elderand	2023-02-16	203	210	35	238	0.7891
Combat Mission: Battle for Normandy	2023-03-28	104	51	5	109	0.7891
Drain Mansion	2023-03-09	167	80	10	177	0.7889
捉妖物语2	2023-01-18	499	836	172	671	0.7883
Furry Sex 2	2023-01-13	8	38	3	11	0.7883
CUBEMATRIX	2023-01-27	24	96	13	37	0.7881999999999999
Arrogation: Unlight of Day	2023-01-28	43	223	38	81	0.7881
One Military Camp	2023-03-02	822	183	30	852	0.7877
Forest Fire	2023-01-10	22	44	4	26	0.7875
林中人	2023-01-29	9	44	4	13	0.7875
1997	2023-03-30	13	24	1	14	0.7875
Rabat Protocol:Metal Rhapsody	2023-03-25	13	24	1	14	0.7875
Inkulinati	2023-01-31	240	132	20	260	0.7874
The Survival of Sarah Rose	2023-01-19	24	31	2	26	0.7874
Gladiators and Glory	2023-03-03	14	31	2	16	0.7874
Colossal Cave	2023-01-19	35	50	5	40	0.7873000000000001
Atrio: The Dark Wild	2023-01-10	455	330	61	516	0.787
Tebb	2023-02-01	3	16	0	3	0.7869
ShemHaMephorash	2023-03-29	8	16	0	8	0.7869
Human or Not	2023-01-20	9	16	0	9	0.7869
HIGhSCORE	2023-03-09	8	16	0	8	0.7869
GUN KING	2023-03-03	5	16	0	5	0.7869
The Legend of Gwen	2023-02-16	4	16	0	4	0.7869
Trouble in Tornado Town	2023-01-06	3	16	0	3	0.7869
Kill Your Shapes	2023-03-31	5	16	0	5	0.7869
GachaHell	2023-04-07	7	16	0	7	0.7869
Returnal™	2023-02-15	6691	3424	793	7484	0.7867000000000001
Daydream: Prologue	2023-03-03	722	306	56	778	0.7867000000000001
My dream setup	2023-02-20	497	575	116	613	0.7857
Saint Maker	2023-02-22	40	72	9	49	0.7857
Escape First Alchemist	2023-03-02	161	155	25	186	0.7856000000000001
Artificiality-人造物-	2023-02-25	28	30	2	30	0.7848
Flame Keeper	2023-03-17	20	30	2	22	0.7848
Elfheim - Chapter 1	2023-12-31	19	30	2	21	0.7848
Hentai Fox	2023-02-03	7	30	2	9	0.7848
Rogue AI Simulator	2023-01-12	264	212	37	301	0.7847
ONE PIECE ODYSSEY	2023-01-12	7545	1589	356	7901	0.7845000000000001
Alephant	2023-03-01	14	23	1	15	0.7844
Madorica Real Estate 2 - The mystery of the new property -	2023-02-08	12	23	1	13	0.7844
Guardians Frontline	2023-03-09	35	113	17	52	0.7841
Death in the Water 2	2023-01-26	344	541	110	454	0.784
Ogre Chambers DX	2023-03-03	39	54	6	45	0.784
The Exсrawlers	2023-02-27	15	36	3	18	0.7837000000000001
EXS2～EthnologySister2：Structuralism of kinship system	2023-01-20	11	36	3	14	0.7837000000000001
UC Love	2023-03-01	14	36	3	17	0.7837000000000001
丸转三国	2023-01-07	23	48	5	28	0.7836
Life Gallery	2023-01-12	49	142	23	72	0.7831999999999999
All-In-One Sports VR	2023-04-07	51	383	75	126	0.7831
Return to abyss 重返深渊	2023-01-06	2066	585	121	2187	0.783
One Giant Leap	2023-01-08	4	15	0	4	0.783
Checkmate Kings	2023-01-30	5	15	0	5	0.783
Operator8	2023-03-31	3	15	0	3	0.783
BETA-SIXDOUZE	2023-02-10	4	15	0	4	0.783
RUSHAWAY	2023-02-23	6	15	0	6	0.783
超级破碎球	2023-03-11	3	15	0	3	0.783
The secret pyramid VR	2023-01-18	4	15	0	4	0.783
Super Video Golf	2023-02-02	6	15	0	6	0.783
COSMIC HOLES	2023-03-13	3	15	0	3	0.783
Anime RPG: Isekai Journey	2023-03-10	6	15	0	6	0.783
可识此阵	2023-01-25	6	15	0	6	0.783
Finger Football: Goal in One	2023-02-24	2	15	0	2	0.783
Jigsaw Puzzle Delicious Foods	2023-03-09	4	15	0	4	0.783
Vampire Story	2023-03-24	7	15	0	7	0.783
9 Years of Shadows	2023-03-27	316	517	106	422	0.7823000000000001
Apocalyptic Vibes	2023-03-02	37	75	10	47	0.7823000000000001
Innchanted	2023-03-28	133	53	6	139	0.7822
Schildmaid MX	2023-03-24	15	29	2	17	0.7820999999999999
Dream Bright	2023-02-21	14	29	2	16	0.7820999999999999
BACKROOMS: APPREHENSION	2023-01-31	242	85	12	254	0.7816
Whackerball	2023-01-30	17	41	4	21	0.7813
Interstellar Pilot 2	2023-01-02	25	35	3	28	0.7813
Isle of Pan	2023-01-10	6	22	1	7	0.7811
Relic Space	2023-03-09	23	22	1	24	0.7811
COTTOn Rock'n'Roll	2023-01-06	22	22	1	23	0.7811
The Safe Place	2023-03-22	9	22	1	10	0.7811
Otome Legends	2023-02-08	5	22	1	6	0.7811
Alice Escaped!	2023-01-27	145	134	22	167	0.7806000000000001
Gachi: Christmas Party 🎄	2023-01-07	36	68	9	45	0.7798999999999999
Rough Justice: '84	2023-03-13	34	46	5	39	0.7796
Aashaa	2023-01-27	8	46	5	13	0.7796
Burger Bistro Story	2023-01-16	133	57	7	140	0.7794
Supplice	2023-04-06	112	118	19	131	0.7793000000000001
时灵：星辰愚者	2023-02-14	55	78	11	66	0.7793000000000001
Graveyard Architect	2023-02-23	6	28	2	8	0.7792
MeiQi 2023	2023-02-20	17	28	2	19	0.7792
Undead World	2023-03-10	25	28	2	27	0.7792
The You Testament 2D	2023-02-01	10	28	2	12	0.7792
yni^	2023-02-28	4	28	2	6	0.7792
Beyond the Wall	2023-03-21	6	28	2	8	0.7792
You are the weapon	2023-01-03	9	93	14	23	0.779
Sexy Milfs	2023-01-27	9	34	3	12	0.7787999999999999
Helmetman	2023-03-13	19	34	3	22	0.7787999999999999
Cyber Cult City	2023-03-28	3	14	0	3	0.7787000000000001
天地情殇	2023-02-28	12	14	0	12	0.7787000000000001
Strange Town	2023-03-24	10	14	0	10	0.7787000000000001
The Pyraplex	2023-02-13	26	14	0	26	0.7787000000000001
Unforgettable Voyage	2023-03-01	4	14	0	4	0.7787000000000001
The Senex Bird	2023-02-22	4	14	0	4	0.7787000000000001
Ruined Kingdom	2023-03-01	4	14	0	4	0.7787000000000001
Flower Memories	2023-02-01	3	14	0	3	0.7787000000000001
Sky Strikers VR	2023-03-05	15	14	0	15	0.7787000000000001
The militant mouse	2023-01-13	4	14	0	4	0.7787000000000001
Crawlspace 2	2023-01-18	4	14	0	4	0.7787000000000001
The King of Cats	2023-02-16	5	14	0	5	0.7787000000000001
炸弹魔塔 Bomb Tower	2023-03-09	3	14	0	3	0.7787000000000001
Lawnmower Game: Find Trump	2023-02-03	3	14	0	3	0.7787000000000001
TrashMorfers	2023-03-16	2	14	0	2	0.7787000000000001
Words of Wisdom	2023-03-21	3	14	0	3	0.7787000000000001
Rabbi-T	2023-03-07	3	14	0	3	0.7787000000000001
Animalistic	2023-03-01	5	51	6	11	0.7785
Alien Slayers	2023-02-01	47	51	6	53	0.7785
DUCK: Dangerous Ultimate Cartridge Kidnapper	2023-02-14	18	67	9	27	0.7784000000000001
Clunky Hero	2023-01-25	19	72	10	29	0.7781
Kill Pill	2023-01-14	18	56	7	25	0.7777
Refund Me If You Can : Lexy's Story	2023-02-24	4	21	1	5	0.7777
The Legend of Heroes: Kuro no Kiseki	2023-03-02	139	21	1	140	0.7777
Meme Quiz	2023-02-13	5	21	1	6	0.7777
2022生存指南 2022 SURVIVAL GUIDE	2023-03-14	5	21	1	6	0.7777
Gummy Dummy Battles	2023-01-24	8	21	1	9	0.7777
ATONE: Heart of the Elder Tree	2023-01-27	12	45	5	17	0.7775
Ten Dates	2023-02-14	198	186	34	232	0.7774
GROSS	2023-01-11	99	106	17	116	0.777
Ghosts Of Tabor	2023-03-21	1000	1144	265	1265	0.7768
Spelp	2023-01-31	223	39	4	227	0.7767000000000001
Path of the Midnight Sun	2023-01-10	111	86	13	124	0.7765000000000001
Spikair Volleyball	2023-02-06	18	33	3	21	0.7762000000000001
Protect Harem City	2023-02-15	35	33	3	38	0.7762000000000001
Presentiment of Death	2023-03-01	5	27	2	7	0.7762000000000001
Taco Carlos	2023-01-09	11	27	2	13	0.7762000000000001
Senpai Puzzle: Waifu Summer	2023-02-27	6	27	2	8	0.7762000000000001
Arena Renovation	2023-03-27	306	80	12	318	0.7751000000000001
Crimson Dawn	2023-04-11	132	191	36	168	0.7748
Lunar Mirror	2023-01-19	588	623	139	727	0.7745000000000001
Parasomnia	2023-02-18	5	49	6	11	0.7745000000000001
Gachi: Space Orgasm	2023-01-09	84	94	15	99	0.7744
Now There Be Goblins	2023-04-04	8	38	4	12	0.7743000000000001
Mythlink	2023-01-20	2	13	0	2	0.7741
Adventures of The Carrot Captain	2023-04-04	7	13	0	7	0.7741
GRAPPIN	2023-03-24	6	13	0	6	0.7741
Kitten Hero	2023-02-01	3	13	0	3	0.7741
Stars Arisen	2023-03-15	52	13	0	52	0.7741
Super Ninja Miner	2023-03-08	2	13	0	2	0.7741
Frame - Portals on Steroids	2023-01-12	8	13	0	8	0.7741
Carnival of Gods: Oppression	2023-02-21	3	13	0	3	0.7741
Red List Girls.-Andean Flamingo-	2023-02-23	4	13	0	4	0.7741
Forklift Extreme	2023-03-16	12	13	0	12	0.7741
Starway: BaRaider	2023-02-16	4	13	0	4	0.7741
Tower Skydiver	2023-02-15	3	13	0	3	0.7741
Frogurai	2023-03-10	4	13	0	4	0.7741
Web or Dead	2023-02-16	4	13	0	4	0.7741
Wild Seas	2023-02-05	4	13	0	4	0.7741
Unusual Ghost	2023-01-27	3	13	0	3	0.7741
First Person Hooper	2023-02-28	3	13	0	3	0.7741
The House of E.	2023-03-23	5	13	0	5	0.7741
River Tails: Stronger Together	2023-03-16	9	20	1	10	0.774
Public Land Hunter	2023-02-28	8	20	1	9	0.774
Well...	2023-04-01	10	20	1	11	0.774
Hentai Journey	2023-03-24	7	20	1	8	0.774
Eternal Dread 3	2023-03-10	378	126	22	400	0.7734000000000001
Blockworks	2023-01-07	9	32	3	12	0.7734000000000001
Makis Adventure	2023-01-18	16	32	3	19	0.7734000000000001
Out Zone	2023-02-14	13	32	3	16	0.7734000000000001
Alkurai	2023-03-09	24	32	3	27	0.7734000000000001
Card Crawl Adventure	2023-03-01	21	32	3	24	0.7734000000000001
異境迷走	2023-03-23	37	32	3	40	0.7734000000000001
中华一商	2023-02-23	1137	397	85	1222	0.7733
Nucleares	2023-03-13	33	43	5	38	0.7732
Rogue Station	2023-01-26	49	43	5	54	0.7732
Rogue Shift	2023-02-09	11	26	2	13	0.773
Kill The Emperor	2023-01-22	5	26	2	7	0.773
SHIRIME: The Curse of Butt-Eye	2023-03-31	9	26	2	11	0.773
Phantom Brigade	2023-02-28	5671	1627	399	6070	0.7724
Hot And Lovely ：Charm	2023-02-16	666	405	88	754	0.7718
Kingdom of EXPLORERS	2023-03-10	19	37	4	23	0.7718
SpellForce: Conquest of Eo	2023-02-03	3669	1069	256	3925	0.7716
Soul Wargame	2023-01-11	49	101	17	66	0.7715000000000001
台北大空襲 Raid on Taihoku	2023-02-16	91	119	21	112	0.7711
三國立志傳2	2023-03-24	130	42	5	135	0.7709
Mato Anomalies	2023-03-10	49	72	11	60	0.7706999999999999
The Wraith of the Galaxy	2023-02-15	4	31	3	7	0.7706000000000001
Someday You'll Return: Director's Cut	2023-03-07	28	31	3	31	0.7706000000000001
What is snowman made of?	2023-01-17	9	47	6	15	0.7704000000000001
Golgotha	2023-02-21	103	400	88	191	0.7701000000000001
Olgob The Bold	2023-01-20	4	19	1	5	0.77
RPG Stories	2023-04-03	11	19	1	12	0.77
Rayland 2	2023-03-31	7	19	1	8	0.77
Bad Hop Baseball	2023-02-21	6	19	1	7	0.77
Volley Pals	2023-04-07	7	25	2	9	0.7697
Glass Heart	2023-02-03	11	25	2	13	0.7697
Blue Wednesday: Prologue	2023-03-09	23	25	2	25	0.7697
OPEN DOOR	2023-02-02	7	36	4	11	0.7692
Creative Console	2023-01-10	19	36	4	23	0.7692
Hot Heat Reset: Chapter 1	2023-03-02	42	36	4	46	0.7692
Don't Byte Your Tongue	2023-04-07	3	12	0	3	0.7690000000000001
Poly Vita	2023-03-01	5	12	0	5	0.7690000000000001
Kit's Quest	2023-01-06	3	12	0	3	0.7690000000000001
Richman 7	2023-03-16	14	12	0	14	0.7690000000000001
Back Rank Chess	2023-02-04	3	12	0	3	0.7690000000000001
Boundary Walls	2023-02-21	7	12	0	7	0.7690000000000001
Feed Him	2023-02-28	3	12	0	3	0.7690000000000001
The Lone Alien	2023-02-17	6	12	0	6	0.7690000000000001
CRAZY GUY	2023-03-20	3	12	0	3	0.7690000000000001
4 Seasons Runner	2023-04-04	4	12	0	4	0.7690000000000001
Bullet Runner: The First Slaughter	2023-03-24	6	12	0	6	0.7690000000000001
Hidden Harbor 3 Top-Down 3D	2023-03-22	2	12	0	2	0.7690000000000001
AColony	2023-01-19	84	61	9	93	0.7685
A Fox and His Robot	2023-03-01	5	41	5	10	0.7685
Playcraft	2023-01-17	210	557	129	339	0.7683
Armoured Cavalry: Operation Valkyrie	2023-01-12	15	30	3	18	0.7676000000000001
The Karaoke | ヒトカラ	2023-02-04	446	296	64	510	0.7675000000000001
Love n War: Hero by Chance II	2023-01-06	368	201	41	409	0.7673000000000001
Lumencraft	2023-02-28	786	671	160	946	0.7668
Tribe Dash	2023-04-06	25	55	8	33	0.7664
城市弧光	2023-03-03	6	24	2	8	0.7662000000000001
DEFCON: Xenos	2023-01-12	12	24	2	14	0.7662000000000001
Lucky Goal	2023-01-01	55	24	2	57	0.7662000000000001
Save The Girls	2023-02-14	6	24	2	8	0.7662000000000001
EL NE RUE	2023-01-30	14	24	2	16	0.7662000000000001
Elephantasy: Flipside	2023-02-28	13	24	2	15	0.7662000000000001
Turnament	2023-02-17	3	18	1	4	0.7658
Unprompted	2023-03-07	3	18	1	4	0.7658
Dream Fight Will	2023-02-15	7	18	1	8	0.7658
B-Horror: Subway	2023-03-26	5	18	1	6	0.7658
风帆纪元 Sailing Era	2023-01-12	8335	2333	613	8948	0.7656000000000001
RUSLICSTAN INVADES	2023-03-17	29	78	13	42	0.7656000000000001
Star Survivor	2023-03-02	237	169	34	271	0.7654000000000001
Dinogen Online	2023-03-04	96	100	18	114	0.765
Gal Guardians: Demon Purge	2023-02-23	1348	511	121	1469	0.7643000000000001
Gatekeeper: Eclipse	2023-02-27	1133	482	114	1247	0.7637
Pixel Survivors: Roguelike	2023-02-24	169	252	55	224	0.7637
Roller Drama	2023-01-26	7	11	0	7	0.7634000000000001
Orbital Strike VR	2023-01-31	5	11	0	5	0.7634000000000001
BLOOD RITE	2023-03-23	3	11	0	3	0.7634000000000001
SlipDream Resonator	2023-03-01	4	11	0	4	0.7634000000000001
You Are A Pilot	2023-01-19	4	11	0	4	0.7634000000000001
Gem Worlds	2023-01-16	2	11	0	2	0.7634000000000001
Cosmic Ball Tournament	2023-03-02	2	11	0	2	0.7634000000000001
Poly Skies	2023-01-23	6	11	0	6	0.7634000000000001
Pawsecuted	2023-03-24	5	11	0	5	0.7634000000000001
液化物	2023-03-03	3	11	0	3	0.7634000000000001
Basketball Club Story	2023-04-10	131	11	0	131	0.7634000000000001
EXIT The Game – Trail of the Griffin	2023-03-22	14	11	0	14	0.7634000000000001
Amber Trail	2023-02-12	4	11	0	4	0.7634000000000001
Sudden Market	2023-01-20	10	11	0	10	0.7634000000000001
Animal Academy	2023-02-22	4	11	0	4	0.7634000000000001
The Last Craftsman	2023-03-07	4	11	0	4	0.7634000000000001
Midnight Dash	2023-01-09	4	11	0	4	0.7634000000000001
Safehouse	2023-01-22	6	11	0	6	0.7634000000000001
A Symmetric Escape	2023-02-17	3	11	0	3	0.7634000000000001
The Magical Land of Canada	2023-03-08	3	11	0	3	0.7634000000000001
Armored Us	2023-03-13	2	11	0	2	0.7634000000000001
Hentai Oni	2023-03-17	4	11	0	4	0.7634000000000001
My Furry Dragon	2023-03-25	20	23	2	22	0.7625000000000001
Zero Wing	2023-02-14	10	23	2	12	0.7625000000000001
Hentai EroElf	2023-01-06	7	23	2	9	0.7625000000000001
Hole in Won	2023-01-03	12	23	2	14	0.7625000000000001
Sexy New Year	2023-03-31	15	23	2	17	0.7625000000000001
STRIPPERS	2023-04-07	14	23	2	16	0.7625000000000001
The Moroccan Castle 3 : Behind The Secrets	2023-03-20	4	23	2	6	0.7625000000000001
Anemoiapolis	2023-03-04	241	455	108	349	0.7624
Drago Noka	2023-01-12	357	93	17	374	0.7618
Gravity Field	2023-02-22	2386	228	50	2436	0.7614000000000001
PolyShot	2023-03-09	13	17	1	14	0.7613
Slime Warfare	2023-02-17	17	17	1	18	0.7613
Sister Wish	2023-03-02	7	17	1	8	0.7613
Hentai Hanako	2023-01-28	5	17	1	6	0.7613
Grappling Dash	2023-01-27	4	28	3	7	0.7612000000000001
Silent Nights	2023-03-10	10	38	5	15	0.7609
Tristia:legacy	2023-01-20	38	33	4	42	0.7608
Посылка	2023-02-01	11	33	4	15	0.7608
Made In Ohio	2023-03-07	5	33	4	9	0.7608
Scrappage	2023-02-25	16	33	4	20	0.7608
Fantasy World Souls	2023-02-16	18	33	4	22	0.7608
The Last Haven	2023-02-18	429	1603	427	856	0.7604000000000001
The Last Starship	2023-02-15	329	189	41	370	0.7592
Gripper	2023-03-29	33	42	6	39	0.7587999999999999
Femdom Wife Game - Zoe	2023-01-27	26	22	2	28	0.7586
Pocket Harvest	2023-01-16	24	22	2	26	0.7586
回溯勇者 Backdate Hero	2023-01-13	9	22	2	11	0.7586
Maiz	2023-01-20	5	22	2	7	0.7586
Oxygen	2023-04-07	554	107	21	575	0.7582
Nayla's Castle	2023-03-01	29	37	5	34	0.7582
黄泉：孤岛惊魂	2023-01-20	93	299	70	163	0.758
RAIDBORN	2023-03-29	121	90	17	138	0.7578
Chronicles of Forgotten Tears	2023-03-10	82	32	4	86	0.7576999999999999
The Forgotten Tapes: Analog Nightmares	2023-01-23	9	32	4	13	0.7576999999999999
Last Devil	2023-03-16	282	418	102	384	0.7576
GunnRunner	2023-03-17	6	10	0	6	0.7571
Alcyon Infinity	2023-01-16	4	10	0	4	0.7571
Mortal Meal	2023-02-16	3	10	0	3	0.7571
They came from another planet	2023-04-02	2	10	0	2	0.7571
Collab Ball	2023-01-11	6	10	0	6	0.7571
LiMiT's Escape Room Games 2	2023-01-10	9	10	0	9	0.7571
Mini Star Bakery	2023-01-02	11	10	0	11	0.7571
<|>	2023-02-24	2	10	0	2	0.7571
Monster Racing League	2023-03-23	10	10	0	10	0.7571
Martial Fire	2023-01-19	2	10	0	2	0.7571
Car Parking 2	2023-01-19	4	10	0	4	0.7571
Paper Flight - Beyond Time	2023-03-10	5	10	0	5	0.7571
Old Bira´s Farm	2023-01-31	2	10	0	2	0.7571
Flaming Thunderer	2023-01-20	4	10	0	4	0.7571
Lone Traveler	2023-01-20	3	10	0	3	0.7571
Tracadie Bird Shit	2023-01-20	2	10	0	2	0.7571
Ara and the Empty Universe	2023-01-30	3	10	0	3	0.7571
Alien Battlefield	2023-01-27	2	10	0	2	0.7571
Tide Girl: Phenomena	2023-03-25	3	10	0	3	0.7571
Best Pearl	2023-03-08	3	10	0	3	0.7571
Crazy Clown	2023-03-08	3	10	0	3	0.7571
Grounded Sim: Steam Edition	2023-02-17	2	10	0	2	0.7571
Sally Can't Sleep	2023-02-20	9	10	0	9	0.7571
Before The Green Moon	2023-03-14	7	10	0	7	0.7571
SKIP	2023-03-14	4	10	0	4	0.7571
SEX × HEX	2023-03-31	8	10	0	8	0.7571
Archery Simulator	2023-03-13	3	16	1	4	0.7564000000000001
AI Stories	2023-03-16	4	16	1	5	0.7564000000000001
Violet Wisteria	2023-02-09	5	16	1	6	0.7564000000000001
Spy Bros. (Pipi & Bibi's DX)	2023-02-14	7	16	1	8	0.7564000000000001
Weekend Warriors MMA	2023-02-05	13	16	1	14	0.7564000000000001
Extra Lives	2023-03-01	8	16	1	9	0.7564000000000001
学園ハンサムFighters	2023-04-05	12	16	1	13	0.7564000000000001
Second Front	2023-01-31	351	318	76	427	0.7563
恶魔酱的五日恶戏	2023-01-20	14	41	6	20	0.7562000000000001
异世界的城主大人	2023-02-26	171	215	49	220	0.7558
Beaver Clicker	2023-02-07	61	36	5	66	0.7553000000000001
Idle Simple RPG	2023-03-30	261	36	5	266	0.7553000000000001
Undisputed	2023-01-31	7433	5254	1536	8969	0.7545999999999999
Cursed Mansion	2023-03-30	5	31	4	9	0.7545999999999999
Pixel Town: Akanemachi Mystery	2023-02-25	66	31	4	70	0.7545999999999999
Uragun	2023-03-30	52	108	22	74	0.7545000000000001
WWE 2K23	2023-03-17	6535	1152	313	6848	0.7544
Hexrogue	2023-01-08	28	21	2	30	0.7544
Tick Tack Puppet	2023-03-20	90	21	2	92	0.7544
Mystic Gate	2023-02-10	17	21	2	19	0.7544
仙界之剑 仙王少女战记	2023-01-25	31	21	2	33	0.7544
Forrest of Frequencies	2023-01-31	4	21	2	6	0.7544
The Crown of Wu	2023-03-24	11	26	3	14	0.7541
Predictors	2023-01-18	11	26	3	14	0.7541
Ortharion : The Last Battle Prologue	2023-03-31	27	26	3	30	0.7541
Hentai SportsGirl	2023-01-16	6	26	3	9	0.7541
Napoleon Maiden ~A maiden without the word impossible~	2023-01-27	12	40	6	18	0.7536
富甲天下3	2023-01-05	648	234	55	703	0.7535
The Escape: Together	2023-01-13	69	196	45	114	0.7533
Cyclo Chambers	2023-02-21	127	66	12	139	0.7533
Scars Above	2023-02-28	330	369	92	422	0.7531
The Obscura Experiment	2023-03-07	30	53	9	39	0.7529000000000001
Writer's Life	2023-01-18	143	390	98	241	0.7528
Corpse Keeper	2023-02-15	1007	706	188	1195	0.7523000000000001
The True Love Rings	2023-01-17	75	285	70	145	0.7512000000000001
The Art of War: Card Game	2023-02-01	14	30	4	18	0.7512000000000001
Ragdoll: Fall and Destroy	2023-02-01	6	30	4	10	0.7512000000000001
Punch A Bunch	2023-01-20	219	488	127	346	0.751
Johnny Chainsaw	2023-03-28	8	15	1	9	0.751
There Will Be Ink	2023-03-10	8	15	1	9	0.751
Undeadly	2023-04-06	16	15	1	17	0.751
Aery VR - Little Bird Adventure	2023-01-13	4	15	1	5	0.751
Twin Cobra	2023-02-14	21	15	1	22	0.751
Last Kids on Earth: Hit the Deck!	2023-02-17	6	15	1	7	0.751
Land of Towers	2023-01-23	4	15	1	5	0.751
光明王传说	2023-01-05	6	15	1	7	0.751
Notes of the Young Lady: In Turbulent Times	2023-02-20	18	15	1	19	0.751
Manga Maker's Mega Milkers	2023-02-17	9	15	1	10	0.751
2D Dawg 2	2023-04-07	49	97	20	69	0.7508
Touge Shakai	2023-01-08	176	207	49	225	0.7505
Save the Earth ECO inc.	2023-01-11	33	56	10	43	0.7502
Hotel Renovator	2023-03-07	2503	874	240	2743	0.7501000000000001
Ball laB 2	2023-03-03	3	9	0	3	0.75
Hentai Series	2023-02-11	3	9	0	3	0.75
Hero Team	2023-01-05	82	9	0	82	0.75
New Roots	2023-03-16	3	9	0	3	0.75
Battle Tracks	2023-03-29	4	9	0	4	0.75
Rise of Fox Hero	2023-02-17	5	9	0	5	0.75
Knight And Mourning	2023-04-11	7	9	0	7	0.75
My Landlord is a Futanari	2023-03-18	3	9	0	3	0.75
The Exile of Aphrodisia (2023)	2023-02-17	34	9	0	34	0.75
Flowa	2023-03-06	5	9	0	5	0.75
Long Dream	2023-04-11	66	9	0	66	0.75
Forests, Fields and Fortresses	2023-04-05	11	9	0	11	0.75
Tropical Resort Story	2023-04-10	113	9	0	113	0.75
The Helper	2023-01-31	1	9	0	1	0.75
Full Gear	2023-03-01	4	9	0	4	0.75
名媛模拟器	2023-03-29	5	9	0	5	0.75
The Last Hair	2023-03-31	5	9	0	5	0.75
Strip Fighter ZERO	2023-04-08	9	9	0	9	0.75
Pretty Dinosaur Adventures of Ancient Earth VR	2023-02-02	1	9	0	1	0.75
Brazen Thief	2023-01-12	3	9	0	3	0.75
Infinite Mirror	2023-01-12	3	9	0	3	0.75
勇士末路 The End of Warriors	2023-03-24	6	9	0	6	0.75
Yellow History	2023-03-31	3	9	0	3	0.75
小白的保卫战 Xiaobai's defense war	2023-02-12	2	9	0	2	0.75
Dare To Spread	2023-04-01	5	9	0	5	0.75
BadMan	2023-02-23	4	9	0	4	0.75
Fateweaver: Smash or Pass	2023-04-10	7	9	0	7	0.75
The Devilry Reservation	2023-03-06	2	9	0	2	0.75
Not Anyone's Business But My Own	2023-03-07	3	9	0	3	0.75
Glory Room	2023-03-29	3	9	0	3	0.75
Around The World	2023-02-02	5	20	2	7	0.7499
OutWave	2023-01-05	5	20	2	7	0.7499
Naive Riri	2023-03-29	9	20	2	11	0.7499
Dungeons of Aether	2023-02-28	565	257	63	628	0.7498
Midnight Scenes: From the Woods	2023-02-09	14	64	12	26	0.7495999999999999
Winning Post 10	2023-03-30	5115	51	9	5124	0.7484999999999999
Demon Queen Melissa	2023-01-21	189	55	10	199	0.7481
Clarent Saga: Chronicles	2023-01-23	4	29	4	8	0.7478
Steelborn	2023-03-07	19	46	8	27	0.7465
Engine Evolution 2022	2023-02-21	168	568	155	323	0.7463
GRUNND	2023-01-26	13	24	3	16	0.7463
Inward	2023-02-02	12	24	3	15	0.7463
T.D.Z. 3 Dark Way of Stalker	2023-03-31	7	24	3	10	0.7463
inziva	2023-04-10	26	24	3	29	0.7463
Scrap Riders	2023-01-09	5	14	1	6	0.7453000000000001
They Came From the Sky 2	2023-01-11	4	14	1	5	0.7453000000000001
Crystal Riders VR	2023-03-10	2	14	1	3	0.7453000000000001
Mayhem Heroes	2023-02-10	4	14	1	5	0.7453000000000001
Nixxsz Castle	2023-02-14	4	14	1	5	0.7453000000000001
Life is Pain	2023-03-03	3	14	1	4	0.7453000000000001
Hentai Festival	2023-03-10	4	14	1	5	0.7453000000000001
Hentai Snowy	2023-03-24	6	14	1	7	0.7453000000000001
MITE	2023-02-13	6	37	6	12	0.7451000000000001
Onion Assault	2023-01-26	5	19	2	7	0.7451000000000001
Cockroach Simulator house of survive	2023-02-28	4	19	2	6	0.7451000000000001
人形限界	2023-03-06	40	19	2	42	0.7451000000000001
Kitchen Chaos	2023-01-30	9	19	2	11	0.7451000000000001
Little Monki	2023-04-01	5	19	2	7	0.7451000000000001
Back To Ashes	2023-02-20	8	85	18	26	0.7449
Lovebirb	2023-03-15	32	81	17	49	0.7447
Filthy Animals | Heist Simulator	2023-04-04	496	73	15	511	0.7442000000000001
Disfigure: Prologue	2023-03-31	43	28	4	47	0.7441
Kowloon's Curse: Lost Report	2023-03-22	11	45	8	19	0.7440000000000001
Queen's Brothel	2023-01-05	126	61	12	138	0.7438
The Magical Mixture Mill	2023-04-05	282	57	11	293	0.7437
3001: A MILF Odyssey	2023-01-26	61	53	10	71	0.7437
The Ouroboros King	2023-02-27	160	72	15	175	0.7425
SEX with HITLER: 2069	2023-03-24	71	87	19	90	0.7422
Gatedelvers	2023-02-20	33	36	6	39	0.742
Blinded by Fear	2023-01-19	6	23	3	9	0.742
An Adventurer's Gallantry	2023-04-05	4	8	0	4	0.7419
Walthros: Renewal	2023-03-15	3	8	0	3	0.7419
Rooftop Renegade	2023-02-16	5	8	0	5	0.7419
VRNOID	2023-03-04	3	8	0	3	0.7419
Moxie's Lemon	2023-02-10	2	8	0	2	0.7419
Blue Fish Yokohama	2023-02-17	3	8	0	3	0.7419
Ghosted	2023-02-27	4	8	0	4	0.7419
An Architect's Adventure	2023-03-25	6	8	0	6	0.7419
Defend from Candyland!	2023-02-20	2	8	0	2	0.7419
Hotdog Quest: One With Everything	2023-03-05	2	8	0	2	0.7419
DC's Justice League: Cosmic Chaos	2023-03-10	13	8	0	13	0.7419
Jigsaw Puzzles Infinite	2023-04-02	17	8	0	17	0.7419
Code Rivals	2023-02-05	6	8	0	6	0.7419
Boulette Hell	2023-03-10	2	8	0	2	0.7419
DOWNFALLEN	2023-01-27	2	8	0	2	0.7419
Putin Destroys Alien	2023-01-16	2	8	0	2	0.7419
Chibi Ninja Shino-kun: Treasure of Demon Tower	2023-03-14	2	8	0	2	0.7419
Chess Morph: The Queen's Wormholes	2023-03-01	2	8	0	2	0.7419
幻境咖啡馆	2023-01-18	3	8	0	3	0.7419
1WEEK	2023-04-07	4	8	0	4	0.7419
Stay Human	2023-01-26	2	8	0	2	0.7419
Protos Magos	2023-03-30	3	8	0	3	0.7419
Xploquest 3	2023-01-20	3	8	0	3	0.7419
GyroGunner	2023-02-24	5	8	0	5	0.7419
Kristal Mağara	2023-02-05	3	8	0	3	0.7419
SEARCH ALL - WORMS	2023-01-23	3	8	0	3	0.7419
Fumpers	2023-02-14	3	8	0	3	0.7419
Pigskin Punter!	2023-02-08	2	8	0	2	0.7419
Banana Attack VR	2023-02-10	5	8	0	5	0.7419
Gender Dysphoria	2023-04-06	3	8	0	3	0.7419
Puffin Ball Drop	2023-04-04	3	8	0	3	0.7419
Romantic Shooter	2023-03-24	4	8	0	4	0.7419
That Racecar Game	2023-03-27	2	8	0	2	0.7419
Natti	2023-02-16	95	60	12	107	0.7417
Passed Out	2023-03-13	157	123	29	186	0.7412000000000001
Call of Duty®: Black Ops Cold War	2023-03-08	2369	1345	403	2772	0.741
Mahokenshi	2023-01-24	408	248	65	473	0.7404999999999999
微光之镜 Glimmer in Mirror	2023-01-10	702	500	141	843	0.74
Niflhel's Fables: The Book of Gypsies	2023-02-16	3	18	2	5	0.74
Richman 8	2023-03-16	57	18	2	59	0.74
Delve Into Pawssion	2023-03-30	21	18	2	23	0.74
Lawless West	2023-01-07	7	31	5	12	0.7393000000000001
Indies' Lies	2023-01-16	606	422	118	724	0.7391
Rogue Spirit	2023-03-07	112	114	27	139	0.7391
The Maiden, the Butler, and the Witch	2023-02-11	114	35	6	120	0.7389
Stories from the Outbreak	2023-03-27	74	35	6	80	0.7389
Esperia ~ Uprising of the Scarlet Witch ~	2023-03-01	10	13	1	11	0.7389
Cynthia: Hidden in the Moonshadow	2023-04-10	30	13	1	31	0.7389
Inside My Mind 2	2023-02-12	2	13	1	3	0.7389
A Traveler to unknown Thule	2023-02-13	6	13	1	7	0.7389
SENTINEL	2023-01-29	4	13	1	5	0.7389
Retail Wars	2023-01-17	11	13	1	12	0.7389
Diesel The Pug Warrior	2023-01-30	6	13	1	7	0.7389
In The Gym	2023-01-27	4	13	1	5	0.7389
Dungeon Core	2023-03-02	35	39	7	42	0.7387
Kawaii Neko Girls 2	2023-03-06	38	110	26	64	0.7386
違う冬のぼくら	2023-02-13	395	261	70	465	0.7383
Rytmos	2023-02-28	12	22	3	15	0.7375
Reclusive	2023-03-28	5	22	3	8	0.7375
Anthology of Fear	2023-03-17	84	112	27	111	0.7367
Blocky Dungeon	2023-04-06	50	26	4	54	0.7363
Active Soccer 2023	2023-03-29	14	26	4	18	0.7363
Pan'orama: Prologue	2023-02-23	23	26	4	27	0.7363
Fantasy Jigsaw Puzzles	2023-01-02	18	26	4	22	0.7363
Abyss Of Fire	2023-02-28	5	26	4	9	0.7363
The Last Shot	2023-02-16	14	42	8	22	0.7359
Shiitake Showdown	2023-01-14	15	42	8	23	0.7359
古剑奇闻录	2023-03-10	44	34	6	50	0.7356
Initial Drift Online	2023-03-30	826	1717	540	1366	0.7352
Class Reunion Chat Room	2023-02-24	23	86	20	43	0.7351000000000001
奉天白事铺	2023-01-13	121	172	45	166	0.7348
Timestamps: Unconditional Love	2023-01-07	146	64	14	160	0.7345
The Fairy's Secret	2023-02-06	10	17	2	12	0.7345
A Maiden Astrologer Divines the Future	2023-01-25	5	17	2	7	0.7345
Commander: Modern War	2023-01-28	8	17	2	10	0.7345
Temporian	2023-03-30	34	17	2	36	0.7345
SEX with HITLER: WW2	2023-03-11	588	103	25	613	0.7341
House Designer : Fix & Flip	2023-02-21	42	60	13	55	0.7338
Unmatched: Digital Edition	2023-02-28	124	106	26	150	0.7334999999999999
Farming Fever: Cooking Games	2023-02-17	169	99	24	193	0.7334
Tainted Grail: The Fall of Avalon	2023-03-30	932	503	149	1081	0.7329000000000001
Heal & Hurt	2023-02-24	41	143	37	78	0.7329000000000001
The Pioneers: surviving desolation	2023-01-20	393	196	53	446	0.7327
Prison Life 2	2023-03-30	30	21	3	33	0.7327
The end is nahual: If I may say so	2023-02-17	6	21	3	9	0.7327
Deluge: Sermon for the Dead	2023-02-14	8	21	3	11	0.7327
Cruise Ship Manager: Prologue - Maiden Voyage	2023-02-22	15	21	3	18	0.7327
Haulin' Oats	2023-03-09	5	7	0	5	0.7326
Mystica	2023-01-19	7	7	0	7	0.7326
Imposters	2023-02-01	9	7	0	9	0.7326
Stellar Mess: The Princess Conundrum (Chapter 1)	2023-02-27	4	7	0	4	0.7326
Dust Devil	2023-03-01	2	7	0	2	0.7326
Warmonium	2023-01-26	5	7	0	5	0.7326
Catoise	2023-01-24	2	7	0	2	0.7326
THNT	2023-03-21	2	7	0	2	0.7326
Disc Golf : Game On	2023-03-25	9	7	0	9	0.7326
Oliver	2023-04-05	2	7	0	2	0.7326
Farm Under Fire	2023-04-08	11	7	0	11	0.7326
Fluff	2023-01-06	3	7	0	3	0.7326
DELETE AFTER READING	2023-03-14	7	7	0	7	0.7326
Traveler's Game	2023-04-05	5	7	0	5	0.7326
Roxy Raccoon 2: Topsy-Turvy	2023-04-03	4	7	0	4	0.7326
Age of Gladiators Reforged	2023-03-27	19	7	0	19	0.7326
Ovivim	2023-03-13	8	7	0	8	0.7326
Moonflower	2023-03-25	3	7	0	3	0.7326
Olympiades	2023-01-19	12	7	0	12	0.7326
Susurye of Shadows	2023-01-12	4	7	0	4	0.7326
Caverns of Mars: Recharged	2023-03-09	6	7	0	6	0.7326
Keeper Of The Valley	2023-03-01	2	7	0	2	0.7326
Idle interstellar Factory 2	2023-02-08	9	7	0	9	0.7326
Clash: Robot Detective - Complete Edition	2023-01-02	2	7	0	2	0.7326
Crypt Architect	2023-01-06	6	7	0	6	0.7326
Sokoball Dreams	2023-03-01	3	7	0	3	0.7326
Dyztopia: Post-Human RPG	2023-01-06	6	7	0	6	0.7326
Pretty Hentai Girls	2023-01-25	3	7	0	3	0.7326
Sorcerers Summit	2023-04-05	3	7	0	3	0.7326
Duplicado	2023-02-01	2	7	0	2	0.7326
Rhythm Taichi XR	2023-02-22	2	7	0	2	0.7326
Spider Hunter	2023-02-10	2	7	0	2	0.7326
Winnie The Pooh: The Serial Killer	2023-02-09	2	7	0	2	0.7326
Daily Dadish	2023-02-07	6	7	0	6	0.7326
The Grindstone	2023-02-25	7	7	0	7	0.7326
Destiny Duel	2023-03-18	6	7	0	6	0.7326
Hkons Beanrunner	2023-02-21	3	7	0	3	0.7326
R.A.T.T.Z. Maze	2023-03-31	1	7	0	1	0.7326
Pasha Planet: Reborn	2023-03-03	3	7	0	3	0.7326
Nuke Survivors	2023-02-24	2	7	0	2	0.7326
Jump By Coronho: Chapter 2	2023-03-13	3	7	0	3	0.7326
Digital Diamond Baseball V11	2023-03-31	30	7	0	30	0.7326
I commissioned some dogs	2023-03-30	9	7	0	9	0.7326
Hentai Pool	2023-03-22	3	7	0	3	0.7326
Hentai SpaceSuit	2023-04-07	5	7	0	5	0.7326
線路の祠 ～真の放置ゲーム～	2023-04-05	114	7	0	114	0.7326
The 2nd page of the medical examination diary: Another story of exciting days of me and my senpai	2023-02-01	16	33	6	22	0.7321
Tyrant Quest	2023-02-13	56	25	4	60	0.7320000000000001
Power of Ten	2023-01-11	101	115	29	130	0.7319
Warplanes: Battles over Pacific	2023-01-26	20	91	22	42	0.7319
Shopping Center Tycoon	2023-02-27	15	29	5	20	0.7319
VentureVerse: Legend of Ulora	2023-03-09	5	12	1	6	0.7319
The Trasamire Campaigns	2023-02-03	4	12	1	5	0.7319
异世界杂货铺 Skyscraper In Another World	2023-03-26	33	12	1	34	0.7319
Arcade Party	2023-02-22	21	12	1	22	0.7319
Zoe The Exhibitionist	2023-03-21	44	12	1	45	0.7319
My Gym Mommy Treats Me Like A Kid	2023-01-23	6	12	1	7	0.7319
Rich Uncle: A Gay Adventure	2023-02-14	8	12	1	9	0.7319
Hearth's Light Potion Shop	2023-03-24	6	12	1	7	0.7319
Hentai Military	2023-02-24	4	12	1	5	0.7319
Soul Knight: The Forest of Spirits	2023-02-16	3	12	1	4	0.7319
Ghosts from the House of Flesh	2023-03-09	4	12	1	5	0.7319
二分之一	2023-03-17	599	371	108	707	0.7317
Rune Teller	2023-02-09	175	320	92	267	0.7316
Xuan-Yuan Sword: The Cloud of Han	2023-01-12	77	48	10	87	0.7316
Hentai Aim Trainer 2	2023-02-13	7	44	9	16	0.7308
Forsake	2023-03-31	71	114	29	100	0.7306
Arthas - The Game	2023-02-17	195	301	87	282	0.73
叫我皇上	2023-01-20	202	425	127	329	0.7295999999999999
三国：寻将传	2023-03-10	45	36	7	52	0.7293000000000001
Life of Delta	2023-03-13	25	47	10	35	0.7290000000000001
Total Tank Generals	2023-03-30	174	82	20	194	0.7286
Gjallarhorn	2023-01-10	7	16	2	9	0.7286
Metal Black™ S-Tribute	2023-02-01	10	16	2	12	0.7286
Rat Cage	2023-01-31	11	16	2	13	0.7286
阴阳林	2023-01-12	14	16	2	16	0.7286
Hentai Gyaru	2023-01-24	5	16	2	7	0.7286
Hyper Pop	2023-02-27	4	16	2	6	0.7286
Hentai Room	2023-01-09	5	20	3	8	0.7276
NecroCity: Prologue	2023-03-06	39	20	3	42	0.7276
Cyber West: Hidden Object Games - Western	2023-01-27	9	20	3	12	0.7276
Pet Dragon Girl	2023-01-13	6	20	3	9	0.7276
Infinite Incantation	2023-02-28	10	24	4	14	0.7275
The Crimping	2023-03-10	4	24	4	8	0.7275
いっき団結	2023-02-15	3487	476	146	3633	0.7270000000000001
Knights of Braveland	2023-02-16	524	134	36	560	0.7269
Definitely Not Fried Chicken	2023-01-18	789	430	132	921	0.7256999999999999
Wayhaven Chronicles: Book Three	2023-04-06	604	56	13	617	0.7249
Fraymakers	2023-01-19	2333	627	199	2532	0.7248
The Utility Room	2023-02-06	4	31	6	10	0.7248
Lockes The Thief	2023-02-09	2	11	1	3	0.7242000000000001
Exiori	2023-01-10	7	11	1	8	0.7242000000000001
Rival Rides	2023-01-24	6	11	1	7	0.7242000000000001
Flightpath	2023-01-26	5	11	1	6	0.7242000000000001
Frido	2023-01-19	5	11	1	6	0.7242000000000001
Loot Express Delivery Service	2023-02-10	4	11	1	5	0.7242000000000001
A Bit of Tactics	2023-01-19	25	11	1	26	0.7242000000000001
Love Quest	2023-02-14	6	11	1	7	0.7242000000000001
MalovMetaArt	2023-02-28	3	11	1	4	0.7242000000000001
Kingdom Run VR	2023-03-03	2	11	1	3	0.7242000000000001
圣魂	2023-01-25	9	11	1	10	0.7242000000000001
F1 Crazy Stunts	2023-02-06	3	11	1	4	0.7242000000000001
Galactic Empire	2023-03-09	3	11	1	4	0.7242000000000001
Draft - In the woods	2023-03-10	2	11	1	3	0.7242000000000001
Uncle Kenny The Game	2023-03-15	3	11	1	4	0.7242000000000001
Hentai MatureCat	2023-03-31	5	11	1	6	0.7242000000000001
被坏女人骗成冒险者!	2023-04-04	13	11	1	14	0.7242000000000001
Jumping Cat	2023-01-16	6	27	5	11	0.7238
Masterplan Tycoon	2023-03-09	427	240	71	498	0.7234999999999999
Forbidden Escape	2023-01-25	7	23	4	11	0.7228
Umichan Two Scoops	2023-01-13	9	23	4	13	0.7228
Milky Quest II	2023-01-28	298	149	42	340	0.7226
King Fishing	2023-02-09	47	114	31	78	0.7223999999999999
Multiplayer Cowboys	2023-02-14	10	34	7	17	0.7223999999999999
For The Fatherland	2023-03-05	4	15	2	6	0.7222
Peppa Pig: World Adventures	2023-03-17	9	15	2	11	0.7222
Australian Football Coach 2023	2023-03-09	29	15	2	31	0.7222
Fish Simulator: Agonik Lake	2023-03-16	4	15	2	6	0.7222
Don't get lost	2023-02-01	248	195	57	305	0.7220000000000001
The True Slime King	2023-02-04	3	6	0	3	0.7217
Iconic	2023-01-08	2	6	0	2	0.7217
VOENKOMAT	2023-04-08	19	6	0	19	0.7217
Demolition Master	2023-02-28	5	6	0	5	0.7217
Damn Ropes	2023-03-25	3	6	0	3	0.7217
PictoPull	2023-03-29	4	6	0	4	0.7217
星の欠片の物語。しかけ版	2023-01-19	6	6	0	6	0.7217
Cubelander	2023-01-25	3	6	0	3	0.7217
惊魂日记 FrightDiary	2023-03-12	7	6	0	7	0.7217
Hexes	2023-03-27	2	6	0	2	0.7217
Flip of Light	2023-01-23	3	6	0	3	0.7217
Bolt Bot Screwy Viruses	2023-02-16	3	6	0	3	0.7217
Creatures of Energy	2023-01-02	3	6	0	3	0.7217
Biz Builder Delux	2023-03-20	35	6	0	35	0.7217
Anomaly	2023-02-03	2	6	0	2	0.7217
Blade-Shift Rage	2023-02-24	1	6	0	1	0.7217
Me in the Office	2023-02-17	3	6	0	3	0.7217
Unluckily in Love	2023-03-13	5	6	0	5	0.7217
SEKISAI puzzle action	2023-01-06	2	6	0	2	0.7217
The Search For Paradisus	2023-01-11	1	6	0	1	0.7217
Bazooka Cat: First Episode	2023-02-14	5	6	0	5	0.7217
Knight vs Giant: The Broken Excalibur Prologue	2023-02-02	8	6	0	8	0.7217
Kanji Drive	2023-01-08	3	6	0	3	0.7217
Zombies Rocket Boom Boom	2023-01-30	1	6	0	1	0.7217
Button VR	2023-02-03	2	6	0	2	0.7217
Resultarias	2023-01-23	3	6	0	3	0.7217
Double Line Confrontation：New World（双线交锋：新世界）	2023-01-03	2	6	0	2	0.7217
Chex	2023-01-21	2	6	0	2	0.7217
Another Man's Wife	2023-01-21	13	6	0	13	0.7217
Blockappend	2023-03-01	3	6	0	3	0.7217
Castle Capture Topkapi	2023-01-27	6	6	0	6	0.7217
Crunch Time	2023-03-20	1	6	0	1	0.7217
Mistcaller	2023-02-12	81	6	0	81	0.7217
告死天使复仇之夜 Death Angel Nightmare	2023-03-09	5	6	0	5	0.7217
虚空灵药园	2023-01-20	2	6	0	2	0.7217
T-Rex Dinosaur Game	2023-01-20	2	6	0	2	0.7217
Fliese	2023-02-02	3	6	0	3	0.7217
Kinda Knirpsi	2023-03-10	7	6	0	7	0.7217
Mullet Hell	2023-02-01	3	6	0	3	0.7217
Beef Jerky	2023-02-17	1	6	0	1	0.7217
Stack Machines	2023-02-25	4	6	0	4	0.7217
Swords & Bones 3	2023-03-06	3	6	0	3	0.7217
TankLab	2023-02-12	5	6	0	5	0.7217
My Time	2023-02-24	3	6	0	3	0.7217
Polyrhythm Master	2023-02-15	2	6	0	2	0.7217
Strawb	2023-03-10	1	6	0	1	0.7217
Cx6	2023-03-10	2	6	0	2	0.7217
三国世界	2023-03-31	4	6	0	4	0.7217
Hentai Blackjack	2023-02-24	3	6	0	3	0.7217
The Faceless	2023-02-20	2	6	0	2	0.7217
ウワガキアイ	2023-02-25	7	6	0	7	0.7217
pWordle	2023-03-21	3	6	0	3	0.7217
擒贼先擒王	2023-03-24	2	6	0	2	0.7217
The Dorm Is Yours!	2023-03-10	10	6	0	10	0.7217
Vom Drachentöten	2023-03-23	3	6	0	3	0.7217
Deep Space Scoundrel	2023-03-30	3	6	0	3	0.7217
Lust Girls	2023-03-24	2	6	0	2	0.7217
Eloriasha	2023-03-25	3	6	0	3	0.7217
Stickman Trenches	2023-03-01	308	222	66	374	0.7216
Gnome Online	2023-01-24	34	71	18	52	0.7209000000000001
Sexy Valentine 🍆 💜	2023-02-28	29	30	6	35	0.7209000000000001
The paladin & The succubi servant	2023-01-16	10	37	8	18	0.7205
The Moon Hell	2023-02-16	27	87	23	50	0.7204
天下霸圖	2023-02-17	678	125	35	713	0.7203
Merge & Blade	2023-02-28	152	93	25	177	0.7198000000000001
隐秘的角落	2023-01-18	711	323	101	812	0.7195
Rescue Dash Time Management Game	2023-01-12	62	80	21	83	0.7195
Deathtide Survivors	2023-01-26	14	26	5	19	0.7194
Trenches - World War 1 Horror Survival Game	2023-01-20	19	83	22	41	0.7191
LOST EGG 3: The Final	2023-01-02	225	40	9	234	0.7189
No One Survived	2023-01-14	4632	2292	805	5437	0.7187
Encoded War	2023-01-21	9	22	4	13	0.7178
Idle Banshee Alliance	2023-01-11	34	22	4	38	0.7178
Golfie	2023-01-19	175	153	45	220	0.7173
Opportunity: A Sugar Baby Story	2023-02-13	31	36	8	39	0.7170000000000001
It's Hasegawa-san!?	2023-02-28	18	46	11	29	0.7166
Swords Fantasy: Battlefield	2023-03-06	5	18	3	8	0.7162999999999999
Eon of the Green	2023-01-25	4	18	3	7	0.7162999999999999
Tower Walker	2023-02-08	105	39	9	114	0.7156999999999999
Lust Theory Season 2	2023-01-28	881	243	76	957	0.7156
Theseus Protocol	2023-01-17	175	196	60	235	0.7156
Hell Slayer	2023-01-26	7	10	1	8	0.7155
FreedroidRPG	2023-01-20	4	10	1	5	0.7155
Robot Revolt	2023-01-21	13	10	1	14	0.7155
Lady of Dreams	2023-02-15	7	10	1	8	0.7155
Welcome to Levy	2023-03-02	4	10	1	5	0.7155
Don't Wake God	2023-02-21	4	10	1	5	0.7155
Cracks In Hell	2023-01-17	14	10	1	15	0.7155
Astral Coconut	2023-02-10	6	10	1	7	0.7155
ParaSHOTical ARKtiviBeatings	2023-02-14	5	10	1	6	0.7155
CalmLine	2023-03-06	3	10	1	4	0.7155
Noah Please!	2023-03-02	2	10	1	3	0.7155
shita ni	2023-03-03	6	10	1	7	0.7155
Dark rune	2023-03-20	6	10	1	7	0.7155
Experiment: one	2023-03-28	4	10	1	5	0.7155
WITCH RACE	2023-04-07	22	10	1	23	0.7155
Hidden World 4 Top-Down 3D	2023-03-23	5	10	1	6	0.7155
Women's Prison 絕對人權女子監獄	2023-02-17	217	87	24	241	0.7152
Hardwar	2023-02-15	8	14	2	10	0.7152
Agony VR	2023-04-05	10	14	2	12	0.7152
軍靴をはいた猫	2023-02-24	23	14	2	25	0.7152
Time Lock VR-episode Lumber Room	2023-02-22	5	14	2	7	0.7152
奔向繁星	2023-02-20	3	14	2	5	0.7152
Crimson Connect Origin	2023-03-31	30	32	7	37	0.7149
Sea of Craft	2023-03-10	303	331	107	410	0.7148000000000001
Kitten Lost Her Box	2023-02-27	6	25	5	11	0.7148000000000001
Neko Hentai Girl: Beach Match-3	2023-03-17	7	25	5	12	0.7148000000000001
BlackHoopS	2023-01-29	26	42	10	36	0.7145999999999999
Deliver Us Mars	2023-02-02	1113	796	274	1387	0.7141
Non-Stop Raiders	2023-01-23	20	35	8	28	0.7134999999999999
The Great War: Western Front™	2023-03-30	3564	756	261	3825	0.7131000000000001
Melon Journey: Bittersweet Memories	2023-04-06	32	28	6	38	0.7126
DiktaPunk: Fighting for Dominance	2023-02-23	44	28	6	50	0.7126
Angel's Gear	2023-02-14	44	79	22	66	0.7121
Secret Camera	2023-02-13	75	100	29	104	0.7116
Desktop Sex Doll	2023-01-19	27	60	16	43	0.7112
Persona 3 Portable	2023-01-19	3515	2005	733	4248	0.7108
PROTOCOL 11	2023-02-23	5	17	3	8	0.71
Bank Robber	2023-02-04	7	17	3	10	0.71
Sue Shi Survival	2023-04-11	8	17	3	11	0.71
Elowen's Light	2023-03-15	4	17	3	7	0.71
Traveler's Bastion	2023-03-11	37	17	3	40	0.71
Towers Deck	2023-02-01	3	17	3	6	0.71
RINA RhythmERROR	2023-03-10	84	140	43	127	0.7099
Mechaneer Resta's Grand Adventure	2023-04-08	57	24	5	62	0.7099
創業王 CEO	2023-01-20	22	24	5	27	0.7099
ISEKAI FRONTLINE	2023-03-16	778	349	117	895	0.7098000000000001
Howl of Iron	2023-01-12	5	34	8	13	0.7098000000000001
SEXTS	2023-01-31	126	205	66	192	0.7090000000000001
Tune in to the show	2023-03-03	80	37	9	89	0.7088
Kabaret	2023-04-04	17	5	0	17	0.7084
SUFFER 2	2023-01-13	3	5	0	3	0.7084
Alive Paint	2023-03-25	2	5	0	2	0.7084
Horror haze	2023-01-17	3	5	0	3	0.7084
Aurora's Journey and the Pitiful Lackey	2023-01-13	3	5	0	3	0.7084
MORE ENEMIES	2023-01-08	2	5	0	2	0.7084
Bowerwhelm	2023-03-31	5	5	0	5	0.7084
FurBalls Racing	2023-01-30	8	5	0	8	0.7084
Sukebe Beach	2023-03-09	4	5	0	4	0.7084
Lilith	2023-02-11	1	5	0	1	0.7084
Idol Hell	2023-03-03	2	5	0	2	0.7084
Lovely Neko Girl	2023-04-06	4	5	0	4	0.7084
Bite Nite	2023-01-03	5	5	0	5	0.7084
Sticky Notes	2023-04-07	3	5	0	3	0.7084
Deck 'Em!	2023-03-07	3	5	0	3	0.7084
The Janus Problem	2023-02-25	2	5	0	2	0.7084
The Wolf of Derevnya	2023-04-04	2	5	0	2	0.7084
决斗小爱	2023-02-14	3	5	0	3	0.7084
Stories From the Cores	2023-02-05	3	5	0	3	0.7084
Changeling Charade	2023-02-09	16	5	0	16	0.7084
Animal Across: Afrika	2023-03-10	3	5	0	3	0.7084
Beneath Her Starry Sky	2023-01-04	3	5	0	3	0.7084
The Specter Chronicles: Episode 1 - The False Prophet	2023-02-28	3	5	0	3	0.7084
Drive Maker	2023-02-05	3	5	0	3	0.7084
Doodle World Deluxe	2023-03-31	2	5	0	2	0.7084
XenoFeud	2023-01-02	1	5	0	1	0.7084
Subtension	2023-03-28	3	5	0	3	0.7084
Take Care VR	2023-01-05	3	5	0	3	0.7084
Choi	2023-01-12	2	5	0	2	0.7084
Agent Roy - Secure The Temple	2023-01-05	2	5	0	2	0.7084
Easy Game	2023-01-30	3	5	0	3	0.7084
World of Turtle	2023-01-13	2	5	0	2	0.7084
Zooblies	2023-01-16	2	5	0	2	0.7084
Inmortuae Metuunt: Rise of The Undead	2023-01-16	5	5	0	5	0.7084
Domination - War of Nations	2023-02-10	6	5	0	6	0.7084
Highway Speeder	2023-01-12	5	5	0	5	0.7084
Tamerlane	2023-01-25	2	5	0	2	0.7084
Lost Oliver	2023-03-09	3	5	0	3	0.7084
Minibots TD	2023-02-15	4	5	0	4	0.7084
NTR'd By Clumsiness	2023-03-14	6	5	0	6	0.7084
Zombie Apocalypse - The Last Fortress	2023-02-14	1	5	0	1	0.7084
Castle Kingdom Wars	2023-02-28	5	5	0	5	0.7084
Tears RAIN: Tears of Goddess	2023-02-05	3	5	0	3	0.7084
Geko: entering the pipe	2023-03-09	3	5	0	3	0.7084
My Fake Goblin Wife	2023-03-10	2	5	0	2	0.7084
Radical Road	2023-03-25	2	5	0	2	0.7084
Porndle	2023-03-25	3	5	0	3	0.7084
Manual Overcycle	2023-02-28	1	5	0	1	0.7084
Super Crane Bug	2023-03-10	3	5	0	3	0.7084
Ultimate Anime Jigsaw Puzzle	2023-03-10	4	5	0	4	0.7084
Damsels of Vice 2: Project Mesmer	2023-03-10	6	5	0	6	0.7084
House Sitter Escape Game	2023-03-15	3	5	0	3	0.7084
MeiQi:Phoenix and the Chamber of Secrets	2023-03-17	9	5	0	9	0.7084
KingMini	2023-03-27	6	5	0	6	0.7084
Chinese Chess Party (Xiangqi)	2023-03-22	4	5	0	4	0.7084
Rescue Agency: The Kidnapper of happiness	2023-04-06	4	5	0	4	0.7084
Winnie-the-Pooh's book writing speedrunner	2023-04-05	5	5	0	5	0.7084
GENIE	2023-04-07	7	5	0	7	0.7084
ROGUE-FP	2023-03-30	3	5	0	3	0.7084
Perseus: Titan Slayer	2023-02-13	1218	204	66	1284	0.7081999999999999
GPRO	2023-02-13	215	40	10	225	0.7081000000000001
Dreadful River	2023-02-28	17	27	6	23	0.7081000000000001
Happy Mining	2023-02-16	21	27	6	27	0.7081000000000001
Car Racing Highway Driving Simulator, real parking driver sim speed traffic deluxe 2022	2023-01-11	15	27	6	21	0.7081000000000001
Stacks:Space!	2023-02-20	45	27	6	51	0.7081000000000001
魔王终局	2023-04-09	142	27	6	148	0.7081000000000001
Echoes of Mayhem	2023-02-20	6	13	2	8	0.7075
SourceWorlds	2023-03-10	10	13	2	12	0.7075
Waitventure	2023-01-01	47	13	2	49	0.7075
Starshifter	2023-02-15	7	13	2	9	0.7075
Small Town Detective	2023-03-01	3	13	2	5	0.7075
Artur's Pinball	2023-01-10	2	13	2	4	0.7075
Project Liminal Redux	2023-03-23	6	13	2	8	0.7075
ALPEN GHOUL: Prologue	2023-03-20	5	13	2	7	0.7075
Trash Horror Collection 3	2023-03-24	8	13	2	10	0.7075
Finger is 300 bugs	2023-03-28	6	13	2	8	0.7075
Uncharted Ocean 2	2023-01-13	261	100	30	291	0.7072
NRG	2023-02-08	23	46	12	35	0.7072
GirlFriend VR	2023-01-04	15	46	12	27	0.7072
Out of the Park Baseball 24	2023-03-24	1354	146	46	1400	0.7070000000000001
Slave Doll	2023-03-28	96	94	28	124	0.7070000000000001
Fruit Ninja VR 2	2023-04-07	28	49	13	41	0.7069
Windmills	2023-02-03	8	20	4	12	0.7068000000000001
Spaceflight Factory : Prologue	2023-01-20	20	20	4	24	0.7068000000000001
Burst Hero	2023-01-01	13	20	4	17	0.7068000000000001
Romancelvania	2023-03-07	122	76	22	144	0.7064
Minds of Nations	2023-04-11	127	360	124	251	0.7059000000000001
David Slade Mysteries: Case Files	2023-01-25	5	9	1	6	0.7057
Kiteboarding Pro	2023-01-02	4	9	1	5	0.7057
SALVATIONLAND	2023-02-15	3	9	1	4	0.7057
Be A Rock	2023-03-31	3	9	1	4	0.7057
The Smile Alchemist	2023-03-03	11	9	1	12	0.7057
Decent Checkers	2023-02-05	4	9	1	5	0.7057
Golf 5 eClub	2023-02-24	5	9	1	6	0.7057
Rogue Blaster	2023-01-26	24	9	1	25	0.7057
Yummy Girls 3	2023-02-16	1	9	1	2	0.7057
Paccsu	2023-01-06	13	9	1	14	0.7057
Sapu	2023-01-03	3	9	1	4	0.7057
Chadboy	2023-03-13	4	9	1	5	0.7057
Fremdganger - The Cheating Demon	2023-03-02	2	9	1	3	0.7057
THE ABYSS	2023-03-03	3	9	1	4	0.7057
Hot Secretary Puzzle	2023-03-31	2	9	1	3	0.7057
Irradiant	2023-03-31	5	9	1	6	0.7057
Goblin Lord wants me to become a Virgin Wizard by Managing The Brothel!?	2023-04-07	53	9	1	54	0.7057
Find It	2023-04-10	2	9	1	3	0.7057
三国英雄传豪华版	2023-01-20	187	136	43	230	0.7054
Role of Hex	2023-02-21	51	36	9	60	0.7051999999999999
Wilderless	2023-01-10	9	36	9	18	0.7051999999999999
Cooking Live: Restaurant Game	2023-02-02	529	471	166	695	0.7051000000000001
Hunting Labyrinth	2023-02-15	21	23	5	26	0.7048000000000001
只兔：不灭的勇者	2023-03-08	33	107	33	66	0.7047
Mr. Mat Hematic	2023-02-26	9	42	11	20	0.7044
Storyteller	2023-03-23	1493	1072	397	1890	0.7042
REMEDIUM: Sentinels	2023-02-28	36	63	18	54	0.7041
Kunado Chronicles	2023-04-07	102	48	13	115	0.7041
My MILF Stepmom💋	2023-04-07	159	126	40	199	0.7034999999999999
The Last Worker	2023-03-30	25	29	7	32	0.7025
Saga of Sins	2023-03-30	17	29	7	24	0.7025
Grand Theft Auto: Vice City - The Definitive Edition	2023-01-19	955	703	258	1213	0.7022
Ravenswatch	2023-04-06	10018	1561	594	10612	0.7021
My Life as a Cult Leader	2023-03-25	110	65	19	129	0.7019
Anime vs Evil: Apocalypse	2023-02-16	39	44	12	51	0.7011000000000001
ULTRA LMAD	2023-01-20	12	19	4	16	0.7008
The Cleaner	2023-01-05	3	19	4	7	0.7008
Hot Pussy College 2 🍓🔞	2023-03-31	77	87	27	104	0.7001000000000001
Bomberpet	2023-03-24	6	12	2	8	0.6990999999999999
实习班主任 Practice Teacher	2023-01-13	7	12	2	9	0.6990999999999999
It Returned To The Desert	2023-02-15	4	12	2	6	0.6990999999999999
Open Fishing XL	2023-01-23	3	12	2	5	0.6990999999999999
The Last Hike	2023-02-17	6	12	2	8	0.6990999999999999
Crazy Hill Racing	2023-02-15	3	12	2	5	0.6990999999999999
Break Everything - Park	2023-01-27	2	12	2	4	0.6990999999999999
Little Garden	2023-03-10	7	12	2	9	0.6990999999999999
全城警戒	2023-04-07	15	12	2	17	0.6990999999999999
我在地球修仙有系统	2023-04-03	2385	371	134	2519	0.6986
Rabbit Hole Chapter 1	2023-01-31	15	28	7	22	0.698
Phantom Alchemy ~Silvia's Dynamic Urban Planning~	2023-01-07	87	31	8	95	0.6977
Flash Party	2023-01-10	828	817	313	1141	0.6961
December 1914	2023-02-24	15	15	3	18	0.6959000000000001
HIYOKU NO TORI	2023-02-22	8	15	3	11	0.6959000000000001
Horror Tale 2: Samantha	2023-01-11	5	15	3	8	0.6959000000000001
沃瑞尔	2023-02-14	11	15	3	14	0.6959000000000001
Kagura Survivors: Endless Night	2023-04-01	1397	365	135	1532	0.6946
Fantasia Sango Mysteria	2023-01-11	740	314	115	855	0.6946
Comic Book Company Manager	2023-02-21	3	8	1	4	0.6944
Solbane	2023-03-31	3	8	1	4	0.6944
SD Shin Kamen Rider Rumble	2023-04-05	48	8	1	49	0.6944
Frebbventure	2023-02-23	5	8	1	6	0.6944
The Burrito Quest	2023-01-16	3	8	1	4	0.6944
Spirits' Creek	2023-01-13	3	8	1	4	0.6944
Broken Blade: Prelude	2023-02-10	5	8	1	6	0.6944
Paradise Cleaning!- sex-loving family -	2023-03-10	4	8	1	5	0.6944
80's Mania	2023-01-20	3	8	1	4	0.6944
NOT ME	2023-03-02	6	8	1	7	0.6944
PAIN: Below Sanity	2023-01-20	4	8	1	5	0.6944
Monster Waifu	2023-01-15	3	8	1	4	0.6944
Legacy Of The Pact	2023-01-06	5	8	1	6	0.6944
Stonga Bird	2023-01-26	2	8	1	3	0.6944
Friendly Facade	2023-01-27	3	8	1	4	0.6944
Broombot Battlegrounds	2023-02-14	5	8	1	6	0.6944
SuccuSeka: Resist Succubus Temptation	2023-02-14	4	8	1	5	0.6944
WAR ON THE STREET	2023-03-20	2	8	1	3	0.6944
Neko-chan's Club	2023-03-03	5	8	1	6	0.6944
ENEMIES: GONE SUBURBAN	2023-03-26	5	8	1	6	0.6944
Sexy Nurse Puzzle	2023-04-08	3	8	1	4	0.6944
Hentai Miko	2023-03-07	3	8	1	4	0.6944
Hentai Puzzle Quest	2023-03-23	2	8	1	3	0.6944
Munchkin Digital	2023-03-09	678	415	155	833	0.6943
PERISH	2023-02-02	491	275	100	591	0.6942
Surviving the Abyss	2023-01-17	1079	407	152	1231	0.6940999999999999
Amigo: Kebab Simulator	2023-04-03	38	33	9	47	0.6936
Arena Renovation - First Job	2023-03-14	59	27	7	66	0.6933
Darkness Revenge	2023-01-10	34	27	7	41	0.6933
无限投影2	2023-04-01	128	27	7	135	0.6933
Xuan-Yuan Sword: The Clouds Faraway	2023-01-12	81	50	15	96	0.693
Dust & Neon	2023-02-16	190	136	47	237	0.6926000000000001
KartRider: Drift	2023-01-10	4748	2513	1025	5773	0.6923
明日战线 - 放置就能开宝箱（放置挂机探索卡牌策略）	2023-03-28	303	159	56	359	0.6920000000000001
Turbo Cat Fight	2023-02-14	3	4	0	3	0.6920000000000001
Intern Pursuit Game	2023-01-10	2	4	0	2	0.6920000000000001
Hill Agency: PURITY&decay	2023-03-31	3	4	0	3	0.6920000000000001
Working Zombies Steam Edition	2023-03-07	4	4	0	4	0.6920000000000001
Avoid the rain	2023-01-18	4	4	0	4	0.6920000000000001
Field of Arms: Tactics	2023-03-06	3	4	0	3	0.6920000000000001
The Thing from Nowhere	2023-02-01	2	4	0	2	0.6920000000000001
Marco & Polo	2023-02-14	1	4	0	1	0.6920000000000001
The Secret Life of Dorian Pink	2023-03-27	4	4	0	4	0.6920000000000001
Cursed Road Convoy	2023-12-31	3	4	0	3	0.6920000000000001
Burning Vengeance	2023-04-02	2	4	0	2	0.6920000000000001
Steel Defier	2023-03-24	3	4	0	3	0.6920000000000001
The Lost Condor	2023-01-06	2	4	0	2	0.6920000000000001
Super Trunko Go	2023-02-23	2	4	0	2	0.6920000000000001
The Nameless Braves: Heaven	2023-03-01	3	4	0	3	0.6920000000000001
Ball Go Home	2023-02-09	11	4	0	11	0.6920000000000001
Flag Sweeper	2023-03-24	3	4	0	3	0.6920000000000001
Triopticon三昧	2023-03-13	3	4	0	3	0.6920000000000001
The Sea of Death	2023-02-17	3	4	0	3	0.6920000000000001
Going Deep	2023-02-18	3	4	0	3	0.6920000000000001
Enworden	2023-01-05	2	4	0	2	0.6920000000000001
Diamond Skeeball	2023-02-01	6	4	0	6	0.6920000000000001
Attack on King: Reloaded	2023-01-20	3	4	0	3	0.6920000000000001
Code Rubik	2023-01-13	1	4	0	1	0.6920000000000001
Servants of Sumomon	2023-02-28	1	4	0	1	0.6920000000000001
Retired Waves	2023-02-22	2	4	0	2	0.6920000000000001
So Much Stuff	2023-03-02	6	4	0	6	0.6920000000000001
Shong	2023-02-24	4	4	0	4	0.6920000000000001
MEKA SIGURAT	2023-01-22	2	4	0	2	0.6920000000000001
Alien on the Radar	2023-02-17	2	4	0	2	0.6920000000000001
Amabilly	2023-01-30	3	4	0	3	0.6920000000000001
Forbidden City Journey	2023-03-12	2	4	0	2	0.6920000000000001
Rapscallions On Deck	2023-01-19	3	4	0	3	0.6920000000000001
Orbital Bombardment	2023-04-05	2	4	0	2	0.6920000000000001
Little Circuit	2023-03-08	2	4	0	2	0.6920000000000001
Across the Valley	2023-04-06	4	4	0	4	0.6920000000000001
Aim Expert	2023-02-06	4	4	0	4	0.6920000000000001
FaceValue	2023-02-21	2	4	0	2	0.6920000000000001
The Motorcycle	2023-01-09	2	4	0	2	0.6920000000000001
Temanava	2023-03-31	3	4	0	3	0.6920000000000001
ForRest Paper Doll	2023-03-17	7	4	0	7	0.6920000000000001
God Busters : Who watches the watchers?	2023-01-19	3	4	0	3	0.6920000000000001
Dawn of Griseo	2023-01-06	3	4	0	3	0.6920000000000001
You're Fired! Revenge!	2023-01-16	4	4	0	4	0.6920000000000001
The Green Room Experiment (Episode 1)	2023-01-28	5	4	0	5	0.6920000000000001
307 Racing	2023-02-27	2	4	0	2	0.6920000000000001
MageBall	2023-01-30	2	4	0	2	0.6920000000000001
Parts Unknown	2023-02-12	4	4	0	4	0.6920000000000001
Pact of Steel	2023-03-01	3	4	0	3	0.6920000000000001
House of Shadow	2023-01-16	2	4	0	2	0.6920000000000001
Hentai Puzzle Universe	2023-02-05	3	4	0	3	0.6920000000000001
Hentai Casual Slider	2023-01-26	2	4	0	2	0.6920000000000001
Keyboard Warrior: Dreamstate Prologue	2023-01-22	4	4	0	4	0.6920000000000001
PHANOTIA I: ESCAVIVE	2023-01-31	2	4	0	2	0.6920000000000001
Metal March: Beginner Experience	2023-01-24	4	4	0	4	0.6920000000000001
Mega Sudoku	2023-02-16	2	4	0	2	0.6920000000000001
Simnetzero	2023-01-30	4	4	0	4	0.6920000000000001
Fantasya	2023-02-03	3	4	0	3	0.6920000000000001
Go Over The Edge	2023-02-10	5	4	0	5	0.6920000000000001
Food Maze	2023-02-03	5	4	0	5	0.6920000000000001
Animal portal	2023-01-31	2	4	0	2	0.6920000000000001
Cycle Chaser H-5	2023-03-31	2	4	0	2	0.6920000000000001
I commissioned some bees 14	2023-03-02	6	4	0	6	0.6920000000000001
Ultimate Flight Simulator Pro	2023-02-02	3	4	0	3	0.6920000000000001
Find the Energy	2023-02-27	3	4	0	3	0.6920000000000001
Fingerspelling Unleashed - BANZSL Edition	2023-02-28	2	4	0	2	0.6920000000000001
Running Riot	2023-03-17	3	4	0	3	0.6920000000000001
Engineering - Mystery of the ancient clock	2023-02-10	2	4	0	2	0.6920000000000001
Spellarium 9	2023-02-21	10	4	0	10	0.6920000000000001
Pencil Plus: The Wrath of The Spankster	2023-03-28	3	4	0	3	0.6920000000000001
Mind The Pipes!	2023-02-14	1	4	0	1	0.6920000000000001
My Lovely Pets Collector's Edition	2023-02-20	4	4	0	4	0.6920000000000001
Polar Bear Game	2023-02-10	2	4	0	2	0.6920000000000001
DownhillMadness	2023-02-27	2	4	0	2	0.6920000000000001
Vivat Sloboda	2023-02-09	3	4	0	3	0.6920000000000001
Gunpowder Punk	2023-03-01	3	4	0	3	0.6920000000000001
連縁无現里 ~ Misremembered Memories	2023-02-16	3	4	0	3	0.6920000000000001
GHOST: AC-130 CLOSE AIR SUPPORT	2023-02-23	5	4	0	5	0.6920000000000001
雷雨漫漫	2023-03-21	2	4	0	2	0.6920000000000001
IN THE BUILDING: HAMSTERS	2023-02-24	4	4	0	4	0.6920000000000001
Ugmania	2023-03-09	5	4	0	5	0.6920000000000001
Free Kick Football: 3D Soccer	2023-02-24	2	4	0	2	0.6920000000000001
CardShark	2023-03-01	2	4	0	2	0.6920000000000001
Water tank| 貯水槽	2023-03-30	15	4	0	15	0.6920000000000001
大懒子勇闯魔王城	2023-03-06	2	4	0	2	0.6920000000000001
The Adventures of LinShanHai - Chapter2:Bus Bombing	2023-03-03	5	4	0	5	0.6920000000000001
Hentai Casual Slider 3	2023-03-05	2	4	0	2	0.6920000000000001
Goospace	2023-03-18	2	4	0	2	0.6920000000000001
Flea the Cat	2023-03-17	2	4	0	2	0.6920000000000001
Walstikski	2023-03-16	3	4	0	3	0.6920000000000001
All Goblin	2023-03-29	3	4	0	3	0.6920000000000001
Text Twist 3	2023-04-30	3	4	0	3	0.6920000000000001
Showrunner	2023-01-17	53	44	13	66	0.6918000000000001
The King's Dilemma: Chronicles	2023-01-30	155	63	20	175	0.6908
Gloria Victis	2023-02-07	4185	6685	2825	7010	0.6901
Project: Mirror	2023-01-24	131	113	39	170	0.6899
Mori Carta	2023-02-20	17	11	2	19	0.6897
The Hero We Need	2023-02-21	4	11	2	6	0.6897
Practisim Designer	2023-02-14	15	11	2	17	0.6897
Way of the Wizard	2023-01-19	4	11	2	6	0.6897
Break Everything - Living room	2023-01-19	2	11	2	4	0.6897
Cats in Heat - Summer Fling	2023-02-28	8	11	2	10	0.6897
Kiss Effect	2023-02-17	6	11	2	8	0.6897
Station 99	2023-03-20	4	11	2	6	0.6897
Castle Rush Zombies	2023-03-31	2	11	2	4	0.6897
순정만화가 너무 어려워!	2023-04-05	17	11	2	19	0.6897
降妖神兵	2023-03-30	63	54	17	80	0.6887000000000001
The Library of Babel	2023-04-07	23	26	7	30	0.6883
Jump Fucker	2023-02-28	10	26	7	17	0.6883
Upgrade VR	2023-02-03	5	14	3	8	0.688
Sidestep Legends	2023-01-09	11	14	3	14	0.688
Hungry Caveman	2023-02-04	7	14	3	10	0.688
Endless Fireworks Simulator	2023-02-06	7	14	3	10	0.688
Dark Dead	2023-04-07	5	14	3	8	0.688
Ultimate Admiral: Dreadnoughts	2023-01-25	2081	2461	1027	3108	0.6879000000000001
DzombZ	2023-01-30	8	23	6	14	0.6878000000000001
Misteri Rumah Pak RT	2023-02-18	12	23	6	18	0.6878000000000001
소울 가디언즈	2023-02-22	311	190	70	381	0.6875
Your Story	2023-01-19	13	20	5	18	0.6875
Overrun Survivors	2023-02-16	12	20	5	17	0.6875
RINA RhythmERROR：Prologue	2023-02-17	8	17	4	12	0.6875
Miniland Adventure	2023-04-10	274	48	15	289	0.687
The Cenozoic Era	2023-01-20	227	234	88	315	0.6869
Battle of Vukovar: Rain of Steel	2023-01-31	13	34	10	23	0.6859999999999999
Death Roads: Tournament	2023-03-28	379	155	57	436	0.6851
Street Lords	2023-02-07	48	58	19	67	0.685
Cockville	2023-02-07	50	50	16	66	0.6849
A Sex Slave's Love Story	2023-02-28	58	73	25	83	0.6835
蛇香之夜 ～Allure of MUSK～　第一夜　欧洲篇	2023-02-14	257	101	36	293	0.6834
最终堡垒	2023-02-21	11	25	7	18	0.6831
I'm looking for 3024 people	2023-02-03	8	36	11	19	0.6829999999999999
Bobo The Cat	2023-01-05	6	22	6	12	0.682
IN THE BUILDING: CATS 3	2023-01-05	6	22	6	12	0.682
THE MEME HUNTER	2023-03-02	8	49	16	24	0.6819
Pillazon: MMO Drug Lord Tycoon	2023-01-13	15	33	10	25	0.6818000000000001
PyroSlam: VR Table Tennis	2023-02-16	6	7	1	7	0.6815000000000001
Chippy & Noppo	2023-03-08	49	7	1	50	0.6815000000000001
Warspace	2023-03-27	5	7	1	6	0.6815000000000001
The Forest Cathedral	2023-03-14	5	7	1	6	0.6815000000000001
Revenge on the Streets 3	2023-01-02	2	7	1	3	0.6815000000000001
Mudoba	2023-01-05	3	7	1	4	0.6815000000000001
Exhibitors	2023-04-08	7	7	1	8	0.6815000000000001
Hot Coffe Shop	2023-03-31	5	7	1	6	0.6815000000000001
A Matter of Principle	2023-01-19	2	7	1	3	0.6815000000000001
Only A Dream	2023-01-13	2	7	1	3	0.6815000000000001
Sphere Game Legendary	2023-01-06	3	7	1	4	0.6815000000000001
Dark Desire Mute 1	2023-01-14	4	7	1	5	0.6815000000000001
Torico's b-day gift hunt	2023-02-23	2	7	1	3	0.6815000000000001
Hike Valley	2023-01-20	2	7	1	3	0.6815000000000001
Slayin 2	2023-03-30	5	7	1	6	0.6815000000000001
Gallery Manager	2023-02-17	5	7	1	6	0.6815000000000001
Lana and the Milking Table	2023-03-31	6	7	1	7	0.6815000000000001
Flip That Coin!	2023-03-02	3	7	1	4	0.6815000000000001
Vincent's Horror Story	2023-02-27	6	7	1	7	0.6815000000000001
Lost World	2023-02-05	104	144	54	158	0.6811
Rhythm Brawl	2023-04-11	15	102	37	52	0.6809999999999999
Cuckold Life Simulator 😳🔞	2023-01-21	517	87	31	548	0.6809999999999999
Friend or Foe	2023-01-23	13	19	5	18	0.6809999999999999
SUR5	2023-04-01	23	19	5	28	0.6809999999999999
Poozle Mania	2023-03-31	38	19	5	43	0.6809999999999999
Spatial Terminal	2023-01-13	7	19	5	12	0.6809999999999999
Planet Fights	2023-03-24	22	30	9	31	0.6805
Kai Yuan	2023-03-13	12	16	4	16	0.68
山门与幻境	2023-01-15	438	443	181	619	0.6797
The Walking Dead: Saints & Sinners - Chapter 2: Retribution	2023-03-21	532	417	170	702	0.6795
The Unbeatable Path	2023-04-06	10	10	2	12	0.6793000000000001
I Will Be There	2023-02-14	3	10	2	5	0.6793000000000001
Escape Dream	2023-03-13	11	10	2	13	0.6793000000000001
Gehinnom: Prologue	2023-02-27	7	10	2	9	0.6793000000000001
Turbo Racing	2023-03-20	4	10	2	6	0.6793000000000001
Hot Therapy	2023-04-06	33	10	2	35	0.6793000000000001
Aquatico	2023-01-12	937	379	154	1091	0.6792
Beyond Contact	2023-04-04	291	318	128	419	0.6790999999999999
Elemental Raiders	2023-01-16	51	76	27	78	0.6790999999999999
Touch Me	2023-01-12	21	35	11	32	0.679
Goblins of Elderstone	2023-03-08	163	209	82	245	0.6787000000000001
Power Chord	2023-01-26	167	68	24	191	0.6779999999999999
Administrators	2023-03-25	4	24	7	11	0.6776000000000001
Мафия 1x1	2023-03-10	34	24	7	41	0.6776000000000001
异世重生 : 枪之勇者 Reincarnation : Hero of the Gun	2023-02-27	98	32	10	108	0.6775
Deadly Broadcast	2023-02-02	131	319	130	261	0.677
《蜀山：初章》网络版	2023-04-06	1429	337	138	1567	0.6767000000000001
Altf42	2023-03-30	149	104	39	188	0.6764
Otherwar	2023-02-27	33	42	14	47	0.6759999999999999
Alignment	2023-03-10	15	21	6	21	0.6759000000000001
Derealized	2023-03-13	10	29	9	19	0.6758
Dark Prospect	2023-03-05	25	57	20	45	0.6755
Make Her Cum	2023-02-02	47	108	41	88	0.6751
Magic Pussy: Chapter 1	2023-04-08	321	160	63	384	0.6748000000000001
paradise of desire	2023-01-11	62	69	25	87	0.6746
Tiny Troopers: Global Ops	2023-03-09	16	18	5	21	0.674
Ultra Blade	2023-02-24	7	18	5	12	0.674
Road 96: Mile 0	2023-04-04	484	277	114	598	0.6739
13iew	2023-04-04	32	26	8	40	0.6739
Axiom	2023-01-01	34	88	33	67	0.6738
CyberCum: Pussy Attack❗️	2023-04-01	82	73	27	109	0.6727
Prepare Uranus: Exploring Black Holes for Adults	2023-01-06	39	41	14	53	0.6724
Survival Nation	2023-02-02	38	68	25	63	0.6723
Industries of Titan	2023-01-31	2217	917	404	2621	0.6718999999999999
Heavyarms Assemble: WWII	2023-02-03	76	63	23	99	0.6718999999999999
Boxing Gym Story	2023-02-13	242	48	17	259	0.6709
A Foreign World	2023-02-06	83	28	9	92	0.6709
鞭炮&烟花：春节模拟器Firecrackers&fireworks：china new year simulation	2023-01-26	20	28	9	29	0.6709
Light of Alariya	2023-03-01	80	84	32	112	0.6707
Bleak Faith: Forsaken	2023-03-10	1793	1152	515	2308	0.6706000000000001
Super Sketch Bob	2023-03-16	1	3	0	1	0.6706000000000001
Asteroid Defender!	2023-02-09	1	3	0	1	0.6706000000000001
Unification	2023-03-01	2	3	0	2	0.6706000000000001
Johnny Lionface	2023-02-20	6	3	0	6	0.6706000000000001
Lab Chaos	2023-03-04	1	3	0	1	0.6706000000000001
Knight Of The Parking Lot	2023-01-25	2	3	0	2	0.6706000000000001
Hana's Campus Life	2023-03-31	3	3	0	3	0.6706000000000001
PocketCiv	2023-01-17	6	3	0	6	0.6706000000000001
Virtual Near Death Experience	2023-03-11	1	3	0	1	0.6706000000000001
Iron Age	2023-04-05	2	3	0	2	0.6706000000000001
Anti Frank's Wrath	2023-01-13	4	3	0	4	0.6706000000000001
Super Puzzle Cross	2023-03-29	3	3	0	3	0.6706000000000001
BLINNK and the Vacuum of Space	2023-01-17	7	3	0	7	0.6706000000000001
Just a SHMUP?	2023-02-24	2	3	0	2	0.6706000000000001
Space Warden	2023-03-16	1	3	0	1	0.6706000000000001
Sinister	2023-01-25	1	3	0	1	0.6706000000000001
Lucie's Potager	2023-02-16	2	3	0	2	0.6706000000000001
Automoji	2023-03-08	10	3	0	10	0.6706000000000001
Boot & Shoot	2023-02-22	2	3	0	2	0.6706000000000001
Seven Spirits	2023-01-20	2	3	0	2	0.6706000000000001
Game Cycle	2023-01-20	2	3	0	2	0.6706000000000001
The Cursed Knight	2023-02-09	2	3	0	2	0.6706000000000001
Rat Chef	2023-02-26	2	3	0	2	0.6706000000000001
MouseLife - Parenthood	2023-03-31	1	3	0	1	0.6706000000000001
Ghosts over the Water: Changing the Tides of Japan's Future	2023-03-31	3	3	0	3	0.6706000000000001
Home By The River	2023-02-15	3	3	0	3	0.6706000000000001
Cryogenesis	2023-03-07	1	3	0	1	0.6706000000000001
Breakthrough	2023-02-16	2	3	0	2	0.6706000000000001
Flight Level	2023-02-28	6	3	0	6	0.6706000000000001
Spike Mtn	2023-03-30	1	3	0	1	0.6706000000000001
Hex	2023-01-27	1	3	0	1	0.6706000000000001
The Legend of Gandar II	2023-01-02	2	3	0	2	0.6706000000000001
Corgi Cove	2023-02-14	3	3	0	3	0.6706000000000001
Thelos	2023-01-12	2	3	0	2	0.6706000000000001
Huntscape	2023-03-31	4	3	0	4	0.6706000000000001
Fusion Paradox	2023-04-10	2	3	0	2	0.6706000000000001
Mount Farewell	2023-01-27	3	3	0	3	0.6706000000000001
Bugs and Bullets	2023-02-03	4	3	0	4	0.6706000000000001
A Lone Piece	2023-03-02	2	3	0	2	0.6706000000000001
OSAWARI HOCKEY えんこちゃん	2023-01-12	2	3	0	2	0.6706000000000001
Elemental Adventure	2023-02-17	6	3	0	6	0.6706000000000001
The Last Werewolf	2023-02-23	2	3	0	2	0.6706000000000001
BBirthday - Visual Novel	2023-01-20	4	3	0	4	0.6706000000000001
Warung Nasi Campur	2023-02-09	1	3	0	1	0.6706000000000001
Island Bender	2023-03-31	4	3	0	4	0.6706000000000001
Race Code	2023-04-30	2	3	0	2	0.6706000000000001
The Soul's Choice	2023-01-27	7	3	0	7	0.6706000000000001
タイピングで愛を伝えよ	2023-01-05	2	3	0	2	0.6706000000000001
Amanda's Magic Book 6	2023-01-12	3	3	0	3	0.6706000000000001
City Z	2023-04-07	5	3	0	5	0.6706000000000001
Hide and Seek	2023-02-10	16	3	0	16	0.6706000000000001
Super Death Game SHOW！VR	2023-04-05	2	3	0	2	0.6706000000000001
MicroCrawl	2023-02-18	2	3	0	2	0.6706000000000001
Mimicry	2023-02-10	4	3	0	4	0.6706000000000001
Catacombs: The Asper Case	2023-03-28	1	3	0	1	0.6706000000000001
Terix Survivors	2023-02-14	1	3	0	1	0.6706000000000001
Dino V. Xeno - Tower Defense	2023-02-24	2	3	0	2	0.6706000000000001
Candy Arkanoid	2023-01-31	2	3	0	2	0.6706000000000001
激活: Activate	2023-01-18	2	3	0	2	0.6706000000000001
NOTHING TO LOSE	2023-02-13	2	3	0	2	0.6706000000000001
混沌骑士	2023-02-28	4	3	0	4	0.6706000000000001
ALPO: Way to home	2023-02-09	2	3	0	2	0.6706000000000001
Wojak Rush	2023-01-29	1	3	0	1	0.6706000000000001
CubeRun 2	2023-03-22	1	3	0	1	0.6706000000000001
Golden Rails: Valuable Package	2023-03-29	30	3	0	30	0.6706000000000001
Autumn-Time Trade-Up	2023-02-25	2	3	0	2	0.6706000000000001
Cave Raider	2023-02-08	2	3	0	2	0.6706000000000001
Project Nosferatu	2023-02-02	2	3	0	2	0.6706000000000001
Disgusting Puzzle	2023-01-27	1	3	0	1	0.6706000000000001
YourTrain	2023-02-07	4	3	0	4	0.6706000000000001
Crystal Storm	2023-03-30	2	3	0	2	0.6706000000000001
Death Road	2023-03-16	1	3	0	1	0.6706000000000001
My Home/Zombie Center	2023-02-17	9	3	0	9	0.6706000000000001
アパシー学校であった怖い話 極	2023-02-15	10	3	0	10	0.6706000000000001
Wak Attak	2023-02-16	1	3	0	1	0.6706000000000001
愛する妻、美咲の不倫証拠 『旦那とどっちが気持ちいい？』→『貴方の方が…あっ、ダメッ、またイッちゃうッ…！』	2023-04-06	1	3	0	1	0.6706000000000001
Hentai Casual Slider 2	2023-02-02	1	3	0	1	0.6706000000000001
Mikrocosmos	2023-02-04	5	3	0	5	0.6706000000000001
Find The Murderer 3	2023-02-11	1	3	0	1	0.6706000000000001
FIGHTING PUDDING	2023-02-18	3	3	0	3	0.6706000000000001
Kiting Mechanics	2023-02-27	3	3	0	3	0.6706000000000001
The Aching	2023-04-05	3	3	0	3	0.6706000000000001
Tartarus Longo Itinere	2023-02-20	2	3	0	2	0.6706000000000001
R-Lyke: Reverse	2023-02-26	2	3	0	2	0.6706000000000001
STIVENELVRO LEGENDS	2023-03-31	3	3	0	3	0.6706000000000001
Knight Raider	2023-02-23	2	3	0	2	0.6706000000000001
Interstellar Conquest	2023-02-27	3	3	0	3	0.6706000000000001
The Fog	2023-02-28	1	3	0	1	0.6706000000000001
Fishjong	2023-03-08	3	3	0	3	0.6706000000000001
Crusader's March	2023-03-06	2	3	0	2	0.6706000000000001
Mimi and Lisa	2023-03-14	3	3	0	3	0.6706000000000001
Jigsaw Puzzles: Fantasy Landscapes	2023-03-07	4	3	0	4	0.6706000000000001
Demons Infernalize	2023-03-30	2	3	0	2	0.6706000000000001
The Orphan	2023-03-29	2	3	0	2	0.6706000000000001
Aquaphobia	2023-03-16	1	3	0	1	0.6706000000000001
Heroes of Eroticism - Amorous Advances	2023-03-24	19	3	0	19	0.6706000000000001
Wizard of Wyndmoor	2023-03-13	1	3	0	1	0.6706000000000001
Mr Rabbit's Cambridge Point and Click Adventure	2023-03-30	1	3	0	1	0.6706000000000001
sunny-place-3: microgods	2023-03-24	4	3	0	4	0.6706000000000001
Boomerang Battles	2023-04-06	3	3	0	3	0.6706000000000001
Furry Furries	2023-03-31	4	3	0	4	0.6706000000000001
Sex Simulator - Office Affairs	2023-03-04	5	3	0	5	0.6706000000000001
Dickland	2023-03-22	3	3	0	3	0.6706000000000001
Mommy Milkers Miko	2023-04-03	8	3	0	8	0.6706000000000001
Final Gun	2023-03-23	6	3	0	6	0.6706000000000001
PolyGunner	2023-04-03	2	3	0	2	0.6706000000000001
The Adventures of LinShanHai - Chapter3:The Headless Woman	2023-03-31	3	3	0	3	0.6706000000000001
스쿨라이프	2023-04-05	3	3	0	3	0.6706000000000001
Little Crab Fisher	2023-04-01	5	3	0	5	0.6706000000000001
Merging Cubes	2023-03-31	1	3	0	1	0.6706000000000001
My Dear Dad 父亲	2023-04-07	6	3	0	6	0.6706000000000001
Vampire Slayer: The Resurrection	2023-02-09	13	33	11	24	0.6705
Garbage Truck Simulator	2023-02-09	24	33	11	35	0.6705
Clive 'N' Wrench	2023-02-23	48	60	22	70	0.6704000000000001
Sonic Colors: Ultimate	2023-02-06	90	181	74	164	0.6703
Pitch Silent	2023-01-17	4	12	3	7	0.6698000000000001
Tristia:restore	2023-01-20	8	12	3	11	0.6698000000000001
Taste of War	2023-01-20	6	12	3	9	0.6698000000000001
Hidden Post-Apocalyptic 2 Top-Down 3D	2023-02-21	2	12	3	5	0.6698000000000001
龙栖	2023-03-24	9	20	6	15	0.6694
Desktop Dungeons: Rewind - Daily Demo	2023-01-25	27	20	6	33	0.6694
Trackmania	2023-02-02	2935	1576	718	3653	0.6688
Star Survivor - Prologue	2023-02-17	173	83	32	205	0.6687000000000001
Potion Tycoon	2023-03-13	243	113	45	288	0.6684
Underworld Idle	2023-02-02	765	514	226	991	0.668
Mama Die and Retry	2023-01-29	2	9	2	4	0.6676000000000001
Secret Diaries: Manage a Manor	2023-01-30	10	9	2	12	0.6676000000000001
Royal Affairs	2023-03-30	100	9	2	102	0.6676000000000001
Mothership Forever	2023-01-02	4	9	2	6	0.6676000000000001
Nightly Trash	2023-02-26	3	9	2	5	0.6676000000000001
Sakura Battle	2023-02-10	3	9	2	5	0.6676000000000001
Hentai Sera	2023-03-03	6	9	2	8	0.6676000000000001
3 Triplets, 18 Tits	2023-04-06	3	9	2	5	0.6676000000000001
Cursed Pantsu	2023-04-04	15	17	5	20	0.6666
少女的求生之路2：血色洋馆	2023-04-03	7	17	5	12	0.6666
Strange Aeons	2023-01-13	2	6	1	3	0.6662
Mix-A-Max	2023-01-06	3	6	1	4	0.6662
Colony Cephea	2023-03-16	2	6	1	3	0.6662
Juan Sin Miedo	2023-01-09	2	6	1	3	0.6662
Gemstones	2023-01-24	3	6	1	4	0.6662
Metal War	2023-03-25	4	6	1	5	0.6662
Chasmal	2023-01-31	5	6	1	6	0.6662
Turtle Racer	2023-02-20	3	6	1	4	0.6662
Towards the Unknown	2023-02-24	3	6	1	4	0.6662
The Last Sword	2023-03-10	2	6	1	3	0.6662
Hentai Beach	2023-01-22	4	6	1	5	0.6662
That Last Girl	2023-02-12	2	6	1	3	0.6662
50 Days To Survive	2023-03-03	3	6	1	4	0.6662
Lost Dream: Darkness	2023-03-17	1	6	1	2	0.6662
Hentai Pussy 6	2023-02-24	2	6	1	3	0.6662
Captain Meow	2023-03-02	2	6	1	3	0.6662
H Girl	2023-03-07	4	6	1	5	0.6662
Violations Will Be Punished	2023-03-24	5	6	1	6	0.6662
Under the Sky World	2023-01-05	21	27	9	30	0.6657
HellFurnace	2023-02-15	20	46	17	37	0.6643000000000001
Blanc	2023-02-14	339	221	95	434	0.6641
Elder Trial：Prologue	2023-01-25	20	34	12	32	0.6641
Ex Natura: Nature Corrupted	2023-02-20	6	29	10	16	0.6633
Adventure's Calling	2023-02-14	6	14	4	10	0.6633
Pricia Defense	2023-03-25	14	14	4	18	0.6633
Building our Futature	2023-01-09	23	14	4	27	0.6633
Mushroom Agent	2023-01-06	2	14	4	6	0.6633
INVASION	2023-02-10	7	14	4	11	0.6633
My Dream Girl	2023-01-31	6	24	8	14	0.6627
HYPERVIOLENT	2023-04-06	26	19	6	32	0.6625
Hammer Kid	2023-03-13	10	19	6	16	0.6625
Horror Tale	2023-01-06	10	19	6	16	0.6625
When All Guys Turned into Girls	2023-01-10	7	19	6	13	0.6625
Lawnmower Game: Ufo Chase	2023-01-15	3	19	6	9	0.6625
Multiplayer Werewolves	2023-02-07	7	19	6	13	0.6625
Phylakterion	2023-02-20	45	36	13	58	0.6624
Call of Duty®: Modern Warfare®	2023-03-08	1523	779	361	1884	0.6613
Nadir	2023-02-07	144	137	58	202	0.6612
Interference: Dead Air	2023-02-02	36	38	14	50	0.6609
Fight the Landlord	2023-03-31	277	264	117	394	0.6607
Destinesia	2023-02-16	5	11	3	8	0.6593000000000001
Eternal Fidelity	2023-01-27	3	11	3	6	0.6593000000000001
Jamie's Toy Box	2023-04-10	5	16	5	10	0.6586
CODE: PANDORA	2023-03-30	30	16	5	35	0.6586
Heart attack	2023-01-17	7	78	32	39	0.6584000000000001
Gatewalkers	2023-01-12	564	216	96	660	0.6581999999999999
Lone Ruin	2023-01-12	172	97	41	213	0.657
Stewart The Fox	2023-01-20	63	99	42	105	0.6567000000000001
Duelyst GG	2023-01-28	16	23	8	24	0.6567000000000001
神国：创造	2023-01-16	83	144	63	146	0.6564
Grand Theft Auto: San Andreas - The Definitive Edition	2023-01-19	1699	1034	497	2196	0.6561
Sharded World	2023-01-16	9	18	6	15	0.6551
Crime Passional	2023-02-14	6	18	6	12	0.6551
Super Hero Flash Fist	2023-02-14	74	41	16	90	0.6547
We Are The Caretakers	2023-01-06	16	25	9	25	0.6546
ILLUMINATI	2023-01-06	15	25	9	24	0.6546
Dark Skies: The Nemansk Incident	2023-02-24	7	52	21	28	0.6542
Dawngrown	2023-02-14	4	8	2	6	0.6542
Raiden IV x MIKADO remix	2023-01-31	9	8	2	11	0.6542
Revival Quest	2023-03-24	8	8	2	10	0.6542
Mountain Alpaca	2023-02-19	4	8	2	6	0.6542
Mythology Waifus Mahjong	2023-03-10	7	8	2	9	0.6542
Captain The Looper	2023-03-31	5	8	2	7	0.6542
Hentai Ariel	2023-03-30	4	8	2	6	0.6542
Ensora	2023-01-17	8	13	4	12	0.6537999999999999
Eastern Europe Bus Sim	2023-01-27	2	13	4	6	0.6537999999999999
Hexagon Puzzle Blocks	2023-01-24	4	13	4	8	0.6537999999999999
Stars End	2023-01-08	244	839	407	651	0.6531
初夏倾语 - Summer Whisper	2023-01-13	18	20	7	25	0.6525
Paranormal Cleanup	2023-02-15	124	90	39	163	0.652
Lawbringer	2023-02-03	5	15	5	10	0.65
Super Club Soccer	2023-04-01	46	74	32	78	0.6496
Volzerk : Monsters and Lands Unknown	2023-01-25	1437	383	185	1622	0.6485
Tofas Sahin: Online Car Driving	2023-02-15	41	125	57	98	0.6479
It Lurks!	2023-01-18	2	5	1	3	0.6478
Rue	2023-02-13	3	5	1	4	0.6478
三千世界	2023-03-02	5	5	1	6	0.6478
Xheres	2023-03-10	2	5	1	3	0.6478
Nix: Ashes of the Phoenix	2023-03-24	3	5	1	4	0.6478
Clockwork Survivors	2023-01-31	5	5	1	6	0.6478
Radiant Cell	2023-01-10	2	5	1	3	0.6478
Umbral Omen	2023-02-13	4	5	1	5	0.6478
HAXWARE COMGAM	2023-01-31	6	5	1	7	0.6478
Pushing POPO	2023-01-10	2	5	1	3	0.6478
The Beastmaster Princess	2023-03-01	7	5	1	8	0.6478
Demon's Wrath	2023-03-25	4	5	1	5	0.6478
Paper Needs Inspiration!	2023-02-28	5	5	1	6	0.6478
Full Moon Kit	2023-02-07	3	5	1	4	0.6478
Fateel	2023-01-20	3	5	1	4	0.6478
Terrarium Builder	2023-02-17	3	5	1	4	0.6478
Cubis	2023-02-01	5	5	1	6	0.6478
勇者起源	2023-01-16	2	5	1	3	0.6478
Strip 4: Detention Bounce	2023-02-16	4	5	1	5	0.6478
Metal Glove: Exodus	2023-02-17	2	5	1	3	0.6478
Trapers Platformer	2023-01-12	3	5	1	4	0.6478
Guacomole	2023-02-03	4	5	1	5	0.6478
Myristica	2023-01-31	2	5	1	3	0.6478
You Can Do!mino	2023-02-07	2	5	1	3	0.6478
Battle of 2048 - Fantasy Edition	2023-02-01	2	5	1	3	0.6478
Pyramis	2023-03-30	5	5	1	6	0.6478
Donut Adventure	2023-03-20	2	5	1	3	0.6478
Final Dose	2023-03-28	3	5	1	4	0.6478
Hentai Cheerleader	2023-03-02	3	5	1	4	0.6478
三国之旅	2023-04-07	24	5	1	25	0.6478
NOT the Hero	2023-03-24	3	5	1	4	0.6478
DragonStrike	2023-03-27	6	5	1	7	0.6478
Darksy's Adventure	2023-03-31	6	5	1	7	0.6478
Infinite Guitars	2023-03-30	18	10	3	21	0.6476000000000001
Ghostly Moans	2023-03-06	8	10	3	11	0.6476000000000001
Cloak & Dagger: Shadow Operations	2023-03-30	3	10	3	6	0.6476000000000001
Goi	2023-03-14	49	10	3	52	0.6476000000000001
Chess: The Lost Pieces	2023-01-31	8	10	3	11	0.6476000000000001
Vosphia	2023-01-09	6	10	3	9	0.6476000000000001
SlasherRPG	2023-01-07	6	10	3	9	0.6476000000000001
フックと鎧獣	2023-04-07	14	10	3	17	0.6476000000000001
JOIN tiles	2023-02-13	2	10	3	5	0.6476000000000001
Furry Futa 💘	2023-03-31	4	10	3	7	0.6476000000000001
Avoid It!	2023-03-24	5	10	3	8	0.6476000000000001
Dirty Room	2023-03-24	15	10	3	18	0.6476000000000001
Spooky Shelter	2023-03-20	3	10	3	6	0.6476000000000001
7 Sins : Lost in Labyrinth	2023-02-10	15	26	10	25	0.6473000000000001
黑棉花：悟能	2023-01-31	8	26	10	18	0.6473000000000001
Deep Space Gardening	2023-02-13	12	17	6	18	0.6473000000000001
Rally Car	2023-04-09	5	17	6	11	0.6473000000000001
Prison Wars	2023-01-06	5	17	6	11	0.6473000000000001
The Backrooms Experiment	2023-03-15	16	17	6	22	0.6473000000000001
The Alchemist of Ars Magna	2023-03-31	45	17	6	51	0.6473000000000001
Terminal Velocity™: Boosted Edition	2023-03-14	11	19	7	18	0.6452
Yondu's Journey	2023-03-13	8	19	7	15	0.6452
Click & Cum 💘💦	2023-03-01	123	72	32	155	0.6448999999999999
Planet TD	2023-01-06	50	94	43	93	0.6439
Glory of war	2023-03-17	85	98	45	130	0.6437999999999999
Move Nature	2023-02-03	4	21	8	12	0.6436000000000001
Hidden Mars	2023-02-10	4	12	4	8	0.6435
Backroom Warfare II	2023-01-27	7	12	4	11	0.6435
Interkosmos 2000	2023-02-16	5	12	4	9	0.6435
JETT: The Far Shore + Given Time	2023-01-31	22	23	9	31	0.6424
Tower Survivors	2023-02-28	11	23	9	20	0.6424
Elle	2023-03-31	4	2	0	4	0.6408
Unknown Ways	2023-03-27	0	2	0	0	0.6408
Techlie	2023-01-18	1	2	0	1	0.6408
Skyratz	2023-01-02	7	2	0	7	0.6408
Crosswalks	2023-03-31	2	2	0	2	0.6408
Backbeat	2023-03-15	2	2	0	2	0.6408
Warp Tango	2023-03-31	3	2	0	3	0.6408
The Hero Journey in Yggdrasil	2023-03-18	3	2	0	3	0.6408
Solomon Snow - First Contact	2023-04-01	3	2	0	3	0.6408
Anyaroth: The Queen's Tyranny	2023-03-30	3	2	0	3	0.6408
AsteRoid Rage	2023-03-31	1	2	0	1	0.6408
Creature Hunter	2023-03-23	2	2	0	2	0.6408
An Indie Game a Month: Unreal Journey	2023-03-07	4	2	0	4	0.6408
Vacuum	2023-03-17	2	2	0	2	0.6408
COVID_KILLER	2023-02-28	3	2	0	3	0.6408
Anti-Bully Adventure	2023-02-28	1	2	0	1	0.6408
A Weekend in Puzzleburg	2023-02-17	2	2	0	2	0.6408
Natural Spirit	2023-01-30	2	2	0	2	0.6408
Ski3	2023-02-14	2	2	0	2	0.6408
Shenanigans	2023-02-24	5	2	0	5	0.6408
Galactic Escape	2023-02-03	1	2	0	1	0.6408
Hitstun	2023-03-22	4	2	0	4	0.6408
The Killer	2023-02-03	1	2	0	1	0.6408
Mega Demon Blaster	2023-04-04	2	2	0	2	0.6408
YOW	2023-01-25	2	2	0	2	0.6408
ball-e	2023-03-01	1	2	0	1	0.6408
Wizard War VR	2023-02-26	2	2	0	2	0.6408
Destroiders	2023-02-03	1	2	0	1	0.6408
Ashcrown	2023-04-07	5	2	0	5	0.6408
Heartbite: Dating by Daylight	2023-03-24	2	2	0	2	0.6408
Binary.	2023-03-30	3	2	0	3	0.6408
Walk with the Living 2	2023-01-13	2	2	0	2	0.6408
Fleeting	2023-01-05	1	2	0	1	0.6408
Adventures of Skye the Slime Maid	2023-04-07	2	2	0	2	0.6408
Hilm	2023-04-30	3	2	0	3	0.6408
Fisher's Qualm	2023-03-20	2	2	0	2	0.6408
Ninja Scroller	2023-03-31	1	2	0	1	0.6408
Voice of the Wizard by Brett Farkas	2023-01-05	1	2	0	1	0.6408
Rebels - Under the Spell of Magic (Chapter 3)	2023-02-26	2	2	0	2	0.6408
Striker of Sky	2023-02-28	2	2	0	2	0.6408
Around Us	2023-03-15	1	2	0	1	0.6408
Flife	2023-01-01	6	2	0	6	0.6408
DIMENSIONLESS	2023-03-15	1	2	0	1	0.6408
Traveler	2023-01-15	3	2	0	3	0.6408
The Widow's Boutique	2023-03-08	3	2	0	3	0.6408
Keks Slot Machines	2023-03-12	2	2	0	2	0.6408
The Dragon's Prophecy	2023-01-11	5	2	0	5	0.6408
Nusantara	2023-03-31	1	2	0	1	0.6408
Neko Dating Sim	2023-02-18	2	2	0	2	0.6408
Wipe Factor	2023-02-08	10	2	0	10	0.6408
Desktop Table Tennis	2023-04-03	2	2	0	2	0.6408
EXTERMINATOR	2023-02-28	1	2	0	1	0.6408
House of Jigsaw: Masters of Art	2023-03-23	2	2	0	2	0.6408
Neopunk	2023-02-28	2	2	0	2	0.6408
Cloud House	2023-03-31	2	2	0	2	0.6408
Moorhuhn Pirates - Crazy Chicken Pirates	2023-03-02	3	2	0	3	0.6408
7DAYS HEROES	2023-03-31	3	2	0	3	0.6408
BulletLiveVR	2023-03-31	2	2	0	2	0.6408
Crown of Thorns	2023-01-01	2	2	0	2	0.6408
Olho	2023-02-04	1	2	0	1	0.6408
Against All Odds	2023-02-23	4	2	0	4	0.6408
Escape of Pig	2023-01-11	2	2	0	2	0.6408
Just One	2023-01-23	1	2	0	1	0.6408
Neon Blast	2023-02-16	2	2	0	2	0.6408
Finding America: The Pacific Northwest	2023-01-30	3	2	0	3	0.6408
Nature Escapes 2	2023-02-06	4	2	0	4	0.6408
No13Shelter	2023-01-26	2	2	0	2	0.6408
Tales Of Polygonia	2023-01-21	3	2	0	3	0.6408
Water 2050	2023-03-16	2	2	0	2	0.6408
Air Attack VR	2023-01-18	2	2	0	2	0.6408
A Familiar World	2023-01-08	4	2	0	4	0.6408
Farm in another world	2023-04-05	3	2	0	3	0.6408
Lendas do Pebol: Mythic Football	2023-01-12	3	2	0	3	0.6408
シンセティック・デイズ	2023-02-06	2	2	0	2	0.6408
11 Years Ago	2023-02-24	4	2	0	4	0.6408
Space landing	2023-01-14	1	2	0	1	0.6408
Champ at Dawn	2023-01-23	2	2	0	2	0.6408
Stella's Pointless Castle Awakening	2023-01-24	1	2	0	1	0.6408
Glyph Guesser	2023-01-11	1	2	0	1	0.6408
Seeking Asylum: The Game	2023-01-08	2	2	0	2	0.6408
BOSSES	2023-01-02	2	2	0	2	0.6408
The Great Artists	2023-01-09	1	2	0	1	0.6408
Mutant Monty	2023-01-05	1	2	0	1	0.6408
air star	2023-03-05	3	2	0	3	0.6408
Grow Your Pets	2023-03-08	3	2	0	3	0.6408
Grip on Reality	2023-02-19	1	2	0	1	0.6408
Qdice	2023-01-21	2	2	0	2	0.6408
The Sword That Kills Christmas	2023-01-09	3	2	0	3	0.6408
Play football	2023-01-05	1	2	0	1	0.6408
Gunslinger Nova	2023-01-17	2	2	0	2	0.6408
Lichtreich: Willa	2023-01-10	2	2	0	2	0.6408
SlimeCatcher	2023-02-08	1	2	0	1	0.6408
Baalzebub	2023-03-31	1	2	0	1	0.6408
BallZ	2023-01-17	2	2	0	2	0.6408
Dummy Pirates: Ocean Tales	2023-04-01	3	2	0	3	0.6408
Monsters Mess	2023-01-20	2	2	0	2	0.6408
Waiter	2023-01-23	1	2	0	1	0.6408
Light the Backrooms	2023-01-19	6	2	0	6	0.6408
Vradark's Revenge	2023-01-26	1	2	0	1	0.6408
Tedram	2023-01-27	2	2	0	2	0.6408
Puzzle Pieces 4: Farewell Dear Winter	2023-02-23	1	2	0	1	0.6408
CryptoZoo	2023-02-11	1	2	0	1	0.6408
a land Goo's crazy	2023-03-25	2	2	0	2	0.6408
DoDodge	2023-01-27	2	2	0	2	0.6408
Archery Club	2023-03-20	3	2	0	3	0.6408
Marshrutka	2023-02-09	1	2	0	1	0.6408
視靈	2023-02-01	3	2	0	3	0.6408
愛する妻が目の前で他人棒に貫かれ、よがり喘いでいく ～ゴメンなさいあなた。でも、私気持ちいいの…～	2023-04-06	1	2	0	1	0.6408
他の男の精液で孕むとき ～襖の向こうで弟に精液を注ぎ込まれている妻～	2023-04-06	1	2	0	1	0.6408
Disgusting Puzzle 2	2023-02-01	1	2	0	1	0.6408
Omega Survivors	2023-02-03	2	2	0	2	0.6408
Toast	2023-03-26	2	2	0	2	0.6408
Targets	2023-02-12	2	2	0	2	0.6408
Hill Climb	2023-02-06	2	2	0	2	0.6408
Wonder Trips	2023-03-24	1	2	0	1	0.6408
Jigsaw Puzzle Lovers	2023-02-08	2	2	0	2	0.6408
Search	2023-03-31	2	2	0	2	0.6408
Furry Armpits	2023-02-11	2	2	0	2	0.6408
Police Car Armored: Cop Simulator	2023-02-14	2	2	0	2	0.6408
Robot Room Cleaner	2023-02-10	3	2	0	3	0.6408
OrbRider	2023-03-30	1	2	0	1	0.6408
星空骑士	2023-03-14	1	2	0	1	0.6408
Wars of Cards: ROMA	2023-03-24	6	2	0	6	0.6408
BookyPets Legends	2023-03-30	1	2	0	1	0.6408
恩索姆战士	2023-02-20	2	2	0	2	0.6408
Wheelie King 5	2023-03-02	1	2	0	1	0.6408
平凡的我與幽靈的同居生活	2023-02-27	3	2	0	3	0.6408
When Sword Sinks Into Flowers	2023-02-20	2	2	0	2	0.6408
SharkKing	2023-03-07	1	2	0	1	0.6408
Pi Fu Fighter	2023-03-09	2	2	0	2	0.6408
Evil Of Demons: Algailah	2023-04-06	2	2	0	2	0.6408
災難探偵サイガ～名状しがたい怪事件～	2023-03-13	2	2	0	2	0.6408
Mademoiselle Kshatriya	2023-03-01	1	2	0	1	0.6408
Pandora	2023-03-10	4	2	0	4	0.6408
Mahjong - Legacy of the Toltecs	2023-02-28	3	2	0	3	0.6408
Vessel Blue	2023-04-11	5	2	0	5	0.6408
Cyber Girl 1.1: REBOOT	2023-02-28	1	2	0	1	0.6408
Hostile Dreams	2023-03-16	1	2	0	1	0.6408
JetpacToo	2023-04-10	1	2	0	1	0.6408
Endless Spaceship	2023-02-27	1	2	0	1	0.6408
Poly Jigsaw: Cats	2023-02-21	4	2	0	4	0.6408
Forbidden Dojo	2023-03-31	12	2	0	12	0.6408
Cavimilation	2023-03-03	2	2	0	2	0.6408
Hentai Casual Swap	2023-03-02	3	2	0	3	0.6408
Odyssée numérique	2023-04-30	2	2	0	2	0.6408
50 Rounds	2023-03-29	1	2	0	1	0.6408
Escape the Unknown: Awaken the Realm	2023-04-04	3	2	0	3	0.6408
Climber	2023-03-08	1	2	0	1	0.6408
Hentai Senpai: Cyberpussy 2069	2023-03-24	4	2	0	4	0.6408
Phantom Hunter	2023-03-31	3	2	0	3	0.6408
Aqua Marbles - Ocean	2023-03-24	3	2	0	3	0.6408
Mystery Case Files: The Dalimar Legacy Collector's Edition	2023-04-04	15	2	0	15	0.6408
The Die Is Cast	2023-03-22	2	2	0	2	0.6408
Battle Tanks: Arena	2023-03-17	1	2	0	1	0.6408
Heart vs HP	2023-03-21	1	2	0	1	0.6408
Wojak wants Hentai	2023-04-05	5	2	0	5	0.6408
Car Delivery Man	2023-04-04	1	2	0	1	0.6408
Train to Nowhere	2023-03-27	2	2	0	2	0.6408
Shadow BoXR	2023-03-22	2	2	0	2	0.6408
Fire Chat	2023-03-27	5	2	0	5	0.6408
Ten Seconds Trillion	2023-03-21	5	2	0	5	0.6408
Slingshot Battle	2023-03-23	2	2	0	2	0.6408
Hollow Mission	2023-03-31	2	2	0	2	0.6408
WITCH RACE Prologue	2023-03-24	5	2	0	5	0.6408
Silver Box Classics	2023-03-27	8	2	0	8	0.6408
Kings Love	2023-03-23	3	2	0	3	0.6408
Scroter	2023-04-07	2	2	0	2	0.6408
Amazing Trip to Europe	2023-03-21	3	2	0	3	0.6408
Alien Planet Survival	2023-03-27	4	2	0	4	0.6408
Ainmora: O Desastre Iminente	2023-03-29	4	2	0	4	0.6408
Fateful Mages	2023-04-10	2	2	0	2	0.6408
Boom Royale	2023-03-31	3	2	0	3	0.6408
HEX PLAT	2023-03-31	1	2	0	1	0.6408
Mars Colonization	2023-03-31	4	2	0	4	0.6408
Tagger Mascot	2023-04-06	2	2	0	2	0.6408
The Wingless Bee	2023-04-06	1	2	0	1	0.6408
Cat Pipes	2023-04-10	2	2	0	2	0.6408
Arcanika	2023-04-09	5	2	0	5	0.6408
Anima Reprise	2023-06-30	1	2	0	1	0.6408
PACTUM + EPISODE 1	2023-04-07	1	2	0	1	0.6408
Somnus	2023-04-05	2	2	0	2	0.6408
The madness of death	2023-01-25	8	14	5	13	0.6406999999999999
Feudal Fantasy Incremental	2023-02-17	36	29	12	48	0.64
Redemption Reapers	2023-02-22	322	121	58	380	0.6391
Bus Driving Sim 22	2023-02-02	36	152	74	110	0.6389
Alien Egg: Ascent	2023-01-17	6	7	2	8	0.6389
僵尸特攻队	2023-02-17	9	7	2	11	0.6389
UnrealGundy	2023-03-31	3	7	2	5	0.6389
Polaroid	2023-01-06	3	7	2	5	0.6389
King's Hand	2023-01-20	6	7	2	8	0.6389
Race in Desert	2023-01-06	3	7	2	5	0.6389
Square garden	2023-01-31	3	7	2	5	0.6389
House Sitter	2023-03-16	4	7	2	6	0.6389
Infinimine	2023-02-19	35	18	7	42	0.6375000000000001
九州谕	2023-01-06	30	18	7	37	0.6375000000000001
DOOMSDAY SURVIVORS	2023-03-10	13	18	7	20	0.6375000000000001
Mysterious School	2023-02-17	822	154	76	898	0.6365999999999999
EDEN: Create World	2023-03-01	6	20	8	14	0.6365
Monster Battle	2023-03-15	8	20	8	16	0.6365
Cooperative Chess	2023-02-16	16	22	9	25	0.6358
Stay Out Of The Farm: Prologue	2023-02-23	5	22	9	14	0.6358
Battle Team	2023-01-20	7	24	10	17	0.6353
Resoraki	2023-03-23	26	24	10	36	0.6353
Moving in with My Step-sister	2023-02-07	108	97	47	155	0.6348
Omen of Sorrow	2023-03-23	11	9	3	14	0.6345000000000001
Sushi Bar Express	2023-03-23	4	9	3	7	0.6345000000000001
Powers of Hex	2023-04-06	3	9	3	6	0.6345000000000001
Speed Dates	2023-03-31	3	9	3	6	0.6345000000000001
Under the Sky World~Another~	2023-02-07	3	9	3	6	0.6345000000000001
Echo Storm	2023-03-16	8	9	3	11	0.6345000000000001
Into the Wonderland	2023-02-17	7	9	3	10	0.6345000000000001
Lawnmower Game: Zombies	2023-03-06	3	9	3	6	0.6345000000000001
Warehouse Simulator: Forklift Driver	2023-02-11	9	30	13	22	0.6344
Negative Atmosphere: Emergency Room	2023-01-27	59	40	18	77	0.6341
Nearly Dead - Live and Let Die	2023-02-24	62	38	17	79	0.6341
Operation: Harsh Doorstop	2023-02-15	2074	3013	1657	3731	0.6338
Pharaoh: A New Era	2023-02-15	6321	1655	901	7222	0.6336
Handyman Corporation	2023-01-25	311	71	34	345	0.6329
The Backrooms Game	2023-03-22	13	11	4	17	0.6321
Idiotic The Game	2023-02-02	4	11	4	8	0.6321
The Gravehouse	2023-01-06	4	11	4	8	0.6321
School Flight Simulator	2023-02-13	4	11	4	8	0.6321
Hank: Straightjacket	2023-02-01	4	11	4	8	0.6321
SEX Room [18+]	2023-02-04	329	101	50	379	0.6317
Project: WATERFALL	2023-02-28	5	13	5	10	0.6306
Stellar Sovereigns	2023-03-08	11	13	5	16	0.6306
Futanari girls 3D ⚧👧🍆	2023-01-26	6	13	5	11	0.6306
Errant Kingdom	2023-02-28	84	85	42	126	0.63
Dimensions: Dreadnought Architect	2023-02-02	149	81	40	189	0.6295000000000001
Terfenstein 3D	2023-01-13	5	33	15	20	0.6294
For Your Tranquility	2023-01-16	119	79	39	158	0.6293
Dragon's Treasure	2023-03-25	4	17	7	11	0.6293
Scary Turnaround	2023-01-28	3	17	7	10	0.6293
The Guard	2023-02-28	4	17	7	11	0.6293
绝影-Vanishing Shadow	2023-04-11	12	19	8	20	0.629
觅仙	2023-03-10	3290	328	175	3465	0.6287
Dominance	2023-01-12	484	197	103	587	0.6286
Universe in Cum 💦 🌎	2023-03-25	76	129	66	142	0.6286
I Am Your President	2023-02-27	370	99	50	420	0.628
大衍江湖	2023-02-11	324	445	243	567	0.6263000000000001
苦主救助中心 Ⅲ	2023-03-11	560	427	234	794	0.6253000000000001
Winter Survival: Prologue	2023-02-15	337	154	81	418	0.6253000000000001
Getting Freaky With Fujiki	2023-04-07	6	4	1	7	0.6251
A Sad Journey	2023-01-20	2	4	1	3	0.6251
Running Robot Man 4	2023-02-07	4	4	1	5	0.6251
Anica	2023-01-28	4	4	1	5	0.6251
Frost League	2023-03-25	1	4	1	2	0.6251
Alice in dreamland	2023-03-13	7	4	1	8	0.6251
House of the Soul	2023-02-06	3	4	1	4	0.6251
Pedigree Tactics	2023-01-06	3	4	1	4	0.6251
Damoria	2023-02-24	14	4	1	15	0.6251
KAKUDO	2023-03-30	3	4	1	4	0.6251
Legacy	2023-02-03	4	4	1	5	0.6251
BackRoomsNew	2023-01-03	3	4	1	4	0.6251
Roadkill Raceway	2023-02-21	2	4	1	3	0.6251
Dracula Defense!	2023-02-24	2	4	1	3	0.6251
Don't Kill the Cat	2023-01-07	2	4	1	3	0.6251
Cat Life	2023-01-06	3	4	1	4	0.6251
Pepper Girl	2023-01-19	2	4	1	3	0.6251
Horny Spell	2023-01-05	4	4	1	5	0.6251
Yummy Girls 2	2023-01-31	1	4	1	2	0.6251
流浪荒岛	2023-03-01	3	4	1	4	0.6251
PunchMan Online	2023-03-24	6	4	1	7	0.6251
Dragon Pinball	2023-03-03	2	4	1	3	0.6251
Vlobs	2023-03-10	2	4	1	3	0.6251
Christmas Night	2023-04-10	6	4	1	7	0.6251
Survivor:Stay In The Light	2023-01-21	3	4	1	4	0.6251
Horror Explus	2023-03-22	3	4	1	4	0.6251
Goose Ronnie	2023-03-24	1	4	1	2	0.6251
高考夺魁记	2023-02-08	7	4	1	8	0.6251
FLUCTUOID	2023-02-28	4	4	1	5	0.6251
Ghosting Vandal	2023-02-05	2	4	1	3	0.6251
CARTOONITE	2023-03-03	4	4	1	5	0.6251
Pato Martinez	2023-03-17	3	4	1	4	0.6251
SomethingWithSpace	2023-02-18	2	4	1	3	0.6251
Goblins	2023-03-18	3	4	1	4	0.6251
OWLMAN	2023-02-24	3	4	1	4	0.6251
Simple Increment	2023-03-02	16	4	1	17	0.6251
ROBOCOCK	2023-03-29	2	4	1	3	0.6251
Don't Rage	2023-04-08	4	4	1	5	0.6251
Dodge It! Online	2023-01-24	21	30	14	35	0.624
Advanced Rogue Intelligence Assault: Genesis	2023-02-10	179	147	78	257	0.6233
SEX, LOVE & GIRLS❤️💦	2023-02-25	91	87	45	136	0.6226
Caroline's Fantasies	2023-02-24	43	22	10	53	0.6221
Bloodhound: First day in hell	2023-03-30	10	37	18	28	0.6213000000000001
Exipelago	2023-01-10	5	6	2	7	0.621
Tomomon	2023-03-30	13	6	2	15	0.621
Extreme Tag!	2023-03-10	16	6	2	18	0.621
Asunder	2023-01-05	5	6	2	7	0.621
Citadelic	2023-02-17	7	6	2	9	0.621
The Cullfield Ritual	2023-01-05	2	6	2	4	0.621
Stick Bros	2023-01-26	10	6	2	12	0.621
Square Life	2023-01-29	5	6	2	7	0.621
Hand2Hand project	2023-02-12	5	6	2	7	0.621
Cat Jigsaw Puzzle Games	2023-03-06	5	6	2	7	0.621
VDSC Battle Royal	2023-03-30	63	6	2	65	0.621
OnlyFap Simulator 6 💦	2023-02-21	467	35	17	484	0.6207
Stardust Exile	2023-02-17	19	16	7	26	0.6204999999999999
M doll	2023-01-26	5	16	7	12	0.6204999999999999
Hentai Hasshaku	2023-02-10	8	14	6	14	0.62
The Homecoming Exhibition	2023-03-05	4	14	6	10	0.62
The Nightmare Journey	2023-02-24	5	8	3	8	0.6197
FPS Seduce - Hentai	2023-01-18	2	8	3	5	0.6197
Formula Retro Racing - World Tour	2023-03-31	10	8	3	13	0.6197
Lil Baby Poop's NIGHTMARES	2023-01-19	2	8	3	5	0.6197
NoEL - Nothing on Elysion Line	2023-01-05	8	8	3	11	0.6197
Agent Roy - Zombie Hunt	2023-01-26	1	8	3	4	0.6197
Muscle MILF	2023-03-03	9	8	3	12	0.6197
Elysium Heights	2023-03-23	6	8	3	9	0.6197
Erin's Naughty Friday Prologue	2023-03-31	6	8	3	9	0.6197
Who Run The City: Multiplayer	2023-02-10	13	10	4	17	0.6195
CATACOMBS: The Beginning	2023-01-27	6	10	4	10	0.6195
Berry Madness	2023-02-06	1	10	4	5	0.6195
Dude Simulator 5	2023-03-10	4	10	4	8	0.6195
Zombie Survivals [18+]🧟‍♀️🔞	2023-03-04	935	89	47	982	0.6193
World Championship Boxing Manager™ 2	2023-01-17	39	29	14	53	0.6186
Call of Duty®: Vanguard	2023-03-08	636	268	150	786	0.6182
Tom Clancy's The Division 2	2023-01-12	11002	3335	1987	12989	0.6171
Rune Break	2023-03-26	46	23	11	57	0.616
Ghost Recon Breakpoint	2023-01-23	9145	3204	1927	11072	0.6149
Sweets Pusher Friends	2023-02-10	577	48	25	602	0.6144
GameDev Life Simulator 🎮🕹	2023-02-18	165	58	31	196	0.6125
Image	2023-01-20	4	17	8	12	0.6125
Soulforged	2023-02-28	10	26	13	23	0.6118
IamTheExorcist	2023-04-02	9	15	7	16	0.6111
Garten of Banban 2	2023-03-03	1647	1141	692	2339	0.6097
Cube Conflict	2023-02-15	19	13	6	25	0.6095
Deceptus	2023-01-17	12	13	6	18	0.6095
Fallen Bride Mege	2023-02-04	105	87	49	154	0.6079
The Last World	2023-02-04	16	11	5	21	0.6076
Hidden World 3 Top-Down 3D	2023-02-21	5	11	5	10	0.6076
Fap & Cum 💦	2023-01-28	632	80	45	677	0.6074
Fisherman's House	2023-01-07	4	20	10	14	0.6074
Grand Theft Auto III - The Definitive Edition	2023-01-19	774	520	314	1088	0.6072
Ocean Punk	2023-01-12	19	32	17	36	0.6059
TBTE - The Button Tycoon Experience	2023-01-05	93	9	4	97	0.6054
Re:|THM - once upon a time	2023-02-09	8	16	8	16	0.6034
The Third	2023-02-22	339	98	57	396	0.6033
诡仙志异	2023-01-06	4	7	3	7	0.6028
Tragedy of Medusa	2023-04-01	4	7	3	7	0.6028
Hyper Shapes	2023-01-26	5	7	3	8	0.6028
MULTIPLAYER KNIGHTS	2023-02-16	6	7	3	9	0.6028
Quacktown Smackdown	2023-02-28	43	38	21	64	0.6021
Warlander	2023-01-24	23428	3837	2454	25882	0.6020000000000001
Nuclear War Simulator	2023-02-02	91	71	41	132	0.6017
Project Hedra	2023-02-07	6	14	7	13	0.6009000000000001
Korea Dynasty (조선메타실록)	2023-01-15	50	82	48	98	0.6006
Farmer's Father: Save the Innocence	2023-03-29	77	36	20	97	0.6006
The Adventurer's Domain Online	2023-01-26	131	90	53	184	0.6004
Frontiers Reach	2023-03-01	4	5	2	6	0.5997
Sanctuary Saga	2023-03-08	14	5	2	16	0.5997
Isaiah 188	2023-01-06	3	5	2	5	0.5997
一九三零 浪漫譚	2023-03-29	7	5	2	9	0.5997
Pantazil	2023-02-15	2	5	2	4	0.5997
IN CELL	2023-01-12	1	5	2	3	0.5997
Exorcist 2: Crow Magic	2023-01-05	3	5	2	5	0.5997
Demonic Pack	2023-01-07	3	5	2	5	0.5997
Anyone There?	2023-02-14	5	5	2	7	0.5997
Gverse	2023-03-25	3	5	2	5	0.5997
Mighty Mage	2023-02-01	2	5	2	4	0.5997
Party Party Time	2023-01-12	5	5	2	7	0.5997
Adventure with the Goddess	2023-01-19	5	5	2	7	0.5997
No Way Out	2023-03-03	3	5	2	5	0.5997
PARANORMAL GIRLFRIEND	2023-02-27	2	5	2	4	0.5997
Fatrifice	2023-03-20	3	5	2	5	0.5997
Evil Superhero VR - Open-World Chaos	2023-03-26	3	5	2	5	0.5997
THE ILLUSION: CURSE	2023-03-29	3	5	2	5	0.5997
Sex with Succubus ❤️‍🔥	2023-02-08	281	81	48	329	0.5984
Fast Burger Simulator	2023-01-09	4	12	6	10	0.598
Monster Tower Quest	2023-02-28	11	12	6	17	0.598
Hentai MagicalGirl	2023-02-17	5	12	6	11	0.598
INHUMAN	2023-01-11	35	53	31	66	0.5966
Truck World: Driving School	2023-01-10	424	288	181	605	0.5962
Elven Magic	2023-03-28	2	3	1	3	0.596
Bottle Journey	2023-01-05	2	3	1	3	0.596
Scrap Games	2023-01-17	2	3	1	3	0.596
Baldy Bounce	2023-02-13	3	3	1	4	0.596
Random Blacksmith Game	2023-02-19	2	3	1	3	0.596
On my own: A Hot Isekai Adventure	2023-01-13	6	3	1	7	0.596
ハラキリゲイシャガールズ！	2023-01-20	4	3	1	5	0.596
GPMoto Challenge	2023-04-07	3	3	1	4	0.596
Sherlock Holmes The Awakened	2023-04-11	723	3	1	724	0.596
Sovranti	2023-02-23	6	3	1	7	0.596
Paze Knight Ellen and the Dungeon town Sodom	2023-04-07	30	3	1	31	0.596
PolyRoyale	2023-03-01	2	3	1	3	0.596
The Kraken Wakes	2023-03-27	3	3	1	4	0.596
Zombie Prison Break	2023-02-10	2	3	1	3	0.596
Last Order	2023-02-17	5	3	1	6	0.596
无尽星海(Endless Stars)	2023-01-17	3	3	1	4	0.596
Seven Wonders	2023-01-06	2	3	1	3	0.596
Cursed Angel: Time Paradox	2023-01-12	1	3	1	2	0.596
GameDev LiTuber Simulator	2023-02-15	3	3	1	4	0.596
The Final Bastion	2023-02-28	2	3	1	3	0.596
New Earth Saga of the New Gods	2023-03-03	7	3	1	8	0.596
Railways: Train Simulator	2023-03-29	5	3	1	6	0.596
The Entity Within	2023-02-28	2	3	1	3	0.596
Heralds of Silence	2023-03-08	2	3	1	3	0.596
Zero-G-Racer	2023-02-22	4	3	1	5	0.596
Redumption	2023-03-27	3	3	1	4	0.596
Ball Animals	2023-02-23	6	3	1	7	0.596
Eaten by Darkness	2023-04-02	2	3	1	3	0.596
Last Night in zombie village	2023-01-31	1	3	1	2	0.596
Unexpected Futa Corruption	2023-01-05	4	3	1	5	0.596
Stolen Wife ~Cucked On A Host Spring Company Trip~	2023-01-04	5	3	1	6	0.596
CGI™: The Game	2023-01-31	2	3	1	3	0.596
World Soccer Kid	2023-01-06	3	3	1	4	0.596
DiggerSim - Excavator & Heavy Equipment Simulator VR	2023-01-31	2	3	1	3	0.596
IOUA	2023-02-07	3	3	1	4	0.596
A Legend of Wisdom Part I	2023-01-23	2	3	1	3	0.596
Find the Whales	2023-01-12	2	3	1	3	0.596
Love Menu	2023-03-30	5	3	1	6	0.596
The Duck Song Game	2023-01-18	2	3	1	3	0.596
The Survivors	2023-02-24	2	3	1	3	0.596
塔尔战纪	2023-02-08	2	3	1	3	0.596
RPG Fitness VR	2023-01-27	2	3	1	3	0.596
Lilly's Flower Shop	2023-03-02	4	3	1	5	0.596
Midnight彌奈	2023-03-31	2	3	1	3	0.596
Little Land War SRPG	2023-02-14	1	3	1	2	0.596
À Travers Le Temps	2023-02-05	3	3	1	4	0.596
Street Boss	2023-02-28	4	3	1	5	0.596
Universe Survivors	2023-02-28	3	3	1	4	0.596
Web Crawlies {Multiplayer}	2023-02-10	4	3	1	5	0.596
The Abyss	2023-02-16	2	3	1	3	0.596
Gangster City: Mafia Car Driving	2023-02-12	2	3	1	3	0.596
Special Courier	2023-02-27	3	3	1	4	0.596
Sex Simulator - The Yacht	2023-02-09	3	3	1	4	0.596
Blind and Schizophrenic	2023-03-31	3	3	1	4	0.596
Krakout	2023-02-28	3	3	1	4	0.596
Classic Car Simulator: Car Driving	2023-02-21	5	3	1	6	0.596
Mechafare	2023-03-10	2	3	1	3	0.596
Girls Tennis League	2023-03-31	3	3	1	4	0.596
Pporite	2023-03-17	5	3	1	6	0.596
I was born poor	2023-03-18	1	3	1	2	0.596
Twell	2023-03-21	4	3	1	5	0.596
The Last Of The Core	2023-03-27	1	3	1	2	0.596
GogMagog	2023-01-31	23	25	14	37	0.5946
Forlorn	2023-03-01	5	10	5	10	0.5943
Furry OwO	2023-01-20	5	10	5	10	0.5943
Factorybelts 2	2023-02-27	2	1	0	2	0.5942000000000001
OscarWildeCard	2023-03-03	1	1	0	1	0.5942000000000001
Boom	2023-02-24	2	1	0	2	0.5942000000000001
Goblin Keep	2023-03-21	1	1	0	1	0.5942000000000001
Torches of Fate	2023-04-06	2	1	0	2	0.5942000000000001
Brain Tester : Mind trick quiz	2023-01-19	1	1	0	1	0.5942000000000001
Operation: Harsh Doorstop - Development Build	2023-03-30	18	1	0	18	0.5942000000000001
Kapow Pets	2023-03-09	1	1	0	1	0.5942000000000001
Nefasto's Misadventure: Meeting Noeroze	2023-03-23	3	1	0	3	0.5942000000000001
Base Jump	2023-02-13	2	1	0	2	0.5942000000000001
VOLLEYGON	2023-02-17	1	1	0	1	0.5942000000000001
卢沟桥事变	2023-01-27	1	1	0	1	0.5942000000000001
Our Mother's house	2023-04-10	2	1	0	2	0.5942000000000001
RoguekiniZ	2023-01-10	3	1	0	3	0.5942000000000001
Three Adventures Imagined with Monsters - T.I.MO	2023-03-31	2	1	0	2	0.5942000000000001
Core-Blast	2023-03-24	3	1	0	3	0.5942000000000001
Biblios Dice	2023-01-30	4	1	0	4	0.5942000000000001
Tear of Titans	2023-02-27	1	1	0	1	0.5942000000000001
Knight Solitaire 2	2023-01-31	3	1	0	3	0.5942000000000001
Zenteni	2023-02-01	2	1	0	2	0.5942000000000001
Project Utgardr	2023-02-03	1	1	0	1	0.5942000000000001
Hunter Project: Operation Survive	2023-04-08	1	1	0	1	0.5942000000000001
The Original Wizard	2023-03-24	1	1	0	1	0.5942000000000001
Best Of Eleven	2023-04-10	2	1	0	2	0.5942000000000001
Death's Dungeon	2023-03-24	3	1	0	3	0.5942000000000001
Mystery Solitaire. Grimm's Tales 7	2023-01-18	3	1	0	3	0.5942000000000001
Playback Trauma: In Sickness	2023-01-26	2	1	0	2	0.5942000000000001
Blickel	2023-01-13	2	1	0	2	0.5942000000000001
Path of a Player 2	2023-01-26	2	1	0	2	0.5942000000000001
Bullet Chase	2023-01-17	1	1	0	1	0.5942000000000001
Adventures of DaKoo the Dragon	2023-03-29	2	1	0	2	0.5942000000000001
Rally 9000	2023-03-30	2	1	0	2	0.5942000000000001
The Game of Fourtune	2023-04-04	10	1	0	10	0.5942000000000001
1001 Jigsaw. Cute Cats 3	2023-01-20	1	1	0	1	0.5942000000000001
Protocol Aftertime	2023-04-11	2	1	0	2	0.5942000000000001
Living Legends Remastered: Wrath of the Beast Collector's Edition	2023-03-10	7	1	0	7	0.5942000000000001
Bakeborough	2023-03-28	4	1	0	4	0.5942000000000001
SoleSurvivor	2023-04-03	3	1	0	3	0.5942000000000001
Those Left Behind	2023-03-20	1	1	0	1	0.5942000000000001
Dyestributor	2023-01-13	4	1	0	4	0.5942000000000001
ATCo2	2023-03-09	2	1	0	2	0.5942000000000001
Depois da chuva de meteoros	2023-01-08	1	1	0	1	0.5942000000000001
The Prowler Hell	2023-04-07	3	1	0	3	0.5942000000000001
Deltatile	2023-03-31	2	1	0	2	0.5942000000000001
Lollypop	2023-01-06	2	1	0	2	0.5942000000000001
Wander Vyrosa	2023-03-16	4	1	0	4	0.5942000000000001
创业大亨	2023-03-24	4	1	0	4	0.5942000000000001
Atham Battle Simulator	2023-03-24	1	1	0	1	0.5942000000000001
Elven Rivers: The Forgotten Lands Collector's Edition	2023-03-03	5	1	0	5	0.5942000000000001
Meta Lines	2023-04-04	4	1	0	4	0.5942000000000001
ニンニン☆妖怪大戦争	2023-03-09	12	1	0	12	0.5942000000000001
Super Mando	2023-01-27	1	1	0	1	0.5942000000000001
Scientifically Accurate Dinosaur Mating Simulator 2022: American Revolution 1775 - 1786	2023-01-03	1	1	0	1	0.5942000000000001
Witch Guild Survivor	2023-02-15	3	1	0	3	0.5942000000000001
FukTopia 5	2023-01-30	1	1	0	1	0.5942000000000001
That Makes Sense	2023-02-17	1	1	0	1	0.5942000000000001
Sky traveler	2023-02-28	1	1	0	1	0.5942000000000001
Forgotten Souls	2023-04-03	8	1	0	8	0.5942000000000001
Boing	2023-01-19	1	1	0	1	0.5942000000000001
Nuclear Arena	2023-01-15	3	1	0	3	0.5942000000000001
Video Game Trivia	2023-02-25	2	1	0	2	0.5942000000000001
Celebrity Slot Machine	2023-04-06	1	1	0	1	0.5942000000000001
Lucky Slots	2023-04-06	2	1	0	2	0.5942000000000001
STARLITE: Defender of Justice Ultimate HD Edition	2023-01-22	1	1	0	1	0.5942000000000001
VOID	2023-03-15	1	1	0	1	0.5942000000000001
Red Sea	2023-03-13	1	1	0	1	0.5942000000000001
Desktop Bowling	2023-04-03	2	1	0	2	0.5942000000000001
Our Summer Sports	2023-02-02	2	1	0	2	0.5942000000000001
Bat Hero	2023-03-08	1	1	0	1	0.5942000000000001
Takenoko - Tilt Five AR	2023-02-28	2	1	0	2	0.5942000000000001
Millie and Molly	2023-01-23	2	1	0	2	0.5942000000000001
Escape From School	2023-01-06	2	1	0	2	0.5942000000000001
Adventure's Pixel World	2023-01-16	2	1	0	2	0.5942000000000001
How long can you survive	2023-02-21	2	1	0	2	0.5942000000000001
THGITW	2023-03-08	2	1	0	2	0.5942000000000001
TROJAN	2023-02-07	2	1	0	2	0.5942000000000001
Super Uriel	2023-03-27	1	1	0	1	0.5942000000000001
VetVR	2023-03-06	3	1	0	3	0.5942000000000001
Vampire Tourist	2023-01-06	1	1	0	1	0.5942000000000001
Soul Taker	2023-02-16	2	1	0	2	0.5942000000000001
Breu: Shadow Hunt	2023-01-27	1	1	0	1	0.5942000000000001
Stream Runners: Heroes	2023-02-02	3	1	0	3	0.5942000000000001
Off The Tracks	2023-03-17	2	1	0	2	0.5942000000000001
Monster Hide	2023-04-04	11	1	0	11	0.5942000000000001
0xFF	2023-03-28	1	1	0	1	0.5942000000000001
String Along	2023-01-17	2	1	0	2	0.5942000000000001
Laruaville 4	2023-01-08	6	1	0	6	0.5942000000000001
Hot 21	2023-02-17	4	1	0	4	0.5942000000000001
Tiny Troopers: Joint Ops XL	2023-03-09	4	1	0	4	0.5942000000000001
Royale Battle: Warzone	2023-01-06	2	1	0	2	0.5942000000000001
Unlimited Fight Ultimate Strike	2023-03-30	1	1	0	1	0.5942000000000001
The Rocket Jumper	2023-01-27	2	1	0	2	0.5942000000000001
Beach Cafe: Caribbean Sand	2023-01-20	3	1	0	3	0.5942000000000001
KARAKURI KENGEKI	2023-01-08	1	1	0	1	0.5942000000000001
Temple and Secrets	2023-02-10	1	1	0	1	0.5942000000000001
The Big One	2023-02-28	2	1	0	2	0.5942000000000001
Vengeful Castle	2023-02-27	2	1	0	2	0.5942000000000001
JLGJ	2023-01-05	2	1	0	2	0.5942000000000001
Project Sail	2023-01-13	2	1	0	2	0.5942000000000001
Elves Castle and Secrets	2023-02-12	2	1	0	2	0.5942000000000001
Medieval and Secrets	2023-02-10	2	1	0	2	0.5942000000000001
Mouse Dreams	2023-01-03	1	1	0	1	0.5942000000000001
Gravlist	2023-02-05	1	1	0	1	0.5942000000000001
Summer Village	2023-01-03	2	1	0	2	0.5942000000000001
The Fisherman and the Sea	2023-03-31	2	1	0	2	0.5942000000000001
Nautikin Adventures	2023-03-31	5	1	0	5	0.5942000000000001
回响之战	2023-02-03	2	1	0	2	0.5942000000000001
Snake Robot	2023-01-22	1	1	0	1	0.5942000000000001
Halves	2023-02-22	1	1	0	1	0.5942000000000001
Hightail	2023-03-01	1	1	0	1	0.5942000000000001
Johny Explorer	2023-01-13	1	1	0	1	0.5942000000000001
Defending Earth	2023-02-21	1	1	0	1	0.5942000000000001
Up To Clouds	2023-03-07	2	1	0	2	0.5942000000000001
The Space Bar	2023-03-31	3	1	0	3	0.5942000000000001
汐留TrainSimulator	2023-01-31	2	1	0	2	0.5942000000000001
Neptune's Garden	2023-01-13	1	1	0	1	0.5942000000000001
Beat animals	2023-01-05	2	1	0	2	0.5942000000000001
PIP D	2023-01-03	2	1	0	2	0.5942000000000001
Fiendish Freddy's Big Top O' Fun	2023-03-31	1	1	0	1	0.5942000000000001
PINHI!	2023-01-08	1	1	0	1	0.5942000000000001
Ball vs Zombie	2023-03-01	3	1	0	3	0.5942000000000001
Delirium	2023-02-02	3	1	0	3	0.5942000000000001
Training Shooter FPS	2023-01-20	2	1	0	2	0.5942000000000001
white water	2023-01-16	1	1	0	1	0.5942000000000001
BoxLoop 2	2023-01-19	1	1	0	1	0.5942000000000001
Epic Race: The Stadium	2023-01-17	1	1	0	1	0.5942000000000001
一个人的木偶剧	2023-02-07	2	1	0	2	0.5942000000000001
Deep In The Snowy Night	2023-01-20	2	1	0	2	0.5942000000000001
Touch the Color	2023-01-20	1	1	0	1	0.5942000000000001
Traffic Brains 2	2023-03-31	3	1	0	3	0.5942000000000001
FULLYBROKEN: WAY HOME	2023-01-16	1	1	0	1	0.5942000000000001
草食系男子の言いなり入院生活- A passive boy at the Huntress clinic -	2023-01-27	2	1	0	2	0.5942000000000001
Drop It: Block Paradise!	2023-02-13	3	1	0	3	0.5942000000000001
Slippery Flippers	2023-02-02	1	1	0	1	0.5942000000000001
病菌幸存者	2023-04-07	1	1	0	1	0.5942000000000001
键盘侠Keyboardmen	2023-01-24	1	1	0	1	0.5942000000000001
Sudoku Vacation	2023-02-16	2	1	0	2	0.5942000000000001
Quadice	2023-02-01	1	1	0	1	0.5942000000000001
沙盘战火调度	2023-01-24	2	1	0	2	0.5942000000000001
Adventurer Flower	2023-01-27	2	1	0	2	0.5942000000000001
Sky High Games Horror Collection	2023-02-15	1	1	0	1	0.5942000000000001
Cookie Match: Enhanced Edition	2023-01-19	2	1	0	2	0.5942000000000001
Grim Tales: The Time Traveler Collector's Edition	2023-01-13	7	1	0	7	0.5942000000000001
Poly Puzzle: Butterflies	2023-01-21	3	1	0	3	0.5942000000000001
Vacation Adventures: Park Ranger 14 Collector's Edition	2023-01-26	3	1	0	3	0.5942000000000001
Bottoms Up!: Part 1	2023-04-07	2	1	0	2	0.5942000000000001
Beat The Soul Z	2023-02-19	2	1	0	2	0.5942000000000001
Rope Bowling	2023-02-01	1	1	0	1	0.5942000000000001
Wizard Hentai Survivors	2023-02-01	3	1	0	3	0.5942000000000001
EscapeGame TimelessRoom	2023-02-01	1	1	0	1	0.5942000000000001
Jump Tale	2023-02-15	1	1	0	1	0.5942000000000001
Haunting of the Evil Spirit - Horror Choose your own adventure Novel	2023-01-27	1	1	0	1	0.5942000000000001
Carta Nostra	2023-02-01	4	1	0	4	0.5942000000000001
AquaHero	2023-02-17	1	1	0	1	0.5942000000000001
Fairytale Theatre	2023-03-02	1	1	0	1	0.5942000000000001
ソウエンノイセキ	2023-02-03	4	1	0	4	0.5942000000000001
TAL: Arctic 5	2023-02-09	3	1	0	3	0.5942000000000001
Hexield	2023-02-04	1	1	0	1	0.5942000000000001
Ancient Guardians: The Dragon	2023-02-06	3	1	0	3	0.5942000000000001
The MisAdventures of Xenos	2023-03-20	2	1	0	2	0.5942000000000001
愛する妻、玲奈の浮気告白 『お、俺より気持ち良かったのか…？』→『…うん。凄かった』	2023-04-06	1	1	0	1	0.5942000000000001
Sudoku Classic	2023-02-24	4	1	0	4	0.5942000000000001
Dark Traveller	2023-03-16	2	1	0	2	0.5942000000000001
Sigformation	2023-02-10	2	1	0	2	0.5942000000000001
Halloween in Hollywood	2023-02-03	2	1	0	2	0.5942000000000001
It Happened Here: Streaming Lives Collector's Edition	2023-02-10	5	1	0	5	0.5942000000000001
Frogvival	2023-03-06	2	1	0	2	0.5942000000000001
MoonScavenger	2023-03-02	2	1	0	2	0.5942000000000001
Buggy	2023-02-14	2	1	0	2	0.5942000000000001
Doodle TD	2023-02-28	2	1	0	2	0.5942000000000001
Checkerboard Collection	2023-02-09	3	1	0	3	0.5942000000000001
The Last Pawn	2023-02-16	1	1	0	1	0.5942000000000001
Let's go back to our village	2023-02-14	2	1	0	2	0.5942000000000001
My sister-in-law won't let go of my cock ~Seduced by a widowed proprietress~	2023-03-17	1	1	0	1	0.5942000000000001
Sector 598	2023-02-10	1	1	0	1	0.5942000000000001
De Feet	2023-02-16	2	1	0	2	0.5942000000000001
The Hero's Journey through Time	2023-02-20	2	1	0	2	0.5942000000000001
CODING ROBO	2023-03-21	1	1	0	1	0.5942000000000001
Twerk it Girl!	2023-02-24	2	1	0	2	0.5942000000000001
Labyrinthian: Lost 'Til Dawn	2023-02-17	1	1	0	1	0.5942000000000001
Everyone's Happy Place	2023-02-28	2	1	0	2	0.5942000000000001
Cube Roller	2023-03-31	2	1	0	2	0.5942000000000001
The Dragon Queen	2023-03-23	2	1	0	2	0.5942000000000001
ZOMBIE HUNTER -FACE THE SINS-	2023-02-22	2	1	0	2	0.5942000000000001
Magnetik	2023-02-21	1	1	0	1	0.5942000000000001
Jack the Nipper II	2023-02-28	1	1	0	1	0.5942000000000001
Photon Engineer	2023-04-10	2	1	0	2	0.5942000000000001
Offroad Jeep 4x4: Car Driving Simulator	2023-02-22	2	1	0	2	0.5942000000000001
Parcel Problems	2023-02-28	1	1	0	1	0.5942000000000001
Bedrock High	2023-03-10	1	1	0	1	0.5942000000000001
Sinful soul club	2023-04-08	4	1	0	4	0.5942000000000001
Fight With Keys	2023-02-28	1	1	0	1	0.5942000000000001
蒂羅森紫花詠Tirosens thistle-中文版-	2023-02-28	2	1	0	2	0.5942000000000001
Shadow of the Night	2023-02-20	2	1	0	2	0.5942000000000001
Dead eat dead	2023-02-22	2	1	0	2	0.5942000000000001
8-Ball Pocket	2023-03-03	2	1	0	2	0.5942000000000001
The Last Hero	2023-03-27	1	1	0	1	0.5942000000000001
SpiderAttack	2023-02-21	1	1	0	1	0.5942000000000001
Pop Some Eyes	2023-03-31	2	1	0	2	0.5942000000000001
Trans Agent X	2023-03-30	2	1	0	2	0.5942000000000001
Fishjong 2	2023-04-02	2	1	0	2	0.5942000000000001
KitBashers 2 [Multiplayer]	2023-02-23	3	1	0	3	0.5942000000000001
Fox Girl Taming	2023-03-31	4	1	0	4	0.5942000000000001
Fabulous Field Trip	2023-03-07	1	1	0	1	0.5942000000000001
Knight Cats: Leaves on the Road Collector's Edition	2023-02-17	5	1	0	5	0.5942000000000001
Architecture Zeitgeist	2023-03-27	2	1	0	2	0.5942000000000001
Retro Style - Pixel Art Jigsaw Puzzles	2023-02-27	1	1	0	1	0.5942000000000001
Adrenaline Dungeon	2023-03-30	2	1	0	2	0.5942000000000001
1000 Man General	2023-03-28	2	1	0	2	0.5942000000000001
AgrChamp	2023-03-10	2	1	0	2	0.5942000000000001
MoonLess	2023-04-05	1	1	0	1	0.5942000000000001
Starblast: 3D Wars	2023-04-06	2	1	0	2	0.5942000000000001
Crossroad of Worlds: Mirrors to Other worlds Collector's Edition	2023-03-07	1	1	0	1	0.5942000000000001
俺たち対空兵	2023-03-10	2	1	0	2	0.5942000000000001
Project Dark	2023-04-06	3	1	0	3	0.5942000000000001
Shelltered	2023-03-07	1	1	0	1	0.5942000000000001
Lattice Dancer	2023-03-08	1	1	0	1	0.5942000000000001
FOBIA ...worse than fear.	2023-03-24	3	1	0	3	0.5942000000000001
Dune of the Desert	2023-03-21	2	1	0	2	0.5942000000000001
Deeper In The Dark	2023-03-10	1	1	0	1	0.5942000000000001
chi_ninja	2023-03-17	1	1	0	1	0.5942000000000001
GHOST HUNTER	2023-03-21	1	1	0	1	0.5942000000000001
Aniballs	2023-03-14	2	1	0	2	0.5942000000000001
AntiVirus_snake	2023-03-10	2	1	0	2	0.5942000000000001
Undead zone	2023-03-31	1	1	0	1	0.5942000000000001
Bridge to Another World: Cursed Clouds	2023-02-28	9	1	0	9	0.5942000000000001
Shepherd	2023-03-17	3	1	0	3	0.5942000000000001
SEARCH ALL - FRUITS	2023-03-16	4	1	0	4	0.5942000000000001
HandleIT	2023-03-31	1	1	0	1	0.5942000000000001
Volar	2023-03-22	3	1	0	3	0.5942000000000001
Simple Arcade	2023-03-20	1	1	0	1	0.5942000000000001
Poly Jigsaw: Birds	2023-03-11	2	1	0	2	0.5942000000000001
Super Passport Bros	2023-03-27	0	1	0	0	0.5942000000000001
GUARDIAN OF DYNAMITE : A BOMB PROTECTOR	2023-03-28	2	1	0	2	0.5942000000000001
Amazo	2023-03-27	1	1	0	1	0.5942000000000001
VIRA	2023-04-10	1	1	0	1	0.5942000000000001
Manic Archers - Bullseye DEMO	2023-03-29	1	1	0	1	0.5942000000000001
Jump Jump Cyberpunk	2023-03-30	2	1	0	2	0.5942000000000001
Our Summer Festival	2023-04-03	4	1	0	4	0.5942000000000001
Farm Day 2023	2023-03-21	5	1	0	5	0.5942000000000001
Ascendant's Roguelike	2023-03-27	2	1	0	2	0.5942000000000001
The Viriditas Chapel of Perpetual Adoration	2023-03-13	1	1	0	1	0.5942000000000001
车辆对战僵尸 Vehicle Beat Zombie	2023-03-31	1	1	0	1	0.5942000000000001
Bye Bye Swingby	2023-04-03	2	1	0	2	0.5942000000000001
Executioner Girls	2023-04-06	3	1	0	3	0.5942000000000001
Ferb	2023-03-31	1	1	0	1	0.5942000000000001
Robot Lawn Mower	2023-03-31	2	1	0	2	0.5942000000000001
Getting To The Other Side!!!	2023-04-08	1	1	0	1	0.5942000000000001
Crossroads: Escaping the Dark	2023-03-20	5	1	0	5	0.5942000000000001
异界旅客：序章	2023-04-06	3	1	0	3	0.5942000000000001
Fireball Spam	2023-04-04	1	1	0	1	0.5942000000000001
Greymarsh	2023-04-07	2	1	0	2	0.5942000000000001
That Rocket Game	2023-04-11	5	1	0	5	0.5942000000000001
GALAHAD 3093	2023-01-24	62	95	59	121	0.5913
Chinese Rail SIm	2023-02-10	30	18	10	40	0.5910000000000001
PRIMITIVE HEARTS	2023-02-18	121	34	20	141	0.5908
The Hidden and Unknown	2023-01-23	2	13	7	9	0.59
My Neighbor Neko	2023-01-27	4	13	7	11	0.59
Orders Of The Ruler	2023-03-27	2	8	4	6	0.5897
Fear of the Dark	2023-02-17	6	8	4	10	0.5897
The Summon	2023-04-04	17	8	4	21	0.5897
Painter Simulator	2023-03-02	15	8	4	19	0.5897
Code Red	2023-01-20	9	8	4	13	0.5897
Hike Isle	2023-01-13	3	8	4	7	0.5897
SUBNET	2023-02-09	8	8	4	12	0.5897
LEAP	2023-03-01	371	209	135	506	0.589
The Palace of Unrest	2023-01-18	52	49	30	82	0.5881000000000001
Best in the West	2023-01-22	50	79	50	100	0.5864
Secret Of Dungeon	2023-02-25	20	11	6	26	0.5855
Crime Scene	2023-01-20	2	11	6	8	0.5855
Hidden Post-Apocalyptic 4 Top-Down 3D	2023-01-25	2	11	6	8	0.5855
ENDLESS	2023-03-24	9	11	6	15	0.5855
Random Chat	2023-03-28	131	39	24	155	0.585
Hide & Chick	2023-03-01	68	22	13	81	0.5849000000000001
Estencel	2023-01-19	24	31	19	43	0.5833
Yeah！Fighting Girl	2023-01-11	12	14	8	20	0.5833
Liminal Reality	2023-02-15	3	14	8	11	0.5833
Mangavania	2023-01-20	5	6	3	8	0.5833
Mafia Clicker: City Builder	2023-03-16	9	6	3	12	0.5833
Jylko: Through The Song	2023-04-07	3	6	3	6	0.5833
The Past	2023-01-06	1	6	3	4	0.5833
Hike Trip	2023-01-27	2	6	3	5	0.5833
Eggsplorer	2023-03-30	5	6	3	8	0.5833
PlanetSprite	2023-03-23	7	6	3	10	0.5833
League Manager 2023	2023-03-16	30	55	35	65	0.5825
Revans	2023-01-12	9	20	12	21	0.5814
Karagon	2023-02-13	126	41	26	152	0.5805
Summer Daze: Tilly's Tale	2023-03-28	7	9	5	12	0.5796
World Annihilation Operations Parts I-IV	2023-02-14	2	9	5	7	0.5796
Death Swap: End As One	2023-01-25	39	70	46	85	0.5788000000000001
Faith & Shield:4044 Tower Defense	2023-01-06	5	12	7	12	0.5782
Xuan-Yuan Sword V	2023-01-12	62	36	23	85	0.578
Desolation	2023-03-17	8	15	9	17	0.5776
WuJiDaoRen	2023-03-13	43	40	26	69	0.5761000000000001
Ancient Cities	2023-03-24	549	659	466	1015	0.5754
Sun Down	2023-02-25	46	34	22	68	0.5754
1971: Indian Naval Front	2023-04-05	7	4	2	9	0.5739
Lost Empire 2977	2023-01-11	4	4	2	6	0.5739
Castle: Daybreak	2023-01-01	4	4	2	6	0.5739
Gigantosaurus: Dino Kart	2023-02-17	4	4	2	6	0.5739
Hohenheim: Skywards	2023-01-03	2	4	2	4	0.5739
Pentacore	2023-02-11	3	4	2	5	0.5739
Ember's Love	2023-02-24	4	4	2	6	0.5739
Tribu	2023-01-06	4	4	2	6	0.5739
VRrOOm	2023-02-03	4	4	2	6	0.5739
Sex-Loving Family	2023-03-30	15	4	2	17	0.5739
Dungeon Shooter : Dark Temple	2023-02-03	3	4	2	5	0.5739
Snowball Christmas festival	2023-03-22	4	4	2	6	0.5739
Demon Hentai Slayer	2023-03-18	3	4	2	5	0.5739
Dangerous Road	2023-03-31	7	4	2	9	0.5739
OVE : The Sword of Liberation	2023-02-17	5	4	2	7	0.5739
Heavy Armored Assassin	2023-03-20	3	4	2	5	0.5739
VONA / She	2023-03-13	3	4	2	5	0.5739
SimPoly Drive	2023-03-30	2	4	2	4	0.5739
Hentai Melody	2023-04-06	3	4	2	5	0.5739
Forspoken	2023-01-24	12579	3466	2527	15106	0.5726
Bram The Toymaker	2023-01-20	6	16	10	16	0.5726
NecroCity	2023-04-05	90	16	10	100	0.5726
Risnuch	2023-02-20	8	13	8	16	0.5721
Royal Merchant	2023-02-26	18	29	19	37	0.5719
Avernus	2023-01-20	8	7	4	12	0.5718
Hacker's Restart	2023-03-01	26	7	4	30	0.5718
Pain Cage Tournament	2023-02-24	5	7	4	9	0.5718
Paranoia Party	2023-02-11	11	7	4	15	0.5718
Cat Boy Creator	2023-02-24	3	7	4	7	0.5718
Spicy Strip Poker	2023-02-15	12	10	6	18	0.5717
Etherion Online	2023-03-10	191	36	24	215	0.5710000000000001
Sands	2023-03-07	57	30	20	77	0.5694
Puzzle Bobble™2X/BUST-A-MOVE™2 Arcade Edition & Puzzle Bobble™3/BUST-A-MOVE™3 S-Tribute	2023-02-01	17	14	9	26	0.5669
UNRESTRAINED	2023-01-13	6	14	9	15	0.5669
Royal Booty Quest	2023-02-24	102	57	40	142	0.5656
Spring X Elixir	2023-02-13	8	11	7	15	0.5653
You Are Sick	2023-03-10	5	11	7	12	0.5653
Ephesus	2023-02-17	17	54	38	55	0.5647
情人泪	2023-01-24	59	40	28	87	0.5636
Angels on Tanks	2023-02-24	7	8	5	12	0.5632
Word Crystal	2023-01-16	5	8	5	10	0.5632
Clay Soldiers	2023-02-10	5	8	5	10	0.5632
Kinky Cosplay: Gyarus Gone Wild	2023-01-13	13	8	5	18	0.5632
The Last Saintess	2023-04-10	26	8	5	31	0.5632
SmallZ	2023-01-10	7	19	13	20	0.561
Survivors: Three Kingdoms	2023-03-23	38	38	27	65	0.5606
Company of Heroes 3	2023-02-23	36646	8508	6576	43222	0.5605
Space Pirate King	2023-03-10	4	5	3	7	0.5605
A Modest Legacy	2023-01-23	8	5	3	11	0.5605
Building Destruction	2023-01-28	5	5	3	8	0.5605
ROGLE	2023-01-31	2	5	3	5	0.5605
Polygone	2023-03-21	4	5	3	7	0.5605
Snow Mountain	2023-02-24	1	5	3	4	0.5605
Scavenger	2023-03-26	5	5	3	8	0.5605
ApplePop	2023-03-10	2	5	3	5	0.5605
Mechanical Survivor	2023-03-20	18	5	3	21	0.5605
Aconite	2023-02-10	4	12	8	12	0.56
ARTificial	2023-02-27	18	12	8	26	0.56
Osiris: New Dawn	2023-01-18	4773	8116	6310	11083	0.5590999999999999
Rendezvous	2023-04-11	9	2	1	10	0.5569
Surprising My Neighbors 2	2023-03-01	3	2	1	4	0.5569
Rogue Sweeper	2023-03-07	6	2	1	7	0.5569
Seance	2023-03-13	3	2	1	4	0.5569
United Assault - World War 2	2023-03-30	5	2	1	6	0.5569
TruXposure VR	2023-03-08	2	2	1	3	0.5569
The Secret Ops 	2023-01-22	2	2	1	3	0.5569
Upgrader	2023-02-07	2	2	1	3	0.5569
Lich Clicker	2023-02-14	4	2	1	5	0.5569
Death Trials (Director's Cut)	2023-02-08	2	2	1	3	0.5569
Lost Memories	2023-01-01	2	2	1	3	0.5569
Astonishing Basketball Manager	2023-01-06	5	2	1	6	0.5569
Souls of Tartarus	2023-03-17	2	2	1	3	0.5569
Naturia	2023-01-30	3	2	1	4	0.5569
Aunewyth	2023-01-20	1	2	1	2	0.5569
Shadow Lens	2023-01-06	1	2	1	2	0.5569
Akari: School Trip	2023-01-26	2	2	1	3	0.5569
Idle Drift Kings	2023-01-31	5	2	1	6	0.5569
Midnight Alert	2023-01-11	4	2	1	5	0.5569
Dawn Of Hell	2023-02-20	3	2	1	4	0.5569
Survive Now	2023-03-29	3	2	1	4	0.5569
Demon Invasion: Endless	2023-01-14	4	2	1	5	0.5569
A Terrible Place	2023-03-04	1	2	1	2	0.5569
Dark Shrine	2023-01-18	3	2	1	4	0.5569
Chess Defense Saga	2023-02-06	2	2	1	3	0.5569
Milo no Senki 3	2023-03-06	3	2	1	4	0.5569
HEROIC	2023-02-13	1	2	1	2	0.5569
Crazy Designer	2023-03-02	5	2	1	6	0.5569
Banana Clicker	2023-03-28	6	2	1	7	0.5569
Sex Simulator - Pool Party	2023-02-23	4	2	1	5	0.5569
VR Rescue Girls	2023-04-02	4	2	1	5	0.5569
Hentai Galaxy	2023-03-13	2	2	1	3	0.5569
Run On Home	2023-03-21	3	2	1	4	0.5569
King War [RTS]	2023-03-09	1	2	1	2	0.5569
The PenguinGame -Antarctic Savior-	2023-03-23	2	2	1	3	0.5569
Hinami Bay	2023-04-07	2	2	1	3	0.5569
Lovers in Playa Rosa	2023-03-29	3	2	1	4	0.5569
H Girl 2	2023-04-07	4	2	1	5	0.5569
Zombie Rush	2023-03-29	2	2	1	3	0.5569
MiLE HiGH TAXi	2023-03-13	40	41	30	70	0.5561
Drift Stage	2023-01-13	12	25	18	30	0.5553
Superfuse	2023-01-31	1914	438	345	2259	0.5514
Sex and Zombies	2023-02-02	6	6	4	10	0.5514
Killfest	2023-01-31	4	6	4	8	0.5514
Dead Profit	2023-01-03	15	10	7	22	0.5513
Venture Valley	2023-01-24	447	24	18	465	0.5484
Vendetta: Mafia Wars	2023-01-21	10	15	11	21	0.5484
Monster Energy Supercross - The Official Videogame 6	2023-03-09	430	67	52	482	0.5481
Brothel Simulator 🍓	2023-01-14	123	127	101	224	0.5459
Auto Brawl Chess	2023-04-07	37	7	5	42	0.5448
Keiko-san (47) my co-worker, is a single mother	2023-02-15	10	7	5	15	0.5448
Orcs Coming TD	2023-01-16	6	7	5	11	0.5448
СИМУЛЯТОР ЛАЗАНЬЯ ПО ЗАБРОШКАМ	2023-02-10	15	31	24	39	0.5447
Scott Pilgrim vs The World	2023-01-05	446	450	368	814	0.5435
Madshot: Road to Madness	2023-02-23	25	12	9	34	0.5433
Space Game: Star We There Yet?	2023-02-14	38	12	9	47	0.5433
Farm Empire	2023-03-23	368	22	17	385	0.543
Wanted: Dead	2023-02-14	291	257	210	501	0.5424
Watch Dogs: Legion	2023-01-26	5048	1378	1145	6193	0.5418000000000001
Adventure Light	2023-02-01	4	3	2	6	0.5417000000000001
LOST BETWEEN	2023-01-20	2	3	2	4	0.5417000000000001
여동생 ♡ 만들기 : 당신이 바라는 소녀의 모습 - Teen version	2023-01-01	3	3	2	5	0.5417000000000001
Magic Kingdom War	2023-01-20	4	3	2	6	0.5417000000000001
Pop Journey	2023-02-27	3	3	2	5	0.5417000000000001
Lockdown 2024	2023-01-21	21	3	2	23	0.5417000000000001
Lincoln Green	2023-01-20	2	3	2	4	0.5417000000000001
Horny Clinic	2023-01-09	3	3	2	5	0.5417000000000001
SHATTER	2023-01-06	4	3	2	6	0.5417000000000001
DUNGEON WALK－竜迷宮の管理者－	2023-01-04	18	3	2	20	0.5417000000000001
【VR】Physical Exam / イタズラ身体測定	2023-01-19	3	3	2	5	0.5417000000000001
Desktop Garage Kit	2023-03-03	2	3	2	4	0.5417000000000001
Zombie Watch Part II	2023-03-23	7	3	2	9	0.5417000000000001
Horny Hotel Maids	2023-03-20	2	3	2	4	0.5417000000000001
Furry Sweeper	2023-02-21	4	3	2	6	0.5417000000000001
Meet Ball Girls	2023-02-02	2	3	2	4	0.5417000000000001
Pattaya	2023-02-03	2	3	2	4	0.5417000000000001
Emotions: Social MeDie	2023-02-17	2	3	2	4	0.5417000000000001
More than words	2023-03-09	2	3	2	4	0.5417000000000001
Polyturned	2023-02-23	5	3	2	7	0.5417000000000001
Astronomic Date	2023-02-17	3	3	2	5	0.5417000000000001
Jigsaw Realm 3D	2023-02-10	2	3	2	4	0.5417000000000001
Tribefort	2023-03-31	6	3	2	8	0.5417000000000001
人妻学園　～営み指導で調教ッ！？ハメ堕ちする清純妻～	2023-03-15	1	3	2	3	0.5417000000000001
SANRI	2023-01-09	11	13	10	21	0.5402
sim4D ATC	2023-03-31	33	19	15	48	0.5387
浮生箓2：九九行歌	2023-02-20	206	117	97	303	0.5375
僵尸（THE JIANG SHI）	2023-01-01	5	14	11	16	0.5375
Grimgrad	2023-04-05	74	20	16	90	0.5368
Drift Experience Japan	2023-02-07	76	52	43	119	0.5354
Floor44	2023-03-09	80	46	38	118	0.5351
Zhiel's Mystery	2023-02-22	2	4	3	5	0.5332
Iaijutsu	2023-12-31	2	4	3	5	0.5332
FINAL AGE	2023-03-30	3	4	3	6	0.5332
Satay Shop Tycoon	2023-02-08	2	4	3	5	0.5332
Futa Heroism	2023-01-06	5	4	3	8	0.5332
Just Futanari	2023-02-03	5	4	3	8	0.5332
Invincible Medusa	2023-01-23	5	4	3	8	0.5332
ReverseRoom	2023-02-22	5	4	3	8	0.5332
Dot	2023-01-25	2	4	3	5	0.5332
Forkscythe	2023-03-29	2	4	3	5	0.5332
SUA	2023-01-28	4	4	3	7	0.5332
Dark City: International Intrigue	2023-03-06	13	4	3	16	0.5332
二次元老婆生成器	2023-01-09	92	30	25	117	0.5319
Malody V	2023-02-28	30	103	89	119	0.529
Brinefall	2023-04-03	55	27	23	78	0.5278
SEX, Drugs and CYBERPUNK	2023-01-06	11	12	10	21	0.5278
错误之事	2023-01-19	9	12	10	19	0.5278
Sass VS Fash: Girlballs of Steel	2023-01-02	2	5	4	6	0.5278
Abandoned drive-in | 廃ドライブイン	2023-01-29	27	5	4	31	0.5278
她与绳	2023-02-24	3	5	4	7	0.5278
Guns & Fishes	2023-02-01	11	35	30	41	0.5276
有个小村：逍遥	2023-01-10	48	28	24	72	0.5268
苟延残喘	2023-01-23	2	6	5	7	0.5239
Alchemia Story	2023-02-22	123	45	40	163	0.5217
Evil's Den: Forsaken Dungeon	2023-03-07	4	7	6	10	0.5211
Curse of Kisera	2023-02-14	21	7	6	27	0.5211
Grace Online	2023-03-03	8	8	7	15	0.5189
Sapper - Defuse The Bomb Simulator	2023-01-23	63	37	34	97	0.5153
14 Days of Desire	2023-02-03	16	11	10	26	0.5144
Curse of the Sea Rats	2023-04-06	118	40	39	157	0.5046
Kerbal Space Program 2	2023-02-24	25724	6828	6764	32488	0.5022
Garten of Banban	2023-01-06	770	2237	2223	2993	0.5014000000000001
Cursed	2023-01-04	23	28	28	51	0.5
Stay Still	2023-01-06	14	23	23	37	0.5
Samurai Slaughter House	2023-03-31	14	21	21	35	0.5
Claris the Princess Knight ~ Extra Story	2023-01-18	5	10	10	15	0.5
Film Studio Manager	2023-03-17	15	9	9	24	0.5
Plains of Pain	2023-02-17	7	8	8	15	0.5
ACL Pro Cornhole	2023-03-29	62	7	7	69	0.5
Nash Racing: 70 seconds left	2023-01-05	3	7	7	10	0.5
Cat Girl Creator	2023-02-14	3	6	6	9	0.5
Hentai Mikky	2023-03-08	2	6	6	8	0.5
Exorcism Ritual	2023-01-10	3	5	5	8	0.5
Synthwave FURY	2023-02-10	3	5	5	8	0.5
Wormhole Cafe	2023-03-02	5	5	5	10	0.5
A SIMPLE REQUEST	2023-03-01	2	4	4	6	0.5
Third	2023-02-02	3	4	4	7	0.5
Fight & Crush	2023-02-08	3	4	4	7	0.5
League Funny 遊戲大亂鬪	2023-03-31	34	4	4	38	0.5
Barrett Foster : Prologue	2023-03-27	3	4	4	7	0.5
The Most Lecherous	2023-03-29	6	4	4	10	0.5
BRoS - Battle Royale of Survival	2023-03-10	6	3	3	9	0.5
Zen Paint	2023-02-13	4	3	3	7	0.5
A Rum Tale	2023-01-05	1	3	3	4	0.5
Metal Punch	2023-03-05	2	3	3	5	0.5
人形の傷跡：姉の謎を追うサイコホラー	2023-03-25	7	3	3	10	0.5
Sleight of Hand: Dynasty	2023-02-15	2	3	3	5	0.5
Army War: Shooting Simulator	2023-02-06	2	3	3	5	0.5
Citadale Resurrection	2023-02-02	3	3	3	6	0.5
Taxi Driver Simulator: Car Parking	2023-02-09	5	3	3	8	0.5
Minigames Master	2023-03-03	2	3	3	5	0.5
Dead Inside	2023-03-01	1	3	3	4	0.5
Saving Mei	2023-03-06	4	3	3	7	0.5
工业战争	2023-03-28	4	3	3	7	0.5
Fantasy Empires	2023-03-27	20	3	3	23	0.5
Brain Damage	2023-04-03	3	3	3	6	0.5
Gogte	2023-02-09	2	2	2	4	0.5
One Tank Army	2023-01-20	3	2	2	5	0.5
Monsters of Seabrook	2023-02-17	5	2	2	7	0.5
Merchant of Bohemia	2023-02-15	2	2	2	4	0.5
ANGEL DROID	2023-02-16	3	2	2	5	0.5
Dark spell	2023-02-10	5	2	2	7	0.5
Conquering Married Women through Sex	2023-03-16	7	2	2	9	0.5
Dinosaur Simulator	2023-03-02	3	2	2	5	0.5
Courier Tycoon	2023-03-03	2	2	2	4	0.5
Package Dudes	2023-01-31	3	2	2	5	0.5
Cleaning Queens	2023-02-03	5	2	2	7	0.5
Christmas Land	2023-01-10	1	2	2	3	0.5
Blue Sky	2023-01-09	2	2	2	4	0.5
国产手机帝国-Mobile phone empire	2023-01-05	2	2	2	4	0.5
Old Shadow	2023-01-27	1	2	2	3	0.5
The Dark Side Of Mars	2023-01-24	4	2	2	6	0.5
Death Gunfire - Kill the Zombie	2023-02-20	3	2	2	5	0.5
EQUAL PEOPLE	2023-01-27	1	2	2	3	0.5
Hentai Secrets	2023-03-20	2	2	2	4	0.5
街机捕鱼城-经典万炮捕鱼	2023-03-27	12	2	2	14	0.5
Cargo Truck Simulator 2023	2023-02-19	3	2	2	5	0.5
HOW	2023-03-13	3	2	2	5	0.5
十月怪谈	2023-03-17	5	2	2	7	0.5
KITS	2023-04-30	5	2	2	7	0.5
Survival Sprint	2023-03-29	4	2	2	6	0.5
DeathKeep	2023-03-31	6	2	2	8	0.5
Kriaturaz	2023-03-18	1	1	1	2	0.5
Evil Below	2023-02-17	3	1	1	4	0.5
Super Sketchy Party	2023-03-27	1	1	1	2	0.5
Thief vs Detective Blonde Lady	2023-02-08	3	1	1	4	0.5
Emperial Knights	2023-03-15	2	1	1	3	0.5
Darwin's Aquarium	2023-01-10	4	1	1	5	0.5
Barnstormers: Determined to Win	2023-03-22	2	1	1	3	0.5
The Bastonnes	2023-03-15	4	1	1	5	0.5
ギルド受付嬢フィリス	2023-03-20	10	1	1	11	0.5
Captain!	2023-02-02	2	1	1	3	0.5
What's your emergency	2023-01-31	2	1	1	3	0.5
Evolution Tale	2023-03-02	6	1	1	7	0.5
Vanessa	2023-02-20	2	1	1	3	0.5
First Time in Hawaii	2023-02-15	4	1	1	5	0.5
Overdelivery	2023-03-28	1	1	1	2	0.5
Ringborn	2023-01-12	2	1	1	3	0.5
Phantom Island	2023-03-10	1	1	1	2	0.5
Brichi Quest	2023-01-05	2	1	1	3	0.5
Village and The Witch	2023-01-04	4	1	1	5	0.5
Universal Truck Simulator Tow Games	2023-02-21	2	1	1	3	0.5
Petit Petit Petit	2023-03-16	7	1	1	8	0.5
Not born to be King	2023-02-10	1	1	1	2	0.5
PigShip and the Giant Wolf	2023-02-24	1	1	1	2	0.5
Neon Noir	2023-01-05	2	1	1	3	0.5
Fair Princess Under Futa Curse	2023-03-07	5	1	1	6	0.5
剑仙的副本	2023-04-01	2	1	1	3	0.5
ChessBase 17 SE	2023-02-28	5	1	1	6	0.5
A Game You Can Afford In This Economy	2023-03-08	2	1	1	3	0.5
Chains of Time	2023-03-02	4	1	1	5	0.5
Heirs of the Kings	2023-02-03	8	1	1	9	0.5
Eastern Europe Train Sim	2023-01-25	2	1	1	3	0.5
WAR Card Game_uvr	2023-02-01	1	1	1	2	0.5
Secret Dimension	2023-02-06	1	1	1	2	0.5
Crossroad of Worlds: Mystery Agency Collector's Edition	2023-02-02	4	1	1	5	0.5
Void: Edge of Existence	2023-01-02	3	1	1	4	0.5
Digital Virus	2023-02-09	2	1	1	3	0.5
ハーデリアクエスト	2023-01-24	2	1	1	3	0.5
Hentai Jigsaw Puzzle Collection: Christmas Edition	2023-01-07	1	1	1	2	0.5
Red Flower	2023-01-09	2	1	1	3	0.5
Pong Ping	2023-02-16	2	1	1	3	0.5
Mecha Blade	2023-01-01	1	1	1	2	0.5
Our Memories - Hentai	2023-03-09	2	1	1	3	0.5
Star Hive: The Menace	2023-03-02	3	1	1	4	0.5
海伦的神迹	2023-02-24	1	1	1	2	0.5
Find the Whales Español	2023-01-12	1	1	1	2	0.5
Golden Gloves VR	2023-02-15	1	1	1	2	0.5
Earth Mars	2023-02-04	1	1	1	2	0.5
三国群英战略版	2023-01-25	2	1	1	3	0.5
Obsta-Loop	2023-03-31	3	1	1	4	0.5
Skyemont Battle	2023-02-28	1	1	1	2	0.5
Castle Destroyers	2023-02-25	2	1	1	3	0.5
栽培人计划：Meet a Date!	2023-01-31	1	1	1	2	0.5
Dark Desire Mute 2	2023-02-03	2	1	1	3	0.5
Vault City	2023-03-30	2	1	1	3	0.5
City Ambulance Car Driving	2023-02-07	2	1	1	3	0.5
The City: Superhero Flying Experience	2023-02-14	3	1	1	4	0.5
我的拿汀學姐	2023-03-31	2	1	1	3	0.5
Book of Shardows	2023-02-14	1	1	1	2	0.5
Stay in	2023-02-11	2	1	1	3	0.5
First Light	2023-04-07	3	1	1	4	0.5
Real Zombie War Simulator	2023-02-16	3	1	1	4	0.5
Modo Defence	2023-03-12	4	1	1	5	0.5
Gradient	2023-02-21	2	1	1	3	0.5
Slide Puzzle: Cute Moe Girls	2023-03-23	2	1	1	3	0.5
Coerced: Unexpected Detention	2023-03-31	4	1	1	5	0.5
Psychic Investigation of Sakuragi Haru	2023-03-22	7	1	1	8	0.5
Hentai Cookie	2023-03-20	1	1	1	2	0.5
AlcoFox	2023-04-10	1	1	1	2	0.5
Sex Simulator - Girl on Girl	2023-03-21	3	1	1	4	0.5
Keyboard Warrior	2023-03-31	2	1	1	3	0.5
The Dungeon Vendor	2023-04-06	3	1	1	4	0.5
Mizz Survival	2023-04-04	4	1	1	5	0.5
darkside	2023-04-07	4	1	1	5	0.5
GUNSHIP	2023-04-09	3	1	1	4	0.5
Moviehouse - The Film Studio Tycoon	2023-04-05	294	80	81	375	0.4976
Idle Clans	2023-04-07	489	39	40	529	0.4954
Conquest Emperor	2023-04-07	13	25	26	39	0.4932
The Last of Us™ Part I	2023-03-28	36496	13254	13679	50175	0.4925
Ravenbound	2023-03-30	1104	284	296	1400	0.49119999999999997
Warhammer Age of Sigmar: Soul Arena	2023-01-19	227	99	104	331	0.4902
Hidden Islands	2023-03-22	7	11	12	19	0.4866
Propaganda Inc.	2023-01-03	40	10	11	51	0.48560000000000003
联盟大乱斗	2023-01-04	822	90	97	919	0.4852
Bless Global	2023-03-01	466	121	131	597	0.4839
ANETHA	2023-03-20	11	8	9	20	0.4829
Not For Broadcast VR	2023-03-23	7	8	9	16	0.4829
PumPum 2	2023-03-31	30	18	20	50	0.48240000000000005
她的脚	2023-01-20	6	7	8	14	0.4811
Novastella Island	2023-01-17	127	166	184	311	0.47869999999999996
DEAD CIDE CLUB	2023-02-28	1951	411	454	2405	0.47840000000000005
Coal Mining Simulator	2023-04-11	399	13	15	414	0.4772
Richman 6	2023-03-16	16	13	15	31	0.4772
Wo Long: Fallen Dynasty	2023-03-03	75906	10082	11121	87027	0.4767
House Builder VR	2023-03-06	3	5	6	9	0.4761
bloody lonely cold	2023-01-28	4	12	14	18	0.4758
Kink.Inc	2023-03-20	62	11	13	75	0.47409999999999997
The Magic Land	2023-03-04	16	11	13	29	0.47409999999999997
Flight Attendant Simulator VR	2023-02-23	9	4	5	14	0.4722
Monster Knockout	2023-01-03	2	4	5	7	0.4722
Cars vs Train	2023-01-09	2	4	5	7	0.4722
Backrooms - Surreality	2023-01-29	4	4	5	9	0.4722
Spelljammer: Pirates of Realmspace	2023-03-31	17	4	5	22	0.4722
有个小村	2023-01-10	3	3	4	7	0.4668
Lumien	2023-03-29	4	3	4	8	0.4668
Criminal Expert	2023-01-13	10	3	4	14	0.4668
Dragon Survivors	2023-02-22	5	3	4	9	0.4668
Battle for borders	2023-02-22	5	7	9	14	0.46409999999999996
Eleonor's Nightmares	2023-01-08	5	7	9	14	0.46409999999999996
ONI : Road to be the Mightiest Oni	2023-03-08	31	21	26	57	0.46340000000000003
Spirit Eyes	2023-03-01	1	2	3	4	0.4583
Armored Battalion	2023-02-04	2	2	3	5	0.4583
Maiden Kingdom	2023-03-31	5	2	3	8	0.4583
Sears: The Sky Frontier	2023-03-06	1	2	3	4	0.4583
Detective Super Star	2023-02-10	7	2	3	10	0.4583
The Starving Tournament	2023-01-06	5	2	3	8	0.4583
Find the Birds	2023-01-12	3	2	3	6	0.4583
WILD HEARTS™	2023-02-16	28511	4415	5330	33841	0.456
Redemption's Guild	2023-02-24	13	5	7	20	0.45520000000000005
Russian Train Trip 2	2023-03-07	5	11	15	20	0.4516
Here To Stay	2023-03-11	11	4	6	17	0.4486
Bus Simulator: Car Driving	2023-01-25	5	4	6	11	0.4486
迷之战果	2023-03-06	34	4	6	40	0.4486
Hidden Ghost Town	2023-03-21	2	6	9	11	0.4434
Shoot! VR	2023-03-31	7	6	9	16	0.4434
Please FUCK ME my neighbor	2023-02-10	8	6	9	17	0.4434
The Unearthened	2023-02-05	3	1	2	5	0.44310000000000005
Moving Forward	2023-01-15	2	1	2	4	0.44310000000000005
Reddish	2023-01-19	2	1	2	4	0.44310000000000005
Fortune the Fated	2023-01-19	10	1	2	12	0.44310000000000005
The Outer Space Bugs	2023-02-26	2	1	2	4	0.44310000000000005
Phoenix Nightmare	2023-02-08	2	1	2	4	0.44310000000000005
Cyber Cartels	2023-04-01	4	1	2	6	0.44310000000000005
Project: Nightlight	2023-03-10	2	1	2	4	0.44310000000000005
My Land!	2023-01-04	3	1	2	5	0.44310000000000005
CyberHeroes Arena DX	2023-03-31	2	1	2	4	0.44310000000000005
Oli One: Sneak in	2023-03-09	1	1	2	3	0.44310000000000005
Remember U	2023-01-31	2	1	2	4	0.44310000000000005
X-Sports	2023-01-12	3	1	2	5	0.44310000000000005
Road Trucker	2023-01-03	1	1	2	3	0.44310000000000005
Ultra Fishing	2023-01-18	1	1	2	3	0.44310000000000005
丧尸世界	2023-03-10	3	1	2	5	0.44310000000000005
Truck Simulator Ultimate 3D	2023-01-30	3	1	2	5	0.44310000000000005
Fingers' Dating	2023-02-09	3	1	2	5	0.44310000000000005
GUNWATCH: Conflict Survival	2023-01-27	3	1	2	5	0.44310000000000005
Extreme Car Drift Simulator	2023-02-03	4	1	2	6	0.44310000000000005
Putridum	2023-02-23	1	1	2	3	0.44310000000000005
Target G	2023-02-23	1	1	2	3	0.44310000000000005
Dogs Day	2023-02-20	2	1	2	4	0.44310000000000005
Space Pop - Bubble Shooter	2023-03-02	2	1	2	4	0.44310000000000005
Project Horror Tales	2023-03-10	2	1	2	4	0.44310000000000005
我穿越到了魔法世界	2023-03-31	1	1	2	3	0.44310000000000005
Spider Queen cave	2023-02-05	87	60	81	168	0.44229999999999997
Knights of Legends	2023-03-24	7	3	5	12	0.43950000000000006
Art Girl 2	2023-01-06	8	3	5	13	0.43950000000000006
X-Racing	2023-02-03	2	3	5	7	0.43950000000000006
SpaceInvasion	2023-02-28	15	5	8	23	0.4368
CHERNOBYL - Death May Die	2023-02-21	2	4	7	9	0.4282
Dark Days : Devil Hunt Prologue	2023-01-12	21	4	7	28	0.4282
EA SPORTS™ PGA TOUR™	2023-04-07	1796	154	220	2016	0.4266
Deliria	2023-02-22	6	2	4	10	0.4261
PK Girls	2023-01-17	3	2	4	7	0.4261
Super Spy Steve	2023-03-24	10	2	4	14	0.4261
Draft Day Sports: College Basketball 2023	2023-03-10	42	2	4	46	0.4261
Into the Backrooms	2023-03-31	3	2	4	7	0.4261
Hidden Magic Town	2023-03-23	2	5	9	11	0.4204
Manacle | 猪仔	2023-03-27	8	6	11	19	0.41450000000000004
Project Speed 2	2023-01-03	20	12	21	41	0.4108
Gambit!	2023-04-06	29	10	18	47	0.409
Uncharted Waters Origin	2023-03-06	4880	390	596	5476	0.4086
Lovely Girl Puzzle	2023-02-27	1	0	1	2	0.4058
Frontline Grunt	2023-01-27	1	0	1	2	0.4058
Hyparxis	2023-03-08	2	0	1	3	0.4058
Charem of Metropolitan	2023-01-17	1	0	1	2	0.4058
Wind Of Life	2023-01-23	1	0	1	2	0.4058
Three Defilements	2023-02-22	1	0	1	2	0.4058
Godtail: First Cut	2023-02-22	1	0	1	2	0.4058
Chicago 2020	2023-03-02	2	0	1	3	0.4058
Unblocking	2023-02-10	1	0	1	2	0.4058
Eftu	2023-03-17	4	0	1	5	0.4058
Risky Woods	2023-02-01	1	0	1	2	0.4058
BrainAccelerator	2023-02-14	2	0	1	3	0.4058
Dungeonrite	2023-01-17	2	0	1	3	0.4058
GUTTERBRAWLERS	2023-03-28	1	0	1	2	0.4058
What was	2023-01-14	1	0	1	2	0.4058
Escape Jump	2023-01-09	2	0	1	3	0.4058
Eternal Space	2023-03-16	1	0	1	2	0.4058
Squad Game	2023-03-31	2	0	1	3	0.4058
Sword King	2023-02-03	1	0	1	2	0.4058
Futr8	2023-01-13	4	0	1	5	0.4058
世界征服者-成吉思汗（World Conqueror - Genghis Khan）	2023-03-17	1	0	1	2	0.4058
eXecutor	2023-03-24	1	0	1	2	0.4058
Somerholm	2023-02-24	1	0	1	2	0.4058
REX	2023-03-31	1	0	1	2	0.4058
YOU ARE THE DINNER	2023-01-13	2	0	1	3	0.4058
Look Find Find	2023-04-06	1	0	1	2	0.4058
DoTeam	2023-01-12	1	0	1	2	0.4058
声灵	2023-02-09	3	0	1	4	0.4058
BLOCkCORsair	2023-03-17	1	0	1	2	0.4058
Liars' Race in Lost Ruins	2023-01-24	3	0	1	4	0.4058
Kung Fu School	2023-01-13	1	0	1	2	0.4058
Aw Heck, WAR!	2023-03-16	1	0	1	2	0.4058
The Dungeon Rules	2023-01-18	1	0	1	2	0.4058
Umbrella Escape	2023-01-17	1	0	1	2	0.4058
Towers, Turrets, Turtles	2023-01-06	3	0	1	4	0.4058
Orc Survivors	2023-01-11	1	0	1	2	0.4058
Inky & Blinky	2023-02-16	1	0	1	2	0.4058
winVGF	2023-01-05	2	0	1	3	0.4058
Cool Cats	2023-01-15	1	0	1	2	0.4058
Qiybz	2023-02-02	1	0	1	2	0.4058
Hiden Ruin	2023-02-01	1	0	1	2	0.4058
Towering	2023-01-06	1	0	1	2	0.4058
Battle Mage	2023-01-03	1	0	1	2	0.4058
Super Kids Racing : Mini Edition	2023-01-25	2	0	1	3	0.4058
Office Mayhem	2023-01-01	2	0	1	3	0.4058
Nature	2023-01-06	1	0	1	2	0.4058
Stunts above Clouds	2023-01-31	2	0	1	3	0.4058
2032: A New Threat	2023-01-05	2	0	1	3	0.4058
Roxroria: An Island Of Treasures	2023-01-26	1	0	1	2	0.4058
Valkyrie: Dawn of Ragnarok	2023-01-11	2	0	1	3	0.4058
Bargain Blocz	2023-01-06	2	0	1	3	0.4058
Kitten Kingdom	2023-01-17	1	0	1	2	0.4058
Simp	2023-01-23	1	0	1	2	0.4058
Space Escaper	2023-01-31	1	0	1	2	0.4058
Lunar Mountain	2023-02-28	1	0	1	2	0.4058
Blood Money, Good Money	2023-02-28	2	0	1	3	0.4058
Kong Hero	2023-01-18	2	0	1	3	0.4058
Animal Kingdom	2023-02-15	2	0	1	3	0.4058
建造师模拟器	2023-01-30	2	0	1	3	0.4058
Have a Bloody Goal	2023-03-01	2	0	1	3	0.4058
CallOfTree	2023-01-26	1	0	1	2	0.4058
Put Your Brain On 2	2023-02-03	1	0	1	2	0.4058
Saki - sakuseikan.	2023-02-02	2	0	1	3	0.4058
Garden of God	2023-02-02	2	0	1	3	0.4058
Bargain Invaders	2023-01-30	1	0	1	2	0.4058
Learn Japanese	2023-01-27	2	0	1	3	0.4058
Binarion	2023-03-31	1	0	1	2	0.4058
Top Race	2023-02-08	1	0	1	2	0.4058
One Drone	2023-02-09	1	0	1	2	0.4058
The Duduk Master	2023-01-27	1	0	1	2	0.4058
Sex Adventures - Love Yacht	2023-01-17	2	0	1	3	0.4058
Dungeons and Myths 2	2023-01-31	2	0	1	3	0.4058
Karakuru	2023-02-02	2	0	1	3	0.4058
Line Honey	2023-02-16	2	0	1	3	0.4058
Komodo 3K Arena	2023-02-04	1	0	1	2	0.4058
METEOR COMMANDER	2023-01-26	1	0	1	2	0.4058
SparkleWand Puzzle	2023-04-03	1	0	1	2	0.4058
Toy Flying Car	2023-02-06	1	0	1	2	0.4058
Size story	2023-02-28	1	0	1	2	0.4058
Question Mark	2023-02-18	1	0	1	2	0.4058
DESTROY Simulator VR	2023-02-14	2	0	1	3	0.4058
The Little Witch Shop: New in Town	2023-03-11	2	0	1	3	0.4058
Eternal Hunt	2023-03-19	1	0	1	2	0.4058
Containment Search	2023-03-31	2	0	1	3	0.4058
Qualification as Rogue	2023-04-06	2	0	1	3	0.4058
Mafia in Town	2023-03-01	1	0	1	2	0.4058
Money Maker	2023-04-05	3	0	1	4	0.4058
Sexy Dream Girl: Puzzle	2023-03-09	1	0	1	2	0.4058
Toy Rider	2023-02-28	2	0	1	3	0.4058
WWW	2023-03-21	1	0	1	2	0.4058
Road To Place	2023-03-02	1	0	1	2	0.4058
Within	2023-03-25	1	0	1	2	0.4058
Threesome Puzzle	2023-03-14	2	0	1	3	0.4058
Jurassic Pinball	2023-03-24	2	0	1	3	0.4058
Monster Factory	2023-03-28	2	0	1	3	0.4058
Necogram	2023-04-06	1	0	1	2	0.4058
Medchess	2023-03-10	1	0	1	2	0.4058
Island of the Dead	2023-03-10	1	0	1	2	0.4058
穿梭世界	2023-03-23	2	0	1	3	0.4058
Cum On Bus	2023-03-28	2	0	1	3	0.4058
挠痒姐妹	2023-03-27	3	0	1	4	0.4058
Beyond Polaris Guardian	2023-03-30	1	0	1	2	0.4058
Book Travelers: A Victorian Story	2023-03-13	6	0	1	7	0.4058
DobbyxEscape: Pirate Adventure	2023-03-31	1	0	1	2	0.4058
Betrayal of Blood: a Strength & Virtue RPG	2023-03-31	1	0	1	2	0.4058
Save District 3	2023-04-11	2	0	1	3	0.4058
Waifu Puzzles	2023-04-04	2	0	1	3	0.4058
Adult Puzzle - Hentai Aori	2023-04-08	2	0	1	3	0.4058
Terminal Velocity	2023-04-04	1	0	1	2	0.4058
Fluxion	2023-04-04	1	0	1	2	0.4058
My Girl Hates Fruit	2023-04-07	2	0	1	3	0.4058
HuaBing	2023-02-09	5	5	10	15	0.4057
UnderBackroom	2023-02-03	112	25	43	155	0.4046
Arithal	2023-03-27	2	1	3	5	0.40399999999999997
Hammer 2 Reloaded	2023-03-05	3	1	3	6	0.40399999999999997
After Wave: Downfall	2023-01-19	3	1	3	6	0.40399999999999997
Home Office Simulator	2023-02-09	3	1	3	6	0.40399999999999997
Rev Up! RC Grand Prix	2023-03-02	2	1	3	5	0.40399999999999997
E-GIRL Next Door: Exposed	2023-01-08	5	1	3	8	0.40399999999999997
Zombies in Metropolis	2023-01-16	1	1	3	4	0.40399999999999997
Starless Hotel	2023-01-16	2	1	3	5	0.40399999999999997
Aby's Playground	2023-02-18	2	1	3	5	0.40399999999999997
Drift Experience Japan: Supporter Edition	2023-03-06	5	1	3	8	0.40399999999999997
Metawork - Hotel Simulator	2023-04-08	8	1	3	11	0.40399999999999997
Chests, City, Clicker	2023-03-09	18	9	17	35	0.4032
Hentai Leaked!? Only for Fans	2023-01-27	13	10	19	32	0.4006
BEAT AIMER!	2023-02-16	10	2	5	15	0.40030000000000004
Zombie World Pixel	2023-01-15	2	2	5	7	0.40030000000000004
Hidden Futa	2023-03-31	2	2	5	7	0.40030000000000004
Battle of Guardians	2023-04-07	26	2	5	31	0.40030000000000004
Onmyoji：the card game	2023-01-05	18	14	26	44	0.399
White Day2: The Flower That Tells Lies - EP1	2023-02-15	306	134	225	531	0.3948
Volunteer	2023-01-02	2	4	9	11	0.3946
Eternal Kingdom Battle Peak	2023-01-24	79	14	27	106	0.3929
Sword and Fairy Inn	2023-03-30	86	18	34	120	0.39270000000000005
Hidden Map	2023-03-20	2	5	11	13	0.3924
Blood Bowl 3	2023-02-23	4045	926	1561	5606	0.38450000000000006
Brewmastery	2023-12-31	6	2	6	12	0.379
万仙萌	2023-02-15	8	2	6	14	0.379
Polar Penguin	2023-03-07	3	1	4	7	0.3749
In the Dark	2023-01-27	1	1	4	5	0.3749
NIKKA : RISE	2023-01-06	5	1	4	9	0.3749
MrWang And Love	2023-01-29	3	1	4	7	0.3749
Horror Adventure	2023-02-18	2	1	4	6	0.3749
巴克斯的庆典	2023-01-11	138	19	40	178	0.3739
Outstand	2023-02-08	5	4	11	16	0.3679
Only Sex in the Brothel	2023-01-31	10	3	9	19	0.3655
The Outer Worlds: Spacer's Choice Edition	2023-03-07	347	161	313	660	0.36469999999999997
Mask of Fury	2023-03-02	8	2	7	15	0.3611
Pixel Slayer	2023-01-19	10	2	7	17	0.3611
Outcasts of Dungeon	2023-01-19	1	0	2	3	0.3592
Lunch Tycoon	2023-01-20	3	0	2	5	0.3592
Gomorrah	2023-02-16	3	0	2	5	0.3592
CrystalKeepers	2023-01-04	1	0	2	3	0.3592
SAMURAI Survivor -Undefeated Blade-	2023-04-10	19	0	2	21	0.3592
Backrooms: The Game	2023-01-14	2	0	2	4	0.3592
The Alien Space Cat	2023-01-04	1	0	2	3	0.3592
虹城	2023-01-05	1	0	2	3	0.3592
Cut fruit	2023-01-05	1	0	2	3	0.3592
University Life Visual Novel	2023-02-23	6	0	2	8	0.3592
Bargain Toader	2023-01-12	2	0	2	4	0.3592
TITS OKAY TITS FINE: LEWD ME DARLING	2023-02-10	2	0	2	4	0.3592
Trained by a Succubus	2023-02-23	4	0	2	6	0.3592
Futa Jigsaw Dating	2023-01-31	4	0	2	6	0.3592
Sex Simulator - Hot Sauna	2023-01-21	3	0	2	5	0.3592
Jet Fire	2023-02-06	1	0	2	3	0.3592
百鬼幻想記	2023-02-23	1	0	2	3	0.3592
E30 Drift Car Simulator	2023-02-10	3	0	2	5	0.3592
The Azmodeus Project	2023-03-07	2	0	2	4	0.3592
Tank Online: War Shooting Simulator	2023-03-07	3	0	2	5	0.3592
Story of the Olivia	2023-03-23	1	0	2	3	0.3592
Badlands	2023-01-19	11	4	12	23	0.3565
Tomb 盜墓	2023-01-28	7	4	12	19	0.3565
K-Pop & Rock Band Manager	2023-03-10	3	1	5	8	0.3522
Idlenetics	2023-02-09	7	1	5	12	0.3522
江湖十一	2023-01-11	10225	1750	3426	13651	0.3504
The Dark Pictures Anthology: The Devil in Me - Friend's Pass	2023-02-15	59	10	27	86	0.3471
Netherverse	2023-03-09	7	2	8	15	0.3458
Last Stop	2023-03-13	5	2	8	13	0.3458
I Heard There Are Monsters Here	2023-03-07	55	12	33	88	0.3404
Balloon Man	2023-02-08	3	1	6	9	0.33380000000000004
Stepmom	2023-01-09	3	0	3	6	0.32939999999999997
Wild West Dynasty	2023-02-16	2576	380	882	3458	0.3243
ASU	2023-01-26	37	10	32	69	0.3225
赌神模拟器：亚洲风云	2023-03-28	304	41	111	415	0.3204
FlyWings 2018 Flight Simulator	2023-03-14	7	9	31	38	0.3149
New Witch in Town	2023-01-26	39	2	11	50	0.3103
Shadow's Kiss Online Vampire RPG	2023-01-06	10	2	11	21	0.3103
Charades Movie One	2023-03-24	1	0	4	5	0.308
The Backrooms - Nightmare Dimension	2023-03-31	5	0	4	9	0.308
Chinese Expeditionary Force - Assault Team	2023-03-28	3	0	4	7	0.308
8 Ball 3	2023-01-27	9	0	4	13	0.308
Brain Hole Girls	2023-03-23	2	0	4	6	0.308
Merge Me!	2023-02-10	11	1	8	19	0.3056
Lost In The Backrooms	2023-01-06	3	1	11	14	0.2758
Variant 22	2023-02-03	7	1	11	18	0.2758
Sex Prison	2023-03-13	7	1	11	18	0.2758
Knights of Pen and Paper 3	2023-03-07	306	23	90	396	0.2748
Slave	2023-01-20	4	1	12	16	0.2681
SpaceDog	2023-01-24	3	1	12	15	0.2681
Hack and Shoot Heroes	2023-01-09	5	0	7	12	0.26739999999999997
Vampire Survivors	2022-10-20	77061	188186	2341	79402	0.9752
Stray	2022-07-19	62963	113022	3016	65979	0.9598000000000001
Entropy : Zero 2	2022-08-20	3751	15153	253	4004	0.9570000000000001
PowerWash Simulator	2022-07-14	10512	33580	823	11335	0.9556
God of War	2022-01-14	73529	96113	2959	76488	0.9554
Neon White	2022-06-16	3277	10714	187	3464	0.9534
Persona 5 Royal	2022-10-21	35474	33064	946	36420	0.9518000000000001
Placid Plastic Duck Simulator	2022-07-06	647	7394	120	767	0.9511000000000001
Brotato	2022-09-27	30409	30573	914	31323	0.9501000000000001
CULTIC	2022-10-13	738	3819	35	773	0.9500000000000001
Marvel’s Spider-Man Remastered	2022-08-12	66436	58877	2078	68514	0.9490000000000001
The Looker	2022-06-17	1632	10957	259	1891	0.9481
Dorfromantik	2022-04-28	7101	21530	639	7740	0.948
Wobbledogs	2022-03-15	591	6369	119	710	0.9474
Trombone Champ	2022-09-16	1067	6163	114	1181	0.9472
The Case of the Golden Idol	2022-10-13	334	3222	32	366	0.9472
DAVE THE DIVER	2022-10-27	5239	10485	257	5496	0.9470000000000001
Teardown	2022-04-21	8339	65324	2501	10840	0.9469
Patrick's Parabox	2022-03-29	592	2270	14	606	0.9457
Lil Gator Game	2022-12-14	458	2078	11	469	0.9451999999999999
Ib	2022-04-11	2745	2432	21	2766	0.9446
Stacklands	2022-04-08	5186	18021	599	5785	0.9436
Metal: Hellsinger	2022-09-15	3569	8906	248	3817	0.9426000000000001
A Building Full of Cats	2022-07-07	115	2274	24	139	0.9419
Half-Life 2: VR Mod	2022-09-16	1793	4086	83	1876	0.941
The Planet Crafter	2022-03-24	14253	19114	708	14961	0.9407
乡村狂想曲	2022-10-05	2564	9452	293	2857	0.9403
A Castle Full of Cats	2022-11-09	190	1638	11	201	0.9403
Monster Prom 3: Monster Roadtrip	2022-10-21	1774	2041	22	1796	0.9401999999999999
ASTLIBRA ～生きた証～ Revision	2022-10-13	7000	13565	474	7474	0.9399
Dungeon Munchies	2022-07-27	861	5727	156	1017	0.9388
SuchArt!	2022-10-13	920	3336	69	989	0.9383
Lost in Play	2022-08-10	353	2465	40	393	0.9381
Monument Valley	2022-07-12	323	1880	22	345	0.9381
Outcore	2022-09-26	453	4552	120	573	0.937
Bugsnax	2022-04-28	949	3199	69	1018	0.937
Sucker for Love	2022-01-20	247	2034	30	277	0.9367000000000001
Outpath: First Journey	2022-12-17	896	2826	59	955	0.9359999999999999
Frog Detective 3: Corruption at Cowboy County	2022-10-27	220	1071	4	224	0.9356
SIGNALIS	2022-10-27	872	6680	220	1092	0.9354000000000001
月に寄りそう乙女の作法	2022-06-17	689	1892	29	718	0.9351
FreshWomen - Season 1	2022-08-19	3383	10476	400	3783	0.935
Cafe Stella	2022-03-25	1415	2211	40	1455	0.935
Aokana - EXTRA2	2022-12-16	531	919	1	532	0.935
Downfall - A Slay the Spire Fan Expansion	2022-03-25	3132	2453	51	3183	0.9342
At Home Alone Final	2022-01-01	389	4260	124	513	0.9339000000000001
PlateUp!	2022-08-04	12460	11601	473	12933	0.9336
提西探险社	2022-12-02	175	1789	29	204	0.9335
Retrowave	2022-05-07	638	12483	527	1165	0.9329999999999999
怠惰的怪獸公主不想工作	2022-06-22	1102	3909	114	1216	0.9329000000000001
Tiny Rogues	2022-09-23	1694	2835	70	1764	0.9328000000000001
Will You Snail?	2022-03-09	705	2182	45	750	0.9327
枝江畔之梦	2022-01-27	541	1443	19	560	0.9327
NEEDY GIRL OVERDOSE	2022-01-21	3674	20831	988	4662	0.9322
Chop Goblins	2022-12-12	198	1322	17	215	0.9315000000000001
Dialtown: Phone Dating Sim	2022-02-14	133	979	8	141	0.9302
Slime Rancher 2	2022-09-22	21524	18421	902	22426	0.9301
Dwarf Fortress	2022-12-06	28340	18874	929	29269	0.93
Tinykin	2022-08-30	262	1124	13	275	0.9298000000000001
POSTAL Brain Damaged	2022-06-09	764	4654	166	930	0.9293000000000001
Beacon Pines	2022-09-22	198	1282	20	218	0.9287000000000001
Aperture Desk Job	2022-03-01	3519	18042	924	4443	0.9279999999999999
私のリアルは充実しすぎている フルボイス版	2022-12-16	1340	2286	63	1403	0.9274
Raft	2022-06-20	101096	246467	16558	117654	0.9268000000000001
Dinkum	2022-07-14	13412	14721	758	14170	0.9263
COMPOUND	2022-07-19	102	1732	42	144	0.9262
Save Room - Organization Puzzle	2022-04-28	147	1617	38	185	0.9258
Farmer Against Potatoes Idle	2022-08-25	8951	3048	105	9056	0.9254000000000001
Nightmare of Decay	2022-05-03	241	2448	76	317	0.9254000000000001
Against the Storm	2022-11-01	8425	8665	413	8838	0.9253
I Was a Teenage Exocolonist	2022-08-25	688	1578	38	726	0.9248999999999999
Soulstone Survivors: Prologue	2022-08-26	4818	3855	150	4968	0.9245000000000001
REFLEXIA Prototype ver.	2022-08-31	580	1823	50	630	0.9243000000000001
Cosmoteer: Starship Architect & Commander	2022-10-24	13794	6143	277	14071	0.9242
Supraland Six Inches Under	2022-01-14	1973	2215	69	2042	0.924
Nova Lands: Emilia's Mission	2022-10-17	689	1443	34	723	0.924
Symphony of War: The Nephilim Saga	2022-06-10	4383	6906	325	4708	0.9237000000000001
Judgment	2022-09-14	5606	4129	169	5775	0.9236
Strange Horticulture	2022-01-21	1356	6322	294	1650	0.9233
BABBDI	2022-12-22	117	1387	33	150	0.9231
POPGOES Arcade	2022-07-01	258	1062	20	278	0.9228000000000001
Cult of the Lamb	2022-08-11	61780	44731	2859	64639	0.9227
The Upturned	2022-03-23	38	611	4	42	0.9220999999999999
SANABI	2022-06-20	415	2419	85	500	0.9218999999999999
Animal Revolt Battle Simulator	2022-04-15	1091	3915	166	1257	0.9217000000000001
BROK the InvestiGator	2022-08-26	223	717	8	231	0.9217000000000001
daydream 白日夢	2022-03-02	41	678	7	48	0.9212
10 Minutes Till Dawn	2022-05-11	3444	4126	181	3625	0.9211
Shadows Over Loathing	2022-11-11	3077	2021	67	3144	0.9211
Bendy and the Dark Revival	2022-11-15	5703	7013	356	6059	0.9207
Spark the Electric Jester 3	2022-08-14	239	1104	25	264	0.9203
Pentiment	2022-11-15	1250	2769	109	1359	0.9201
The Past Within	2022-11-02	11642	9192	501	12143	0.92
Disney Dreamlight Valley	2022-09-06	14314	10603	595	14909	0.9198999999999999
FAITH	2022-10-21	693	2717	107	800	0.9198999999999999
Spaceflight Simulator	2022-02-18	469	2681	105	574	0.9198999999999999
时间切片：序章	2022-11-24	196	1377	38	234	0.9198999999999999
The Stanley Parable: Ultra Deluxe	2022-04-27	13802	18935	1165	14967	0.9196
Lily's Well	2022-01-04	140	1368	38	178	0.9196
Super Lesbian Animal RPG	2022-12-20	119	558	4	123	0.9196
Love Delivery	2022-05-30	546	2029	72	618	0.9192
Resonance of the Ocean	2022-07-08	29	810	14	43	0.919
Insomnia: Theater in the Head	2022-12-16	80	1030	24	104	0.9185
Sudocats	2022-03-14	37	573	6	43	0.9175
Warsim: The Realm of Aslona	2022-12-20	263	1120	30	293	0.9170999999999999
Klonoa Phantasy Reverie Series	2022-07-07	753	1198	34	787	0.917
Not For Broadcast	2022-01-25	864	8726	504	1368	0.9169
Ever Seen A Cat?	2022-01-18	15	504	4	19	0.9167000000000001
Zodiacats	2022-01-21	37	446	2	39	0.9167000000000001
Leap of Faith	2022-02-11	505	1240	37	542	0.9163
Teenage Mutant Ninja Turtles: Shredder's Revenge	2022-06-16	11933	10391	631	12564	0.9159
A Taste of the Past	2022-03-11	47	848	19	66	0.9157
恋爱绮谭 不存在的真相	2022-10-28	437	1356	45	482	0.9151
Capybara Spa	2022-03-14	188	1020	28	216	0.915
所向之未来 - Towards Future	2022-02-18	28	474	4	32	0.9148999999999999
Marvel's Spider-Man: Miles Morales	2022-11-18	13539	14033	909	14448	0.9148000000000001
Dungeon Alchemist	2022-03-31	1181	1514	54	1235	0.9147
Lost Judgment	2022-09-14	2269	2720	125	2394	0.9145000000000001
Roadwarden	2022-09-12	622	1717	66	688	0.9144
Card Survival: Tropical Island	2022-09-16	2144	1256	41	2185	0.9143000000000001
Sonic Frontiers	2022-11-08	19181	15493	1031	20212	0.9141
Magical Girl Celesphonia	2022-05-07	1583	1503	55	1638	0.9139
The Complex: Found Footage	2022-08-18	235	5019	279	514	0.9135
Tribal Hunter	2022-08-22	270	1039	31	301	0.9134000000000001
Last Command	2022-10-25	422	1283	44	466	0.9133
Lunistice	2022-11-10	104	825	21	125	0.9127
Ember Knights	2022-04-20	1039	1975	86	1125	0.9122
Turbo Overkill	2022-04-22	314	1690	70	384	0.9117000000000001
Treasure of Nadia	2022-02-16	1699	4295	241	1940	0.9114
Acquitted	2022-05-02	137	758	19	156	0.9114
Cave Crawler	2022-01-23	107	2480	120	227	0.9113
Prodeus	2022-09-23	716	4828	280	996	0.9111
ELDEN RING	2022-02-24	953426	609072	54122	1007548	0.9109999999999999
My Sticker Book	2022-08-24	27	767	20	47	0.9109
Cut	2022-01-15	19	972	31	50	0.9105
The Legend of Heroes: Trails from Zero	2022-09-27	817	616	13	830	0.9105
Baldi's Basics Classic Remastered	2022-10-21	847	4128	235	1082	0.9103
DEATH STRANDING DIRECTOR'S CUT	2022-03-30	6093	14835	1052	7145	0.9102
14 Minesweeper Variants	2022-11-14	346	427	5	351	0.9098999999999999
Wylde Flowers	2022-09-20	653	747	20	673	0.9098
Seal World	2022-04-01	14	344	2	16	0.9093000000000001
Super Kiwi 64	2022-12-02	94	745	21	115	0.9086
Melatonin	2022-12-15	314	2018	98	412	0.9084000000000001
瘟疫清零计划 Project Zero	2022-09-11	1172	2326	119	1291	0.9081999999999999
Hook 2	2022-06-29	59	429	6	65	0.9081999999999999
Freedom Planet 2	2022-09-13	964	1128	43	1007	0.9081
Her New Memory	2022-02-08	261	3186	179	440	0.908
How Fish Is Made	2022-01-14	96	2078	103	199	0.908
Flatworld	2022-04-28	442	735	21	463	0.908
click to ten	2022-03-09	49	2161	109	158	0.9078
Lunacid	2022-03-15	547	1321	55	602	0.9078
One-armed cook	2022-08-30	2408	9986	704	3112	0.9076000000000001
Gun Devil	2022-08-02	106	857	28	134	0.9076000000000001
奇怪的RPG	2022-10-01	1160	2907	163	1323	0.9070999999999999
暖雪 Warm Snow	2022-01-19	44702	24307	1916	46618	0.907
TYRONE vs COPS	2022-02-12	70	1626	76	146	0.9069
《文字遊戲》	2022-01-21	4105	4705	297	4402	0.9067000000000001
Garden Galaxy	2022-12-14	415	536	12	427	0.9065000000000001
Linelith	2022-05-19	65	385	5	70	0.9064
Shredders	2022-03-16	697	1544	72	769	0.9062000000000001
Railbound	2022-09-06	365	775	25	390	0.9061
Kiwi Clicker	2022-07-29	1320	773	25	1345	0.9059999999999999
梦魇：无归 Nightmare without return	2022-09-30	300	544	13	313	0.9056000000000001
Shadow Burglar	2022-03-01	36	581	15	51	0.9055
Fear & Hunger 2: Termina	2022-12-09	411	1035	41	452	0.9054000000000001
20 Minutes Till Dawn	2022-06-08	12953	18327	1443	14396	0.9053
Citizen Sleeper	2022-05-05	570	3066	181	751	0.9053
The Lost Dachshund	2022-05-17	28	480	10	38	0.9053
Her World	2022-10-06	137	349	4	141	0.9052
Error143	2022-07-26	494	1574	76	570	0.9051
Yoiyami Dancers: Twilight Danmaku Dancers	2022-09-28	77	320	3	80	0.9046
Five nights at Floppa	2022-02-18	40	910	35	75	0.9041
Urbek City Builder: Prologue	2022-03-10	475	1405	67	542	0.9039
JellyCar Worlds	2022-12-08	97	333	4	101	0.9036
Weed Shop 3	2022-04-21	2551	2828	170	2721	0.9035
HYPER DEMON	2022-09-19	365	1541	77	442	0.9035
Deadeye Deepfake Simulacrum	2022-10-13	45	286	2	47	0.9035
Little Noah: Scion of Paradise	2022-06-28	1478	1226	56	1534	0.9034000000000001
Rock Life: The Rock Simulator	2022-07-21	515	1506	75	590	0.9033
Endling - Extinction is Forever	2022-07-19	232	810	30	262	0.9031
I Frog-ot	2022-12-16	25	325	4	29	0.9027
CaseCracker	2022-12-19	638	1685	89	727	0.9025
けものフレンズ Cellien May Cry	2022-05-01	302	664	22	324	0.9024
TUNIC	2022-03-16	2501	7786	580	3081	0.9023000000000001
Iron Lung	2022-03-10	172	5091	356	528	0.902
Atelier Sophie 2: The Alchemist of the Mysterious Dream	2022-02-25	3622	1608	85	3707	0.9018
打工吧！天使酱 ~天使在魔界的劳改生活~	2022-07-22	40	293	3	43	0.9016
Rogue: Genesia 	2022-09-19	5178	4007	271	5449	0.9014
Nightmare Reaper	2022-03-28	1159	2740	171	1330	0.9013
Pulling No Punches	2022-08-10	122	415	9	131	0.9013
Gloomwood	2022-09-05	1939	3109	200	2139	0.9012000000000001
The Spirit and the Mouse	2022-09-26	57	310	4	61	0.9009999999999999
her tears were my light	2022-09-28	5	216	0	5	0.9009999999999999
Seraph's Last Stand	2022-03-23	771	2760	174	945	0.9009
Potion Craft: Alchemist Simulator	2022-12-13	10161	18485	1561	11722	0.9007
Countryball: Europe 1890	2022-03-21	56	261	2	58	0.9005
Kalinur	2022-08-18	44	405	9	53	0.9004000000000001
Ex-Zodiac	2022-07-21	90	439	11	101	0.9
LEGO® Star Wars™: The Skywalker Saga	2022-04-05	82517	33926	3049	85566	0.8998999999999999
Jaded	2022-04-29	73	506	15	88	0.8996
常轨脱离Creative	2022-09-30	184	453	12	196	0.8996
The Last Clockwinder	2022-06-02	64	359	7	71	0.8996
The Zachtronics Solitaire Collection	2022-09-06	128	339	6	134	0.8996
IronWolf VR	2022-04-12	45	979	45	90	0.8995000000000001
Ravenous Devils	2022-04-29	2415	5347	395	2810	0.8994
Quaver	2022-08-19	891	10919	891	1782	0.8993000000000001
GNOSIA	2022-01-23	1140	1821	107	1247	0.8989
Return to Monkey Island	2022-09-19	15539	6639	513	16052	0.8987
东方秘剑录	2022-02-14	55	575	20	75	0.8983
Hush Hush - Only Your Love Can Save Them	2022-08-22	512	731	30	542	0.8981
DRAINUS	2022-05-22	194	605	22	216	0.8981
Moss: Book II	2022-10-20	64	243	2	66	0.8981
Ever Seen A Cat? 2	2022-05-30	20	285	4	24	0.8979
Shotgun King: The Final Checkmate	2022-05-12	769	3437	241	1010	0.8978
Kena: Bridge of Spirits	2022-09-27	2643	7411	593	3236	0.8974
Hana no No ni Saku Utakata no	2022-04-22	238	395	10	248	0.8974
Last Call BBS	2022-08-03	770	734	31	801	0.8972
Kinkoi Golden Time	2022-07-15	328	357	8	336	0.8972
Shinobi Warfare	2022-06-14	209	1173	62	271	0.897
Hatsune Miku: Project DIVA Mega Mix+	2022-05-26	2730	9189	766	3496	0.8966
Instruments of Destruction	2022-03-02	335	724	31	366	0.8965000000000001
Lucy Dreaming	2022-10-18	49	210	1	50	0.8965000000000001
Core Keeper	2022-03-08	34508	21328	1942	36450	0.8964
SuperTux	2022-01-12	82	646	26	108	0.8963
Escape Dungeon 2	2022-01-14	868	1182	64	932	0.8962000000000001
Priest Simulator	2022-10-06	238	503	17	255	0.8962000000000001
DOUKYUUSEI	2022-04-15	1325	1164	63	1388	0.8959
Havsala: Into the Soul Palace	2022-06-21	170	466	15	185	0.8958
The Testing Chamber	2022-03-28	23	465	15	38	0.8956999999999999
Captain of Industry	2022-05-31	6135	2890	204	6339	0.8955
Monument Valley 2	2022-07-12	105	783	36	141	0.8955
ナツノカナタ	2022-08-17	296	636	26	322	0.8955
Freshly Frosted	2022-06-10	43	224	2	45	0.8952
Shattered Pixel Dungeon	2022-03-23	336	784	37	373	0.8946
Owinka Shooter	2022-07-23	44	593	24	68	0.8945000000000001
Vault of the Void	2022-10-04	1003	1984	131	1134	0.8944
旅行こいし: デスクトップ少女 ~ Koishi Navigation Desktop Youkai	2022-08-02	482	544	21	503	0.8942
Touch Some Grass	2022-04-11	23	495	18	41	0.8939
Robin Morningwood Adventure	2022-09-30	140	410	13	153	0.8933
Breadsticks	2022-11-05	34	360	10	44	0.8933
怕不怕趴喵霸霸 Ghost Party Nyanbaba	2022-01-22	14	232	3	17	0.8932
Tree Simulator 2023	2022-04-01	160	576	24	184	0.893
Choo-Choo Charles	2022-12-09	4058	9966	885	4943	0.8929
Bio Prototype	2022-12-17	1984	922	49	2033	0.8929
A=B	2022-03-29	280	485	18	298	0.8929
A Plague Tale: Requiem	2022-10-17	4927	8151	710	5637	0.8926999999999999
Serious Sam: Siberian Mayhem	2022-01-25	1765	3032	227	1992	0.8926999999999999
Soda Crisis	2022-05-24	1631	2340	166	1797	0.8926000000000001
Growing My Grandpa!	2022-07-12	25	227	3	28	0.8923000000000001
Depersonalization	2022-12-20	3044	2639	195	3239	0.8918
FAR: Changing Tides	2022-03-01	989	2346	170	1159	0.8915000000000001
Choice of Life: Middle Ages 2	2022-09-30	261	410	14	275	0.8915000000000001
Charlie in the MoistVerse of Madness	2022-03-11	63	327	9	72	0.8911
McPixel 3	2022-11-14	99	358	11	110	0.8909
Tag: The Power of Paint	2022-04-18	77	509	21	98	0.8908
Paradise Marsh	2022-10-13	43	218	3	46	0.8908
fox soldier	2022-04-15	43	198	2	45	0.8906999999999999
FIND ALL 2: Middle Ages	2022-03-03	24	177	1	25	0.8906999999999999
The Death | Thần Trùng	2022-09-15	2894	2559	192	3086	0.8906000000000001
The Night of the Scissors	2022-05-13	11	254	5	16	0.8906000000000001
Ten Trials of Babel: The Doppelganger Maze	2022-03-14	642	2770	212	854	0.8903
Who's Lila?	2022-02-24	87	905	51	138	0.8901000000000001
I'm on Observation Duty 5	2022-05-13	244	413	15	259	0.89
Evil Nun: The Broken Mask	2022-10-31	132	543	24	156	0.8898
Ukraine Defense Force Tactics	2022-06-29	40	192	2	42	0.8896
Tinyfolks	2022-06-01	436	780	42	478	0.8894
Breeze	2022-08-05	35	331	10	45	0.8894
HAYAI	2022-05-19	34	191	2	36	0.8894
Smithworks	2022-06-17	604	1448	97	701	0.8893000000000001
Beeny	2022-10-15	11	228	4	15	0.8892
Little Witch in the Woods	2022-05-17	4358	5472	479	4837	0.8889
PAC-MAN WORLD Re-PAC	2022-08-25	313	587	28	341	0.8887
Ever Seen A Cat? 3	2022-10-11	23	144	0	23	0.8882
Aonatsu Line	2022-12-02	415	594	29	444	0.8881
Yotsume God -Reunion-	2022-02-16	82	222	4	86	0.8881
Endoparasitic	2022-10-24	430	1555	109	539	0.8879000000000001
Stay Out of the House	2022-10-14	191	669	35	226	0.8878
Rollerdrome	2022-08-16	542	1124	72	614	0.8876999999999999
We Were Here Forever	2022-05-10	8390	8355	789	9179	0.8872
The one who pulls out the sword will be crowned king	2022-03-28	2247	6916	639	2886	0.8872
Prince of Suburbia - Part 1	2022-05-12	429	1091	70	499	0.8872
Pupperazzi	2022-01-20	100	346	12	112	0.8871
Wicked Games	2022-07-27	13	180	2	15	0.8871
Tile Cities	2022-05-05	167	404	16	183	0.887
Sunset Routes	2022-11-17	155	266	7	162	0.8868
イハナシの魔女	2022-08-19	22	197	3	25	0.8867
Islets	2022-08-24	127	429	18	145	0.8865999999999999
角斗士学院	2022-03-01	42	342	12	54	0.8865000000000001
花落冬陽 Snowdreams -lost in winter-	2022-03-09	95	228	5	100	0.8859
The Divine Speaker	2022-03-30	133	192	3	136	0.8856999999999999
Banana Shooter	2022-05-01	1768	7175	680	2448	0.8856
Betrayal At Club Low	2022-09-09	52	275	8	60	0.8856
Coral Island	2022-10-11	7487	5408	496	7983	0.8855
Athanasy	2022-04-13	29	290	9	38	0.8855
VOCÊ É UM DEFUNTO MECÂNICO	2022-01-10	10	319	11	21	0.8853
A Story Beside	2022-05-24	20	206	4	24	0.8849
Ninja Village	2022-05-23	254	206	4	258	0.8849
Mega Serval	2022-11-30	20	170	2	22	0.8849
Gerda: A Flame in Winter	2022-09-01	44	169	2	46	0.8845999999999999
The Excavation of Hob's Barrow	2022-09-28	233	963	63	296	0.8842
群侠传，启动！	2022-09-16	548	568	30	578	0.8842
What Lies in the Multiverse	2022-03-04	48	383	16	64	0.8842
Void Sols	2022-11-17	32	219	5	37	0.8841
Rogue Legacy 2	2022-04-28	22811	11375	1156	23967	0.8839
The Sushi Spinnery	2022-05-23	227	234	6	233	0.8839
Before The Night	2022-07-14	51	310	11	62	0.8837999999999999
100 hidden fish	2022-01-17	24	265	8	32	0.8837999999999999
Chasing Sunsets	2022-02-15	203	447	21	224	0.8837
奇迹一刻 Surmount	2022-02-14	557	1250	90	647	0.8833
Your Blight	2022-11-10	70	181	3	73	0.8832
Chained Echoes	2022-12-08	2212	2966	258	2470	0.8831
Potato Flowers in Full Bloom	2022-03-10	272	305	11	283	0.883
Across the Obelisk	2022-08-16	14037	6898	675	14712	0.8829000000000001
Soulstone Survivors	2022-11-07	18854	9391	954	19808	0.8826
Just Go	2022-08-09	697	1557	120	817	0.8826
Infernax	2022-02-14	645	1238	90	735	0.8826
Donut Dodo	2022-06-03	19	142	1	20	0.8826
Gunner, HEAT, PC!	2022-09-06	981	2075	171	1152	0.8823000000000001
Magic Rampage	2022-05-24	314	741	46	360	0.8823000000000001
Hidden Cats in London	2022-12-16	16	141	1	17	0.8823000000000001
Please Be Happy	2022-11-21	72	159	2	74	0.8822
Dark Egg	2022-08-28	38	193	4	42	0.8821
The Mortuary Assistant	2022-08-02	1399	3760	346	1745	0.8818000000000001
Alina of the Arena	2022-10-13	1636	2636	230	1866	0.8815000000000001
The Entropy Centre	2022-11-03	615	1481	115	730	0.8815000000000001
Taiji	2022-09-09	733	651	39	772	0.8815000000000001
Bone's Cafe	2022-10-29	64	173	3	67	0.8813
Potato Survival	2022-10-11	23	137	1	24	0.8812000000000001
NORCO	2022-03-24	120	1364	105	225	0.8808
Stardom 3 Deluxe	2022-03-31	2191	991	70	2261	0.8806999999999999
Football Coach: College Dynasty	2022-12-12	220	249	8	228	0.8806999999999999
Trapped with Jester	2022-10-10	15	398	19	34	0.8806
King of the Hat	2022-10-21	27	135	1	28	0.8806
NEBULOUS: Fleet Command	2022-02-11	1133	1706	139	1272	0.8805
Epic Battle Fantasy Collection	2022-05-30	219	216	6	225	0.8801000000000001
Orc Massage	2022-02-09	1723	4994	489	2212	0.88
Cats and the Other Lives	2022-11-21	113	647	40	153	0.88
Chessformer	2022-01-18	29	133	1	30	0.88
Miss Neko 3	2022-12-18	388	1323	103	491	0.8797
The Legend of Heroes: Kuro no Kiseki	2022-07-27	2120	976	70	2190	0.8797
Circadian Dice	2022-07-11	360	429	22	382	0.8795999999999999
Nobody Saves the World	2022-01-18	3517	3710	352	3869	0.8795000000000001
Burnhouse Lane	2022-12-02	133	451	24	157	0.8792
Bakso Simulator	2022-10-08	1204	1177	90	1294	0.8790000000000001
Card Shark	2022-06-02	1017	1700	142	1159	0.8789
Mago	2022-06-21	115	484	27	142	0.8788
Fishing Vacation	2022-04-21	9	129	1	10	0.8788
Ctrl Alt Ego	2022-07-22	37	294	12	49	0.8786
Dome Keeper	2022-09-27	6883	5828	593	7476	0.8785
Golden Light	2022-03-11	160	1982	172	332	0.8785
Crystal Project	2022-03-31	825	1392	112	937	0.8785
APICO	2022-05-20	645	719	48	693	0.8782
JUSTICE SUCKS	2022-09-08	30	127	1	31	0.8782
7 Days to End with You	2022-02-06	628	827	58	686	0.8781
東方花映塚 ～ Phantasmagoria of Flower View.	2022-04-25	134	161	3	137	0.8781
The Forest of Drizzling Rain	2022-11-16	134	161	3	137	0.8781
Syberia - The World Before	2022-03-18	1302	2286	205	1507	0.878
Dimension Tripper Neptune: TOP NEP	2022-01-20	58	368	18	76	0.878
Mad Adventures	2022-11-22	647	813	57	704	0.8779000000000001
100 hidden turtles	2022-09-04	8	176	4	12	0.8779000000000001
100 hidden hares	2022-06-10	8	143	2	10	0.8776999999999999
You Will (Not) Remain	2022-01-07	137	1805	156	293	0.8775000000000001
PomoFarm	2022-07-05	92	174	4	96	0.8773000000000001
Occupy White Walls	2022-07-08	163	1136	89	252	0.8771
The Price Of Flesh	2022-05-02	178	259	10	188	0.877
Mr. Rainer's Solve-It Service	2022-02-21	79	188	5	84	0.877
ZERO Sievert	2022-11-15	6136	5876	612	6748	0.8768000000000001
PRODUCER (2021)	2022-11-14	10	104	0	10	0.8768000000000001
NEO: The World Ends with You	2022-10-19	258	444	25	283	0.8765999999999999
The Heilwald Loophole	2022-02-04	11	139	2	13	0.8765000000000001
NEKO-MIMI SWEET HOUSEMATES Vol. 1	2022-04-08	61	214	7	68	0.8762000000000001
Banana Drama	2022-07-25	48	199	6	54	0.8761
Medieval Fantasy Survival Simulator	2022-02-25	9	227	8	17	0.876
Backpack Hero	2022-08-15	3627	2855	274	3901	0.8759
Jack Move: I.C.E Breaker	2022-05-19	332	519	32	364	0.8759
Buck Up And Drive!	2022-01-10	83	508	31	114	0.8759
Prose & Codes	2022-02-11	22	120	1	23	0.8759
Polda 7	2022-04-14	618	541	34	652	0.8758
CRISIS CORE –FINAL FANTASY VII– REUNION	2022-12-13	9648	3515	350	9998	0.8754000000000001
The Neverland of the Mountain and Sea	2022-12-19	45	167	4	49	0.8754000000000001
יום פתוח	2022-06-22	41	100	0	41	0.8754000000000001
Psycho地雷InLove : 싸이코지라이 인 러브	2022-06-08	30	210	7	37	0.8753000000000001
FINAL FANTASY VII REMAKE INTERGRADE	2022-06-17	13803	12817	1464	15267	0.8752
Perfect Tides	2022-02-22	31	151	3	34	0.8752
Different Strokes	2022-11-10	156	811	60	216	0.875
Hardspace: Shipbreaker	2022-05-25	7731	14336	1657	9388	0.8749
镇邪 Zhenxie	2022-11-04	2379	1978	181	2560	0.8749
Nightmare Frames	2022-06-16	25	150	3	28	0.8749
Tina & Rook! Cookie Quest!	2022-08-19	16	134	2	18	0.8749
Hell Pie	2022-07-21	276	662	46	322	0.8747
Bear and Breakfast	2022-07-28	3027	3071	303	3330	0.8745999999999999
Arcadie: Second-Born	2022-12-09	240	207	7	247	0.8745
Gordian Quest	2022-06-23	1913	4529	472	2385	0.8744
Fashion Police Squad	2022-08-15	142	517	33	175	0.8742000000000001
Once Again	2022-10-03	32	473	29	61	0.8742000000000001
Madohi Shiroki no Kamikakushi	2022-02-04	210	297	14	224	0.8742000000000001
Hooked on You: A Dead by Daylight Dating Sim™	2022-08-03	4382	4715	496	4878	0.8740000000000001
山：临界幸存者	2022-08-01	138	355	19	157	0.8738
MareQuest	2022-12-01	46	231	9	55	0.8738
白色哀悼：灰域美术馆	2022-12-18	33	176	5	38	0.8738
Blood West	2022-02-10	250	1420	124	374	0.8737
Haiku, the Robot	2022-04-28	410	1352	117	527	0.8736
Tumbleweed Destiny	2022-04-01	429	306	15	444	0.8736
Time Thief	2022-05-25	12	161	4	16	0.8736
幻恋の夜宴: ハルーシサノバこいし ~ Halluci-Sabbat of Koishi	2022-01-07	51	216	8	59	0.8734000000000001
ヘブンバーンズレッド	2022-08-10	20201	2307	222	20423	0.8733
The Monster Breeder	2022-01-19	81	94	0	81	0.8731
Re-Volt	2022-07-29	250	830	64	314	0.873
李雷和韩梅梅	2022-03-31	88	397	23	111	0.873
Deadlink	2022-10-18	270	788	60	330	0.8729000000000001
Hidden Cats in Paris	2022-03-31	11	253	11	22	0.8729000000000001
Otome * Domain	2022-12-23	92	187	6	98	0.8729000000000001
Trash Horror Collection	2022-06-17	19	277	13	32	0.8727
Socialism Simulator	2022-09-09	17	172	5	22	0.8726
Orb of Creation	2022-03-31	1152	683	50	1202	0.8725
Terror of Hemasaurus	2022-10-17	170	426	26	196	0.8723000000000001
Police Stories: The Academy	2022-08-02	282	801	62	344	0.8722
そろそろ寿司を食べないと死ぬぜ！	2022-06-21	28	126	2	30	0.8722
TOMOMI	2022-03-25	15	92	0	15	0.8722
DEEP FOG	2022-04-29	17	92	0	17	0.8722
Urbek City Builder	2022-07-13	665	889	71	736	0.8721
嗜血印 Bloody Spell	2022-01-26	7267	25909	3215	10482	0.872
Hatsune Miku Logic Paint S	2022-11-19	237	522	35	272	0.872
Cosmonious High	2022-03-31	80	184	6	86	0.872
Trimps	2022-05-02	3865	766	59	3924	0.8718000000000001
SpiderHeck	2022-09-22	3011	2648	266	3277	0.8717
TimeShifters	2022-06-01	15	108	1	16	0.8715999999999999
Sakura Hime 3	2022-12-16	88	247	11	99	0.8715
Space Beast Terror Fright	2022-06-04	149	1362	122	271	0.8714000000000001
V Rising	2022-05-17	150645	54573	7093	157738	0.8711
Rush Rally 3	2022-11-24	59	194	7	66	0.8711
からぱりうぉーず	2022-05-27	90	167	5	95	0.8711
FUCK HITLER	2022-11-30	204	2634	267	471	0.871
FUCK PUTIN	2022-04-13	246	4907	539	785	0.8709
Karambola	2022-06-16	16	218	9	25	0.8706
Memory Lost: Chapter One	2022-12-01	4299	165	5	4304	0.8704999999999999
The Wandering Village	2022-09-14	5786	3076	321	6107	0.8704000000000001
Plants vs. Zombies™ Garden Warfare 2: Deluxe Edition	2022-05-16	4888	9634	1137	6025	0.8703000000000001
Ballads at Midnight	2022-07-15	31	217	9	40	0.8703000000000001
Galaxy Life	2022-08-31	4741	5072	565	5306	0.8701000000000001
咸鱼喵喵	2022-08-05	510	650	49	559	0.8701000000000001
Garden of the Sea	2022-01-13	72	528	37	109	0.87
Jabroni Brawl: Episode 3	2022-11-11	651	1052	91	742	0.8699
Sail Forth	2022-12-21	170	288	15	185	0.8699
幸福的二人房	2022-09-29	670	1690	162	832	0.8697
OlliOlli World	2022-02-07	403	1057	92	495	0.8695999999999999
Astral Ascent	2022-04-12	382	935	79	461	0.8695999999999999
Pewt 'em Up!	2022-06-08	44	134	3	47	0.8695999999999999
Chicken Invaders Universe	2022-12-15	420	2053	204	624	0.8695
Tap Ninja	2022-03-17	3387	4614	513	3900	0.8694
SCP : Secret Files	2022-09-13	927	2793	292	1219	0.8693000000000001
The Longest Walk	2022-09-09	11	273	14	25	0.8692000000000001
Space Tail: Lost in the Sands	2022-08-12	77	161	5	82	0.8692000000000001
CrushBorgs	2022-06-10	18	118	2	20	0.8692000000000001
King of Retail	2022-09-14	1079	2755	288	1367	0.8691
Prognostic	2022-05-19	43	352	21	64	0.8691
Retro Gadgets	2022-11-30	124	186	7	131	0.8688
Neighbor Fight	2022-06-09	24	117	2	26	0.8688
Wee Tanks!	2022-02-23	97	271	14	111	0.8687
Mount & Blade II: Bannerlord	2022-10-25	248216	192573	26841	275057	0.8684000000000001
Knightfall: A Daring Journey	2022-04-01	3328	4963	563	3891	0.8684000000000001
RUNGORE: Beginner Experience	2022-09-02	862	684	54	916	0.8684000000000001
Tandis	2022-04-21	40	116	2	42	0.8684000000000001
RUN: The world in-between	2022-04-14	78	116	2	80	0.8684000000000001
Duck Paradox	2022-07-19	48	222	10	58	0.8683
Shirone: the Dragon Girl	2022-03-10	27	83	0	27	0.8683
As Dusk Falls	2022-07-19	300	1477	141	441	0.8682
Sakura Hime 2	2022-04-22	150	653	51	201	0.8682
Touhou Crisis	2022-05-26	10	184	7	17	0.8682
Dread Delusion	2022-06-15	117	563	42	159	0.868
Oxygen: First Breath	2022-10-07	968	1167	107	1075	0.8677
UNCHARTED™: Legacy of Thieves Collection	2022-10-19	10851	11037	1357	12208	0.8676
Crypt	2022-09-27	234	958	84	318	0.8676
VenusBlood HOLLOW International	2022-01-07	343	207	9	352	0.8676
Sekai to Sekai no Mannaka de	2022-02-11	70	156	5	75	0.8676
Immortal Mantis	2022-04-22	10	156	5	15	0.8676
9-nine-:NewEpisode	2022-03-18	85	288	16	101	0.8674
Beat Invaders	2022-03-10	23	142	4	27	0.8674
In The Rural Village of Nagoro	2022-11-08	12	218	10	22	0.8673000000000001
High On Life	2022-12-13	11608	8514	1034	12642	0.8669
Melody's Escape 2	2022-09-30	70	167	6	76	0.8669
Psycho Bathroom	2022-04-29	655	112	2	657	0.8668000000000001
OxU	2022-09-22	11	80	0	11	0.8668000000000001
Drift racing car	2022-09-29	412	140	4	416	0.8667
Squad 51 vs. the Flying Saucers	2022-09-21	22	126	3	25	0.8666
GigaBash	2022-08-04	305	686	56	361	0.8665
Ponchoman	2022-03-15	11	96	1	12	0.8665
Grounded	2022-09-27	32012	48533	6580	38592	0.8664000000000001
Just King	2022-07-21	1247	932	83	1330	0.8662000000000001
Mayonnaise Simulator	2022-05-13	12	165	6	18	0.8662000000000001
纸嫁衣3鸳鸯债	2022-09-29	655	519	39	694	0.8661
Cursed 3	2022-10-26	35	95	1	36	0.8661
Temperia: Soul of Majestic	2022-07-26	1258	746	63	1321	0.8659
Beat Hazard 3	2022-11-14	107	213	10	117	0.8659
My Therapy	2022-08-11	22	236	12	34	0.8658
SurrounDead	2022-06-24	511	2405	258	769	0.8656
封神榜2022	2022-01-06	119	807	70	189	0.8656
WasteLand Express 废土快递	2022-10-28	472	743	63	535	0.8656
I commissioned some bees	2022-05-30	16	163	6	22	0.8654999999999999
東方眠世界 ~ Wonderful Waking World	2022-06-15	29	150	5	34	0.8654999999999999
Lost Nova	2022-05-11	130	256	14	144	0.8652
HomeWind	2022-03-10	189	608	49	238	0.8651000000000001
Ozymandias	2022-10-11	1032	645	53	1085	0.865
Harmony's Odyssey	2022-10-19	30	174	7	37	0.865
CHAOS;HEAD NOAH	2022-10-07	238	319	20	258	0.8647
Force Reboot	2022-08-25	25	276	16	41	0.8647
Lust Theory	2022-03-19	1417	2818	313	1730	0.8645999999999999
BLOWFLY	2022-10-27	65	92	1	66	0.8645999999999999
Devil Spire	2022-02-02	50	231	12	62	0.8645
Impaler	2022-12-06	39	264	15	54	0.8644
We Who Are About To Die	2022-11-14	2266	3448	394	2660	0.8643000000000001
Just Act Natural	2022-03-25	855	3364	384	1239	0.8642000000000001
Island Cities	2022-08-30	20	106	2	22	0.8642000000000001
Once Upon a Jester	2022-11-09	26	75	0	26	0.8642000000000001
Kharon's Crypt - Even Death May Die	2022-02-01	20	91	1	21	0.8641
沙盒勇者：序章	2022-03-08	77	146	5	82	0.8640000000000001
Impact Point	2022-07-20	283	924	85	368	0.8639
Doors: Paradox	2022-11-04	341	455	34	375	0.8638
发糖模拟器	2022-10-21	238	304	19	257	0.8638
HAAK	2022-08-25	898	1633	169	1067	0.8637
聖石傳說EX	2022-03-11	313	261	15	328	0.8637
Gunvein	2022-11-11	38	105	2	40	0.8637
Gods of Sand	2022-02-07	135	415	30	165	0.8636
Seventh Lair	2022-03-31	43	205	10	53	0.8636
Yakiniku Simulation	2022-06-03	137	271	16	153	0.8634999999999999
Tuition Academia	2022-02-22	180	249	14	194	0.8634000000000001
Gibbon: Beyond the Trees	2022-05-18	44	238	13	57	0.8634000000000001
Our way down	2022-03-31	26	157	6	32	0.8634000000000001
Dreamin' Her - 僕は、彼女の夢を見る。-	2022-04-28	54	104	2	56	0.8633
Voodoo Detective	2022-05-24	29	144	5	34	0.8632
融雪	2022-09-30	262	853	78	340	0.8631000000000001
Entropy	2022-02-02	7	117	3	10	0.8629000000000001
和你相遇的那天是轮回高校的日常这也是合理的吗？	2022-03-03	33	117	3	36	0.8629000000000001
Line Path	2022-05-26	13	117	3	16	0.8629000000000001
Potionomics	2022-10-17	5170	3599	421	5591	0.8628
Cat Museum	2022-03-17	74	506	40	114	0.8628
Drums Rock	2022-06-02	16	155	6	22	0.8627
KoboldKare	2022-12-15	470	802	73	543	0.8623999999999999
Spirits of the Hellements	2022-04-28	252	256	15	267	0.8623999999999999
Neophyte	2022-08-31	385	426	32	417	0.8622
Guild Wars 2	2022-08-23	8324	7609	969	9293	0.8617
FINAL FANTASY VI	2022-02-23	4556	2153	239	4795	0.8616
Garage: Bad Dream Adventure	2022-07-07	98	127	4	102	0.8615
The RPG Engine	2022-01-06	26	114	3	29	0.8615
The Classrooms	2022-10-29	15	100	2	17	0.8614
Camp Buddy: Scoutmaster Season	2022-08-04	58	139	5	63	0.8613
They Don't Sleep	2022-09-14	28	139	5	33	0.8613
Winkeltje: The Little Shop	2022-04-22	940	1230	125	1065	0.8612000000000001
Dungeons of Dreadrock	2022-03-15	12	208	11	23	0.8611
Regular Factory: Escape Room	2022-04-13	51	126	4	55	0.8611
Time Rift	2022-02-17	15	113	3	18	0.8611
Escape From Mandrillia	2022-07-18	28	85	1	29	0.8611
Crustacean Nations	2022-08-19	84	240	14	98	0.861
FIND ALL 3: Travel	2022-07-21	55	185	9	64	0.8609
Sophstar	2022-02-18	32	69	0	32	0.8608
MineSweeper Tetris	2022-12-15	51	217	12	63	0.8605
Fursan al-Aqsa: The Knights of the Al-Aqsa Mosque	2022-04-18	11	161	7	18	0.8605
Beyond The Edge Of Owlsgard	2022-12-23	28	84	1	29	0.8605
Fallen Arena	2022-12-23	87	1493	159	246	0.8604
Espresso Tycoon Prologue: Underwater	2022-11-04	323	509	42	365	0.8604
LUL Inc.	2022-01-14	26	98	2	28	0.8604
Quasimorphosis	2022-03-02	143	279	18	161	0.8603000000000001
Deisim	2022-09-01	37	589	51	88	0.8602
Curse Crackers: For Whom the Belle Toils	2022-08-31	22	111	3	25	0.8601000000000001
TRATRITLE	2022-07-16	456	451	36	492	0.86
MONSTER CARDS	2022-08-12	78	148	6	84	0.86
求闻编年史 ～ Gensokyo Recollection	2022-08-23	30	83	1	31	0.86
U-ena -遠花火の少女-	2022-05-08	99	394	30	129	0.8598
书之旅人 Story Walker	2022-08-12	15	123	4	19	0.8598
FOONDA	2022-05-06	32	97	2	34	0.8598
たすけて！おつかれさとり様	2022-03-08	46	558	48	94	0.8597
The Last Cube	2022-03-10	47	110	3	50	0.8597
Red Matter 2	2022-08-18	75	266	17	92	0.8595999999999999
Muv-Luv Alternative Total Eclipse	2022-07-21	117	135	5	122	0.8595999999999999
Baldwin's Bear	2022-04-01	10	67	0	10	0.8595999999999999
Repella Fella: Prologue	2022-11-18	12	67	0	12	0.8595999999999999
Flight Of Nova	2022-05-31	75	181	9	84	0.8595
Gedonia	2022-10-14	1331	2335	270	1601	0.8592000000000001
Trash Bomber	2022-07-18	36	146	6	42	0.8592000000000001
KEEK	2022-08-18	27	109	3	30	0.8592000000000001
Expeditions: Rome	2022-01-20	9765	3610	441	10206	0.8591
Clanfolk	2022-07-14	2784	1494	162	2946	0.8590000000000001
memoir	2022-06-03	13	157	7	20	0.8590000000000001
Withering Rooms	2022-10-04	13	66	0	13	0.8590000000000001
ADACA	2022-07-26	131	398	31	162	0.8588
卖萌恶霸喵霸霸 Cute Bully Nyanbaba	2022-09-16	8	81	1	9	0.8588
LumbearJack	2022-06-11	30	81	1	31	0.8588
Like Dreamer	2022-07-21	25	81	1	26	0.8588
Panzer Arena: Prologue	2022-09-16	16	81	1	17	0.8588
Zombie Apocalypse Survival Simulator	2022-10-17	5	81	1	6	0.8588
Skinwalker Hunt	2022-08-19	62	585	52	114	0.8584999999999999
Climbey	2022-01-08	69	1027	105	174	0.8582
PANELKI	2022-03-04	43	395	31	74	0.8582
Justin Wack and the Big Time Hack	2022-08-23	30	107	3	33	0.8582
天天地下城	2022-01-13	4	107	3	7	0.8582
Higurashi When They Cry Hou - Rei	2022-06-02	29	107	3	32	0.8582
Trust No Bunny	2022-09-13	67	107	3	70	0.8582
Graveyard Girls	2022-09-30	8	80	1	9	0.8582
Beach Island Deluxe	2022-08-27	30	166	8	38	0.8581000000000001
PowerSlave Exhumed	2022-02-10	237	466	39	276	0.8579000000000001
System Purge	2022-04-05	7	119	4	11	0.8579000000000001
Cat's Kiss	2022-05-27	175	1317	142	317	0.8578
Lootun	2022-08-31	519	239	15	534	0.8578
With You	2022-02-02	91	1512	167	258	0.8577
Midnight Fight Express	2022-08-23	783	1093	114	897	0.8577
萝莉的远征	2022-01-15	57	176	9	66	0.8577
月出之时	2022-04-20	9	64	0	9	0.8577
Voltage High Society	2022-07-27	6	64	0	6	0.8577
江湖幸存者	2022-12-28	847	639	59	906	0.8576
We Are One Prologue	2022-02-09	10	79	1	11	0.8576
Starship Troopers: Terran Command	2022-06-16	8163	6501	855	9018	0.8575
Deducto	2022-02-10	752	2410	286	1038	0.8573999999999999
We Are OFK	2022-08-18	36	153	7	43	0.8573999999999999
Star Valor	2022-08-03	1891	1836	210	2101	0.8573000000000001
The Bridge Curse Road to Salvation	2022-08-25	1251	1498	166	1417	0.8573000000000001
CatNab	2022-03-14	15	92	2	17	0.8572
Obama Maze	2022-08-01	46	893	90	136	0.8571
夏恋幻梦	2022-08-19	41	152	7	48	0.8570000000000001
Easy Red 2	2022-01-06	242	2348	280	522	0.8567
纸嫁衣2奘铃村	2022-05-06	738	691	66	804	0.8567
东方异乡录 ~the Apocryphal Gensoukyou	2022-09-30	24	162	8	32	0.8566
Margo	2022-12-27	21	162	8	29	0.8566
Love of Magic Book 2: The War	2022-05-31	86	91	2	88	0.8566
INCISION	2022-09-16	55	368	29	84	0.8565
Owlone in the Woods	2022-01-06	29	116	4	33	0.8565
少女妖精弹珠台 Elf Girl Pinball	2022-11-30	124	283	20	144	0.8564
Super Dungeon Maker	2022-02-15	68	264	18	86	0.8564
Dino Nest	2022-04-28	45	193	11	56	0.8562000000000001
The Plague Doctor of Wippra	2022-10-05	22	150	7	29	0.8562000000000001
Splatter	2022-12-15	21	103	3	24	0.8562000000000001
Paradiddle	2022-11-02	34	384	31	65	0.8561
Title_Pending	2022-09-27	36	182	10	46	0.856
Lord Winklebottom Investigates	2022-07-28	36	115	4	40	0.856
Escape the Backrooms	2022-08-11	3301	14332	2028	5329	0.8558
Mini Pipes	2022-04-18	15	61	0	15	0.8556999999999999
Legend of the Outlaw Mage	2022-02-18	28	251	17	45	0.8555
This Way Madness Lies	2022-11-10	41	89	2	43	0.8555
Tailbound	2022-09-12	25	159	8	33	0.8554
Unsolved Case	2022-11-24	1087	2012	239	1326	0.8553000000000001
MARVEL SNAP	2022-10-18	11670	11225	1574	13244	0.8551000000000001
Catto Pew Pew!	2022-08-16	127	620	59	186	0.8551000000000001
Warlord: Britannia	2022-05-25	379	990	105	484	0.855
Princess Farmer	2022-03-31	22	113	4	26	0.855
Plot of the Druid	2022-11-01	9	60	0	9	0.8549
Meet me at NooN	2022-06-21	13	60	0	13	0.8549
Conrad Stevenson's Paranormal P.I.	2022-02-28	66	517	47	113	0.8548
Bombergrounds: Reborn	2022-10-06	1945	7003	954	2899	0.8547
The House of Da Vinci 3	2022-12-23	338	341	27	365	0.8545999999999999
Capcom Fighting Collection	2022-06-24	828	464	41	869	0.8545
东方心之解束~Saving from the devil	2022-07-12	27	74	1	28	0.8545
Warpips	2022-04-21	2136	3008	380	2516	0.8543000000000001
LASER LAB	2022-09-08	30	177	10	40	0.8542000000000001
Para Eyes	2022-10-25	17	59	0	17	0.8542000000000001
Save the Reactor	2022-05-11	20	59	0	20	0.8542000000000001
真空战姬	2022-07-11	23	134	6	29	0.8541
EZ2ON REBOOT : R	2022-04-14	2768	4262	560	3328	0.8540000000000001
Heaven Dust 2	2022-01-06	651	554	52	703	0.8540000000000001
Void Scrappers	2022-10-21	353	347	28	381	0.8540000000000001
House Party	2022-07-16	1800	11734	1671	3471	0.8539
My Time at Sandrock	2022-05-26	21778	10799	1531	23309	0.8538
你已经猜到结局了吗	2022-07-15	141	216	14	155	0.8538
Songs of Conquest	2022-05-10	4192	4511	598	4790	0.8537
Demon Turf: Neon Splash	2022-04-14	22	110	4	26	0.8534999999999999
ケチャップandマヨネーズ	2022-04-10	23	58	0	23	0.8534999999999999
Football Manager 2023	2022-11-08	83715	10106	1432	85147	0.8534
Project Sparrow	2022-03-11	575	1042	114	689	0.8534
双相	2022-11-17	51	205	13	64	0.8534
Bingus: My Beloved	2022-11-18	14	72	1	15	0.8532
MultiVersus	2022-07-19	153433	80992	12666	166099	0.8531000000000001
WTF Do You Know?	2022-05-02	10	109	4	14	0.8529000000000001
BLACK SHEEP TOWN	2022-09-15	152	71	1	153	0.8525
MONSTER HUNTER RISE	2022-01-12	231360	61237	9565	240925	0.8523000000000001
Antimatter Dimensions	2022-12-17	6962	1248	143	7105	0.8523000000000001
HBDIE: The Nonce 2	2022-08-05	34	656	66	100	0.8523000000000001
Temp Zero	2022-04-29	20	119	5	25	0.8522
Putinist Slayer	2022-08-22	4	56	0	4	0.8520000000000001
Nekomancy	2022-09-01	11	56	0	11	0.8520000000000001
Mage and Monsters	2022-10-12	528	491	46	574	0.8519
The Final Earth 2	2022-07-15	51	107	4	55	0.8519
Mega Mall Story	2022-07-04	62	107	4	66	0.8519
Toilet Chronicles	2022-07-14	162	746	78	240	0.8517
Dissonance	2022-04-27	20	129	6	26	0.8517
Grandpa's Cheese	2022-05-14	55	118	5	60	0.8517
花都之恋	2022-04-27	13	118	5	18	0.8517
Super Psycho Baseball	2022-12-20	41	118	5	46	0.8517
Antivine	2022-12-21	13	95	3	16	0.8517
Submerged: Hidden Depths	2022-03-09	41	228	16	57	0.8515
Stardeus	2022-10-12	2139	714	75	2214	0.8506
琳琳	2022-11-11	22	81	2	24	0.8505
Crysis 2 Remastered	2022-11-17	863	1879	234	1097	0.8504
混世萌王喵霸霸 Cute Chaos Demon Nyanbaba	2022-09-21	6	54	0	6	0.8504
Sokobos	2022-04-01	6	54	0	6	0.8504
我的猫娘恋人 My Cat Girl Lover	2022-08-15	26	167	10	36	0.8503000000000001
LEGO® Bricktales	2022-10-12	739	481	46	785	0.8502
Sex and the Furry Titty 2: Sins of the City	2022-09-08	219	407	37	256	0.8502
Dark Nights	2022-11-01	39	104	4	43	0.8502
RGB Rush	2022-04-20	29	115	5	34	0.8501000000000001
Lorn's Lure: Prologue	2022-03-11	18	176	11	29	0.85
AI: THE SOMNIUM FILES - nirvanA Initiative	2022-06-24	2845	1813	226	3071	0.8499
ＲＰＧタイム！～ライトの伝説～	2022-09-13	72	166	10	82	0.8499
Vox Machinae	2022-05-13	110	1017	116	226	0.8498000000000001
Over the Counter	2022-02-13	85	232	17	102	0.8498000000000001
EndCycle VS	2022-04-20	18	80	2	20	0.8498000000000001
Cavity Busters	2022-03-18	14	80	2	16	0.8498000000000001
Queen of the flies 蝇后	2022-03-31	9	213	15	24	0.8495999999999999
原灵·深海遗梦 Medusa the Origin ~ Lost Dream of the Deep	2022-03-27	45	103	4	49	0.8495999999999999
Cute Cats 3	2022-05-25	6	103	4	10	0.8495999999999999
Dice Tribes: Ambitions	2022-06-15	49	67	1	50	0.8495999999999999
The Elder Scrolls II: Daggerfall	2022-04-26	535	1628	201	736	0.8495
Sqroma	2022-02-28	9	53	0	9	0.8495
Ultimate Epic Battle Simulator 2	2022-05-12	1802	2860	379	2181	0.8494
WARRIORS OROCHI 3 Ultimate Definitive Edition	2022-07-12	2996	1298	155	3151	0.8494
RiffTrax: The Game	2022-05-05	120	155	9	129	0.8494
The Use of Life	2022-05-21	176	284	23	199	0.8493
NecroBouncer: Prologue	2022-10-13	419	193	13	432	0.8492000000000001
Please, Touch The Artwork	2022-01-26	12	124	6	18	0.8492000000000001
Frozen Memories	2022-03-12	11	79	2	13	0.8492000000000001
Chronicles of Tal'Dun: The Remainder	2022-03-23	10	79	2	12	0.8492000000000001
Necrosmith	2022-07-13	4498	3378	457	4955	0.8491
Gilded Shadows	2022-05-13	138	113	5	143	0.8491
Atari 50: The Anniversary Celebration	2022-11-11	76	144	8	84	0.8490000000000001
Settlement Survival	2022-10-24	5613	4843	679	6292	0.8489
Smasher and the Will o' the Thiccs	2022-07-12	14	66	1	15	0.8489
Dungeon Master	2022-09-29	23	400	37	60	0.8488
Eternal Edge Plus Prologue	2022-05-05	572	1317	159	731	0.8487
你画我拼You draw I puzzle	2022-02-21	12	52	0	12	0.8487
Aery - A New Frontier	2022-05-13	4	52	0	4	0.8487
起飞吧！兔兔	2022-06-30	8	52	0	8	0.8487
Spellbook Demonslayers Prologue	2022-08-03	862	504	50	912	0.8486
Reloader: test_subject	2022-01-14	23	210	15	38	0.8486
CozyTyper	2022-07-22	39	112	5	44	0.8484999999999999
CosmoOdyssey:Trip to Mars	2022-08-18	4	78	2	6	0.8484999999999999
Home Behind 2	2022-02-16	20081	5619	801	20882	0.8484
THE BUTTON	2022-04-27	438	1363	166	604	0.8484
Nitro Kid	2022-10-18	155	236	18	173	0.8482
Dead Grid	2022-03-24	194	227	17	211	0.8482
Coromon	2022-03-31	4026	3314	452	4478	0.8481000000000001
TRYP FPV	2022-06-30	234	732	80	314	0.8481000000000001
Yes My Lord	2022-09-16	73	89	3	76	0.848
I Live Under Your House	2022-10-31	9	89	3	12	0.848
Ruza	2022-11-11	26	89	3	29	0.848
Warhammer 40,000: Shootas, Blood & Teef	2022-10-20	932	1385	170	1102	0.8479000000000001
INPUT6	2022-12-23	17	111	5	22	0.8479000000000001
Pickle Clicker	2022-05-03	59	700	76	135	0.8478
Andro Dunos 2	2022-03-25	10	77	2	12	0.8478
Quadrata	2022-10-10	15	77	2	17	0.8478
Pair Of Stamps	2022-11-25	11	51	0	11	0.8478
Escape Memoirs: Mini Stories	2022-09-30	2987	2206	289	3276	0.8477
Cross Concerto	2022-09-23	111	189	13	124	0.8476
Blacktop Hoops	2022-04-19	30	434	42	72	0.8473999999999999
SUKEBE BLOCKS	2022-03-03	18	110	5	23	0.8473999999999999
Cute Cats 2	2022-04-01	7	88	3	10	0.8473
HimeYoku: A Sacrifice of Lust and Grace	2022-09-09	68	88	3	71	0.8473
Five Stages of Pink	2022-04-29	10	64	1	11	0.8473
The Caligula Effect 2	2022-06-23	297	259	21	318	0.8472
Outdoor Adventures With Marisa Kirisame	2022-03-01	5	76	2	7	0.8470000000000001
QUICKERFLAK	2022-01-12	19	187	13	32	0.8469
Making Lovers After Stories	2022-08-26	35	50	0	35	0.8469
Kitty Ball	2022-04-19	35	168	11	46	0.8467
Nomad Survival	2022-10-09	2431	1366	170	2601	0.8466
Karisvale	2022-04-01	17	139	8	25	0.8466
"""LIFE"" not found;"	2022-06-23	6	87	3	9	0.8466
Magic Axolotl	2022-10-28	5	63	1	6	0.8465
Meteor World Actor: Badge & Dagger	2022-06-10	125	213	16	141	0.8464
Obama	2022-01-20	83	799	91	174	0.8462999999999999
The Journey - Episode 2: Words of Wisdom	2022-06-06	8	75	2	10	0.8462999999999999
シャルドネロマンシア	2022-04-25	213	108	5	218	0.8462000000000001
Sunday Gold: Prologue	2022-08-10	19	108	5	24	0.8462000000000001
Graphwar	2022-02-23	124	339	31	155	0.8461
躲猫猫	2022-11-13	21	138	8	29	0.8461
Mothmen 1966	2022-07-14	22	157	10	32	0.846
Rush Rally Origins	2022-04-13	18	128	7	25	0.846
KamiYaba: Destiny on a Dicey Deadline	2022-01-28	21	97	4	25	0.846
G-Darius HD	2022-03-30	56	86	3	59	0.846
---Red---Tether-->	2022-01-18	28	49	0	28	0.846
Meowjiro	2022-11-08	200	394	38	238	0.8458
One Dreamer	2022-09-09	103	246	20	123	0.8458
SPEARHEAD	2022-05-14	12	62	1	13	0.8456999999999999
TAPE: Unveil the Memories	2022-04-13	15	62	1	16	0.8456999999999999
Chess Survivors	2022-11-10	20	62	1	21	0.8456999999999999
Super Alloy Ranger	2022-09-15	47	155	10	57	0.8451000000000001
World Racing 2	2022-12-08	51	136	8	59	0.8451000000000001
The Elevator Game with Catgirls	2022-12-13	10	48	0	10	0.8451000000000001
Nomori: Prologue	2022-08-17	13	106	5	18	0.845
Crysis 3 Remastered	2022-11-17	492	1473	189	681	0.8449
Yumahorome ~Toki o Tometa Yakata de Asu o Sagasu Maigo-tachi~	2022-08-12	131	200	15	146	0.8449
Epiphany City	2022-04-12	74	182	13	87	0.8449
Rail Route: The Story of Jozic	2022-06-21	34	73	2	36	0.8448000000000001
Elec Dude	2022-03-02	7	73	2	9	0.8448000000000001
Ero Manager	2022-03-11	91	242	20	111	0.8445
Siren's Call	2022-04-15	25	163	11	36	0.8445
Blazing Aries	2022-03-12	180	216	17	197	0.8444
The Unluckiest Man	2022-10-27	18	144	9	27	0.8443
RUKIMIN's Disappointing Adventure!	2022-05-23	66	258	22	88	0.8442000000000001
Vacant Kingdom	2022-10-06	14	47	0	14	0.8441
Light Maze	2022-07-18	7	47	0	7	0.8441
Sweety Kitty 2	2022-11-14	19	47	0	19	0.8441
Logic Light	2022-01-26	6	60	1	7	0.8440000000000001
BVOVB - Bruising Vengeance of the Vintage Boxer	2022-08-11	4	60	1	5	0.8440000000000001
GRAND CROSS: ReNOVATION	2022-01-20	27	83	3	30	0.8439
Ghost Watchers	2022-07-28	4747	9769	1513	6260	0.8438
Pocket City	2022-08-22	26	114	6	32	0.8438
Marble World	2022-09-30	124	633	71	195	0.8437000000000001
街机三国志	2022-09-09	192	611	68	260	0.8437000000000001
After the Inferno	2022-08-01	134	361	35	169	0.8437000000000001
Sephonie	2022-04-12	36	170	12	48	0.8436
Stranded: Alien Dawn	2022-10-12	5273	2589	361	5634	0.8434999999999999
Yokai Art: Night Parade of One Hundred Demons	2022-09-29	251	506	54	305	0.8434999999999999
Sunday Rivals	2022-05-16	23	205	16	39	0.8434999999999999
Timeloop: Sink Again Beach	2022-11-16	11	142	9	20	0.8433
Ralph and the Blue Ball	2022-10-11	6	71	2	8	0.8432
Grand Mountain Adventure	2022-03-10	45	204	16	61	0.8431000000000001
雨にして人を外れ	2022-10-13	24	82	3	27	0.8431000000000001
120 Yen Stories	2022-01-28	9	59	1	10	0.8431000000000001
Employee of the Month	2022-09-21	12	59	1	13	0.8431000000000001
Unusual Findings	2022-10-12	123	254	22	145	0.843
The Jackbox Party Starter	2022-06-30	293	132	8	301	0.843
Monster Girls and the Mysterious Adventure 2	2022-08-26	558	212	17	575	0.8429000000000001
Bonding Ambivalence	2022-10-26	42	186	14	56	0.8429000000000001
Takoyaki Party Survival	2022-08-27	654	177	13	667	0.8428
Goonect	2022-05-27	228	122	7	235	0.8428
Tiny Combat Arena	2022-02-22	400	959	118	518	0.8427
Few Nights More	2022-04-28	99	92	4	103	0.8427
NeverAwake	2022-09-28	53	102	5	58	0.8425
Jelly Is Sticky	2022-05-19	27	70	2	29	0.8423999999999999
Swordship	2022-12-05	18	70	2	20	0.8423999999999999
Monster Girl Manager	2022-03-06	29	70	2	31	0.8423999999999999
汉字大冒险	2022-12-17	46	58	1	47	0.8422000000000001
What Lies in the Multiverse - Prologue	2022-01-25	6	58	1	7	0.8422000000000001
Social Moth	2022-05-11	22	58	1	23	0.8422000000000001
Dragon Drop	2022-06-11	10	45	0	10	0.8421
A Wholesome Game About Farming	2022-12-15	6	45	0	6	0.8421
RUKIMIN's Disappointing Adventure! ~SHOBOMI AND THE PHANTOM RUINS~	2022-09-17	26	111	6	32	0.8420000000000001
JoJo's Bizarre Adventure: All-Star Battle R	2022-09-01	7029	5446	825	7854	0.8419
RESTLESS SOUL	2022-09-01	14	101	5	19	0.8419
Jivana	2022-01-21	25	407	42	67	0.8418000000000001
Creature Creator	2022-12-23	123	337	33	156	0.8416
come see my hole	2022-10-27	25	120	7	32	0.8416
Who Is The Red Queen?	2022-08-15	15	80	3	18	0.8416
Volley Court	2022-11-26	111	69	2	113	0.8416
Diluvian Winds Prologue	2022-09-21	283	352	35	318	0.8415
Space Quest: 2099	2022-01-25	21	110	6	27	0.8414
What if George Washington was a Girl?	2022-08-12	9	138	9	18	0.8412999999999999
Egression	2022-10-12	16	57	1	17	0.8412999999999999
Byte Lynx	2022-10-12	31	57	1	32	0.8412999999999999
Bounty of One	2022-08-18	1648	1275	167	1815	0.8412000000000001
Titan Station	2022-11-11	27	182	14	41	0.8412000000000001
Abalon	2022-06-20	109	173	13	122	0.841
Triple Take	2022-10-06	10	44	0	10	0.841
Ringlorn Saga	2022-11-07	7	44	0	7	0.841
Azazel's Christmas Fable	2022-11-29	5	44	0	5	0.841
Sora no Ao to Shiro to	2022-11-04	38	146	10	48	0.8408
Stardom	2022-03-31	159	68	2	161	0.8408
I Fetch Rocks	2022-03-03	17	68	2	19	0.8408
All Quiet Roads	2022-04-11	48	68	2	50	0.8408
TOKOYO: The Tower of Perpetuity	2022-06-02	169	387	40	209	0.8407
HipWitch	2022-02-04	18	99	5	23	0.8406
Ashina: The Red Witch	2022-06-04	12	89	4	16	0.8406
Game Dev Story	2022-03-28	286	511	57	343	0.8405
Poker Quest	2022-11-14	281	475	52	333	0.8405
Paradox of Hope	2022-09-15	109	423	45	154	0.8404
Gretel and Winslow's Mansion	2022-01-19	231	197	16	247	0.8404
Zetria	2022-06-10	300	653	77	377	0.8403
Foretales	2022-09-15	628	474	52	680	0.8403
DAGURI: Gambling Apocalypse	2022-10-14	61	56	1	62	0.8403
Late Bird	2022-01-20	3	78	3	6	0.8401000000000001
Vestaria Saga II: The Sacred Sword of Silvanister	2022-07-28	157	162	12	169	0.84
Let's Ride! Silver Buckle Stables	2022-01-28	11	43	0	11	0.84
A Walk With Yiayia	2022-11-03	4	43	0	4	0.84
How to Say Goodbye	2022-11-03	19	43	0	19	0.84
Galacticon	2022-05-20	12	43	0	12	0.84
Profession investigator	2022-07-13	8	43	0	8	0.84
Personal Space	2022-06-24	7	43	0	7	0.84
My Name is Mayo 3	2022-05-17	27	117	7	34	0.8399
Epics of Distant Realm: Holy Return	2022-03-16	8	117	7	15	0.8399
Polygunners	2022-01-14	18	88	4	22	0.8399
Sand Castle	2022-03-14	17	88	4	21	0.8399
BroodStar	2022-06-15	9	67	2	11	0.8399
Cool Kid Cody	2022-04-08	19	67	2	21	0.8399
A Little to the Left	2022-11-08	1144	2104	298	1442	0.8398000000000001
Vacuum Pilot	2022-10-30	38	153	11	49	0.8398000000000001
女拳主義F-ist	2022-12-22	1156	1570	215	1371	0.8397
Grapple Dog	2022-02-10	79	299	29	108	0.8397
Meow Express	2022-01-07	45	228	20	65	0.8397
The Odyssey of the Mammoth	2022-03-04	72	329	33	105	0.8395
Chasm: The Rift	2022-10-10	100	178	14	114	0.8395
SAOMI	2022-04-30	6	55	1	7	0.8394
雛ちゃんブレイカー2ndBreak	2022-07-29	52	55	1	53	0.8394
Aztlan Uncovered	2022-07-28	26	152	11	37	0.8393
Blast Brigade vs. the Evil Legion of Dr. Cread	2022-04-13	49	169	13	62	0.8392000000000001
Virtual Circuit Board	2022-05-20	49	134	9	58	0.8392000000000001
Rise of the Third Power	2022-02-10	126	320	32	158	0.8391
吞食天地2022	2022-09-30	124	357	37	161	0.8390000000000001
Mago: The Villain's Burger	2022-02-07	280	566	66	346	0.8388
Warstride Challenges	2022-04-19	95	151	11	106	0.8388
依依	2022-03-26	8	151	11	19	0.8388
Crate Mates	2022-02-25	11	42	0	11	0.8388
There Swings a Skull: Grim Tidings	2022-09-15	5	42	0	5	0.8388
Slaughter Horse 2	2022-12-05	13	42	0	13	0.8388
MOONPONG: Tales of Epic Lunacy	2022-09-09	8	42	0	8	0.8388
Ghost Exile	2022-01-07	476	1836	259	735	0.8387000000000001
Forgotten Realms: The Archives - Collection Two	2022-03-29	193	115	7	200	0.8387000000000001
Ardor	2022-05-06	205	124	8	213	0.8386
Watamari - A Match Made in Heaven Part1	2022-09-23	79	124	8	87	0.8386
目盲/Blind	2022-11-26	124	522	60	184	0.8384999999999999
Just A Humble Swordsmith	2022-07-09	44	436	48	92	0.8384999999999999
Night Cascades	2022-03-01	14	76	3	17	0.8384999999999999
GearCity	2022-01-14	289	1071	141	430	0.8384
sunny-place	2022-05-31	10	86	4	14	0.8384
Regular Human Workshop	2022-09-24	75	362	38	113	0.8383
Fungiman	2022-06-30	21	332	34	55	0.8383
Prime of Flames	2022-12-15	550	714	88	638	0.8382
MOTHERGUNSHIP: FORGE	2022-06-16	21	158	12	33	0.8381000000000001
Kapia	2022-01-25	8	65	2	10	0.8381000000000001
Guildford Castle VR	2022-03-24	11	65	2	13	0.8381000000000001
选王之剑	2022-01-15	1325	1013	133	1458	0.8379000000000001
DORAEMON STORY OF SEASONS: Friends of the Great Kingdom	2022-11-01	573	191	16	589	0.8379000000000001
VTuber Connect	2022-11-21	17	95	5	22	0.8378
COSPLAY LOVE! Enchanted princess	2022-03-30	9	41	0	9	0.8377
Bocce Time!	2022-06-17	6	41	0	6	0.8377
WikiArena	2022-10-25	13	41	0	13	0.8377
Boots Quest DX	2022-11-25	7	41	0	7	0.8377
To Be or Not to Be	2022-12-09	4559	2749	411	4970	0.8372
NIGHT/SHADE: You're The Drug	2022-03-11	44	64	2	46	0.8372
JANITOR BLEEDS	2022-04-07	24	156	12	36	0.8371
Static of Eve –凝滯聖夜–	2022-07-11	34	74	3	37	0.8368000000000001
non-binary	2022-07-19	16	180	15	31	0.8367
Overloop	2022-08-26	33	93	5	38	0.8364
Rocco's Island: Ring to End the Pain	2022-03-02	13	93	5	18	0.8364
TYRONE vs COPS VR	2022-10-01	8	93	5	13	0.8364
MicroWorks	2022-09-02	248	171	14	262	0.8362999999999999
Time Master	2022-01-18	12	63	2	14	0.8362999999999999
SCP Strategy	2022-05-05	28	404	45	73	0.8362
Arcade Spirits: The New Challengers	2022-05-27	147	102	6	153	0.8362
Knight's Try	2022-01-27	33	111	7	40	0.8361000000000001
Room 301 NO.6	2022-09-21	28	111	7	35	0.8361000000000001
FAREWELL SEN	2022-10-29	21	111	7	28	0.8361000000000001
Cut to the Core	2022-08-01	6	83	4	10	0.8361000000000001
Witchpunk	2022-11-18	39	137	10	49	0.836
Sigh of the Abyss: Shadow Bonds	2022-04-05	20	73	3	23	0.836
Ys IX -Monstrum NOX-	2022-01-19	149	210	19	168	0.8359000000000001
Gunlocked	2022-12-06	69	286	29	98	0.8358
Winter Falling	2022-11-08	68	153	12	80	0.8356
Pixel Cup Soccer - Ultimate Edition	2022-10-14	332	422	48	380	0.8355
Inside the Backrooms	2022-06-20	15033	27301	4786	19819	0.8354
I Am Sakuya: Touhou FPS Game	2022-09-13	33	336	36	69	0.8354
Insomnis	2022-01-07	25	185	16	41	0.8353
Salamander County Public Television	2022-07-29	8	62	2	10	0.8353
Mess Quest	2022-11-09	10	62	2	12	0.8353
Manufactoria 2022	2022-08-16	34	51	1	35	0.8353
Dead Forest	2022-07-26	8	39	0	8	0.8353
Geballer	2022-06-10	9	39	0	9	0.8353
SokoChess	2022-08-12	8	39	0	8	0.8353
Songs from the Iron Sea	2022-09-22	21	39	0	21	0.8353
Cozy Time	2022-07-13	46	144	11	57	0.8351999999999999
Freight Hopper	2022-07-29	10	72	3	13	0.8351000000000001
Albert Innovation	2022-10-28	9	91	5	14	0.8349
Frontier Hunter: Erza’s Wheel of Fortune	2022-12-15	343	548	67	410	0.8345
Born Into Fear	2022-03-21	27	151	12	39	0.8345
Thymesia	2022-08-18	3224	4371	699	3923	0.8344
Racingmaybe	2022-01-10	11	61	2	13	0.8344
Airborne Kingdom	2022-03-07	1136	1381	197	1333	0.8343
Kamikaze Veggies	2022-07-07	17	71	3	20	0.8342
Self-Delusion	2022-08-17	20	71	3	23	0.8342
Blood Nova	2022-10-05	8	71	3	11	0.8342
The Scorchfarer	2022-04-15	8	50	1	9	0.8342
Shooting Game KARI	2022-08-04	14	50	1	15	0.8342
Arcade Paradise	2022-08-11	511	692	89	600	0.8341
Hot Springs Story	2022-03-28	87	142	11	98	0.8341
Night At the Gates of Hell	2022-09-15	108	436	51	159	0.8340000000000001
Ticklish Tessa	2022-06-03	7	38	0	7	0.8340000000000001
Winging It	2022-02-11	10	38	0	10	0.8340000000000001
Sky Caravan	2022-05-05	8	38	0	8	0.8340000000000001
Summum Aeterna	2022-06-16	53	166	14	67	0.8339
Fobia - St. Dinfna Hotel	2022-06-28	310	954	130	440	0.8337000000000001
Eternal Threads	2022-05-19	77	272	28	105	0.8337000000000001
Three Finger Battle Arena	2022-02-26	101	279	29	130	0.8336
黑猫魔法师	2022-01-21	91	189	17	108	0.8336
Hack and Slime	2022-06-01	18	107	7	25	0.8334999999999999
Space Bandit	2022-09-18	10	60	2	12	0.8334
Fabular: Prologue	2022-07-08	27	60	2	29	0.8334
Queer Man Peering Into A Rock Pool.jpg	2022-07-13	10	70	3	13	0.8333
BLACKJACK and WAIFUS	2022-02-14	49	384	44	93	0.8331000000000001
Neodash	2022-08-17	185	370	42	227	0.8331000000000001
Chicken Feet	2022-10-25	86	233	23	109	0.833
Pets at Work	2022-02-28	30	115	8	38	0.833
Hamster Playground	2022-08-22	546	858	116	662	0.8329000000000001
The Whispering Valley	2022-11-30	11	79	4	15	0.8328
温泉旅館のパイズリ怪異	2022-04-11	7	37	0	7	0.8327
That's Not How it Happened	2022-08-08	3	37	0	3	0.8327
Samurai Bringer	2022-04-21	1360	766	102	1462	0.8326000000000001
Dream Hacker	2022-08-30	181	347	39	220	0.8326000000000001
Get Achievements for Achievements	2022-03-01	7	88	5	12	0.8326000000000001
Tide Up	2022-03-11	46	163	14	60	0.8323999999999999
The Crackpet Show	2022-12-15	136	448	54	190	0.8321
The Bible	2022-11-14	57	352	40	97	0.8321
Letters - a written adventure	2022-02-09	47	122	9	56	0.8321
Onde	2022-03-17	18	122	9	27	0.8321
DEPO : Death Epileptic Pixel Origins	2022-07-25	37	105	7	44	0.8321
Grindstone	2022-06-20	57	105	7	64	0.8321
Sand:box	2022-11-23	26	105	7	33	0.8321
Planet S	2022-07-01	75	434	52	127	0.8320000000000001
Insect Swarm	2022-06-01	392	818	111	503	0.8319
Griddy	2022-08-22	7	78	4	11	0.8319
MADiSON	2022-07-08	506	1615	241	747	0.8317
The Closing Shift | 閉店事件	2022-03-19	278	1397	205	483	0.8317
Pocket Academy	2022-06-13	173	113	8	181	0.8317
Two Point Campus	2022-08-09	7553	2656	418	7971	0.8316
Cat Cafe Manager	2022-04-14	582	1175	169	751	0.8315000000000001
Boo Men	2022-09-15	404	1241	180	584	0.8314
Car Tehc	2022-05-29	7	36	0	7	0.8314
Heartstop	2022-05-05	6	36	0	6	0.8314
天香与小百合 - Tinheung & Sayuri	2022-08-05	4	36	0	4	0.8314
No More Future	2022-10-07	6	36	0	6	0.8314
MIND CORRIDORS: Paroniria	2022-11-28	4	36	0	4	0.8314
Diplomacy is Not an Option	2022-02-09	3180	3535	572	3752	0.8312999999999999
Super Ride Grandpa	2022-05-09	5	58	2	7	0.8312999999999999
Skala	2022-10-04	45	176	16	61	0.8312
Fears to Fathom - Episode 2	2022-01-06	96	986	139	235	0.831
A.R.D. Alien Removal Division	2022-06-17	149	805	110	259	0.831
Spell Defender	2022-10-10	42	112	8	50	0.831
Coloring Game: Girls	2022-07-22	76	77	4	80	0.831
Windjammers 2	2022-01-20	492	429	52	544	0.8309000000000001
Cactus Simulator	2022-02-04	53	198	19	72	0.8309000000000001
Hentai Mission Ukraine	2022-05-03	5	144	12	17	0.8307
Class Escape	2022-03-25	15	47	1	16	0.8307
a completely normal dating simulation that is definitely completely sweet, innnocent and normal: SOMETHINGETH ANIVERSARY EDITION	2022-08-26	1041	103	7	1048	0.8306
Mushy	2022-02-16	266	1207	176	442	0.8305
The Last Hero of Nostalgaia	2022-10-19	356	629	83	439	0.8304
Fresh Start Cleaning Simulator	2022-12-20	368	565	73	441	0.8304
Superbugs: Awaken	2022-03-23	50	159	14	64	0.8304
Cursed 2	2022-04-22	39	111	8	47	0.8304
Counterpact	2022-10-14	34	111	8	42	0.8304
Run N' Gun	2022-04-14	16	94	6	22	0.8303
The Legend of Heroes: Ao no Kiseki KAI	2022-01-12	66	143	12	78	0.8301999999999999
Everdell	2022-07-28	152	240	25	177	0.8301000000000001
Regiments	2022-08-16	1258	1448	217	1475	0.8300000000000001
Depths of Sanity	2022-11-02	6	35	0	6	0.8300000000000001
BORE DOME	2022-05-30	6	35	0	6	0.8300000000000001
Turbo Sloths	2022-12-08	5	35	0	5	0.8300000000000001
Virtual Maid Streamer Ramie	2022-01-20	16	35	0	16	0.8300000000000001
Sneaky Rat	2022-10-22	8	35	0	8	0.8300000000000001
Neon Sundown	2022-03-18	185	282	31	216	0.8299
Walk While My Grandmother Plays The Piano	2022-11-04	9	150	13	22	0.8297
TFC: The Fertile Crescent	2022-03-29	34	110	8	42	0.8297
Temtem	2022-09-06	39572	30775	5679	45251	0.8296
Farthest Frontier	2022-08-09	24910	10223	1799	26709	0.8296
Tin Can	2022-05-12	282	650	87	369	0.8296
Ikonei Island: An Earthlock Adventure	2022-08-18	42	118	9	51	0.8295
Kawaii Hentai Girls 2	2022-06-09	21	93	6	27	0.8295
Hausmeister	2022-10-11	11	66	3	14	0.8295
Kriegsfront Battlescaper	2022-08-04	11	46	1	12	0.8295
秋恋物语 Autumn Romance	2022-02-04	12	46	1	13	0.8295
Rimward Basilisk	2022-12-07	12	46	1	13	0.8295
长明火计划 Project: Eternal Flame	2022-07-08	30	84	5	35	0.8293
Grim Quest	2022-04-01	15	84	5	20	0.8293
Unlock the Feelings	2022-05-06	12	84	5	17	0.8293
DEATHWATCH	2022-10-21	18	84	5	23	0.8293
Fishing Paradiso	2022-06-01	101	149	13	114	0.8292
Springblades	2022-11-25	110	75	4	114	0.8292
RXC - Rally Cross Challenge	2022-11-22	17	56	2	19	0.8291
Super Ember Kaboom	2022-06-15	6	56	2	8	0.8291
瓔珞事件簿之誰殺了愛情	2022-01-31	15	56	2	17	0.8291
Keplerth	2022-05-24	7526	3114	509	8035	0.8290000000000001
Army of Ruin	2022-10-27	1021	913	130	1151	0.8290000000000001
I got a millenary cat	2022-10-07	240	341	40	280	0.8290000000000001
Chili Con Valley	2022-01-17	10	117	9	19	0.8289
Crash Bandicoot™ 4: It’s About Time	2022-10-18	454	1013	147	601	0.8287000000000001
Session: Skate Sim	2022-09-22	1757	8502	1495	3252	0.8286
Altero	2022-10-17	5	34	0	5	0.8285
Amberial Dreams	2022-10-18	19	34	0	19	0.8285
Newton Going Home	2022-01-20	5	34	0	5	0.8285
Supercow	2022-03-05	6	34	0	6	0.8285
Lit Up	2022-05-09	6	34	0	6	0.8285
Amber City	2022-09-01	23	34	0	23	0.8285
Katydids	2022-06-14	11	34	0	11	0.8285
Boom Slingers	2022-09-16	10	34	0	10	0.8285
MopGarden's Veggie Cart	2022-11-30	7	34	0	7	0.8285
TurnTheLine	2022-04-01	33	83	5	38	0.8284
Ignited Steel: Prologue	2022-10-14	466	83	5	471	0.8284
Timemelters	2022-10-12	27	65	3	30	0.8284
Light & Shadow	2022-11-24	18	124	10	28	0.8281999999999999
Gunborg: Dark Matters	2022-03-04	4	45	1	5	0.8281999999999999
Lapin	2022-11-17	33	91	6	39	0.8279000000000001
Eiyuden Chronicle: Rising	2022-05-10	1163	1249	188	1351	0.8278
Tetris for Two	2022-01-25	30	241	26	56	0.8278
Berserk Mode	2022-01-09	15	107	8	23	0.8275
Superfly	2022-06-18	63	414	52	115	0.8273999999999999
Dexter Stardust : Adventures in Outer Space	2022-03-03	19	64	3	22	0.8273999999999999
Reefland	2022-10-17	22	64	3	25	0.8273999999999999
ガチムチでドスケベな家庭教師のお兄さんと過ごす夏	2022-10-22	80	64	3	83	0.8273999999999999
Darold The Doomer: Psychedelic Lucid Dreams	2022-04-06	6	73	4	10	0.8273
Gabenwood: 99 Hidden Bucks	2022-11-07	6	73	4	10	0.8273
Lost and Hound	2022-08-17	8	33	0	8	0.8270000000000001
Fluffy Milo	2022-03-28	6	33	0	6	0.8270000000000001
Infinite Turtles	2022-06-19	11	33	0	11	0.8270000000000001
房间的秘密	2022-07-08	9	33	0	9	0.8270000000000001
Colorful Recolor	2022-08-10	5	33	0	5	0.8270000000000001
Cat Herder	2022-11-03	18	33	0	18	0.8270000000000001
Know by heart...	2022-02-10	255	527	70	325	0.8269
Secret Summer	2022-07-05	136	273	31	167	0.8269
RoboCo	2022-11-03	98	98	7	105	0.8269
start;again	2022-03-31	5	44	1	6	0.8269
NOX: Chapter 1	2022-12-23	8	44	1	9	0.8269
Lust Academy	2022-04-12	952	960	141	1093	0.8268000000000001
Boxville	2022-09-30	24	114	9	33	0.8268000000000001
Mokoko X	2022-04-07	32	106	8	40	0.8268000000000001
Pool Slide Story	2022-07-04	104	106	8	112	0.8268000000000001
Froggie	2022-11-04	7	54	2	9	0.8268000000000001
lure	2022-04-08	11	252	28	39	0.8267
Deluge: Threnody of Crashing Waves	2022-07-08	18	137	12	30	0.8266
Yomawari: Lost in the Dark	2022-10-25	110	144	13	123	0.8262999999999999
YAKIMOCHI STREAM	2022-01-22	32	105	8	40	0.8261000000000001
Zombie Rollerz: Pinball Heroes	2022-03-02	126	236	26	152	0.8259000000000001
與經紀人戀愛是絕對禁止！	2022-03-23	456	540	73	529	0.8258
Ukraine War Stories	2022-10-18	86	711	101	187	0.8256
My Dad Left Me	2022-08-05	6	53	2	8	0.8256
Father's Day	2022-10-22	53	342	42	95	0.8255
Solitaire Expeditions	2022-07-23	14	43	1	15	0.8255
Weeping Falls Massacre	2022-06-16	11	43	1	12	0.8255
Nekomew's Nightmares	2022-10-28	13	32	0	13	0.8255
Despot's Game: Dystopian Army Builder	2022-09-29	1463	2186	358	1821	0.8254000000000001
冥婚交友中心《厲鬼的戀愛指南》	2022-02-08	767	575	79	846	0.8254000000000001
Solar Ash	2022-12-08	172	406	52	224	0.8254000000000001
The Infinite Black 2	2022-10-29	53	135	12	65	0.8254000000000001
ABRISS	2022-04-14	213	295	35	248	0.8253
fault - StP - LIGHTKRAVTE	2022-05-28	101	295	35	136	0.8253
Relapse	2022-10-12	44	142	13	57	0.8251000000000001
重构	2022-03-29	403	359	45	448	0.8248000000000001
Biters & Bullets: Prologue	2022-07-19	315	233	26	341	0.8247
Automon	2022-03-04	89	111	9	98	0.8247
The Backrooms: Survival	2022-03-31	78	804	118	196	0.8244
Catie in MeowmeowLand	2022-03-31	15	70	4	19	0.8244
It's Kooky	2022-11-01	23	52	2	25	0.8244
Haha Doodle	2022-01-25	318	118	10	328	0.8242
Dead Beacon	2022-11-18	10	61	3	13	0.8242
reIterate()	2022-01-13	10	42	1	11	0.8240999999999999
NoWayBack无路可退	2022-10-20	52	42	1	53	0.8240999999999999
Automaton Lung	2022-12-16	6	42	1	7	0.8240999999999999
The Archipelago	2022-11-11	971	42	1	972	0.8240999999999999
Polda 3	2022-12-11	32	42	1	33	0.8240999999999999
Sir Whoopass	2022-08-18	600	616	87	687	0.8240000000000001
Brewmaster: Beer Brewing Simulator	2022-09-29	581	573	80	661	0.8239000000000001
White Lavender	2022-06-20	15	110	9	24	0.8239000000000001
The Forest Quartet	2022-12-08	10	78	5	15	0.8239000000000001
Riding Seas	2022-01-31	6	31	0	6	0.8239000000000001
Kalyzmyr	2022-03-11	4	31	0	4	0.8239000000000001
Witchhazel Woods	2022-08-12	4	31	0	4	0.8239000000000001
Pierre's Adventures in French	2022-10-14	6	31	0	6	0.8239000000000001
Extraneum	2022-06-15	5	31	0	5	0.8239000000000001
TTV4	2022-07-07	2	31	0	2	0.8239000000000001
Blossom Tales 2: The Minotaur Prince	2022-08-16	43	86	6	49	0.8237000000000001
FPS Chess	2022-07-16	3142	15180	2861	6003	0.8236
FixFox	2022-03-31	27	196	21	48	0.8235
Police Simulator: Patrol Officers	2022-11-10	3330	9899	1833	5163	0.8233
Sackboy™: A Big Adventure	2022-10-27	610	1329	211	821	0.8231999999999999
Sandwalkers: The Fourteenth Caravan	2022-10-26	241	256	30	271	0.8231999999999999
Military Conflict: Vietnam	2022-12-16	228	611	87	315	0.8231
Fidget Spinner RPG	2022-05-02	110	124	11	121	0.8231
CRAYON SHINCHAN The Storm Called! FLAMING KASUKABE RUNNER!!	2022-10-18	10	51	2	12	0.8231
Medieval Fantasy Survival Simulator 2 Gladiator Edition	2022-11-07	4	51	2	6	0.8231
Watch Your Plastic Duck	2022-09-09	17	101	8	25	0.823
Flowers -Le volume sur hiver-	2022-06-18	377	421	56	433	0.8229000000000001
DREAM LOGIC	2022-09-06	19	131	12	31	0.8229000000000001
Ruins Of Mitriom	2022-01-11	23	77	5	28	0.8229000000000001
Lights Off!	2022-05-27	50	1246	197	247	0.8228
The Golden Rose: Book One	2022-06-02	207	116	10	217	0.8228
Whateverland	2022-09-15	32	93	7	39	0.8228
Queen Beast	2022-12-06	14	93	7	21	0.8228
Zombies and Keys	2022-07-21	3	41	1	4	0.8227
Dead Man's Rest	2022-03-14	9	41	1	10	0.8227
Manafinder	2022-10-05	22	41	1	23	0.8227
Love, Death & Veggies	2022-01-07	3	41	1	4	0.8227
My Big Sister: Remastered	2022-10-25	6	41	1	7	0.8227
Azure Striker Gunvolt 3	2022-10-13	216	228	26	242	0.8226000000000001
Turbo Golf Racing	2022-08-04	546	376	49	595	0.8225
Parkour Tag	2022-01-24	61	152	15	76	0.8225
Security Booth: Director's Cut	2022-08-19	40	123	11	51	0.8225
Captain Bones	2022-07-27	48	173	18	66	0.8224
Animal Shelter	2022-03-23	1750	1575	257	2007	0.8222
Dungeon Village	2022-03-28	288	381	50	338	0.8222
The Swordbearer	2022-07-04	69	100	8	77	0.8222
Galaxy Tales: Story of Rapunzel	2022-06-30	4	30	0	4	0.8222
The Cartomancy Anthology	2022-08-09	13	30	0	13	0.8222
Astrocat: Milky Way Journey	2022-04-15	6	30	0	6	0.8222
Dragon Mine	2022-08-17	10	30	0	10	0.8222
Shiny Ski Resort	2022-11-28	31	30	0	31	0.8222
Aery VR - Calm Mind	2022-12-19	4	30	0	4	0.8222
伊格利亚战记	2022-04-13	563	1294	207	770	0.8220000000000001
Lost In Fantaland	2022-09-26	264	266	32	296	0.8220000000000001
Cartridge Defense	2022-09-03	21	76	5	26	0.8220000000000001
Tales From The Unending Void	2022-05-02	211	259	31	242	0.8219
Of Blades & Tails	2022-10-19	43	84	6	49	0.8219
Telepath Tactics Liberated	2022-03-14	32	84	6	38	0.8219
Life on the Edge	2022-06-17	20	59	3	23	0.8219
Skator Gator	2022-01-17	5	50	2	7	0.8219
Numeral Lord	2022-10-15	24	50	2	26	0.8219
Forgive Me Father	2022-04-07	333	2185	370	703	0.8217
Audio Trip	2022-12-19	15	239	28	43	0.8217
My Gaming Club	2022-12-14	181	452	62	243	0.8215000000000001
EarthRoyale	2022-07-29	33	99	8	41	0.8214
City Bus Manager	2022-11-10	986	660	97	1083	0.8212999999999999
pemsa	2022-04-13	32	114	10	42	0.8212999999999999
Rhapsody: A Musical Adventure	2022-08-30	26	67	4	30	0.8212
The Rat Plague	2022-11-14	99	67	4	103	0.8212
My devil's voice	2022-08-30	56	40	1	57	0.8212
SokoWinter	2022-03-13	7	40	1	8	0.8212
Twin Cores	2022-09-14	6	40	1	7	0.8212
Tournament Ark	2022-12-19	36	75	5	41	0.821
AGRYOS: Recovering Eden	2022-02-11	12	75	5	17	0.821
Repetendium	2022-11-04	176	135	13	189	0.8208
Pants Quest	2022-03-02	10	58	3	13	0.8207
Dungeons & Dragons: Krynn Series	2022-03-29	78	58	3	81	0.8207
What if your girl was a frog?	2022-06-03	10	190	21	31	0.8206
Cube Racer 2	2022-03-09	92	223	26	118	0.8205
Curtain Call	2022-04-26	7	49	2	9	0.8205
A HERO AND A GARDEN	2022-05-05	7	49	2	9	0.8205
SquishCraft	2022-07-27	26	49	2	28	0.8205
Solanaceae: After All	2022-10-06	9	29	0	9	0.8204000000000001
Tumblebugs	2022-03-18	12	29	0	12	0.8204000000000001
Pengu Never Left	2022-02-20	3	29	0	3	0.8204000000000001
Hare Apparent	2022-04-04	4	29	0	4	0.8204000000000001
Egglien	2022-08-05	4	29	0	4	0.8204000000000001
东方光耀夜 ~ Lost Branch of Legend	2022-08-18	302	368	49	351	0.8203
Kayak VR: Mirage	2022-07-12	126	536	77	203	0.8201999999999999
Salt 2	2022-09-20	753	606	89	842	0.8201
Illusion	2022-03-01	24	105	9	33	0.8201
Cafeteria Nipponica	2022-07-04	285	105	9	294	0.8201
Isonzo	2022-09-13	4196	4922	901	5097	0.8199
Kanjozoku Game レーサー	2022-07-17	622	2413	419	1041	0.8199
筒楼异事	2022-10-21	62	112	10	72	0.8198000000000001
Slot Shots Pinball Collection	2022-10-18	5	39	1	6	0.8197
Mystwood Manor	2022-09-30	1898	690	104	2002	0.8196
The Tale of Bistun	2022-07-13	27	140	14	41	0.8195
Seashell	2022-03-28	6	57	3	9	0.8195
Kris and the City of Pleasure	2022-09-16	38	57	3	41	0.8195
Hand Simulator: Rendezvous	2022-11-01	172	601	89	261	0.8192
The Inheritance of Crimson Manor	2022-05-05	66	290	37	103	0.8192
Toy Tanks	2022-05-12	10	48	2	12	0.8192
UuultraC	2022-03-24	27	48	2	29	0.8192
Grand Prix Story	2022-10-11	123	48	2	125	0.8192
Miss Kawaii 3	2022-12-02	15	48	2	17	0.8192
Aliens vs. Ghosts	2022-07-06	62	180	20	82	0.8190000000000001
Dawn of the Monsters	2022-03-15	24	81	6	30	0.8190000000000001
The Creature of Chaos	2022-03-14	6	81	6	12	0.8190000000000001
Biomisland	2022-10-15	33	81	6	39	0.8190000000000001
Dream Team Basketball	2022-12-12	27	81	6	33	0.8190000000000001
Trifox	2022-10-14	17	73	5	22	0.8189000000000001
Astral Slider	2022-03-10	20	73	5	25	0.8189000000000001
For Mother Matron	2022-10-17	15	73	5	20	0.8189000000000001
tERRORbane	2022-04-01	196	232	28	224	0.8188
Ubaste	2022-09-27	12	96	8	20	0.8188
Ghost Song	2022-11-03	685	656	99	784	0.8187000000000001
This is a Ghost	2022-12-09	119	225	27	146	0.8186
Beers and Boomerangs	2022-11-22	6	28	0	6	0.8186
Kitten Burst	2022-09-02	7	28	0	7	0.8186
Go! Go! PogoGirl	2022-01-26	7	28	0	7	0.8186
Platypus Adventures	2022-07-07	6	28	0	6	0.8186
Retro Kart Rush	2022-03-10	5	28	0	5	0.8186
Triga	2022-05-19	8	28	0	8	0.8186
TPORT	2022-07-13	4	28	0	4	0.8186
妖与夜的幻想	2022-03-23	3	28	0	3	0.8186
Arrival of Beasts	2022-05-13	10	28	0	10	0.8186
Chess Pills	2022-06-16	3	28	0	3	0.8186
Fishing Game	2022-08-25	5	28	0	5	0.8186
Hermit Home Designer	2022-09-15	4	28	0	4	0.8186
Signal & Echo: Iris is Missing (demo)	2022-11-02	5	28	0	5	0.8186
Idle Research	2022-08-01	4787	881	139	4926	0.8185
Brigandine The Legend of Runersia	2022-05-11	1547	654	99	1646	0.8184
Portal Dungeon	2022-12-15	1332	445	63	1395	0.8184
猎魔战纪	2022-05-25	116	145	15	131	0.8183
Defending Lydia Collier	2022-12-14	38	38	1	39	0.8181
Eremidia - Archivist's Curse	2022-08-15	16	38	1	17	0.8181
Spellbook Demonslayers	2022-11-02	944	754	117	1061	0.818
佩尔霍宁	2022-06-08	17	158	17	34	0.8179000000000001
Escape Academy	2022-07-14	305	466	67	372	0.8178000000000001
白晓	2022-05-03	9	64	4	13	0.8178000000000001
The Rabbit's Scroll	2022-06-25	14	64	4	18	0.8178000000000001
Molytropia: Cloud in Shape of Hurt	2022-12-07	4	64	4	8	0.8178000000000001
Gore Screaming Show	2022-11-12	27	47	2	29	0.8178000000000001
Golf Gang	2022-05-19	684	858	136	820	0.8177
三国群英志	2022-12-02	34	109	10	44	0.8175
灵墟	2022-07-08	400	498	73	473	0.8170999999999999
Dark Siren	2022-12-17	17	150	16	33	0.8170999999999999
Block'Em!	2022-09-08	152	79	6	158	0.8170999999999999
东方梦无境 ～ Dreamland of Infinity	2022-11-15	99	79	6	105	0.8170999999999999
Fight of Steel: Infinity Warrior	2022-07-15	46	55	3	49	0.8169
HoverRace	2022-02-07	13	55	3	16	0.8169
Five nights at Floppa 0	2022-07-01	4	55	3	7	0.8169
Makai Kingdom: Reclaimed and Rebound	2022-05-10	135	86	7	142	0.8166
リトルハーツ	2022-12-02	48	27	0	48	0.8166
SOKOBOT	2022-03-04	11	27	0	11	0.8166
Bomb Club Deluxe	2022-03-01	14	27	0	14	0.8166
SEARCH ALL - CRABS	2022-02-17	3	27	0	3	0.8166
I Hate You, Please Suffer - Basic	2022-04-27	4	27	0	4	0.8166
Downpurr	2022-06-13	8	27	0	8	0.8166
PUTRID SHOT ULTRA	2022-11-07	8	27	0	8	0.8166
Aery - Path of Corruption	2022-12-16	6	27	0	6	0.8166
Deadly Harvest	2022-10-24	14	27	0	14	0.8166
ASTRONAUTILUS	2022-03-30	15	37	1	16	0.8165000000000001
TitTok 2	2022-03-07	5	37	1	6	0.8165000000000001
Corn Defenders	2022-04-13	4	37	1	5	0.8165000000000001
I commissioned some bees 2	2022-06-23	10	37	1	11	0.8165000000000001
安科俱乐部	2022-01-15	27	46	2	29	0.8163
HEROish	2022-12-16	8	46	2	10	0.8163
SEARCH ALL - SPIDERS	2022-03-01	3	46	2	5	0.8163
Pixel Samurai	2022-06-16	12	78	6	18	0.8161
Jitsu Squad	2022-03-29	61	168	19	80	0.816
RATUZ	2022-04-22	72	200	24	96	0.8159000000000001
Zapling Bygone	2022-08-05	36	107	10	46	0.8159000000000001
Chambers of Devious Design	2022-09-05	47	70	5	52	0.8157
Scarlet Tower	2022-10-31	233	727	115	348	0.8156
Runes of Pandemonium	2022-02-22	14	54	3	17	0.8156
PongPong Girl	2022-08-17	13	54	3	16	0.8156
Forward: Escape the Fold - Ultimate Edition	2022-03-29	396	468	69	465	0.8155
My life as an archeologist	2022-01-10	642	255	33	675	0.8154000000000001
The Backroom - Lost and Found	2022-07-25	24	186	22	46	0.8153
Dealer's Life 2	2022-02-15	2884	2595	472	3356	0.8151999999999999
Aim Climb	2022-03-19	90	173	20	110	0.8151999999999999
Romancing SaGa -Minstrel Song- Remastered	2022-12-01	2410	160	18	2428	0.8151999999999999
NinNinDays2	2022-01-20	65	106	10	75	0.8151
Smutty Scrolls	2022-09-19	99	77	6	105	0.8150000000000001
An Outcry	2022-01-05	9	77	6	15	0.8150000000000001
Astro Colony	2022-11-07	2751	1009	168	2919	0.8148000000000001
Nyaaaanvy	2022-04-22	55	45	2	57	0.8148000000000001
Mini Gardens - Logic Puzzle	2022-03-22	9	45	2	11	0.8148000000000001
Madcap Mosaic	2022-08-15	25	45	2	27	0.8148000000000001
The Most Awesome Game Ever Made	2022-11-15	6	45	2	8	0.8148000000000001
Hentai BunnyGirl	2022-11-22	5	45	2	7	0.8148000000000001
The Maze	2022-12-08	6	36	1	7	0.8147
Garden Guardian	2022-08-10	14	36	1	15	0.8147
Bullet Hell Monday	2022-09-12	14	36	1	15	0.8147
Every Day's Different	2022-02-12	9	26	0	9	0.8146
Falling Out	2022-10-05	14	26	0	14	0.8146
Very Very Valet	2022-05-26	15	26	0	15	0.8146
Astronium	2022-02-06	6	26	0	6	0.8146
Skeleton Scramble Deluxe	2022-03-18	9	26	0	9	0.8146
Captain Cigarrr	2022-03-04	5	26	0	5	0.8146
Jigsaw Bestiary	2022-02-21	6	26	0	6	0.8146
Cupid Kiss	2022-07-22	4	26	0	4	0.8146
Kid Ball Adventure	2022-09-01	8	26	0	8	0.8146
Space Turbo 2	2022-05-24	4	26	0	4	0.8146
Astrocat: Skylar´s Memories	2022-06-17	5	26	0	5	0.8146
Lost Lands: Sand Captivity	2022-12-09	38	26	0	38	0.8146
Fabric Of Reality	2022-12-15	8	26	0	8	0.8146
Check it Out!	2022-04-29	70	389	56	126	0.8145
My Dream is a Lost Memory	2022-06-19	3	119	12	15	0.8145
Suhoshin	2022-04-14	29	91	8	37	0.8144
The Genesis Project	2022-04-13	615	806	131	746	0.8143000000000001
SEX with HITLER 2	2022-12-17	690	165	19	709	0.8143000000000001
Miss Kawaii	2022-09-19	20	98	9	29	0.8143000000000001
完美的一天 / A Perfect Day	2022-02-25	1732	1248	214	1946	0.8142
Everglow	2022-07-24	11	61	4	15	0.8142
沃姆斯传说：午夜新娘	2022-08-11	7	61	4	11	0.8142
Wolves on the Westwind	2022-05-25	38	53	3	41	0.8142
Lost2	2022-09-30	691	975	163	854	0.8139000000000001
Orbital Bullet	2022-03-21	131	398	58	189	0.8138
King Arthur: Knight's Tale	2022-04-26	5376	4005	761	6137	0.8137000000000001
Angry Putin	2022-05-08	6	138	15	21	0.8137000000000001
The Backrooms: Lost Tape	2022-12-24	79	385	56	135	0.8134
My First Femboy Date	2022-08-25	6	97	9	15	0.8134
Don't Shit On My #!$@& Roof	2022-09-27	94	97	9	103	0.8134
h8machine	2022-08-04	10	44	2	12	0.8133
Heat Death	2022-07-18	32	44	2	34	0.8133
MAGICAL DEATHPAIR	2022-01-11	7	44	2	9	0.8133
Hunt for Junk	2022-06-23	10	44	2	12	0.8133
骸心 Mainbody	2022-11-06	5	44	2	7	0.8133
Is Simon There?	2022-05-06	16	188	23	39	0.813
Wayward Strand	2022-09-15	16	60	4	20	0.813
Outshine	2022-11-03	10	35	1	11	0.813
Mega Knockdown	2022-07-29	7	35	1	8	0.813
Starless	2022-08-25	7	35	1	8	0.813
SiNKR 3	2022-08-25	7	35	1	8	0.813
Shadow of the Guild	2022-11-10	7	35	1	8	0.813
Axolotl is Dry	2022-04-25	9	35	1	10	0.813
Kraino Origins	2022-09-03	6	35	1	7	0.813
The Robot Girl Meets The Human!	2022-08-19	5	35	1	6	0.813
Soda Story - Brewing Tycoon	2022-07-21	109	52	3	112	0.8129000000000001
MORODASHI SUMO	2022-08-05	102	52	3	105	0.8129000000000001
地牢100	2022-11-25	2197	1040	177	2374	0.8128000000000001
CashGrab	2022-09-19	15	89	8	23	0.8125
Kevin's Path to Wizdom	2022-12-08	5	25	0	5	0.8125
Barold	2022-10-06	8	25	0	8	0.8125
S-IN	2022-04-14	4	25	0	4	0.8125
The Indigo Parallel	2022-11-24	7	25	0	7	0.8125
Nachkriegsratten Punk-Rock Puzzle	2022-06-01	3	25	0	3	0.8125
Candle Prick	2022-11-04	5	25	0	5	0.8125
Hot“Sento Girls”and love	2022-09-01	7	25	0	7	0.8125
Vactics	2022-06-22	4	25	0	4	0.8125
One Many Nobody	2022-10-11	5	25	0	5	0.8125
Board	2022-06-17	3	25	0	3	0.8125
Hermea	2022-08-01	5	25	0	5	0.8125
Interrogation Simulator	2022-10-31	4	25	0	4	0.8125
럭키 스태미나	2022-08-27	6	25	0	6	0.8125
Rocket Bot Royale	2022-04-20	394	527	82	476	0.8124
HITMAN 3	2022-01-20	9043	10555	2137	11180	0.8123
Sexy Mystic Survivors	2022-11-18	1551	872	146	1697	0.8123
藏梦	2022-08-22	11	67	5	16	0.8122
Pill Baby	2022-03-25	10	67	5	15	0.8122
Hello Lady! - Complete Edition	2022-01-21	181	229	30	211	0.8120999999999999
To Be A King - Volume 1	2022-09-30	134	109	11	145	0.8119
Latex Dungeon	2022-03-15	490	541	85	575	0.8118000000000001
连海CASINO	2022-09-30	30	74	6	36	0.8118000000000001
Touhou: Fading Illusion	2022-12-05	14	74	6	20	0.8118000000000001
Space Tail: Every Journey Leads Home	2022-11-03	52	59	4	56	0.8117000000000001
Blast Beat	2022-01-13	7	43	2	9	0.8117000000000001
Tomboy Adventure	2022-08-30	10	43	2	12	0.8117000000000001
Oh! Edo Towns	2022-09-05	40	43	2	42	0.8117000000000001
Democracy 4	2022-01-13	699	3657	703	1402	0.8116
STRIDE	2022-06-10	142	1737	315	457	0.8116
The Tenants	2022-10-20	4583	4715	922	5505	0.8115000000000001
Akai Katana Shin	2022-12-14	40	51	3	43	0.8114
净化之径	2022-10-11	9	51	3	12	0.8114
Forgotten Realms: The Archives - Collection One	2022-03-29	138	108	11	149	0.8111
Moo Lander	2022-05-27	8	34	1	9	0.8111
Super Mega Zero	2022-04-20	5	34	1	6	0.8111
Lords of Ravage - Сhapter 1	2022-09-08	22	34	1	23	0.8111
StickmanThug3D	2022-10-09	4	34	1	5	0.8111
Maid for Loving You	2022-12-31	21	34	1	22	0.8111
Q.U.B.E. 10th Anniversary	2022-09-14	29	66	5	34	0.8109999999999999
Adorable Witch 3	2022-05-07	153	410	62	215	0.8109000000000001
a pet shop after dark	2022-08-30	87	250	34	121	0.8109000000000001
Venture Towns	2022-05-23	84	101	10	94	0.8109000000000001
H-Isekai Loves	2022-02-11	897	1022	177	1074	0.8107
Intruder In Antiquonia	2022-07-08	19	73	6	25	0.8107
Sonority	2022-05-25	27	87	8	35	0.8106
RUMBLE	2022-09-23	227	1175	207	434	0.8105
Motocross: Chasing the Dream	2022-08-30	29	80	7	36	0.8105
College Craze	2022-08-03	24	80	7	31	0.8105
Memory Traces: japan	2022-08-10	18	58	4	22	0.8104000000000001
Miss Kawaii 2	2022-10-26	22	58	4	26	0.8104000000000001
All Ashes and Illusions	2022-08-03	5	24	0	5	0.8103
amazin' George 2	2022-01-24	2	24	0	2	0.8103
Runner Party	2022-12-22	12	24	0	12	0.8103
ASCIILL	2022-02-25	5	24	0	5	0.8103
NinjaThea	2022-08-23	6	24	0	6	0.8103
Hidden Shapes - Trick or Cats	2022-10-20	4	24	0	4	0.8103
Pocket Witch	2022-10-27	4	24	0	4	0.8103
Of Moons and Mania	2022-12-16	3	24	0	3	0.8103
Ghostwire: Tokyo	2022-03-24	14086	10231	2102	16188	0.8102
Project Lazarus	2022-06-23	752	893	153	905	0.8101
Tentacular	2022-03-24	20	50	3	23	0.81
Boys Tale	2022-02-11	9	50	3	12	0.81
Shores of Loci	2022-05-24	5	50	3	8	0.81
The Ditty of Carmeana	2022-04-16	10	42	2	12	0.81
Entangled	2022-07-07	9	42	2	11	0.81
Starcom: Unknown Space	2022-12-14	419	224	30	449	0.8099
1428: Shadows over Silesia	2022-10-04	62	113	12	74	0.8098000000000001
Dr. Chatelet: Faith 神医	2022-11-30	36	65	5	41	0.8098000000000001
Remnant Records	2022-07-19	133	253	35	168	0.8097
IT Simulator	2022-06-01	12	86	8	20	0.8096
The Backrooms 1998 - Found Footage Backroom Survival Horror Game	2022-05-25	60	529	85	145	0.8092
PogoChamp	2022-05-26	8	33	1	9	0.8092
Togges	2022-12-07	8	33	1	9	0.8092
Tear Factory	2022-10-03	2	33	1	3	0.8092
Hole in the Clouds	2022-08-26	6	33	1	7	0.8092
Pentagons Go WEEE	2022-03-31	6	33	1	7	0.8092
Thrill Penguin	2022-06-29	6	33	1	7	0.8092
Reimus Awesome Holiday	2022-10-06	6	33	1	7	0.8092
Bughouse	2022-07-14	9	112	12	21	0.809
Pirates: Golden tits chapter 1	2022-09-29	29	57	4	33	0.809
Dwarven Realms	2022-12-16	157	222	30	187	0.8089000000000001
Persona 4 Arena Ultimax	2022-03-17	7099	2281	434	7533	0.8087000000000001
Coffee Shop Tycoon	2022-12-19	113	456	72	185	0.8086
HunterX	2022-04-29	141	352	53	194	0.8086
Project R4T	2022-12-16	12	105	11	23	0.8086
Hands of Necromancy	2022-06-20	12	85	8	20	0.8085
Air Traffic: Greenlight	2022-02-04	18	64	5	23	0.8085
Mister Furry	2022-12-16	36	318	47	83	0.8084
剑与桃花	2022-07-22	7	49	3	10	0.8084
Asian Truck Simulator	2022-09-09	7	49	3	10	0.8084
Blood Wizard Odyssey	2022-12-12	9	49	3	12	0.8084
クレヨンしんちゃん「オラと博士の夏休み」～おわらない七日間の旅～	2022-08-31	139	155	19	158	0.8083
girl agent	2022-03-29	7	41	2	9	0.8083
Super Lone Survivor	2022-10-31	15	41	2	17	0.8083
Exodemic	2022-07-08	28	41	2	30	0.8083
Wolfenstein: Enemy Territory	2022-04-26	577	1244	225	802	0.8081999999999999
Garden Simulator	2022-09-08	269	167	21	290	0.8081999999999999
Witchy Life Story	2022-09-30	270	311	46	316	0.8079000000000001
Armored Lab Force VULVEHICLES	2022-08-25	10	23	0	10	0.8079000000000001
AV-Racer	2022-05-20	3	23	0	3	0.8079000000000001
Sokolor	2022-06-17	4	23	0	4	0.8079000000000001
Pitstop in Purgatory	2022-10-14	4	23	0	4	0.8079000000000001
Super Choppy Orc	2022-11-16	12	23	0	12	0.8079000000000001
SIC-1	2022-12-02	10	23	0	10	0.8079000000000001
Freedom Drive	2022-10-28	3	23	0	3	0.8079000000000001
Sapiens	2022-07-26	1826	1180	213	2039	0.8078000000000001
FPS Game: Dev Test	2022-02-26	353	917	161	514	0.8078000000000001
PAC-MAN MUSEUM+	2022-05-26	93	231	32	125	0.8077
Between Two Worlds	2022-08-12	135	148	18	153	0.8077
Buggos	2022-03-17	257	425	67	324	0.8076000000000001
Ghostlore	2022-04-14	108	172	22	130	0.8076000000000001
I See Red	2022-10-24	13	56	4	17	0.8076000000000001
Grocket	2022-09-09	103	56	4	107	0.8076000000000001
Movie Quest	2022-12-17	29	56	4	33	0.8076000000000001
Rule No. 2	2022-08-26	6	56	4	10	0.8076000000000001
SCP: Labrat	2022-12-25	567	1936	367	934	0.8075
Wavetale	2022-12-12	57	123	14	71	0.8075
F-Rank hero story	2022-01-05	4	63	5	9	0.8073
Richman: Classic	2022-07-28	95	63	5	100	0.8073
EON Fighter	2022-11-22	28	63	5	33	0.8073
HeatStroke	2022-12-16	17	70	6	23	0.8072
Midnight Legends	2022-01-06	9	32	1	10	0.8072
Big Earth	2022-06-23	4	32	1	5	0.8072
subROV	2022-12-02	7	32	1	8	0.8072
Trapper: Drug Dealing RPG	2022-04-28	10	32	1	11	0.8072
Vespa's Test	2022-08-03	6	32	1	7	0.8072
Mushroom Card RPG	2022-10-04	25	32	1	26	0.8072
E.E.R.I.E2	2022-11-05	34	224	31	65	0.8070999999999999
Ballex²: The Hanging Gardens	2022-07-15	27	48	3	30	0.8069
The Immaculate Drag	2022-01-17	3	48	3	6	0.8069
Deflector: Specimen One	2022-03-31	28	48	3	31	0.8069
Revita	2022-04-21	2112	1364	252	2364	0.8068000000000001
Pocket League Story	2022-08-08	243	90	9	252	0.8068000000000001
Warriors of the Nile 2	2022-08-24	2199	684	117	2316	0.8067000000000001
Panic Porcupine	2022-10-27	7	40	2	9	0.8066
烛光迷局 Candlelight	2022-05-13	10	40	2	12	0.8066
Phobies	2022-03-08	197	537	89	286	0.8064
Tame It!	2022-03-18	284	367	57	341	0.8064
Anglerfish	2022-11-10	24	152	19	43	0.8063
Coin Flipper	2022-10-03	256	96	10	266	0.8063
This Means Warp	2022-03-17	253	239	34	287	0.8062
A Memoir Blue	2022-03-24	22	222	31	53	0.8062
Witch Schools: Love Potions	2022-09-19	9	55	4	13	0.8062
Boba Simulator	2022-12-01	31	69	6	37	0.8059999999999999
Bound By Blades	2022-11-15	25	62	5	30	0.8059000000000001
Grisaia Phantom Trigger Vol.8	2022-02-25	121	62	5	126	0.8059000000000001
Emi - New Beginning	2022-11-08	22	62	5	27	0.8059000000000001
米可可大冒險	2022-11-08	111	127	15	126	0.8058
Vestige	2022-01-22	38	89	9	47	0.8058
Mad Streets	2022-03-15	59	157	20	79	0.8057
Touhou Ibunseki - Ayaria Dawn: ReCreation	2022-04-01	486	1231	228	714	0.8054000000000001
PlayForm: Human Dynamics	2022-07-27	23	82	8	31	0.8054000000000001
IZBOT 2	2022-03-10	4	22	0	4	0.8054000000000001
Project Absentia	2022-07-29	6	22	0	6	0.8054000000000001
Unknown Number: A First Person Talker	2022-09-21	6	22	0	6	0.8054000000000001
Super Nano Blaster	2022-05-03	5	22	0	5	0.8054000000000001
Invisible Places - Pixel Art Jigsaw Puzzle	2022-01-24	2	22	0	2	0.8054000000000001
Riley & Rochelle	2022-10-18	6	22	0	6	0.8054000000000001
Rotund Zero	2022-04-21	4	22	0	4	0.8054000000000001
Tales of Autumn	2022-04-30	4	22	0	4	0.8054000000000001
Duks	2022-07-02	5	22	0	5	0.8054000000000001
Invercity	2022-11-09	24	22	0	24	0.8054000000000001
幻覚	2022-07-30	33	22	0	33	0.8054000000000001
EXECUTE DADDY	2022-11-30	4	22	0	4	0.8054000000000001
ALIEN XENOBLASTER	2022-08-23	6	22	0	6	0.8054000000000001
Stereo Boy	2022-08-09	5	22	0	5	0.8054000000000001
Temple of Horror	2022-10-26	6	22	0	6	0.8054000000000001
Seaberry Keep	2022-11-11	2	22	0	2	0.8054000000000001
Saint Kotar: The Crawling Man	2022-12-02	3	22	0	3	0.8054000000000001
Seaberry Holiday	2022-12-07	4	22	0	4	0.8054000000000001
Catizens	2022-08-17	93	180	24	117	0.8053
Zorbus	2022-09-14	68	114	13	81	0.8053
Mosaic Chronicles	2022-09-29	11	47	3	14	0.8053
Frail Hearts: Versicorae Domlion	2022-08-16	15	47	3	18	0.8053
Operation STEEL	2022-01-27	10	47	3	13	0.8053
Mind Diver	2022-06-22	7	47	3	10	0.8053
Scurvy Dogs	2022-11-01	24	47	3	27	0.8053
Bunny Girl Story	2022-04-22	11	120	14	25	0.8052
SKULL CHAINZ	2022-10-31	10	31	1	11	0.8051
I Am a Rock	2022-02-18	3	31	1	4	0.8051
PAIN	2022-06-17	9	31	1	10	0.8051
η κλοπή του ΚΡΑΣΙΟΥ	2022-01-21	3	31	1	4	0.8051
Rally: Endless Conquest	2022-08-19	38	31	1	39	0.8051
Traumada	2022-08-12	4	31	1	5	0.8051
学園スイーツ発見 ～双目（ざらめ）のドーナツ編～	2022-05-10	4	31	1	5	0.8051
Adventures of Quin85	2022-07-29	72	31	1	73	0.8051
Valkyrie of Phantasm	2022-10-22	277	373	59	336	0.805
The Shadow Government Simulator: Prologue	2022-09-07	109	138	17	126	0.805
B.I.O.T.A.	2022-04-12	51	132	16	67	0.805
Kamifuda	2022-09-13	23	75	7	30	0.805
尘埃见闻录	2022-01-11	21	88	9	30	0.8048000000000001
Commando Hero	2022-12-16	20	39	2	22	0.8048000000000001
Elven Assassin	2022-09-14	426	519	87	513	0.8047
Overhaul	2022-10-14	22	68	6	28	0.8047
Desktop Jumpscares	2022-07-31	11	68	6	17	0.8047
Land of Screens	2022-02-04	6	54	4	10	0.8047
Noun Town	2022-12-15	17	61	5	22	0.8046
Morendo	2022-11-21	6	119	14	20	0.8044
Foxhole	2022-09-28	11791	24649	5462	17253	0.8043000000000001
Catch Me If You Can	2022-10-28	46	81	8	54	0.8043000000000001
The Kids We Were	2022-01-13	43	81	8	51	0.8043000000000001
MILF HUNTER	2022-04-01	11	81	8	19	0.8043000000000001
Gloomgrave	2022-07-11	33	100	11	44	0.804
枝江第一舞斗会	2022-07-25	65	189	26	91	0.8039000000000001
Hellfire Tactics	2022-11-10	121	142	18	139	0.8036
Kolhii ChampionsAU	2022-08-25	37	46	3	40	0.8036
Eira	2022-08-04	24	46	3	27	0.8036
Yars: Recharged	2022-08-23	11	46	3	14	0.8036
人类动物园 Human Zoo	2022-10-27	9	46	3	12	0.8036
Chivalry 2	2022-06-12	16959	19926	4416	21375	0.8034
花园魔三国 蜀汉篇 -The Sacrificial Girl of the Fantasy 3 Kingdoms- SHU	2022-02-25	144	171	23	167	0.8034
Like No Other: The Legend Of The Twin Books	2022-08-25	8	60	5	13	0.8031999999999999
Photogenic Minds : Identity	2022-09-29	53	60	5	58	0.8031999999999999
Renai Royale	2022-09-30	133	60	5	138	0.8031999999999999
Stillwater	2022-09-07	5	53	4	9	0.8031999999999999
BBQ Simulator: The Squad	2022-05-25	152	669	118	270	0.8031
Autonauts vs Piratebots	2022-07-28	763	276	42	805	0.8031
RC Rush	2022-01-28	6	30	1	7	0.8029999999999999
Path of Ra	2022-12-05	12	30	1	13	0.8029999999999999
False Skies	2022-11-30	11	30	1	12	0.8029999999999999
Scoop Kick!	2022-02-11	6	30	1	7	0.8029999999999999
Sokobalien	2022-08-01	9	30	1	10	0.8029999999999999
World Cruise Story	2022-10-31	32	30	1	33	0.8029999999999999
東方蒼神縁起V -The genius of sappheiros-	2022-10-31	45	30	1	46	0.8029999999999999
hololive ERROR	2022-09-16	171	324	51	222	0.8029000000000001
寂夜微光 - A Flicker of Light	2022-03-09	10	105	12	22	0.8029000000000001
Palallel	2022-05-27	16	38	2	18	0.8029000000000001
Tough Law	2022-01-20	5	38	2	7	0.8029000000000001
Shadow Heroes	2022-10-11	11	38	2	13	0.8029000000000001
Die Känguru-Verschwörung	2022-12-25	11	38	2	13	0.8029000000000001
The Elder Scrolls: Arena	2022-04-26	299	1124	211	510	0.8028000000000001
Wanderer	2022-01-27	141	587	102	243	0.8028000000000001
Robotry!	2022-10-26	5	21	0	5	0.8028000000000001
Lost Sunday Comics	2022-03-04	2	21	0	2	0.8028000000000001
MerFight	2022-03-31	16	21	0	16	0.8028000000000001
Wonderputt Forever	2022-12-02	6	21	0	6	0.8028000000000001
Chefy-Chef	2022-05-06	4	21	0	4	0.8028000000000001
IKUSAAAAAAAN!	2022-02-26	6	21	0	6	0.8028000000000001
The Battle Never Ends	2022-03-04	2	21	0	2	0.8028000000000001
Dogs Cyberpuzzle	2022-06-17	3	21	0	3	0.8028000000000001
I commissioned some bees 4	2022-07-28	6	21	0	6	0.8028000000000001
Tux and Fanny	2022-09-08	4	21	0	4	0.8028000000000001
 Elf World Adventure: Part 1	2022-03-15	70	264	40	110	0.8026000000000001
Ghost Trap	2022-07-26	39	73	7	46	0.8026000000000001
Nordic Ashes	2022-12-15	2978	1368	263	3241	0.8022
Kawaii Hentai Girls 3	2022-08-19	17	66	6	23	0.8020999999999999
Cyrah's Ascent	2022-06-04	31	180	25	56	0.802
Paint Warfare	2022-03-06	54	598	105	159	0.8019
Cyanotype Daydream -The Girl Who Dreamed the World-	2022-02-09	206	321	51	257	0.8019
Into the Nightmare	2022-12-03	330	110	13	343	0.8019
Little Inner Monsters	2022-06-20	13	45	3	16	0.8019
The Princess of the Tower Wants a Hero	2022-12-06	8	45	3	11	0.8019
Project Beril / 贝丽尔养成计划	2022-10-28	28	59	5	33	0.8018000000000001
On the Wings - Birth of a Hero	2022-09-08	3	59	5	8	0.8018000000000001
The Eternal Cylinder	2022-10-13	277	310	49	326	0.8017000000000001
Kovox Pitch	2022-01-17	16	52	4	20	0.8017000000000001
兽设格斗前传：上	2022-03-31	7	52	4	11	0.8017000000000001
Convenient	2022-09-23	12	52	4	16	0.8017000000000001
Summoners War: Chronicles	2022-11-10	38641	5927	1266	39907	0.8016
IMMORTALITY	2022-08-30	399	833	153	552	0.8016
The Gunk	2022-04-29	165	414	69	234	0.8016
Madshot	2022-06-09	68	103	12	80	0.8011
Isekai Succubus ~My Genderbent Saga in Another World~	2022-01-15	77	109	13	90	0.8009999999999999
Cardfight!! Vanguard Dear Days	2022-11-16	1587	593	105	1692	0.8009000000000001
Totemlands	2022-05-02	6	37	2	8	0.8009000000000001
Valor	2022-11-03	6	37	2	8	0.8009000000000001
Raspberry Cube	2022-11-04	19	37	2	21	0.8009000000000001
Pinku Kult Hex Mortis	2022-05-31	9	29	1	10	0.8007
Chroma Chronicles	2022-06-08	17	29	1	18	0.8007
Video Game Fables	2022-07-15	8	29	1	9	0.8007
Roxy Raccoon's Pinball Panic	2022-03-15	4	29	1	5	0.8007
I commissioned some bees 3	2022-07-12	8	29	1	9	0.8007
The Resurrection Of Amelia : Across two worlds	2022-09-30	8	29	1	9	0.8007
King Of Water	2022-11-05	5	29	1	6	0.8007
SokoFrog	2022-12-15	6	29	1	7	0.8007
Flower girl 2	2022-07-21	393	1557	307	700	0.8006000000000001
BLACKTAIL	2022-12-15	516	684	124	640	0.8004000000000001
Krai. Digital-poetry vol. 1	2022-01-17	17	126	16	33	0.8004000000000001
Stranded Nightmare	2022-10-19	9	58	5	14	0.8004000000000001
Half-Earth Socialism	2022-07-19	168	450	77	245	0.8003
Battle Bands	2022-03-17	108	120	15	123	0.8003
Hot Spring Hero	2022-04-09	201	114	14	215	0.8002
Archmage Ricka	2022-11-04	60	96	11	71	0.8002
Illuminaria	2022-08-04	13	44	3	16	0.8002
Eschaton	2022-11-03	4	44	3	7	0.8002
Pocket Clothier	2022-07-25	32	44	3	35	0.8002
Miss Kobayashi's Dragon Maid	2022-10-26	15	44	3	18	0.8002
Bengan Yes	2022-12-28	108	44	3	111	0.8002
少女的求生之路	2022-07-26	16	102	12	28	0.8001
黎明为歌 - Melody before the Dawn	2022-03-12	13	51	4	17	0.8001
The Mensional	2022-04-21	64	51	4	68	0.8001
Void Prison	2022-05-19	8	51	4	12	0.8001
Terra Invicta	2022-09-26	9826	3405	714	10540	0.8
Journey to the West	2022-03-10	819	692	126	945	0.8
Nevergrind Online	2022-06-09	1184	474	82	1266	0.8
Cheese Runner	2022-07-14	5	20	0	5	0.8
Get Your Sheep Together	2022-04-02	3	20	0	3	0.8
Lucky Fish Bread	2022-02-10	6	20	0	6	0.8
Deadland 4000	2022-10-07	11	20	0	11	0.8
Satan's Puzzle 2	2022-05-04	3	20	0	3	0.8
THE DREADFUL SPACE	2022-04-30	4	20	0	4	0.8
Herald of Havoc	2022-12-21	4	20	0	4	0.8
Updog	2022-07-19	4	20	0	4	0.8
Philosophical Jigsaw - The Zen Koans	2022-06-01	3	20	0	3	0.8
明日、初めて彼女と❤	2022-08-11	21	20	0	21	0.8
Moorhuhn X - Crazy Chicken X	2022-10-08	9	20	0	9	0.8
Cube Farmer	2022-08-26	4	20	0	4	0.8
Garbanzo Quest	2022-09-16	4	20	0	4	0.8
RunBean Galactic	2022-09-13	3	20	0	3	0.8
Kind Heart Defenders	2022-12-21	5	20	0	5	0.8
Cats and Sokoban - Mimi's Scratcher	2022-12-16	4	20	0	4	0.8
Tiny Tactics	2022-08-05	1468	468	81	1549	0.7997
Sunday Gold	2022-10-13	193	346	57	250	0.7997
Asterigos: Curse of the Stars	2022-10-11	1672	1513	300	1972	0.7996
11号小镇综合症	2022-07-10	13	64	6	19	0.7995000000000001
Little Witch Nobeta	2022-09-29	3707	8717	1929	5636	0.7993000000000001
互联网原住民Internet Generation	2022-10-20	1070	966	184	1254	0.7993000000000001
Almost Home Now	2022-05-26	26	491	86	112	0.7992
South of the Circle	2022-08-03	123	593	107	230	0.7989
Japanese Rail Sim: Journey to Kyoto	2022-06-22	11	70	7	18	0.7989
Super Galaxy Ball	2022-10-24	35	70	7	42	0.7989
UnHappy Place	2022-08-27	10	57	5	15	0.7989
武林鸡侠传	2022-12-23	59	36	2	61	0.7989
Penny for Your Thoughts	2022-03-01	5	36	2	7	0.7989
Colors! Platform	2022-07-22	11	36	2	13	0.7989
Daigaku Gurashi	2022-09-01	20	36	2	22	0.7989
Rogue Tower	2022-01-28	4318	3656	777	5095	0.7988
Escape Memoirs: Mansion Heist	2022-06-16	60	158	22	82	0.7988
The Passenger	2022-12-29	99	76	8	107	0.7985
Touken Ranbu Warriors	2022-05-24	94	112	14	108	0.7984
Orgynizer	2022-10-12	11	50	4	15	0.7984
Archtower	2022-09-30	21	50	4	25	0.7984
True Idle Simulator	2022-09-16	26	50	4	30	0.7984
GOR3	2022-12-01	7	106	13	20	0.7983
Lunar Axe	2022-07-11	17	82	9	26	0.7983
Attack at Dawn: North Africa	2022-06-07	26	43	3	29	0.7983
Naval Hurricane	2022-11-16	15	43	3	18	0.7983
Map Of Materials	2022-03-11	10	43	3	13	0.7983
TitTok 3	2022-10-10	6	43	3	9	0.7983
SOWON	2022-10-28	10	43	3	13	0.7983
Hentai Sexy Nurses	2022-10-15	9	43	3	12	0.7983
For a Vast Future	2022-11-01	8	28	1	9	0.7983
DR4X	2022-01-15	3	28	1	4	0.7983
Bee: The Knight	2022-06-11	8	28	1	9	0.7983
Moon Dancer	2022-01-14	8	28	1	9	0.7983
Aery - Calm Mind 2	2022-03-29	7	28	1	8	0.7983
SEARCH ALL - CACTUSES	2022-03-01	3	28	1	4	0.7983
Meowtopia: Expedition	2022-05-24	7	28	1	8	0.7983
Closer To Home	2022-10-20	4	28	1	5	0.7983
Land of the Vikings	2022-11-08	1134	806	152	1286	0.7981
Lighthouse Keeper	2022-08-23	71	238	37	108	0.7981
魂之起源 God Souls	2022-12-02	15	63	6	21	0.7981
建筑吧公司	2022-04-27	187	232	36	223	0.7978000000000001
Frogun	2022-08-02	123	258	41	164	0.7977
GOODBYE WORLD	2022-11-16	112	450	79	191	0.7976000000000001
Forest Camp Story	2022-11-28	112	69	7	119	0.7976000000000001
Beach Invasion 1944	2022-12-02	196	420	73	269	0.7975
WW2 Rebuilder: Germany Prologue	2022-07-26	360	309	51	411	0.7975
Dodge It! 2	2022-01-28	21	145	20	41	0.7975
Cheese Game	2022-05-30	24	172	25	49	0.7972
A Musical Story	2022-03-04	25	139	19	44	0.7972
Poop Clicker	2022-03-26	2011	313	52	2063	0.7970999999999999
赠予神家与谎言	2022-08-26	22	87	10	32	0.7970999999999999
Mini Matches	2022-03-21	7	19	0	7	0.7970999999999999
Learn Japanese RPG: Hiragana Forbidden Speech	2022-10-21	5	19	0	5	0.7970999999999999
Bistro Days	2022-02-25	8	19	0	8	0.7970999999999999
Portal Mortal	2022-04-01	13	19	0	13	0.7970999999999999
Cheaphaven	2022-07-22	5	19	0	5	0.7970999999999999
On Your Hands	2022-04-16	7	19	0	7	0.7970999999999999
One by One	2022-08-15	11	19	0	11	0.7970999999999999
Constellations: Puzzles in the Sky	2022-05-25	4	19	0	4	0.7970999999999999
Garbage Pail Kids: Mad Mike and the Quest for Stale Gum	2022-10-25	11	19	0	11	0.7970999999999999
Pillars of Light	2022-09-29	4	19	0	4	0.7970999999999999
Dragon Caffi	2022-04-21	5	19	0	5	0.7970999999999999
Endless Bullet Heaven	2022-05-10	4	19	0	4	0.7970999999999999
Loop	2022-07-04	3	19	0	3	0.7970999999999999
I commissioned some bees 5	2022-08-18	8	19	0	8	0.7970999999999999
The Asafo Journey	2022-10-14	2	19	0	2	0.7970999999999999
The Shadow Over Route 80	2022-11-23	4	19	0	4	0.7970999999999999
Dune: Spice Wars	2022-04-26	8397	5943	1315	9712	0.7968999999999999
The Cabin - Summer Vacation	2022-09-21	49	49	4	53	0.7968000000000001
One Line: Letters and Codes	2022-03-10	3	35	2	5	0.7968000000000001
MewMew - PewPew	2022-05-21	7	35	2	9	0.7968000000000001
Furry Sex - GameDev Story 🎮	2022-10-05	28	35	2	30	0.7968000000000001
i love me, i love me not	2022-10-22	3	35	2	5	0.7968000000000001
Mechs V Kaijus	2022-02-17	197	367	63	260	0.7966
Demolish & Build 3: Excavator Playground	2022-08-19	54	110	14	68	0.7966
Not Tonight 2	2022-02-11	172	203	31	203	0.7965000000000001
Maptroid: Worlds	2022-12-12	29	42	3	32	0.7965000000000001
Deathsmiles I・II	2022-06-22	31	42	3	34	0.7965000000000001
The Underground Man 2	2022-09-29	108	104	13	121	0.7964
THE KING OF FIGHTERS XV	2022-02-17	8226	4707	1035	9261	0.7961
Crypto Miner Tycoon Simulator	2022-04-21	62	86	10	72	0.7959999999999999
Entity Researchers: Prologue	2022-08-19	149	74	8	157	0.7959999999999999
Nayuta no Kiseki: KAI	2022-05-25	75	55	5	80	0.7958
Harvest Hero Origins	2022-02-08	5	27	1	6	0.7958
Hats Are Not Allowed	2022-04-22	3	27	1	4	0.7958
Blacken Slash	2022-07-22	10	27	1	11	0.7958
Shadow Fate	2022-04-05	6	27	1	7	0.7958
Eden's Last Sunrise	2022-12-02	18	27	1	19	0.7958
Trigger Witch	2022-05-27	13	27	1	14	0.7958
Twin Edge	2022-06-27	8	27	1	9	0.7958
Murder Is Game Over	2022-10-25	3	27	1	4	0.7958
Seven Deadly Dates	2022-07-08	13	27	1	14	0.7958
Race to Kyiv	2022-05-12	3	27	1	4	0.7958
Escape: The Endless Dogwatch	2022-08-24	5	27	1	6	0.7958
Morris Cave	2022-09-02	6	27	1	7	0.7958
This is Hell	2022-11-01	28	27	1	29	0.7958
甜點王子2	2022-05-31	236	109	14	250	0.7957
Disaster Band	2022-12-20	150	294	49	199	0.7956000000000001
LAY	2022-06-21	56	258	42	98	0.7954000000000001
Heroine Anthem Zero 2	2022-02-22	197	519	95	292	0.7953
Impasto	2022-11-03	25	131	18	43	0.7953
Peglin	2022-04-25	3764	6253	1404	5168	0.7952
집착의 망자 - 집으로부터의 탈출	2022-05-20	37	61	6	43	0.7952
TRAIL OUT	2022-09-07	496	1562	322	818	0.7951
Beautiful Mystic Defenders	2022-01-06	208	322	55	263	0.7948000000000001
Please Fix The Road	2022-06-10	68	163	24	92	0.7948000000000001
Catgirls From My Sweet Dream	2022-12-07	54	85	10	64	0.7948000000000001
World of Contraptions	2022-03-24	56	73	8	64	0.7948000000000001
精神病大王花	2022-02-14	43	152	22	65	0.7947
Yag	2022-03-26	14	34	2	16	0.7946
Velocity Noodle	2022-01-21	5	34	2	7	0.7946
残世界的鸢尾花	2022-11-14	9	34	2	11	0.7946
A Jornada de Vanildo	2022-05-09	4	34	2	6	0.7946
Raisond'etre	2022-04-26	8	34	2	10	0.7946
ISOLATE	2022-03-08	5	34	2	7	0.7946
Curley Laboratory	2022-04-19	10	34	2	12	0.7946
My Trainer is a Futanari	2022-07-17	6	34	2	8	0.7946
Survive Till Morning	2022-11-29	12	34	2	14	0.7946
Pathmaster	2022-10-23	8	41	3	11	0.7945000000000001
Prop and Seek	2022-11-19	984	3622	795	1779	0.7944
Pacifish	2022-06-07	1916	438	79	1995	0.7943000000000001
Spirits of Baciu - Prologue	2022-11-10	19	96	12	31	0.7942
Friendsim 2	2022-04-13	53	54	5	58	0.7942
The Hotel	2022-11-17	9	54	5	14	0.7942
Lost Marbles	2022-11-18	5	18	0	5	0.7939
Elevenses: The Flask	2022-11-28	4	18	0	4	0.7939
Corpse Box Racers	2022-12-20	5	18	0	5	0.7939
Moondrop	2022-08-12	7	18	0	7	0.7939
Spaceship for Newbies	2022-05-13	4	18	0	4	0.7939
Cat Powered UFO	2022-05-04	4	18	0	4	0.7939
Cassiodora	2022-12-15	6	18	0	6	0.7939
Teamkill	2022-02-17	12	18	0	12	0.7939
The Sink Gods	2022-02-11	3	18	0	3	0.7939
Zoo Seeker	2022-01-27	6	18	0	6	0.7939
Ancient Islands	2022-10-26	6	18	0	6	0.7939
Synchronizacja	2022-01-21	5	18	0	5	0.7939
Gelatine	2022-09-30	3	18	0	3	0.7939
Di-Da-Dobble	2022-02-16	4	18	0	4	0.7939
Pretty Girls Speed	2022-02-25	3	18	0	3	0.7939
MeteoHeroes	2022-02-28	12	18	0	12	0.7939
Boom Bears on Stream	2022-02-11	7	18	0	7	0.7939
Golden Rails: Road To Klondike	2022-02-24	25	18	0	25	0.7939
Barry of Wrath	2022-03-04	5	18	0	5	0.7939
Chico and the Magic Orchards	2022-08-08	4	18	0	4	0.7939
Terra Flame	2022-11-17	8	18	0	8	0.7939
Melon Dusk	2022-04-15	2	18	0	2	0.7939
Pogo Stick Miooooooon	2022-04-15	8	18	0	8	0.7939
The Last Tater	2022-05-19	12	18	0	12	0.7939
Jishogi	2022-06-23	3	18	0	3	0.7939
Death's Playground	2022-10-25	8	18	0	8	0.7939
Nonozle	2022-08-12	8	18	0	8	0.7939
Mech Shuffle	2022-07-29	4	18	0	4	0.7939
Kiss the Demiurge	2022-12-02	5	18	0	5	0.7939
Unscramble Heroes	2022-10-02	29	18	0	29	0.7939
Early Worm	2022-11-10	2	18	0	2	0.7939
Prehistoric Kingdom	2022-04-27	2520	1488	309	2829	0.7937000000000001
Citizens: Far Lands	2022-07-15	75	84	10	85	0.7937000000000001
Zenith MMO	2022-01-27	4629	3003	656	5285	0.7936
Turbo Sliders Unlimited	2022-04-27	80	66	7	87	0.7935
Moonstuck	2022-04-14	27	123	17	44	0.7931999999999999
Notes From Province	2022-08-13	25	47	4	29	0.7931999999999999
Gravity Ace	2022-05-26	4	26	1	5	0.7931999999999999
Kukoos - Lost Pets	2022-12-06	6	26	1	7	0.7931999999999999
Otteretto	2022-01-29	7	26	1	8	0.7931999999999999
Boat Crew	2022-08-01	7	26	1	8	0.7931999999999999
Snowyland	2022-01-14	2	26	1	3	0.7931999999999999
Siege of Treboulain	2022-04-14	35	26	1	36	0.7931999999999999
Notebook Entries Vol. 1	2022-11-11	3	26	1	4	0.7931999999999999
All the Words She Wrote	2022-03-08	8	26	1	9	0.7931999999999999
Gravitar: Recharged	2022-06-02	5	26	1	6	0.7931999999999999
Through the Kill Screen	2022-04-20	8	26	1	9	0.7931999999999999
Mr.Brocco & Co	2022-09-10	11	26	1	12	0.7931999999999999
Crystal Winter	2022-12-17	108	26	1	109	0.7931999999999999
Christmas Luge	2022-12-23	4	26	1	5	0.7931999999999999
Hentai Christmas	2022-12-24	8	26	1	9	0.7931999999999999
SCP: 5K - Alpha Testing	2022-02-22	497	2946	645	1142	0.7931
Bean Stalker	2022-06-06	28	171	26	54	0.7931
Last Days of Lazarus	2022-06-22	20	89	11	31	0.7928000000000001
FLERP	2022-09-09	252	242	40	292	0.7927
Immortal Tactics: War of the Eternals	2022-07-15	28	83	10	38	0.7925
To Make a Game	2022-02-12	3	53	5	8	0.7925
Kitty May Cry	2022-11-14	34	53	5	39	0.7925
Riftbound	2022-05-12	30	40	3	33	0.7925
Rasetsu Fumaden	2022-08-13	19	40	3	22	0.7925
Bad Faith	2022-02-04	8	40	3	11	0.7925
INCUR Survival	2022-12-13	37	40	3	40	0.7925
No Place Like Home	2022-03-17	1344	2540	554	1898	0.7924
Pocket Stables	2022-09-26	231	77	9	240	0.7923
风色幻想6:冒险奏鸣	2022-08-09	82	77	9	91	0.7923
ZOR: Pilgrimage of the Slorfs	2022-08-30	33	33	2	35	0.7923
Move 78	2022-08-03	6	33	2	8	0.7923
DnD Adventure: Wizard's Choice	2022-06-15	9	33	2	11	0.7923
Outside the Window	2022-09-15	6	33	2	8	0.7923
How To Bathe Your Cat: Impossible Mission	2022-01-20	5	33	2	7	0.7923
Chronescher	2022-08-31	8	33	2	10	0.7923
The Chaput's Baby	2022-09-26	4	33	2	6	0.7923
Fit Puzzle Blocks	2022-09-20	5	33	2	7	0.7923
Tile Town	2022-10-13	8	33	2	10	0.7923
Warlocks Quarry	2022-08-31	15	59	6	21	0.7922
The Trench	2022-10-12	4	65	7	11	0.7920999999999999
No More Heroes 3	2022-10-11	241	290	50	291	0.7919
Aquarist	2022-03-08	146	362	65	211	0.7917000000000001
Hyperbolica	2022-03-14	591	848	170	761	0.7916
NEON STRUCT: Desperation Column	2022-01-20	7	46	4	11	0.7914
Dolmenjord - Viking Islands	2022-11-17	12	46	4	16	0.7914
Roll Player	2022-05-20	26	46	4	30	0.7914
轮回修仙路	2022-12-02	1851	921	187	2038	0.7911
Buriedbornes - Dungeon RPG	2022-12-14	993	585	113	1106	0.7909999999999999
Annie and the Art Gallery	2022-04-12	19	115	16	35	0.7909999999999999
The Manga Works	2022-07-25	272	115	16	288	0.7909999999999999
体育館の天井に挟まったマッチョを助けるゲーム	2022-06-28	27	76	9	36	0.7909999999999999
Crush the Castle Legacy Collection	2022-03-29	28	70	8	36	0.7908
Last Night of Winter	2022-08-09	11	52	5	16	0.7908
Mechanibot	2022-08-31	21	52	5	26	0.7908
Countess in Crimson	2022-05-18	214	277	48	262	0.7906000000000001
ARRIVAL: ZERO EARTH	2022-10-11	54	64	7	61	0.7906000000000001
Heliotropism	2022-03-24	20	64	7	27	0.7906000000000001
Bad Cat	2022-03-02	11	64	7	18	0.7906000000000001
Infinite Stars - The Visual Novel	2022-09-29	31	58	6	37	0.7906000000000001
Jester`s Theater Museum	2022-06-10	30	58	6	36	0.7906000000000001
Witch 3 Return	2022-10-06	56	58	6	62	0.7906000000000001
Mary Skelter 2	2022-01-13	47	87	11	58	0.7905
Nyanco Impact	2022-11-11	12	87	11	23	0.7905
Lux Ex	2022-06-17	3	17	0	3	0.7905
Donut Arena	2022-03-18	6	17	0	6	0.7905
Elearning Development Intern	2022-11-30	6	17	0	6	0.7905
Gastova: The Witches of Arkana	2022-12-07	7	17	0	7	0.7905
SUPER UFO FIGHTER	2022-07-13	27	17	0	27	0.7905
Afterthought	2022-08-01	4	17	0	4	0.7905
Hapland Trilogy	2022-12-14	14	17	0	14	0.7905
Pale Night	2022-06-20	7	17	0	7	0.7905
Reflection	2022-09-29	3	17	0	3	0.7905
Dorfs	2022-06-21	7	17	0	7	0.7905
MACE: Mapinguari's Temple	2022-04-29	16	17	0	16	0.7905
Space Ballers	2022-08-01	3	17	0	3	0.7905
Heroes of Book & Paper	2022-05-18	3	17	0	3	0.7905
Wilderplace	2022-09-09	5	17	0	5	0.7905
Hellfire 1988: An Oregon Story	2022-05-11	4	17	0	4	0.7905
The Adventures of Mr. Hat	2022-02-25	7	17	0	7	0.7905
Num One: Revised Edition	2022-03-02	6	17	0	6	0.7905
Pow! 2	2022-03-07	3	17	0	3	0.7905
Nightfall Comes	2022-04-22	5	17	0	5	0.7905
Bash The Party	2022-07-22	2	17	0	2	0.7905
INTRAQUARTZ	2022-07-19	2	17	0	2	0.7905
风墓战记	2022-05-16	4	17	0	4	0.7905
Lamoneo	2022-05-25	2	17	0	2	0.7905
Aery - Vikings	2022-07-22	9	17	0	9	0.7905
Blaze in Space: Beat a-maze	2022-10-18	7	17	0	7	0.7905
City Limits	2022-08-05	4	17	0	4	0.7905
Yukar From The Abyss	2022-11-14	5	17	0	5	0.7905
Buy Hyacinths	2022-08-30	4	17	0	4	0.7905
The Fantastic Kitty Rue	2022-12-16	2	17	0	2	0.7905
Card Cowboy	2022-10-04	4	17	0	4	0.7905
Masarada Town Story	2022-11-09	5	17	0	5	0.7905
Oakenfold	2022-11-17	7	39	3	10	0.7904000000000001
Dr. Kobushi's Labyrinthine Laboratory	2022-09-15	8	39	3	11	0.7904000000000001
Lila's Tale and The Hidden Forest	2022-11-10	6	25	1	7	0.7904000000000001
Brendan Keogh's Putting Challenge	2022-02-25	8	25	1	9	0.7904000000000001
BOX RUSH 2: Ice worlds	2022-05-18	5	25	1	6	0.7904000000000001
BDSM Apocalypse	2022-05-30	8	25	1	9	0.7904000000000001
Woodlock Manor	2022-07-31	7	25	1	8	0.7904000000000001
Project Gunship	2022-08-31	24	247	42	66	0.7903
The Heart of Darkness	2022-04-16	342	197	32	374	0.7902
Cat Saves Halloween	2022-10-13	11	32	2	13	0.7898999999999999
No Cat Fights Here	2022-04-29	7	32	2	9	0.7898999999999999
CORPSE FACTORY	2022-05-31	120	347	63	183	0.7898000000000001
One More Gate: A Wakfu Legend	2022-10-11	554	171	27	581	0.7897
Police Response VR Disturbance	2022-04-06	6	75	9	15	0.7897
Predecessor	2022-12-01	7339	4306	989	8328	0.7895000000000001
Deliver Us From Evil	2022-03-02	10	45	4	14	0.7895000000000001
Yerr Out	2022-10-17	29	45	4	33	0.7895000000000001
Sentimental K	2022-01-18	116	279	49	165	0.7894
Drill Deal - Oil Tycoon	2022-03-09	128	97	13	141	0.7893000000000001
Asphalt 9: Legends	2022-08-02	999	3351	761	1760	0.7892
*NEW* SCUFFED BHOP SIMULATION 2026 GOTY EDITION	2022-03-25	53	160	25	78	0.7892
Teenage Mutant Ninja Turtles: The Cowabunga Collection	2022-08-30	379	406	76	455	0.7891
Watcher Chronicles	2022-01-19	37	113	16	53	0.7891
Fairyside	2022-11-01	26	63	7	33	0.7891
Barro GT	2022-05-19	24	123	18	42	0.7886
OkIPullUp	2022-12-12	22	123	18	40	0.7886
Construction Simulator	2022-09-20	17365	4551	1056	18421	0.7885
Hellstuck: Rage With Your Friends	2022-05-27	77	107	15	92	0.7885
Nympho's Path	2022-07-15	40	107	15	55	0.7885
Kao the Kangaroo	2022-05-27	404	482	93	497	0.7883
Cosmos Bit	2022-03-11	5	38	3	8	0.7883
Arclight Beat	2022-05-26	25	38	3	28	0.7883
4X4	2022-10-05	16	38	3	19	0.7883
Paragon Pioneers	2022-09-29	51	38	3	54	0.7883
Drift King	2022-07-28	31	133	20	51	0.7881999999999999
Extra Case: My Girlfriend's Secrets	2022-09-12	11	85	11	22	0.7881999999999999
Nine Noir Lives	2022-09-07	22	68	8	30	0.788
Voor de kroon	2022-12-09	17	68	8	25	0.788
Love, Money, Rock'n'Roll	2022-08-04	4153	4464	1039	5192	0.7879
Electrician Simulator - First Shock	2022-01-06	566	1393	301	867	0.7879
停留此刻 Stay in the moment	2022-06-03	13	117	17	30	0.7879
Floppy Knights	2022-05-24	143	183	30	173	0.7877
Deepening Fire	2022-11-29	204	251	44	248	0.7876000000000001
Three Kingdoms : Hero	2022-04-01	47	79	10	57	0.7876000000000001
Cracking the Cryptic	2022-08-01	96	79	10	106	0.7876000000000001
La Pucelle: Ragnarok	2022-08-30	71	44	4	75	0.7875
Boo Party	2022-10-24	14	24	1	15	0.7875
Wavecade	2022-07-10	4	24	1	5	0.7875
DRAWER	2022-01-27	6	24	1	7	0.7875
Ryzer: The Reflectors Path	2022-01-20	5	24	1	6	0.7875
GRADUATER	2022-04-05	7	24	1	8	0.7875
PopSlinger	2022-04-14	4	24	1	5	0.7875
Madville+	2022-08-23	7	24	1	8	0.7875
Animal Trail ☆ Girlish Square	2022-08-12	9	24	1	10	0.7875
 Castle of Full Moon 月圆之堡	2022-08-27	4	24	1	5	0.7875
Intergalactic Taxi Co.	2022-05-31	4	24	1	5	0.7875
Walking In The Abyss	2022-10-17	2	24	1	3	0.7875
Dusk Diver 2	2022-01-14	35	56	6	41	0.7874
Cubes and Knights	2022-05-04	8	56	6	14	0.7874
Zemblanity	2022-04-03	8	56	6	14	0.7874
Ultimate Protector	2022-09-27	8	56	6	14	0.7874
Swordbreaker: Origins	2022-05-13	13	31	2	15	0.7874
Mini Maker: Make A Thing	2022-06-28	10	31	2	12	0.7874
CAT Interstellar: Recast	2022-02-04	6	31	2	8	0.7874
Faded Stories: Greenberg	2022-06-18	10	31	2	12	0.7874
A Butterfly's Dream	2022-04-04	4	31	2	6	0.7874
GoBangTetris	2022-03-06	18	31	2	20	0.7874
Demon Go!	2022-09-08	5	31	2	7	0.7874
PIEN-ぴえん- & PAON-ぱおん- plus	2022-12-06	14	31	2	16	0.7874
Adorable Witch 4 ：Lust	2022-09-08	78	312	57	135	0.7873000000000001
Unsouled	2022-04-27	37	202	34	71	0.7873000000000001
Nevermore: The Chamber Door	2022-06-15	5	50	5	10	0.7873000000000001
Light	2022-10-19	20	50	5	25	0.7873000000000001
Abort, Retry, Fail	2022-05-17	5	50	5	10	0.7873000000000001
Noelle Does Her Best!	2022-08-13	384	255	45	429	0.7872
异世界无厘头生活2	2022-04-22	50	142	22	72	0.7872
Goat's Tale	2022-01-17	248	269	48	296	0.7870999999999999
Luckitown	2022-01-19	66	157	25	91	0.7870999999999999
Sakura Succubus 5	2022-04-04	27	73	9	36	0.7870999999999999
Crystal Clash	2022-01-14	1163	911	191	1354	0.787
Your Love Story 被你忘记的那个夏天	2022-08-19	10	116	17	27	0.787
Nightmare Hunter	2022-08-20	102	84	11	113	0.787
Neptunia x SENRAN KAGURA: Ninja Wars	2022-05-11	595	660	134	729	0.7869
Tenko's Magical Sword Quest	2022-06-22	3	16	0	3	0.7869
AlCHeMoS	2022-02-15	5	16	0	5	0.7869
AST-Hero	2022-09-20	5	16	0	5	0.7869
ReThink 4	2022-11-01	12	16	0	12	0.7869
CIPHER 61	2022-01-06	5	16	0	5	0.7869
Rolling Gunner	2022-12-21	6	16	0	6	0.7869
A Walk With My Dog	2022-10-28	4	16	0	4	0.7869
Unwell Known	2022-05-26	6	16	0	6	0.7869
Blow & Fly	2022-05-03	2	16	0	2	0.7869
A Day of Maintenance	2022-04-22	4	16	0	4	0.7869
Dashpong	2022-10-28	5	16	0	5	0.7869
The Alchemist Shop: An Apprentice's Life	2022-08-23	4	16	0	4	0.7869
Sand: A Superfluous Game	2022-09-29	7	16	0	7	0.7869
Laboratory	2022-01-24	4	16	0	4	0.7869
Buggy Game	2022-03-09	4	16	0	4	0.7869
Stairway to Heaven's Gate	2022-01-21	8	16	0	8	0.7869
Gav-Gav Odyssey	2022-01-26	3	16	0	3	0.7869
Astrogon	2022-09-30	6	16	0	6	0.7869
Reimei no Gakuen - Otome/Visual Novel	2022-02-11	13	16	0	13	0.7869
Cleaning The System	2022-08-30	9	16	0	9	0.7869
B-RAIN	2022-03-01	3	16	0	3	0.7869
毛玉大冒险 ~ Kedama's Adventure	2022-08-23	6	16	0	6	0.7869
散落之瓣：華 - Falling Petals: Bloom Edition	2022-07-02	8	16	0	8	0.7869
YUMMY CHICKEN DRAGON	2022-04-20	3	16	0	3	0.7869
The Secret Life of Dorian Pink (Prologue)	2022-05-14	2	16	0	2	0.7869
MeiQi:Story	2022-05-13	19	16	0	19	0.7869
Music Man	2022-06-16	3	16	0	3	0.7869
Light Them Up	2022-07-15	6	16	0	6	0.7869
Epic Astro Story	2022-10-11	30	16	0	30	0.7869
焰色方糖 flamed sugar	2022-07-20	3	16	0	3	0.7869
TrainFormation	2022-08-19	4	16	0	4	0.7869
Dawn of Kagura: Maika's Story - The Dragon's Wrath	2022-09-30	5	16	0	5	0.7869
Lonely White	2022-08-26	8	16	0	8	0.7869
The Travel Game	2022-09-01	9	16	0	9	0.7869
Hidden Shapes - Cat Realm	2022-11-16	5	16	0	5	0.7869
Flawless	2022-10-06	4	16	0	4	0.7869
Routemania	2022-11-01	6	16	0	6	0.7869
Strip n Play with Valerie	2022-10-15	9	16	0	9	0.7869
Seventh Star	2022-12-24	5	16	0	5	0.7869
Born Punk	2022-06-18	40	100	14	54	0.7868
Dreamland	2022-10-31	222	755	156	378	0.7865000000000001
The Ice Caves	2022-04-11	15	136	21	36	0.7865000000000001
Bananner Nababber	2022-08-13	11	67	8	19	0.7865000000000001
祖玛少女	2022-05-01	239	487	96	335	0.7861
Last Slice	2022-04-20	19	61	7	26	0.7861
Hell Division	2022-06-03	199	61	7	206	0.7861
The Pointless Car Chase: Refueled	2022-02-22	6	37	3	9	0.7859999999999999
Blast Off Far Away	2022-07-23	11	37	3	14	0.7859999999999999
Chevalier Historie	2022-02-26	415	257	46	461	0.7859
Zombie Cure Lab	2022-12-07	412	185	31	443	0.7859
Crowns and Pawns: Kingdom of Deceit	2022-05-06	125	252	45	170	0.7858
东方远空界 ~ Ultimate Vitality of Imagination	2022-02-07	95	55	6	101	0.7857
Bass Monkey	2022-06-02	10	55	6	16	0.7857
Salome's Kiss	2022-04-26	12	55	6	18	0.7857
My Coworker Is An Idiot	2022-12-08	8	55	6	14	0.7857
AdventureQuest 3D	2022-10-28	2098	6609	1592	3690	0.7856000000000001
Pro Cycling Manager 2022	2022-06-09	3263	449	88	3351	0.7855
Arcane Vale	2022-12-16	65	104	15	80	0.7855
Camp Focus	2022-01-26	13	49	5	18	0.7855
Warplan Pacific	2022-03-17	15	49	5	20	0.7855
PolyCore Defense	2022-07-21	27	43	4	31	0.7855
Platonic	2022-05-13	17	43	4	21	0.7855
TAISHO x ALICE: HEADS & TAILS	2022-07-27	52	43	4	56	0.7855
面具古墓	2022-10-31	33	43	4	37	0.7855
Plunder Panic	2022-09-16	678	462	91	769	0.7854000000000001
DREAMWILD	2022-10-31	12	88	12	24	0.7853
Memoirs of a Battle Brothel	2022-09-30	146	114	17	163	0.7851
Raifu Wars	2022-02-22	18	66	8	26	0.7851
苍白花树繁茂之时Blood Flowers	2022-11-03	16	66	8	24	0.7851
Game Dev Masters	2022-06-03	25	119	18	43	0.785
REPLIKATOR	2022-05-11	37	77	10	47	0.785
Hot Hentai	2022-07-08	10	93	13	23	0.7848999999999999
Parallel	2022-10-06	5	30	2	7	0.7848
Catellite-609: feline space adventure	2022-07-27	7	30	2	9	0.7848
Dead End Aegis	2022-01-14	7	30	2	9	0.7848
Loplight	2022-07-18	4	30	2	6	0.7848
Chromosome Evil	2022-03-24	107	212	37	144	0.7847
Dream House Days DX	2022-03-28	87	183	31	118	0.7846
One More Dungeon 2	2022-09-19	44	98	14	58	0.7846
Beltex	2022-07-08	74	98	14	88	0.7846
红月	2022-10-15	36	60	7	43	0.7845000000000001
Ghost on the Shore	2022-02-24	23	103	15	38	0.7844
Running Fable	2022-11-04	6	23	1	7	0.7844
A Way To Die	2022-05-13	4	23	1	5	0.7844
The Pentest	2022-12-16	7	23	1	8	0.7844
Dungeon Lad	2022-03-31	6	23	1	7	0.7844
Traction Control	2022-03-28	6	23	1	7	0.7844
Timeline	2022-04-22	8	23	1	9	0.7844
Project Xenoflora	2022-02-17	5	23	1	6	0.7844
SEARCH ALL - RUNES	2022-02-22	3	23	1	4	0.7844
Polar Penguin Post	2022-11-30	16	23	1	17	0.7844
Neko Loop	2022-12-23	5	23	1	6	0.7844
ColorCube	2022-07-14	3	23	1	4	0.7844
S.E.C.U.	2022-11-02	3	23	1	4	0.7844
NekoNecro	2022-10-31	7	23	1	8	0.7844
Cats in Heat	2022-08-25	7	23	1	8	0.7844
Ship of Fools	2022-11-22	2324	1615	363	2687	0.7843000000000001
Out of the Park Baseball 23	2022-04-22	1855	773	163	2018	0.7843000000000001
You Suck at Parking	2022-09-14	110	168	28	138	0.7843000000000001
Time Lock VR 2	2022-07-13	12	71	9	21	0.7843000000000001
Young Souls	2022-03-10	261	350	67	328	0.7842
Super Bullet Break	2022-08-12	226	230	41	267	0.7842
The Jackbox Party Pack 9	2022-10-20	2337	386	75	2412	0.7841
SCP: Vacation	2022-03-03	9	113	17	26	0.7841
Smilemo	2022-05-19	83	435	86	169	0.784
Shadow Racer	2022-05-19	46	138	22	68	0.784
Daggan	2022-05-30	29	54	6	35	0.784
Otoko Cross: Pretty Boys Klondike Solitaire	2022-07-14	10	54	6	16	0.784
Prison Life	2022-09-23	786	1474	330	1116	0.7839
FurryFury	2022-04-14	1029	1118	245	1274	0.7837999999999999
WARNO	2022-01-20	2113	4104	980	3093	0.7837000000000001
MuseSwipr	2022-12-21	69	196	34	103	0.7837000000000001
Lullaby days	2022-01-28	22	76	10	32	0.7837000000000001
Santhai	2022-01-13	106	76	10	116	0.7837000000000001
Cupid Story: First Date	2022-01-07	8	36	3	11	0.7837000000000001
第一千零二夜的童话	2022-01-25	6	36	3	9	0.7837000000000001
Playable Mockup	2022-05-25	50	48	5	55	0.7836
My Truck Game	2022-02-07	20	152	25	45	0.7834000000000001
In Nightmare	2022-11-29	15	42	4	19	0.7834000000000001
隐秘的原罪8	2022-07-29	33	42	4	37	0.7834000000000001
みなも流し	2022-09-09	12	42	4	16	0.7834000000000001
Isolated Room	2022-12-16	8	42	4	12	0.7834000000000001
Another Farm Roguelike	2022-11-30	147	200	35	182	0.7833
Sketch Crawler	2022-11-14	55	147	24	79	0.7833
Quatro!	2022-11-14	70	112	17	87	0.7831999999999999
MMX: Otherworld Mystery - Expanded Edition	2022-11-09	8	15	0	8	0.783
Edengrall	2022-01-07	4	15	0	4	0.783
Uncle Nook's Monster Emporium	2022-04-28	2	15	0	2	0.783
Squish	2022-06-28	15	15	0	15	0.783
Totally Convenient	2022-03-04	1	15	0	1	0.783
Stolen Crown	2022-10-13	6	15	0	6	0.783
Hype Prototype	2022-10-31	4	15	0	4	0.783
Cheftastic!: Buffet Blast	2022-02-03	9	15	0	9	0.783
Threaded	2022-02-10	6	15	0	6	0.783
Saffron Fields	2022-03-03	4	15	0	4	0.783
TEN	2022-06-03	6	15	0	6	0.783
A Maze Fox	2022-01-21	3	15	0	3	0.783
Naughty Waifu	2022-02-17	3	15	0	3	0.783
Headland	2022-07-26	6	15	0	6	0.783
Spinning Maze	2022-01-20	3	15	0	3	0.783
Dark Flame	2022-01-20	9	15	0	9	0.783
Slayer	2022-06-01	10	15	0	10	0.783
Slidetracked	2022-03-19	5	15	0	5	0.783
Jigsaw Souls	2022-02-11	3	15	0	3	0.783
Amelite	2022-03-25	13	15	0	13	0.783
Mathletix	2022-02-07	3	15	0	3	0.783
ShapeGrid	2022-04-04	4	15	0	4	0.783
Guns N Stuff 2	2022-07-12	19	15	0	19	0.783
Winter With You	2022-01-31	3	15	0	3	0.783
13 Steps	2022-10-18	4	15	0	4	0.783
Koni: The Secrets of Castle	2022-03-09	3	15	0	3	0.783
Space Piercer	2022-03-07	3	15	0	3	0.783
Raven	2022-05-29	3	15	0	3	0.783
Boxel Golf	2022-08-01	6	15	0	6	0.783
We See You	2022-08-19	3	15	0	3	0.783
Tomorrow for Mar	2022-05-31	2	15	0	2	0.783
Is It You?	2022-11-08	17	15	0	17	0.783
Square Journey	2022-06-01	3	15	0	3	0.783
GUTTER: The Cursed	2022-10-21	3	15	0	3	0.783
Keep it Cool, Man	2022-07-28	4	15	0	4	0.783
Paper Flight - Speed Rush	2022-11-11	9	15	0	9	0.783
Space Rescue	2022-06-20	3	15	0	3	0.783
Fanatic Zeal	2022-06-24	3	15	0	3	0.783
DracoFighter	2022-07-07	5	15	0	5	0.783
Sokorun: one box	2022-08-05	3	15	0	3	0.783
Keyboard Warrior: Dreamstate	2022-07-23	2	15	0	2	0.783
Puzzline	2022-11-04	86	15	0	86	0.783
Planet Surfer	2022-12-14	3	15	0	3	0.783
Drakkon World Builder	2022-09-01	4	15	0	4	0.783
The Villager and the Werewolf - A jigsaw puzzle tale	2022-10-26	4	15	0	4	0.783
The Heart of the Teddy Bear	2022-12-06	3	15	0	3	0.783
与魔共舞	2022-12-15	9	15	0	9	0.783
Hell Runner	2022-12-08	4	15	0	4	0.783
Antioch : Scarlet Bay	2022-11-25	83	151	25	108	0.7826000000000001
Digimon Survive	2022-07-28	6179	2014	466	6645	0.7824
Zodiac fantasy 2	2022-11-24	95	111	17	112	0.7822
MH-Zombie	2022-03-28	6	53	6	12	0.7822
Locked Up	2022-03-31	7	53	6	13	0.7822
Moon Runner	2022-10-21	20	160	27	47	0.7820999999999999
SEARCH ALL - CHRISTMAS	2022-01-10	5	29	2	7	0.7820999999999999
SEARCH ALL - MUSHROOMS	2022-03-01	3	29	2	5	0.7820999999999999
Winter tramp	2022-05-24	4	29	2	6	0.7820999999999999
The Lord of Isekai Brothels	2022-10-20	39	29	2	41	0.7820999999999999
Craft Hero	2022-10-10	349	281	53	402	0.782
Space Wreck	2022-12-05	50	64	8	58	0.782
Pompom	2022-03-14	23	64	8	31	0.782
Yummy Girl 2	2022-04-08	8	64	8	16	0.782
_keyboardkommander	2022-12-21	20	80	11	31	0.7819
SEARCH ALL - CATS	2022-02-09	4	80	11	15	0.7819
MECH PUNK	2022-11-24	7	47	5	12	0.7816
Symbiotic	2022-05-16	40	130	21	61	0.7814
Cursed	2022-02-18	10	69	9	19	0.7814
A Mage Reborn	2022-08-04	61	69	9	70	0.7814
Inua	2022-02-10	10	35	3	13	0.7813
Franchise Hockey Manager 9	2022-11-08	253	110	17	270	0.7812000000000001
DEEP 8	2022-06-17	3	22	1	4	0.7811
OverShoot Battle Race	2022-04-14	6	22	1	7	0.7811
Camellia Train	2022-05-13	7	22	1	8	0.7811
Quest Of Graal	2022-02-04	7	22	1	8	0.7811
Icemaze Cave: Skate Escape	2022-05-18	7	22	1	8	0.7811
Tower of Spirit	2022-07-12	4	22	1	5	0.7811
Cold Land	2022-05-26	3	22	1	4	0.7811
Hop Step Sing! VR Live Hop☆Summer 2nd	2022-08-02	7	22	1	8	0.7811
A Most Extraordinary Gnome	2022-12-08	5	22	1	6	0.7811
Chacara	2022-10-19	5	22	1	6	0.7811
Hentai Pussy 5	2022-12-09	2	22	1	3	0.7811
rote²(RoteSquare)	2022-04-03	10	74	10	20	0.7809
Angry Angry Shark	2022-01-02	250	219	40	290	0.7808
Monster Hunter Rise: Sunbreak Demo	2022-06-15	27540	849	186	27726	0.7807
WorldMaker	2022-09-02	20	79	11	31	0.7806000000000001
Milk Bottle And Monster Girl 2	2022-04-05	56	214	39	95	0.7805
Station Manager	2022-03-28	107	153	26	133	0.7804000000000001
名酱三国	2022-12-02	44	84	12	56	0.7804000000000001
Decisive Campaigns: Ardennes Offensive	2022-02-10	33	63	8	41	0.7804000000000001
Dying Light 2	2022-02-04	274983	101975	27328	302311	0.7803
バレットフィリア達の闇市場　〜 100th Black Market.	2022-08-14	1660	383	77	1737	0.7801
缄默咖啡厅	2022-10-15	22	99	15	37	0.7801
Strategic Command: American Civil War	2022-07-14	214	94	14	228	0.7801
VAIL	2022-11-17	256	845	186	442	0.78
Oblivity	2022-03-24	1064	791	173	1237	0.78
Devil's Dungeon	2022-02-04	108	208	38	146	0.7797000000000001
Unconventional Warfare	2022-04-21	13	46	5	18	0.7796
99 Fails Lite	2022-06-15	13	46	5	18	0.7796
魔塔三国之群雄争霸	2022-06-24	48	46	5	53	0.7796
Idle Spiral	2022-04-30	2214	838	185	2399	0.7795000000000001
Indoorlands	2022-10-14	74	147	25	99	0.7795000000000001
Deadburg	2022-03-15	19	73	10	29	0.7795000000000001
Glitchhikers: The Spaces Between	2022-03-31	12	73	10	22	0.7795000000000001
Guardener	2022-06-21	33	73	10	43	0.7795000000000001
Bound by Love	2022-01-08	531	394	80	611	0.7794
Heat and Run	2022-10-13	14	28	2	16	0.7792
Dungeons of Voidria	2022-07-28	15	28	2	17	0.7792
Instinct War	2022-12-15	6	28	2	8	0.7792
Takkoman -Kouzatsu World-	2022-05-02	7	28	2	9	0.7792
Killer Worm 2	2022-01-18	2	28	2	4	0.7792
URUBU	2022-04-25	10	28	2	12	0.7792
BLOCKED ZONA	2022-05-18	4	28	2	6	0.7792
Atama	2022-10-13	12	28	2	14	0.7792
Mutagenic	2022-08-09	14	28	2	16	0.7792
惡魔調酒師	2022-07-12	316	252	48	364	0.779
Buccaneers!	2022-03-07	138	225	42	180	0.779
Martha Is Dead	2022-02-24	750	1863	440	1190	0.7789
Shatterline	2022-09-08	21760	20153	5272	27032	0.7787999999999999
Immortal Life	2022-04-28	2952	1719	404	3356	0.7787999999999999
Divinia Chronicles: Relics of Gan-Ti	2022-09-18	96	62	8	104	0.7787999999999999
Ninja JaJaMaru: The Great Yokai Battle + Hell	2022-05-11	17	34	3	20	0.7787999999999999
6-Mon Adventure	2022-06-10	6	34	3	9	0.7787999999999999
俠之道(PathOfWuxia)	2022-11-15	16175	23204	6096	22271	0.7787000000000001
Nummels	2022-06-21	4	14	0	4	0.7787000000000001
In Retrospect	2022-09-07	3	14	0	3	0.7787000000000001
Sky Squadron	2022-12-14	4	14	0	4	0.7787000000000001
Muslim 3D	2022-02-21	4	14	0	4	0.7787000000000001
Shell Out Showdown	2022-04-04	7	14	0	7	0.7787000000000001
Urban Mage	2022-03-08	2	14	0	2	0.7787000000000001
Toaster Defense	2022-05-23	3	14	0	3	0.7787000000000001
Tokyo Rogue	2022-07-15	4	14	0	4	0.7787000000000001
The Chronos Principle	2022-03-02	3	14	0	3	0.7787000000000001
Mini Golf Worlds VR	2022-01-11	4	14	0	4	0.7787000000000001
Bugged Dungeon	2022-02-22	5	14	0	5	0.7787000000000001
Move Dodge and Kill	2022-01-27	2	14	0	2	0.7787000000000001
GASERB	2022-01-28	4	14	0	4	0.7787000000000001
怪盗ミューのシークレットプリマ	2022-10-13	3	14	0	3	0.7787000000000001
回家 - Homeward	2022-02-23	2	14	0	2	0.7787000000000001
Halloween is Crazy as Hell	2022-05-11	5	14	0	5	0.7787000000000001
Tales From The Under-Realm: After Midnight	2022-10-07	13	14	0	13	0.7787000000000001
SGS Pacific D-Day	2022-04-28	7	14	0	7	0.7787000000000001
Blood Bay: Card History	2022-12-14	2	14	0	2	0.7787000000000001
Sad Ghouls	2022-03-18	4	14	0	4	0.7787000000000001
Wormhole	2022-03-30	4	14	0	4	0.7787000000000001
Brothers	2022-03-11	4	14	0	4	0.7787000000000001
Furry Hentai Quest	2022-03-07	4	14	0	4	0.7787000000000001
Dragons On Desktop	2022-03-04	4	14	0	4	0.7787000000000001
SNOT	2022-04-01	3	14	0	3	0.7787000000000001
Spider Slingers	2022-08-12	10	14	0	10	0.7787000000000001
Ambulance Emergency Simulation	2022-04-25	4	14	0	4	0.7787000000000001
Alkali	2022-11-10	4	14	0	4	0.7787000000000001
Seasons	2022-11-11	2	14	0	2	0.7787000000000001
梦境魔法意志	2022-08-17	3	14	0	3	0.7787000000000001
Life is Paradise	2022-06-08	11	14	0	11	0.7787000000000001
Before the explosion	2022-07-11	2	14	0	2	0.7787000000000001
Meteorites 3D	2022-12-16	6	14	0	6	0.7787000000000001
Jack Big Chin: Alien Invasion	2022-09-29	4	14	0	4	0.7787000000000001
Oh Sheep!	2022-10-14	6	14	0	6	0.7787000000000001
Radial Flow	2022-08-01	6	14	0	6	0.7787000000000001
MeMoMi	2022-11-21	2	14	0	2	0.7787000000000001
TAMAKAGURA: Tales of Turmoil	2022-08-26	5	14	0	5	0.7787000000000001
The Perfect Garden	2022-08-16	2	14	0	2	0.7787000000000001
阴桃花	2022-12-01	2	14	0	2	0.7787000000000001
Bunny Eureka	2022-10-20	3	14	0	3	0.7787000000000001
Pixelmancer	2022-10-14	3	14	0	3	0.7787000000000001
Cards with Personalities	2022-11-18	4	14	0	4	0.7787000000000001
Sands of Slumber: The RPG	2022-11-23	7	14	0	7	0.7787000000000001
Spartacus: Born to be free	2022-11-20	3	14	0	3	0.7787000000000001
Rootless: Memories Of Green	2022-12-12	4	14	0	4	0.7787000000000001
Arcanium	2022-09-22	316	528	112	428	0.7786
Cygnus	2022-12-16	119	197	36	155	0.7786
Adventure in My Head	2022-03-10	7	174	31	38	0.7786
Freud's Bones-the game	2022-05-25	21	51	6	27	0.7785
Blank Frame	2022-01-28	10	51	6	16	0.7785
Maid PizzaHub	2022-05-20	6	51	6	12	0.7785
Sweety kitty	2022-10-10	7	51	6	13	0.7785
Wheel of Innocence	2022-10-24	11	51	6	17	0.7785
Crafty Survivors - Prologue	2022-11-17	124	51	6	130	0.7785
Queen's Wish 2: The Tormentor	2022-08-24	128	67	9	137	0.7784000000000001
Kibbi Keeper	2022-03-04	55	136	23	78	0.7782
Wandering in space VR	2022-06-30	14	136	23	37	0.7782
DON'T LOOK AWAY	2022-10-16	28	112	18	46	0.7782
DeadPoly	2022-01-12	1067	3143	770	1837	0.7781
Electrician Simulator	2022-09-21	998	968	219	1217	0.7781
CARNAGE OFFERING	2022-04-29	6	150	26	32	0.7781
MATH EXPRESSions	2022-04-21	32	131	22	54	0.778
The Imperial Gatekeeper	2022-09-03	1115	828	185	1300	0.7779
Project Vostok	2022-07-19	12	77	11	23	0.7779
Furry Cyberfucker II	2022-07-23	682	92	14	696	0.7778
Fore Score	2022-07-12	7	21	1	8	0.7777
Contract Killer	2022-05-19	5	21	1	6	0.7777
Scholar of the Arcane Arts	2022-12-15	6	21	1	7	0.7777
Aeternum Vale	2022-10-05	4	21	1	5	0.7777
Skyscraper Jump	2022-05-13	4	21	1	5	0.7777
Dwarfenstein	2022-05-13	4	21	1	5	0.7777
Delta Manifold	2022-08-22	5	21	1	6	0.7777
SEARCH ALL - BIRDS	2022-06-11	3	21	1	4	0.7777
The Stone Cutter and the Mountain Spirit	2022-11-15	3	21	1	4	0.7777
Train Operator 377	2022-12-02	7	21	1	8	0.7777
Chess Royale	2022-11-16	9	21	1	10	0.7777
Project Playtime	2022-12-12	21105	20020	5277	26382	0.7776000000000001
Recursive Ruin	2022-05-18	31	140	24	55	0.7776000000000001
SEARCH ALL - BERRIES	2022-02-25	6	45	5	11	0.7775
Forgotten Hill Tales	2022-04-27	42	45	5	47	0.7775
Trash Horror Collection 2	2022-09-20	7	45	5	12	0.7775
American Theft 80s: Prologue	2022-03-08	617	557	120	737	0.7774
Ultimechs	2022-09-15	39	116	19	58	0.7774
Demeo - PC Edition	2022-12-15	345	489	104	449	0.7772
First Date : Late To Date	2022-08-19	49	383	79	128	0.7772
Attacker-chan!	2022-08-09	26	61	8	34	0.7772
First Snow	2022-12-10	18	61	8	26	0.7772
Thy Creature	2022-11-15	43	106	17	60	0.777
Sniper Elite 5	2022-05-26	14870	8114	2089	16959	0.7769
灵途	2022-01-20	71	125	21	92	0.7769
The Book of Warriors	2022-09-24	70	153	27	97	0.7768
妖刀退魔忍	2022-09-16	57	139	24	81	0.7768
Anomalous	2022-01-11	11	66	9	20	0.7768
Realms of Magic	2022-07-20	773	641	141	914	0.7767000000000001
Space Block Buster	2022-09-05	10	39	4	14	0.7767000000000001
Heck Deck	2022-01-11	10	39	4	14	0.7767000000000001
Furry Love & Sex	2022-10-22	36	39	4	40	0.7767000000000001
Nazi Furry	2022-05-21	647	120	20	667	0.7766
怪物狩猎：序章	2022-12-15	27	81	12	39	0.7765000000000001
AGNI	2022-10-03	61	50	6	67	0.7765000000000001
Project Downfall	2022-12-01	22	264	52	74	0.7762000000000001
Out of Bounds	2022-12-16	4	33	3	7	0.7762000000000001
茶叶蛋大冒险	2022-06-14	48	33	3	51	0.7762000000000001
PewPew Live	2022-09-10	10	33	3	13	0.7762000000000001
Torii	2022-11-17	7	27	2	9	0.7762000000000001
Teabat!	2022-03-03	10	27	2	12	0.7762000000000001
Yumeiri	2022-03-02	10	27	2	12	0.7762000000000001
Skylost	2022-05-30	7	27	2	9	0.7762000000000001
Live Maze	2022-08-31	11	27	2	13	0.7762000000000001
Hentai Nurse	2022-11-26	5	27	2	7	0.7762000000000001
Meteor Volleyball!	2022-01-07	36	124	21	57	0.7759
Touhou Library Survivors	2022-10-14	22	55	7	29	0.7759
KAMIMAHOU	2022-01-28	49	285	57	106	0.7758
大侠请重来	2022-06-14	955	2203	538	1493	0.7757
Train Sim World® 3	2022-09-06	1796	1849	447	2243	0.7756000000000001
Warlords Under Siege	2022-12-02	264	219	42	306	0.7756000000000001
恋来い温泉物語VR	2022-10-11	40	95	15	55	0.7755
Kynseed	2022-12-06	2304	1870	453	2757	0.7754000000000001
Rise Of The White Sun	2022-09-26	16	44	5	21	0.7754000000000001
Entity Researchers	2022-03-02	42	44	5	47	0.7754000000000001
Shoot Trip Die	2022-05-06	9	44	5	14	0.7754000000000001
My Doctor is a Futanari	2022-02-25	5	44	5	10	0.7754000000000001
Battlerace	2022-06-28	10	44	5	15	0.7754000000000001
Doomed to Hell	2022-03-25	18	128	22	40	0.7753
Ultra Age	2022-04-27	68	196	37	105	0.7752
Serial Cleaners	2022-09-22	132	151	27	159	0.7752
Aviator: Air Combat	2022-11-23	5	85	13	18	0.7752
Northend Tower Defense	2022-03-08	215	560	123	338	0.7751000000000001
Dread X Collection 5	2022-05-20	128	169	31	159	0.7751000000000001
Monster Girl Dormitory	2022-08-19	18	137	24	42	0.7751000000000001
Splat Cat	2022-06-18	12	75	11	23	0.7751000000000001
Nurose	2022-01-07	15	70	10	25	0.7751000000000001
Fencing Girl	2022-01-12	8	70	10	18	0.7751000000000001
索罗灵魂之戒	2022-03-18	37	123	21	58	0.775
Power to the People	2022-02-08	342	283	57	399	0.7748999999999999
SEX with HITLER	2022-01-22	2001	1967	480	2481	0.7748
Stellar Monarch 2	2022-10-03	29	49	6	35	0.7745000000000001
Nude In The Castle	2022-06-11	3	49	6	9	0.7745000000000001
TRIANGLE STRATEGY	2022-10-13	2489	1133	267	2756	0.7744
Castle of secrets: Prologue	2022-11-18	142	230	45	187	0.7744
Within Skerry	2022-02-08	26	159	29	55	0.7744
TrinityS	2022-04-28	269	113	19	288	0.7744
Apotheorasis	2022-05-12	3	38	4	7	0.7743000000000001
Lost Alone Ep.2 - Paparino	2022-05-15	6	38	4	10	0.7743000000000001
Return to the Skyway	2022-09-03	11	38	4	15	0.7743000000000001
Mobmania	2022-08-18	126	190	36	162	0.7742
HoneySelect2Libido DX	2022-06-03	491	686	155	646	0.7741
YYDS成神之路	2022-09-25	3	13	0	3	0.7741
sfäre	2022-01-11	4	13	0	4	0.7741
The Star Legation	2022-02-04	4	13	0	4	0.7741
Midnight Manor	2022-10-01	3	13	0	3	0.7741
Dark Romance: Vampire Origins Collector's Edition	2022-07-15	12	13	0	12	0.7741
RiffleEffect	2022-11-24	9	13	0	9	0.7741
Dragon Saddle Melee	2022-01-26	20	13	0	20	0.7741
青鳥樂園 Blue Bird Land EP.1 上篇	2022-10-25	3	13	0	3	0.7741
Weirdlands	2022-12-23	6	13	0	6	0.7741
OrbWars	2022-04-29	7	13	0	7	0.7741
Laika	2022-11-03	3	13	0	3	0.7741
Dave Dave Dave	2022-01-15	4	13	0	4	0.7741
Pingo's Revenge	2022-05-24	2	13	0	2	0.7741
Box to the Box	2022-05-20	5	13	0	5	0.7741
Great Marble Adventure	2022-02-11	8	13	0	8	0.7741
极简地牢 Simple Killer	2022-01-21	4	13	0	4	0.7741
Porcelana	2022-01-22	4	13	0	4	0.7741
Jetbounce	2022-02-11	3	13	0	3	0.7741
Hunt-or-Haunt	2022-01-29	27	13	0	27	0.7741
月影待蚀The Incomplete Lunar	2022-01-11	12	13	0	12	0.7741
Dimension Quest Pinball	2022-02-13	3	13	0	3	0.7741
Fluids & Sounds: Mind relaxing and meditative	2022-02-03	4	13	0	4	0.7741
SnackHunter	2022-07-08	5	13	0	5	0.7741
Sandream	2022-12-01	2	13	0	2	0.7741
Mixed Feelings: While You Were Away	2022-03-24	4	13	0	4	0.7741
Quick Words	2022-03-23	4	13	0	4	0.7741
Swords & Bones 2	2022-05-09	4	13	0	4	0.7741
Forget-me-not	2022-04-17	4	13	0	4	0.7741
Dungeon Rummage - Tiqee's Escape	2022-04-29	2	13	0	2	0.7741
My Therapist is a Futanari 2	2022-10-17	4	13	0	4	0.7741
The Accursed Crown of the Giant King	2022-08-08	5	13	0	5	0.7741
Survive 10 Minutes Please	2022-06-02	3	13	0	3	0.7741
Putinator	2022-06-15	3	13	0	3	0.7741
Alice's Warped Wonderland:REcollection	2022-09-02	16	13	0	16	0.7741
Motorbike Video Puzzle	2022-07-29	2	13	0	2	0.7741
JB Hunter: Adventure	2022-12-30	5	13	0	5	0.7741
Klitorax	2022-10-18	2	13	0	2	0.7741
My Mad Scientist Roommate Turned Me Into Her Personal Robotic Battle Maiden?!?	2022-12-09	9	13	0	9	0.7741
Out of the Cube	2022-10-21	4	13	0	4	0.7741
SokoMelody	2022-12-19	4	13	0	4	0.7741
A Clockwork Ley-Line: Flowers Falling in the Morning Mist	2022-11-11	17	13	0	17	0.7741
Budgie Genetics Simulator	2022-11-02	4	13	0	4	0.7741
Vs Chat Pack	2022-10-13	4	13	0	4	0.7741
ナツキリー夏休みは切島邸にて	2022-11-16	4	13	0	4	0.7741
Osminog Adventure - The Lost Island	2022-12-09	4	13	0	4	0.7741
Out of the ground	2022-12-13	3	13	0	3	0.7741
Raiders of Ruin	2022-12-02	4	13	0	4	0.7741
Swarm the City: Full Release Prologue	2022-05-11	356	163	30	386	0.774
Twice Reborn: a vampire visual novel	2022-06-16	8	20	1	9	0.774
The Sunny Life	2022-07-21	10	20	1	11	0.774
RUNOUT	2022-03-08	3	20	1	4	0.774
EchoBlade	2022-05-03	3	20	1	4	0.774
 Wordeous	2022-08-22	10	20	1	11	0.774
No Fair Play	2022-09-09	46	20	1	47	0.774
News Reacts	2022-05-20	5	20	1	6	0.774
堕天者 ~Back to Origin~	2022-03-22	8	20	1	9	0.774
Mirrorama	2022-01-12	3	20	1	4	0.774
Bad Credit	2022-02-17	6	20	1	7	0.774
Diptych: The Great War	2022-05-12	2	20	1	3	0.774
Cryptid Coffeehouse	2022-08-12	4	20	1	5	0.774
Silent World	2022-06-02	3	20	1	4	0.774
Fly By Knight	2022-06-18	3	20	1	4	0.774
HEN, CHICKS AND CATS	2022-06-17	3	20	1	4	0.774
Catlike Magic	2022-09-03	3	20	1	4	0.774
Terracotta	2022-11-14	47	84	13	60	0.7739
The Witch's Sexual Prison	2022-01-25	149	534	118	267	0.7737
Fabular: Once upon a Spacetime	2022-11-10	106	103	17	123	0.7737
Once Ever After	2022-10-14	98	103	17	115	0.7737
MegaFactory Titan	2022-02-23	34	74	11	45	0.7736000000000001
Red Valley	2022-05-09	6	74	11	17	0.7736000000000001
Screeps: Arena	2022-04-07	202	69	10	212	0.7736000000000001
Mess Adventures 2	2022-01-26	46	69	10	56	0.7736000000000001
Isle of Jura	2022-02-11	7	69	10	17	0.7736000000000001
Marauders	2022-10-03	14332	10696	2844	17176	0.7734000000000001
Evasion from Hell	2022-04-23	5	32	3	8	0.7734000000000001
EvoMon	2022-12-15	15	32	3	18	0.7734000000000001
Desperate: Vladivostok	2022-11-03	5	43	5	10	0.7732
Paper Wizards	2022-09-04	17	43	5	22	0.7732
My Stepbro is a Femboy	2022-08-11	15	266	54	69	0.773
Rogueslide	2022-02-22	7	26	2	9	0.773
Invader TD	2022-09-05	5	26	2	7	0.773
Nineteen	2022-01-21	6	26	2	8	0.773
Hovercars 3077: Underground	2022-05-19	3	26	2	5	0.773
Kuroi Tsubasa	2022-04-04	5	26	2	7	0.773
Pwnk	2022-04-22	109	26	2	111	0.773
KAWAII SLIME ARENA	2022-05-20	4	26	2	6	0.773
Galactic Wars EX	2022-04-21	5	26	2	7	0.773
Moonrakers: Luminor	2022-07-23	175	26	2	177	0.773
Forgotten Realms: The Archives - Collection Three	2022-03-29	26	26	2	28	0.773
Hoverboy	2022-07-11	4	26	2	6	0.773
Cursed Crops	2022-10-03	12	26	2	14	0.773
hOrnyWars	2022-01-12	14	139	25	39	0.7728
Project Crypt	2022-05-13	14	125	22	36	0.7725
Deliverance	2022-04-08	63	134	24	87	0.7724
Artist Life Simulator	2022-12-13	24	78	12	36	0.7724
发现姐姐是妹控的我今后该如何是好	2022-07-01	4	78	12	16	0.7724
Stargazing: Genesis	2022-03-29	46	111	19	65	0.7723000000000001
Holy Shit	2022-05-27	7	165	31	38	0.7722
Hentai Girls: Contact [18+]	2022-03-04	10	73	11	21	0.7722
Hanyo	2022-09-24	40	213	42	82	0.7721
Mechanic 8230: Escape from Ilgrot	2022-04-13	8	53	7	15	0.7721
DEATHRUN TV	2022-06-01	21	53	7	28	0.7721
Fayburrow	2022-02-03	35	264	54	89	0.772
Endlanders : First Encounter	2022-06-04	350	178	34	384	0.772
Lila’s Sky Ark	2022-04-21	15	68	10	25	0.772
Demonheart: The Ice Demon	2022-11-14	104	58	8	112	0.772
Gold Drill	2022-09-14	24	58	8	32	0.772
Wigmund	2022-03-28	382	364	78	460	0.7719
Last Group Out	2022-02-18	12	63	9	21	0.7719
Jack Move	2022-09-08	209	405	88	297	0.7718
Nightmare: The Lunatic	2022-01-07	20	37	4	24	0.7718
QUICKERFLAK_RUTHLESSMOD	2022-06-10	4	37	4	8	0.7718
Rune Factory 5	2022-07-13	2690	914	216	2906	0.7716
Warhammer 40,000: Chaos Gate - Daemonhunters	2022-05-05	12455	6852	1816	14271	0.7715000000000001
Warbox Sandbox	2022-06-24	23	124	22	45	0.7715000000000001
Marvel's Midnight Suns	2022-12-02	15500	8852	2369	17869	0.7714
Isle of Arrows	2022-09-08	598	489	109	707	0.7714
Project Warlock II	2022-06-10	139	350	75	214	0.7712000000000001
Warriors: Rise to Glory	2022-01-20	345	726	169	514	0.7709999999999999
Porcelain Tales	2022-02-04	132	266	55	187	0.7709
我反对这门亲事-I'm against this marriage	2022-05-22	14	42	5	19	0.7709
Conductor: Creative Joy Engine	2022-03-27	10	42	5	15	0.7709
Just Ignore Them: Brea's Story Tape 1	2022-03-29	5	42	5	10	0.7709
Knotwords	2022-04-28	40	42	5	45	0.7709
PARADISE CLEANING - pregnant ogre -	2022-08-26	7	42	5	12	0.7709
River City Girls 2	2022-12-15	833	697	162	995	0.7706999999999999
Mech Armada	2022-06-16	395	361	78	473	0.7706999999999999
Dank Subs	2022-05-10	32	114	20	52	0.7706000000000001
Hatchwell	2022-05-13	10	31	3	13	0.7706000000000001
Trophy Chaser	2022-12-27	4	31	3	7	0.7706000000000001
Old World	2022-05-19	3589	1674	417	4006	0.7705
HerrAnwalt: Lawyers Legacy	2022-11-04	419	393	86	505	0.7705
Potion Permit	2022-09-22	4894	2362	601	5495	0.7704000000000001
Super SplashTube Bros.	2022-04-12	13	47	6	19	0.7704000000000001
One Night With Stalin	2022-03-19	7	145	27	34	0.7703
Citywars Tower Defense	2022-03-04	347	608	140	487	0.7702
Speedway Challenge 2022	2022-06-08	79	52	7	86	0.7702
Cyber Slayer	2022-10-08	10	52	7	17	0.7702
Blade Assault	2022-01-18	721	1438	356	1077	0.77
Burger Patrol	2022-02-15	7	19	1	8	0.77
Phaseshift	2022-03-08	4	19	1	5	0.77
Josh Journey: Darkness Totems	2022-10-15	5	19	1	6	0.77
Obscurant	2022-04-29	4	19	1	5	0.77
Doki Doki Ragnarok	2022-02-14	9	19	1	10	0.77
Cthulhu pub	2022-07-24	5	19	1	6	0.77
Cloaks and Capes	2022-10-14	5	19	1	6	0.77
Rock 'n' Roll Will Never Die!	2022-04-28	5	19	1	6	0.77
YOGA MASTER	2022-01-03	3	19	1	4	0.77
モールス信号で愛を伝えよ。	2022-05-29	7	19	1	8	0.77
Dirty Girls	2022-03-23	3	19	1	4	0.77
Psychosis	2022-12-20	3	19	1	4	0.77
Chess, but...	2022-08-30	18	19	1	19	0.77
Magazine Mogul	2022-09-05	22	19	1	23	0.77
First Bite	2022-02-14	35	81	13	48	0.7698999999999999
捉妖物语/Monster Girl	2022-07-16	87	399	88	175	0.7698
Nadir - Prologue	2022-03-22	46	140	26	72	0.7698
Remorse: The List	2022-04-22	33	153	29	62	0.7697
Best Forklift Operator	2022-08-11	37	153	29	66	0.7697
街机捕鱼嘉年华	2022-02-14	38	131	24	62	0.7697
COVID Kawaii!	2022-12-26	5	25	2	7	0.7697
How I learned to Skate	2022-06-24	6	25	2	8	0.7697
Tiny Island	2022-12-09	4	25	2	6	0.7697
Build Lands	2022-08-04	5	25	2	7	0.7697
EvoluShip	2022-11-23	4	25	2	6	0.7697
Match Village	2022-10-20	22	25	2	24	0.7697
Make Love Not War	2022-09-27	8	25	2	10	0.7697
Koa: The Forgotten Gods	2022-08-08	4	25	2	6	0.7697
OneBit Adventure	2022-08-19	278	251	52	330	0.7696
蔚蓝月下的回忆~SAPPHIRE MOON-FOREVER MEMORIES	2022-09-24	67	255	53	120	0.7695000000000001
Fire & Maneuver	2022-07-15	1780	1597	400	2180	0.7693000000000001
Snowman Adventure	2022-01-03	4	36	4	8	0.7692
Utomah	2022-10-29	5	36	4	9	0.7692
Sweet Office	2022-07-29	21	108	19	40	0.7691
LEGIONCRAFT	2022-08-19	1324	1066	260	1584	0.7690000000000001
Bounce Paradise	2022-03-11	15	12	0	15	0.7690000000000001
Woodland Empire	2022-10-19	8	12	0	8	0.7690000000000001
Rocket Drift	2022-06-24	2	12	0	2	0.7690000000000001
The Royal Game of Ur 3D	2022-04-09	7	12	0	7	0.7690000000000001
A Bad Game Of Football	2022-09-27	25	12	0	25	0.7690000000000001
Belle Boomerang	2022-06-03	6	12	0	6	0.7690000000000001
Ergo VR	2022-05-09	3	12	0	3	0.7690000000000001
Ricochet Ranger	2022-05-20	3	12	0	3	0.7690000000000001
Birb Race	2022-06-29	3	12	0	3	0.7690000000000001
Move that Box!	2022-08-06	3	12	0	3	0.7690000000000001
Homunculus Hotel	2022-03-03	3	12	0	3	0.7690000000000001
Horoscopicus	2022-10-20	4	12	0	4	0.7690000000000001
Commuter	2022-03-04	3	12	0	3	0.7690000000000001
QuaQua	2022-02-04	3	12	0	3	0.7690000000000001
Project Kunai	2022-01-29	6	12	0	6	0.7690000000000001
Le Avventure di Blue	2022-12-06	4	12	0	4	0.7690000000000001
Xross Dreams	2022-12-25	14	12	0	14	0.7690000000000001
Pirates on Target	2022-01-22	2	12	0	2	0.7690000000000001
Eyo - Jump 'n' Run RPG	2022-11-04	3	12	0	3	0.7690000000000001
Arboreal	2022-02-03	6	12	0	6	0.7690000000000001
Pieces of Beauty 3	2022-02-13	3	12	0	3	0.7690000000000001
Spirit of Shotgun	2022-03-11	5	12	0	5	0.7690000000000001
Cleopatra Fortune™ S-Tribute	2022-11-23	12	12	0	12	0.7690000000000001
Spe:X	2022-05-18	2	12	0	2	0.7690000000000001
星际神格	2022-05-04	4	12	0	4	0.7690000000000001
Elite School Roof Club!	2022-03-27	5	12	0	5	0.7690000000000001
Mini Putt	2022-11-12	11	12	0	11	0.7690000000000001
夏日相册	2022-06-10	3	12	0	3	0.7690000000000001
Demons Happened	2022-07-25	3	12	0	3	0.7690000000000001
FIRE HEAT	2022-05-26	8	12	0	8	0.7690000000000001
AN IOU	2022-11-13	2	12	0	2	0.7690000000000001
The Patient: After Hours	2022-07-15	3	12	0	3	0.7690000000000001
Sissa's Path	2022-08-09	4	12	0	4	0.7690000000000001
听不到你的话语的我，想要静静聆听你的心	2022-08-30	3	12	0	3	0.7690000000000001
无极修仙传·序章	2022-10-20	4	12	0	4	0.7690000000000001
Department of the Devil	2022-10-24	3	12	0	3	0.7690000000000001
Super DynoStory	2022-11-09	3	12	0	3	0.7690000000000001
Gravity Box	2022-09-23	5	12	0	5	0.7690000000000001
Mr. White	2022-11-06	4	12	0	4	0.7690000000000001
Hack & Schlitz	2022-09-30	8	12	0	8	0.7690000000000001
Word	2022-11-12	5	12	0	5	0.7690000000000001
Spooky Halloween in the Voxel World	2022-10-31	3	12	0	3	0.7690000000000001
Morrow	2022-10-21	3	12	0	3	0.7690000000000001
World Zero	2022-10-12	3	12	0	3	0.7690000000000001
Argol - Kronoss' Castle	2022-12-25	4	12	0	4	0.7690000000000001
Super Planet Life	2022-12-01	5	12	0	5	0.7690000000000001
Pretty Girls 2048 Strike	2022-12-02	6	12	0	6	0.7690000000000001
List: Game of Candles	2022-12-02	3	12	0	3	0.7690000000000001
Femboy Bangers 2	2022-09-22	6	66	10	16	0.7687999999999999
Hero's Hour	2022-03-01	4265	2939	766	5031	0.7685
Dr. Professor Scientist's Weapons Testing Facility	2022-03-08	48	61	9	57	0.7685
Zombie Slaughter VR	2022-05-11	4	41	5	9	0.7685
Climber: Sky is the Limit - Free Trial	2022-07-19	629	215	44	673	0.7682
Femboys & Fries	2022-08-18	13	125	23	36	0.7682
Sakura Succubus 6	2022-07-11	26	51	7	33	0.7682
HVS: Hitler VS Stalin	2022-11-01	4	51	7	11	0.7682
Furry Sex	2022-03-18	9	285	61	70	0.7681
Psych	2022-10-22	34	198	40	74	0.7681
Spacelines from the Far Out - Captain's Prologue	2022-02-07	124	181	36	160	0.768
NecroBouncer	2022-12-08	62	75	12	74	0.768
Clown For Speed	2022-06-30	11	75	12	23	0.768
KartKraft	2022-01-26	206	2250	581	787	0.7678
Right and Down	2022-10-18	122	129	24	146	0.7678
Kingdom of Atham: Crown of the Champions	2022-01-07	96	214	44	140	0.7676000000000001
Stardom 2000	2022-03-31	295	120	22	317	0.7676000000000001
Hex Rally Racers	2022-05-20	17	84	14	31	0.7676000000000001
MAFIA: Family's Secret	2022-01-08	31	30	3	34	0.7676000000000001
Tad the Lost Explorer	2022-11-15	13	30	3	16	0.7676000000000001
Presenter Slides™	2022-08-01	10	30	3	13	0.7676000000000001
wurdweb	2022-11-01	16	30	3	19	0.7676000000000001
The Swarm	2022-11-25	13	30	3	16	0.7676000000000001
Best Month Ever!	2022-05-05	30	111	20	50	0.7675000000000001
Astronite - Landing on Neplea	2022-09-08	20	111	20	40	0.7675000000000001
Please Subscribe	2022-02-10	38	93	16	54	0.7674
Apostle: Rebellion	2022-07-30	473	201	41	514	0.7673000000000001
Fairy Biography2：Confidante	2022-11-24	129	205	42	171	0.7672
SEX with HITLER 3D	2022-11-05	382	209	43	425	0.7671
Festival Tycoon	2022-05-04	82	137	26	108	0.7671
Wings of Glory	2022-07-21	29	65	10	39	0.7671
Neko Maid	2022-02-11	13	115	21	34	0.767
Motherless - Season 1	2022-09-01	242	343	76	318	0.7669
Infinite Tao	2022-11-30	2588	559	131	2719	0.7668
Stardom 2	2022-03-31	638	221	46	684	0.7668
Otoko Cross: Pretty Boys Mahjong Solitaire	2022-05-19	38	88	15	53	0.7668
XP Soccer	2022-11-11	17	74	12	29	0.7665000000000001
BAD DREAMS	2022-12-16	6	35	4	10	0.7665000000000001
SnOut 2	2022-02-22	14	35	4	18	0.7665000000000001
Hot Springs Story 2	2022-12-19	96	35	4	100	0.7665000000000001
Axiom Verge 2	2022-08-11	136	249	53	189	0.7664
The medical examination diary: the exciting days of me and my senpai	2022-05-05	19	55	8	27	0.7664
FURRY CYBERSEX	2022-07-16	38	55	8	46	0.7664
Moonbreaker	2022-09-29	882	491	114	996	0.7663
Kainga	2022-12-06	238	440	101	339	0.7662000000000001
百詰怪軼與金魚	2022-01-13	15	24	2	17	0.7662000000000001
Fingun	2022-03-18	5	24	2	7	0.7662000000000001
Menu Please!	2022-01-21	5	24	2	7	0.7662000000000001
Legacy of Sin blood oath	2022-09-01	4	24	2	6	0.7662000000000001
Two Colours	2022-06-01	8	24	2	10	0.7662000000000001
IMAGO: Beyond the Nightmares	2022-09-30	5	24	2	7	0.7662000000000001
勇者联盟星耀传说	2022-09-30	9	24	2	11	0.7662000000000001
A Tale of Paper	2022-08-19	16	50	7	23	0.7661
Britannia	2022-07-07	15	40	5	20	0.7661
Dungeon Wizards	2022-02-04	63	40	5	68	0.7661
Zombie Death Quota	2022-05-13	9	40	5	14	0.7661
Hentai DarkElf	2022-11-14	5	40	5	10	0.7661
Hohokum	2022-07-28	24	45	6	30	0.766
BornWild • Versus S1 - Prologue	2022-06-18	9	45	6	15	0.766
Vampire: The Masquerade - Heartless Lullaby	2022-04-21	38	211	44	82	0.7658
C.A.R.L.	2022-09-29	12	18	1	13	0.7658
SUPEROLA CHAMPION EDITION	2022-07-14	3	18	1	4	0.7658
Hero Lodge	2022-01-12	9	18	1	10	0.7658
Out of Order	2022-03-16	4	18	1	5	0.7658
The Soul Stone War 2	2022-01-13	45	18	1	46	0.7658
Rabbit Meadow	2022-03-01	3	18	1	4	0.7658
Telestians	2022-06-16	3	18	1	4	0.7658
Tiles and Towers TD	2022-12-07	5	18	1	6	0.7658
Egg Ascent	2022-05-02	3	18	1	4	0.7658
The Night of Death	2022-05-14	4	18	1	5	0.7658
Link The Cubes	2022-11-11	4	18	1	5	0.7658
Aery - Last Day of Earth	2022-10-24	5	18	1	6	0.7658
禁忌taboo	2022-08-26	4	18	1	5	0.7658
Platformity	2022-06-20	5	18	1	6	0.7658
MMI	2022-11-20	2	18	1	3	0.7658
Skate Rift	2022-11-01	4	18	1	5	0.7658
Snuff	2022-09-05	4	18	1	5	0.7658
Hoshizora no Memoria -Eternal Heart- HD	2022-11-18	9	18	1	10	0.7658
Long and Hard... Summer!	2022-12-15	136	78	13	149	0.7656000000000001
Tricking 0	2022-03-31	46	148	29	75	0.7655
Lost In Malul	2022-10-14	20	64	10	30	0.7654000000000001
Viltnemda	2022-06-23	11	173	35	46	0.7653
Aerofly FS 4 Flight Simulator	2022-07-04	52	214	45	97	0.7651000000000001
Synthetic Lover	2022-01-13	18	59	9	27	0.7648999999999999
The Iron Oath	2022-04-19	725	365	83	808	0.7647
Umichan Sorani	2022-05-27	14	29	3	17	0.7645000000000001
Another Tomorrow	2022-02-14	11	29	3	14	0.7645000000000001
Super Shooter	2022-02-04	4	29	3	7	0.7645000000000001
Grey Heritage: Faded Vision	2022-12-09	12	29	3	15	0.7645000000000001
I Am Two People	2022-09-30	6	29	3	9	0.7645000000000001
White Mirror	2022-08-26	7	29	3	10	0.7645000000000001
人生牌	2022-11-30	7	29	3	10	0.7645000000000001
Office Management 101	2022-03-16	46	54	8	54	0.7644
Retail Royale	2022-04-29	882	2715	725	1607	0.7643000000000001
Technicity: Prologue	2022-08-10	64	95	17	81	0.7643000000000001
DogeFight	2022-04-26	90	418	97	187	0.7641
Sex with Teachers	2022-09-09	13	86	15	28	0.7641
Ibatic	2022-01-17	13	49	7	20	0.7640000000000001
Sparkling Memories	2022-10-28	81	125	24	105	0.7639
依盖之书 book of yog	2022-07-30	4192	5401	1491	5683	0.7637999999999999
Aroma	2022-12-09	46	171	35	81	0.7637999999999999
Paranormal Detective: Escape from the 90s	2022-01-18	8	44	6	14	0.7637
Milling machine simulator	2022-02-23	16	44	6	22	0.7637
Lodventure	2022-12-12	51	44	6	57	0.7637
Nightmare House 噩梦之馆	2022-06-20	7	34	4	11	0.7637
Planetary Planter	2022-05-16	9	34	4	13	0.7637
TRAFFIC	2022-09-02	4	34	4	8	0.7637
Night Janitor	2022-09-20	5	39	5	10	0.7635
Workaholic	2022-07-12	13	39	5	18	0.7635
Hatup	2022-06-16	6	39	5	11	0.7635
Fantasia Medieval	2022-10-14	8	39	5	13	0.7635
A.W.O.L.	2022-09-16	136	485	115	251	0.7634000000000001
The Last One Month	2022-01-13	46	81	14	60	0.7634000000000001
Federation77	2022-10-06	12	72	12	24	0.7634000000000001
Makiomino	2022-04-19	4	11	0	4	0.7634000000000001
Hyperwheel Overdrive	2022-07-20	9	11	0	9	0.7634000000000001
Angry Cat	2022-08-26	5	11	0	5	0.7634000000000001
Kanso	2022-01-25	2	11	0	2	0.7634000000000001
A Way Back	2022-04-29	3	11	0	3	0.7634000000000001
Codename Prodigy	2022-12-27	4	11	0	4	0.7634000000000001
My Personal Hilopet	2022-03-09	5	11	0	5	0.7634000000000001
¡Arre Unicornio!	2022-03-18	6	11	0	6	0.7634000000000001
Timore Redo	2022-07-26	4	11	0	4	0.7634000000000001
Community College Hero: Fun and Games	2022-02-03	8	11	0	8	0.7634000000000001
Me and my eldritch parasite	2022-04-29	2	11	0	2	0.7634000000000001
Tether	2022-01-04	3	11	0	3	0.7634000000000001
Mixx Island: Remix Vol. 2	2022-01-03	5	11	0	5	0.7634000000000001
Pyramid Quest	2022-01-20	4	11	0	4	0.7634000000000001
Claire's Cruisin' Cafe: High Seas Cuisine	2022-02-16	15	11	0	15	0.7634000000000001
Eggroll	2022-01-26	2	11	0	2	0.7634000000000001
Axiom of Maria	2022-03-03	4	11	0	4	0.7634000000000001
Invasion From Space	2022-02-13	3	11	0	3	0.7634000000000001
Barbarous 2 - Tavern Wars	2022-03-28	8	11	0	8	0.7634000000000001
Pipe connect	2022-02-28	3	11	0	3	0.7634000000000001
Looping Bravery	2022-09-28	2	11	0	2	0.7634000000000001
The D-T.E.A.M.	2022-04-16	4	11	0	4	0.7634000000000001
Project Angels	2022-07-14	7	11	0	7	0.7634000000000001
The Dream Team	2022-06-01	7	11	0	7	0.7634000000000001
Bargue	2022-06-17	12	11	0	12	0.7634000000000001
Trash Pit	2022-04-15	5	11	0	5	0.7634000000000001
Radon Break	2022-04-07	3	11	0	3	0.7634000000000001
Easter Bunny	2022-04-05	2	11	0	2	0.7634000000000001
Just a ball: jumping in the space	2022-04-16	2	11	0	2	0.7634000000000001
Mineralis	2022-10-20	2	11	0	2	0.7634000000000001
The Revenge of Mr.Samuel	2022-05-04	2	11	0	2	0.7634000000000001
Let's Play Jigsaw Puzzles	2022-12-19	8	11	0	8	0.7634000000000001
Lunaela	2022-05-13	4	11	0	4	0.7634000000000001
Lone elven wanderer	2022-05-19	4	11	0	4	0.7634000000000001
StoneDEF	2022-05-26	4	11	0	4	0.7634000000000001
Treats Please!	2022-06-07	3	11	0	3	0.7634000000000001
Ultimate Fighters	2022-06-10	4	11	0	4	0.7634000000000001
Paper Flight - Super Speed Dash	2022-09-09	5	11	0	5	0.7634000000000001
TargetPOP	2022-07-29	3	11	0	3	0.7634000000000001
WUFO	2022-12-13	6	11	0	6	0.7634000000000001
Streamer's Court	2022-07-21	10	11	0	10	0.7634000000000001
Ailin: Traps and Treasures	2022-10-25	2	11	0	2	0.7634000000000001
Panda Roll	2022-09-28	3	11	0	3	0.7634000000000001
Stunts Contest Super Bike	2022-10-08	2	11	0	2	0.7634000000000001
TOKKI	2022-11-21	2	11	0	2	0.7634000000000001
Cabbagers	2022-12-21	12	11	0	12	0.7634000000000001
Cuppy's	2022-11-30	4	11	0	4	0.7634000000000001
Furious Sword	2022-11-17	4	11	0	4	0.7634000000000001
The Awakening Program	2022-12-14	2	11	0	2	0.7634000000000001
Twistingo: Bird Paradise Collector's Edition	2022-12-04	4	11	0	4	0.7634000000000001
Ninety-Six	2022-12-24	2	11	0	2	0.7634000000000001
Idle Monster TD: Evolved	2022-11-16	1085	737	182	1267	0.7633
Hats and Hand Grenades	2022-11-11	45	137	27	72	0.7633
Bounty game	2022-12-23	1793	2585	694	2487	0.7631
Jerez's Arena II	2022-04-29	226	141	28	254	0.7631
Skábma™ - Snowfall	2022-04-22	29	85	15	44	0.7628
Crowalt: Traces of the Lost Colony	2022-01-06	19	67	11	30	0.7626000000000001
Cactus Cowboy - Plants at War	2022-05-03	12	67	11	23	0.7626000000000001
Honey, I Joined a Cult	2022-11-03	1161	936	237	1398	0.7625000000000001
Dead Man's Fault	2022-11-30	3	23	2	5	0.7625000000000001
Energy Island Corp.	2022-01-19	12	23	2	14	0.7625000000000001
Chernobyl inferno	2022-01-17	5	23	2	7	0.7625000000000001
Don't Get Tagged	2022-09-15	5	23	2	7	0.7625000000000001
Lawnarchy	2022-03-29	5	23	2	7	0.7625000000000001
Dead End City	2022-10-13	7	23	2	9	0.7625000000000001
Tightrope Theatre	2022-08-11	4	23	2	6	0.7625000000000001
맛있는 사랑	2022-04-29	8	23	2	10	0.7625000000000001
Soccer But Different	2022-07-22	11	23	2	13	0.7625000000000001
St. Yariman's Little Black Book ~Complete~	2022-11-01	12	23	2	14	0.7625000000000001
Pocket Arcade Story	2022-09-26	31	23	2	33	0.7625000000000001
Pink Explorer	2022-08-05	3	23	2	5	0.7625000000000001
The Seven Realms - Realm 1	2022-11-17	171	115	22	193	0.7624
Slaycation Paradise	2022-08-18	64	53	8	72	0.7624
TRUFFLE	2022-01-07	6	53	8	14	0.7624
BrVR Backrooms Virtual Reality	2022-07-15	7	53	8	15	0.7624
建安外史 The Tales of Jian An	2022-11-01	72	106	20	92	0.7619
Milk Bottle And Monster Girl	2022-01-13	61	315	72	133	0.7618
Beastie Bay DX	2022-12-19	64	48	7	71	0.7618
Hard West 2	2022-08-04	3058	1595	421	3479	0.7617
EXOME	2022-12-16	66	156	32	98	0.7617
ANNO:Mutationem	2022-03-17	2938	3216	883	3821	0.7613
OverDrift Festival	2022-12-22	128	538	131	259	0.7613
The Chant	2022-11-03	168	279	63	231	0.7613
UNDETECTED	2022-09-30	12	43	6	18	0.7613
Trinoline Genesis	2022-01-20	7	17	1	8	0.7613
Defect Process	2022-12-01	4	17	1	5	0.7613
toz	2022-06-10	4	17	1	5	0.7613
Sea of Dreams	2022-04-15	2	17	1	3	0.7613
Tengin Music Engine	2022-09-08	5	17	1	6	0.7613
Eat Colors	2022-06-16	2	17	1	3	0.7613
Square Farm	2022-10-27	20	17	1	21	0.7613
...knew the beginning	2022-04-15	3	17	1	4	0.7613
My Little Dictator	2022-06-06	12	17	1	13	0.7613
Delivery in Space	2022-05-16	3	17	1	4	0.7613
JAMPING FISH	2022-05-05	6	17	1	7	0.7613
Chickenoidz Super Pre-Party	2022-09-07	21	17	1	22	0.7613
Miners and Machines	2022-10-14	7	17	1	8	0.7613
Dimensional Gears	2022-09-17	5	17	1	6	0.7613
HellEscape	2022-09-18	8	17	1	9	0.7613
魔塔三国之逆乱时空	2022-09-20	34	17	1	35	0.7613
LALA Hentai	2022-11-27	4	17	1	5	0.7613
Facteroids	2022-04-28	30	28	3	33	0.7612000000000001
Cactus Simulator - Bofete Stories	2022-03-18	3	28	3	6	0.7612000000000001
Hauling Away	2022-07-15	4	28	3	7	0.7612000000000001
Further Still: Survivors	2022-09-19	11	28	3	14	0.7612000000000001
QuentBlast	2022-09-28	8	28	3	11	0.7612000000000001
Hentai DevilGirl	2022-12-02	6	28	3	9	0.7612000000000001
Cataplexy	2022-01-12	4	38	5	9	0.7609
Zorro The Chronicles	2022-06-16	15	38	5	20	0.7609
Final Upgrade	2022-12-06	258	274	62	320	0.7608
TVs: The Awakening	2022-07-28	3	33	4	7	0.7608
恋~一些小清新的猎奇故事~	2022-03-30	15	126	25	40	0.7606999999999999
ShadowBringer	2022-05-06	20	130	26	46	0.7606
First Class Escape 2: Head in the Clouds	2022-02-08	43	109	21	64	0.7605
Townsmen VR	2022-03-24	46	312	72	118	0.7604000000000001
SGS Korean War	2022-10-27	24	52	8	32	0.7603
Yu-Gi-Oh! Master Duel	2022-01-19	262689	45314	13536	276225	0.7601000000000001
魔导圣战:风色幻想	2022-08-09	100	70	12	112	0.7601000000000001
Tales of Yore	2022-03-28	56	198	43	99	0.76
Fadeout: Underground	2022-06-25	141	162	34	175	0.76
Vigorus	2022-03-03	17	61	10	27	0.76
Hidden Deep	2022-01-24	1226	2178	593	1819	0.7597
Barro F22	2022-04-25	22	104	20	42	0.7595000000000001
风色幻想5:赤月战争	2022-08-09	146	104	20	166	0.7595000000000001
Neko Doll	2022-02-04	26	74	13	39	0.7595000000000001
謎塔魔女	2022-03-01	20	47	7	27	0.7595000000000001
NeuraGun	2022-01-21	199	47	7	206	0.7595000000000001
Click Real Fast	2022-12-20	11	47	7	18	0.7595000000000001
Roma Invicta	2022-02-11	17	141	29	46	0.7593000000000001
LiBER	2022-01-11	8	65	11	19	0.7592
Going Rogue	2022-11-11	65	65	11	76	0.7592
Phil Alone	2022-07-22	11	91	17	28	0.7591
Graduated	2022-07-29	321	301	70	391	0.7589
HARVESTELLA	2022-11-04	3395	1202	318	3713	0.7587999999999999
Mujun's Casefile ~ The Mystery Mansion ~	2022-02-17	46	42	6	52	0.7587999999999999
Nightmare Knock	2022-12-14	22	42	6	28	0.7587999999999999
Fabled Lands	2022-05-26	175	293	68	243	0.7587
Requiem Of Science	2022-01-07	14	243	55	69	0.7587
Midnight Ghost Hunt	2022-03-31	4987	4413	1250	6237	0.7586
Trash is Fun	2022-07-05	8	22	2	10	0.7586
Godless	2022-11-08	26	22	2	28	0.7586
Lofi Furries	2022-06-16	4	22	2	6	0.7586
Package Rush	2022-10-28	7	22	2	9	0.7586
Abigor	2022-08-01	5	22	2	7	0.7586
《蜀山：初章》买断版	2022-11-18	9202	5231	1492	10694	0.7585
Re:BF	2022-03-12	432	188	41	473	0.7585
Villa's Blinds	2022-01-27	20	164	35	55	0.7584000000000001
ACTION SANDBOX	2022-04-22	203	589	148	351	0.7582
Kingdom Under Fire: War of Heroes	2022-12-07	123	107	21	144	0.7582
Halt The Heist!	2022-07-29	42	51	8	50	0.7582
EL PASO, NIGHTMARE	2022-10-25	14	51	8	22	0.7582
London Ripper	2022-03-19	4	37	5	9	0.7582
Kamiwaza: Way of the Thief	2022-10-11	64	37	5	69	0.7582
Warrior Paint - 2005 GOTY Edition	2022-12-28	3	37	5	8	0.7582
The Quarry	2022-06-10	6349	7148	2066	8415	0.7581
Last Lovers 绿洲之爱	2022-03-04	17	111	22	39	0.758
Sycamore Free	2022-11-22	19	90	17	36	0.7578
Neko Ghost, Jump!	2022-01-11	8	32	4	12	0.7576999999999999
MeiQi 2019	2022-11-03	11	32	4	15	0.7576999999999999
Claris the Princess Knight	2022-05-06	15	32	4	19	0.7576999999999999
Running on Magic	2022-07-15	5	32	4	9	0.7576999999999999
Keyboard Warrior	2022-07-15	6	32	4	10	0.7576999999999999
Novi Cube	2022-09-22	58	32	4	62	0.7576999999999999
Astonishing Baseball 22	2022-01-14	12	27	3	15	0.7576999999999999
Chicken Fall	2022-09-22	44	27	3	47	0.7576999999999999
Midnight at Forest	2022-03-06	3	27	3	6	0.7576999999999999
Entropic Float: This World Will Decay And Disappear	2022-07-09	7	27	3	10	0.7576999999999999
Hedgewars	2022-12-17	16	27	3	19	0.7576999999999999
Monochrome Mobius: Rights and Wrongs Forgotten	2022-11-16	723	425	104	827	0.7575000000000001
Incubus	2022-06-04	365	369	89	454	0.7574
Tiny Tina's Wonderlands	2022-06-23	15021	7768	2264	17285	0.7572
Cellyon: Boss Confrontation	2022-10-11	13	46	7	20	0.7572
OLI	2022-03-29	9	46	7	16	0.7572
Bot Gaiden	2022-04-22	3	10	0	3	0.7571
Death Leak	2022-07-16	4	10	0	4	0.7571
Listeria Wars	2022-12-08	4	10	0	4	0.7571
LuPR: Lunar Post Recruit	2022-05-13	2	10	0	2	0.7571
Space Captain McCallery - Episode 3: The Weaponmaster's Challenge	2022-07-05	2	10	0	2	0.7571
Alder Forge	2022-01-07	5	10	0	5	0.7571
JETMAN	2022-07-13	4	10	0	4	0.7571
Dance Assembly	2022-12-08	3	10	0	3	0.7571
Figurine Scene Simulator	2022-03-01	4	10	0	4	0.7571
Venture Within	2022-05-29	3	10	0	3	0.7571
Thomas' Tales	2022-06-16	2	10	0	2	0.7571
The VII Enigma	2022-01-25	4	10	0	4	0.7571
Multiply Factory	2022-07-27	14	10	0	14	0.7571
YOKAIWARE	2022-01-03	2	10	0	2	0.7571
Jump Challenge!	2022-03-19	4	10	0	4	0.7571
Under The Warehouse	2022-03-23	2	10	0	2	0.7571
Ball Boys	2022-09-22	8	10	0	8	0.7571
Yonder World: Interview with the Void	2022-06-23	4	10	0	4	0.7571
Action Ball	2022-03-14	3	10	0	3	0.7571
Journey to the Heart of Gaia	2022-01-12	6	10	0	6	0.7571
路地裏グローリーホール	2022-06-23	3	10	0	3	0.7571
雷鸟Thunderbird	2022-10-10	4	10	0	4	0.7571
Cyber Runner	2022-08-04	4	10	0	4	0.7571
XenoTown	2022-08-17	3	10	0	3	0.7571
A Ghostly Rose	2022-04-05	2	10	0	2	0.7571
Trapped VR	2022-02-09	3	10	0	3	0.7571
OOZEscape	2022-02-17	3	10	0	3	0.7571
ToyCar	2022-08-04	10	10	0	10	0.7571
Machine Gun Fury	2022-10-28	3	10	0	3	0.7571
Run Away SkyDancer	2022-02-23	3	10	0	3	0.7571
My Pet Rock	2022-05-02	7	10	0	7	0.7571
Memetric: Classic	2022-11-10	2	10	0	2	0.7571
Eyeball Master	2022-04-01	10	10	0	10	0.7571
John Christian 2	2022-06-14	3	10	0	3	0.7571
You will die a lot buddy, trust me!	2022-04-22	6	10	0	6	0.7571
Overstrike Arena	2022-12-16	30	10	0	30	0.7571
DEVIL DEVOUR ALIVE DX	2022-10-25	1	10	0	1	0.7571
Santo Island Incident	2022-06-22	5	10	0	5	0.7571
Until the Night	2022-06-06	88	10	0	88	0.7571
Elena's Journal - Unfinished Expedition	2022-07-14	5	10	0	5	0.7571
BeachRun	2022-05-25	3	10	0	3	0.7571
Outpost Defender 2-Beta	2022-05-10	4	10	0	4	0.7571
CROPPED	2022-06-10	4	10	0	4	0.7571
The Legend of Chibi Ninja	2022-09-29	3	10	0	3	0.7571
Was it a cat I saw?	2022-07-01	4	10	0	4	0.7571
MonGirl Expedition	2022-12-15	8	10	0	8	0.7571
วีรบุรุษไร้พลัง ไข่ต้ม	2022-06-17	5	10	0	5	0.7571
A Pact With Me	2022-07-16	6	10	0	6	0.7571
Lovers Anonymous Rehab for Romantics	2022-09-18	3	10	0	3	0.7571
UNILOGUE	2022-10-22	7	10	0	7	0.7571
Opaloid Kingdom	2022-11-22	3	10	0	3	0.7571
Space Route	2022-08-26	3	10	0	3	0.7571
Trigger Henry	2022-10-28	5	10	0	5	0.7571
Hanaja's Body	2022-07-15	12	10	0	12	0.7571
Crossfar	2022-07-28	5	10	0	5	0.7571
Gronk Want Rock	2022-07-17	3	10	0	3	0.7571
Sippin Hot Blickety Block N Bop Those Bad Battle Boys Down To Size Supreme	2022-08-30	4	10	0	4	0.7571
Meow Defence	2022-10-21	2	10	0	2	0.7571
Heroes of Hellas Origins: Part Two	2022-09-28	13	10	0	13	0.7571
Odium	2022-10-21	2	10	0	2	0.7571
LUMbA: REDUX	2022-08-04	3	10	0	3	0.7571
Tiny Solar System	2022-10-19	3	10	0	3	0.7571
Step Journey	2022-09-09	4	10	0	4	0.7571
Stunts Contest Extreme Cars	2022-11-07	2	10	0	2	0.7571
Samurai pussy	2022-09-23	2	10	0	2	0.7571
Fix My Hand Doc	2022-10-26	2	10	0	2	0.7571
Fury Turn	2022-10-11	4	10	0	4	0.7571
Dark Moon Motel	2022-10-07	2	10	0	2	0.7571
Motherboard Under Attack	2022-12-15	2	10	0	2	0.7571
Puzzle: Triangles	2022-10-14	2	10	0	2	0.7571
VR Solo Noble(Peg solitaire)	2022-11-15	1	10	0	1	0.7571
VR World of Pandas	2022-11-15	1	10	0	1	0.7571
Across-Stitch	2022-11-23	6	10	0	6	0.7571
VR Pterosaur	2022-12-02	1	10	0	1	0.7571
VR Dinosaur Invasion	2022-12-02	1	10	0	1	0.7571
Anime Hunter	2022-12-16	5	10	0	5	0.7571
VR Dinosaur Hunter	2022-12-09	1	10	0	1	0.7571
Forbidden Love with My Wife's Sister	2022-12-20	4	10	0	4	0.7571
Soulstice	2022-09-20	599	771	200	799	0.757
SUKUR	2022-11-02	8	81	15	23	0.757
Line War	2022-05-05	306	460	114	420	0.7569
方境战记BlockFight	2022-05-25	159	114	23	182	0.7568000000000001
Furry Orgasm	2022-07-22	10	114	23	33	0.7568000000000001
Furry Fantasy	2022-07-09	487	68	12	499	0.7568000000000001
Jump The Gun	2022-11-25	25	68	12	37	0.7568000000000001
Magical Girl Clicker	2022-10-06	71	68	12	83	0.7568000000000001
MY LITTLE PONY: A Maretime Bay Adventure	2022-05-27	96	315	75	171	0.7567
Anvil Saga	2022-06-21	804	662	170	974	0.7565999999999999
Broken Edge	2022-11-17	34	138	29	63	0.7565999999999999
Alan's Automaton Workshop	2022-01-20	134	134	28	162	0.7565999999999999
Oaken	2022-05-03	143	134	28	171	0.7565999999999999
Exoblast	2022-01-31	195	243	56	251	0.7565000000000001
Nonno Lorenzo	2022-10-06	6	16	1	7	0.7564000000000001
Operation Zeta	2022-01-14	3	16	1	4	0.7564000000000001
Hearts of the Dungeon List	2022-04-29	7	16	1	8	0.7564000000000001
Crooks Like Us	2022-04-06	12	16	1	13	0.7564000000000001
Omegabot	2022-06-16	3	16	1	4	0.7564000000000001
2089 - Space Divided	2022-09-16	9	16	1	10	0.7564000000000001
Heart & Soul	2022-02-28	4	16	1	5	0.7564000000000001
Indirection	2022-01-09	3	16	1	4	0.7564000000000001
JENTRIX	2022-01-27	6	16	1	7	0.7564000000000001
Tough Love Arena	2022-05-05	6	16	1	7	0.7564000000000001
A Clockwork Ley-Line: Daybreak of Remnants Shadow	2022-03-18	18	16	1	19	0.7564000000000001
Sperm Runner	2022-03-14	2	16	1	3	0.7564000000000001
Billy 101	2022-05-31	6	16	1	7	0.7564000000000001
Crazy Cube Adventure	2022-02-08	2	16	1	3	0.7564000000000001
Sharing Lights	2022-03-04	12	16	1	13	0.7564000000000001
Project Medved	2022-05-25	6	16	1	7	0.7564000000000001
Jewel Match Origins 2 - Bavarian Palace Collector's Edition	2022-04-21	20	16	1	21	0.7564000000000001
Past Particles	2022-05-11	7	16	1	8	0.7564000000000001
Z-Warp	2022-06-21	4	16	1	5	0.7564000000000001
Alice in Wonderland Jigsaw Puzzle	2022-09-26	3	16	1	4	0.7564000000000001
2MD:VR Football Unleashed All-Star	2022-09-20	10	16	1	11	0.7564000000000001
Pretty Girls Tile Match	2022-09-30	5	16	1	6	0.7564000000000001
The First Mountain	2022-10-05	2	16	1	3	0.7564000000000001
Battle Cry of Freedom	2022-03-01	893	1423	387	1280	0.7563
Riding to Bounce City	2022-09-15	98	208	47	145	0.7562000000000001
Sail	2022-08-10	12	41	6	18	0.7562000000000001
Hero King Quest: Peacemaker Prologue	2022-05-13	8	41	6	14	0.7562000000000001
Krampus Kills	2022-12-02	56	41	6	62	0.7562000000000001
The Way Home: Pixel Roguelike	2022-10-17	35	41	6	41	0.7562000000000001
Dog Adventure	2022-01-18	3	50	8	11	0.756
Where Are My Mittens	2022-04-08	8	50	8	16	0.756
BONELAB	2022-09-29	11991	8536	2519	14510	0.7556
Deadly Night	2022-09-02	58	141	30	88	0.7556
The Hotel	2022-06-17	8	63	11	19	0.7556
Maid Knight Alicia	2022-05-14	38	80	15	53	0.7555
Synth Retro Vapor Wave	2022-09-13	3	36	5	8	0.7553000000000001
攻城三国志	2022-04-29	13	36	5	18	0.7553000000000001
Fried Panic	2022-09-28	13	36	5	18	0.7553000000000001
Furry Meow	2022-11-04	8	36	5	13	0.7553000000000001
Monuments Flipper: Prologue	2022-05-18	340	191	43	383	0.7551000000000001
Redout 2	2022-06-16	412	623	161	573	0.755
The WILDS	2022-02-15	13	67	12	25	0.755
Paladin's Oath	2022-03-03	10	67	12	22	0.755
The Ramen Sensei	2022-09-05	95	54	9	104	0.755
オンライン線香花火	2022-06-24	158	45	7	165	0.7548
Football Simulator	2022-06-09	61	198	45	106	0.7545999999999999
Secret Series : BJ	2022-01-31	18	128	27	45	0.7545999999999999
The Crackpet Show: Prologue	2022-12-02	699	128	27	726	0.7545999999999999
Primal Survivors	2022-11-15	10	31	4	14	0.7545999999999999
Kurokami-sama's Feast	2022-01-21	15	31	4	19	0.7545999999999999
Polimines	2022-03-29	9	31	4	13	0.7545999999999999
未知记录	2022-04-29	36	31	4	40	0.7545999999999999
Windfolk: Sky is just the Beginning	2022-09-26	8	31	4	12	0.7545999999999999
Good Night, Peregrine	2022-10-27	3	31	4	7	0.7545999999999999
Fairy Biography	2022-05-26	274	499	127	401	0.7544
皇帝与社稷·测试版 The Emperor and State·Beta version	2022-06-02	432	299	72	504	0.7544
Dead Containment	2022-10-21	9	21	2	11	0.7544
Last Visit	2022-08-19	6	21	2	8	0.7544
BeastCrimes	2022-01-08	111	21	2	113	0.7544
NaGongGan	2022-08-12	6	21	2	8	0.7544
Mythos: Sudoku	2022-10-17	14	21	2	16	0.7544
D&D Stronghold: Kingdom Simulator	2022-03-29	21	21	2	23	0.7544
Yum Collector	2022-03-02	3	21	2	5	0.7544
Alchemia: Creatio Ex Nihilo	2022-07-28	25	21	2	27	0.7544
Occult Rewrite	2022-06-24	5	21	2	7	0.7544
Chonky - From Breakfast to Domination	2022-11-01	3	21	2	5	0.7544
Matcha	2022-08-09	38	21	2	40	0.7544
Slime Ranger	2022-11-15	3	21	2	5	0.7544
Domino Simulator	2022-03-29	23	58	10	33	0.7543000000000001
Bots Are Stupid	2022-12-15	53	58	10	63	0.7543000000000001
For Goodness Sake	2022-12-05	9	58	10	19	0.7543000000000001
Runaway Animals	2022-09-22	13	26	3	16	0.7541
Virus At Home	2022-01-07	4	26	3	7	0.7541
TENDY: Robot Gardener	2022-05-19	5	26	3	8	0.7541
It's Hard Being A Dog	2022-05-02	7	26	3	10	0.7541
The Call of Krul'ar	2022-06-08	25	26	3	28	0.7541
SCP: Containment Breach Remastered	2022-08-04	89	454	115	204	0.7538
Task Force	2022-08-27	229	327	80	309	0.7538
Undergrave	2022-07-13	12	49	8	20	0.7537
Pro Strategy Football 2023	2022-09-08	45	49	8	53	0.7537
Life of a Space Force Captain	2022-05-05	71	40	6	77	0.7536
山海皆可平	2022-08-19	3	40	6	9	0.7536
Past Synergy	2022-04-04	12	40	6	18	0.7536
Rolling in the Maze	2022-05-13	132	464	118	250	0.7535
Kach	2022-08-18	14	162	36	50	0.7535
Furry Striptease	2022-09-30	16	66	12	28	0.7533
Itorah	2022-03-21	104	289	70	174	0.7532
Dark Light	2022-09-29	96	398	100	196	0.7531
Cave Digger 2: Dig Harder	2022-09-08	20	70	13	33	0.7529000000000001
Duloga	2022-01-22	6	53	9	15	0.7529000000000001
Resist the succubus—The end of the female Knight	2022-07-22	2171	771	206	2377	0.7528
Deadly Premonition 2	2022-06-11	104	184	42	146	0.7528
Source of Madness	2022-05-11	184	536	139	323	0.7526999999999999
8/8/88 Needle AL	2022-05-09	7	78	15	22	0.7524
Umbra galaxy	2022-02-14	11	35	5	16	0.7524
Xeno Command	2022-11-09	24	35	5	29	0.7524
Xmas Apocalypse	2022-12-15	14	35	5	19	0.7524
Hellslave	2022-05-26	691	403	102	793	0.7523000000000001
A World of Little Legends	2022-03-01	43	57	10	53	0.7523000000000001
Lilith Odyssey	2022-11-05	13	44	7	20	0.7523000000000001
Breakout: Recharged	2022-02-10	12	44	7	19	0.7523000000000001
Age of Valakas: Vietnam	2022-05-13	7	44	7	14	0.7523000000000001
The Fox's Drawing World	2022-02-06	16	44	7	23	0.7523000000000001
PI.EXE	2022-03-07	14	44	7	21	0.7523000000000001
Car Dealership Simulator	2022-09-20	536	889	241	777	0.7522
Kaiju Wars	2022-04-28	91	141	31	122	0.752
Moonscars	2022-09-27	347	459	118	465	0.7519
Final Vendetta	2022-06-17	23	160	36	59	0.7518000000000001
Cartel Tycoon	2022-07-26	2244	2059	589	2833	0.7517
Hero's Journey	2022-07-14	697	865	235	932	0.7515999999999999
The Centennial Case: A Shijima Story	2022-05-12	873	528	138	1011	0.7514000000000001
Astronite	2022-11-30	28	65	12	40	0.7514000000000001
Ashen Empires	2022-09-03	1271	208	49	1320	0.7512000000000001
Rabbit Hole	2022-09-10	21	144	32	53	0.7512000000000001
Far Away From Home	2022-08-18	24	30	4	28	0.7512000000000001
Arali	2022-08-13	4	30	4	8	0.7512000000000001
Elf Sex Farm	2022-10-25	634	274	67	701	0.7511
Skull's Impossible Quest	2022-01-16	3	15	1	4	0.751
Birb Café	2022-05-12	4	15	1	5	0.751
Help me please	2022-01-09	6	15	1	7	0.751
Slime Dice	2022-08-26	8	15	1	9	0.751
Box's Dream	2022-01-14	3	15	1	4	0.751
Bhop Craze	2022-08-29	8	15	1	9	0.751
BYLITSA: VASNA	2022-02-18	6	15	1	7	0.751
雛ちゃんのとっかえ！わらしべランチ	2022-01-11	8	15	1	9	0.751
Jigsaw Pink	2022-03-08	2	15	1	3	0.751
Battle of the Four Towers	2022-03-19	5	15	1	6	0.751
Paper Nebula	2022-10-20	4	15	1	5	0.751
Alexander the Great: Secrets of Power	2022-07-15	9	15	1	10	0.751
Bone Lover - Horror Escape	2022-09-12	4	15	1	5	0.751
Enclosure 3-D	2022-09-13	4	15	1	5	0.751
Shape Of The Toilet Rim	2022-09-20	3	15	1	4	0.751
Tower Numbers	2022-11-11	2	15	1	3	0.751
Tropical Hearts	2022-11-19	3	15	1	4	0.751
BLASTRONAUT	2022-07-27	126	105	22	148	0.7509
Ampersat	2022-05-06	8	39	6	14	0.7509
Sky in your eyes	2022-07-23	9	39	6	15	0.7509
Helicopter Gunship DEX	2022-12-01	8	39	6	14	0.7509
東方実在相 ～ Dream Logical World	2022-01-21	47	170	39	86	0.7506999999999999
HENTAI: NAZI GIRL	2022-09-27	4	52	9	13	0.7506999999999999
Weird West	2022-03-31	4621	1984	571	5192	0.7505
The Matriarch	2022-09-26	490	423	109	599	0.7505
Numina	2022-06-30	18	25	3	21	0.7503000000000001
CAT & MOUSE	2022-09-04	18	25	3	21	0.7503000000000001
Dungeon Looter	2022-10-14	9	25	3	12	0.7503000000000001
CreepWars TD	2022-04-15	4	25	3	7	0.7503000000000001
Baby Goat Billy	2022-04-29	4	25	3	7	0.7503000000000001
Content	2022-02-04	3	25	3	6	0.7503000000000001
Melania	2022-05-30	3	25	3	6	0.7503000000000001
Something Strange	2022-05-31	3	25	3	6	0.7503000000000001
Model Builder	2022-02-08	880	854	234	1114	0.7502
Sex Chess	2022-11-10	324	513	135	459	0.7501000000000001
Evil Reap	2022-04-15	4	9	0	4	0.75
Mongrel	2022-02-19	5	9	0	5	0.75
Birds with Feelings	2022-05-13	3	9	0	3	0.75
Faking to Dance	2022-05-18	1	9	0	1	0.75
Project Colonies: MARS 2120	2022-10-27	5	9	0	5	0.75
Neko Nyaa~	2022-03-22	2	9	0	2	0.75
The Sound of Fireworks: The Haiku	2022-06-24	2	9	0	2	0.75
Godbeast Mk.II	2022-11-23	3	9	0	3	0.75
JezzBall Atomic	2022-02-14	3	9	0	3	0.75
STERN	2022-03-15	3	9	0	3	0.75
Godspell Defender	2022-05-23	3	9	0	3	0.75
Gridform	2022-07-29	3	9	0	3	0.75
RD Mars	2022-01-19	1	9	0	1	0.75
ET Superman : Wrath of Tyrannosaurus Rex	2022-11-06	2	9	0	2	0.75
Clutter 12: It's About Time - Collector's Edition	2022-04-05	8	9	0	8	0.75
AgriLife	2022-04-14	4	9	0	4	0.75
Skew Pong	2022-02-10	3	9	0	3	0.75
Citrus Rampage	2022-04-20	4	9	0	4	0.75
Destructor Tanks 	2022-01-11	5	9	0	5	0.75
No Haste	2022-01-07	4	9	0	4	0.75
Satama Puzzle	2022-05-18	6	9	0	6	0.75
Imperial Arms: Curse of the Conqueror	2022-02-06	4	9	0	4	0.75
Nectar Wars	2022-07-26	4	9	0	4	0.75
SGS Glory Recalled	2022-02-10	5	9	0	5	0.75
Cramit's Keep	2022-01-10	4	9	0	4	0.75
Warsaw: Paris of the North	2022-01-26	3	9	0	3	0.75
Ms. Holmes: The Adventure of the McKirk Ritual Collector's Edition	2022-01-03	7	9	0	7	0.75
Bitcoin Chill	2022-02-04	3	9	0	3	0.75
Panicked and Surrounded by Hot Vampires	2022-02-08	3	9	0	3	0.75
Gaikokujin No Sensei (Foreigner Teacher)	2022-06-20	7	9	0	7	0.75
Alien Space Bastards	2022-02-09	2	9	0	2	0.75
FACTOR D	2022-05-24	3	9	0	3	0.75
The Forked Road	2022-10-14	2	9	0	2	0.75
I Love Finding Critters	2022-04-11	5	9	0	5	0.75
Legend of Radiance	2022-03-04	3	9	0	3	0.75
Forget Westbury Falls: Disc One	2022-03-01	3	9	0	3	0.75
Dial-In	2022-07-16	4	9	0	4	0.75
SONOHIGURASHI VS. TOUHOU UNIVERSE	2022-03-25	3	9	0	3	0.75
Hit Him	2022-04-12	3	9	0	3	0.75
No Anglerfish	2022-04-05	4	9	0	4	0.75
hehe	2022-04-16	3	9	0	3	0.75
Dodge & Weave	2022-04-22	3	9	0	3	0.75
Ren's Demons I	2022-08-08	2	9	0	2	0.75
Kaiju	2022-06-03	4	9	0	4	0.75
Departure.	2022-06-06	4	9	0	4	0.75
Manglepaw	2022-05-10	2	9	0	2	0.75
Panique à Temple A-Steak	2022-10-04	3	9	0	3	0.75
Happy Hops	2022-05-14	3	9	0	3	0.75
Awakening of Legend	2022-10-31	6	9	0	6	0.75
Last Meow Standing	2022-12-15	4	9	0	4	0.75
Pylorus - Footsteps of Greed	2022-07-11	3	9	0	3	0.75
Panda Run	2022-06-03	3	9	0	3	0.75
Yeah Jam Fury (2012)	2022-07-06	6	9	0	6	0.75
BUBBLE NIGHT	2022-07-12	4	9	0	4	0.75
Charlie and Friends	2022-08-12	5	9	0	5	0.75
Beat Blitz	2022-10-24	2	9	0	2	0.75
Triennale Game Collection 2	2022-07-11	3	9	0	3	0.75
Omega Squad	2022-07-01	2	9	0	2	0.75
Once in Yaissor 3	2022-12-03	2	9	0	2	0.75
流星降临的小镇：来自过去的幽灵	2022-07-26	4	9	0	4	0.75
Finding Ice	2022-08-29	2	9	0	2	0.75
Junkyard Fury 2	2022-10-28	5	9	0	5	0.75
I commissioned some bees 6	2022-09-08	6	9	0	6	0.75
DON'T STOP, YOU'LL DIE!	2022-08-12	4	9	0	4	0.75
Abstract Grind	2022-10-15	3	9	0	3	0.75
Night Flight	2022-08-20	2	9	0	2	0.75
Unreal Vendetta	2022-09-03	3	9	0	3	0.75
The Entity Code	2022-10-12	2	9	0	2	0.75
Dry School	2022-09-27	2	9	0	2	0.75
Love Spell: Aslan's Route	2022-11-02	13	9	0	13	0.75
Coffee For Robots	2022-09-29	3	9	0	3	0.75
NSG	2022-10-28	2	9	0	2	0.75
My Girlfriend is a Futanari	2022-11-11	3	9	0	3	0.75
PARADISE CLEANING - Married Woman Cosplay Life -	2022-12-30	3	9	0	3	0.75
Needy Dragons	2022-10-04	3	9	0	3	0.75
Lost Dream: Stars	2022-11-04	2	9	0	2	0.75
Lighten Up	2022-11-02	3	9	0	3	0.75
MY NEEDY NEIGHBOUR GIRLS	2022-11-02	5	9	0	5	0.75
Maruja Mallo	2022-11-15	2	9	0	2	0.75
Ruins of Istanbul	2022-11-23	2	9	0	2	0.75
Blocks Tracks Trains	2022-11-03	4	9	0	4	0.75
下山的试炼之江湖遗失录	2022-12-23	3	9	0	3	0.75
向往的方向	2022-12-21	2	9	0	2	0.75
Innocence Or Money - V 0.0.3	2022-05-20	120	250	61	181	0.7499
Ricky Recharge	2022-12-20	3	20	2	5	0.7499
Downslope	2022-01-20	7	20	2	9	0.7499
Weapons Simulator	2022-02-27	4	20	2	6	0.7499
YONESAWARA HOSPITAL	2022-08-19	22	20	2	24	0.7499
WORDLAND - Let's Travel	2022-06-20	7	20	2	9	0.7499
Still be a Human	2022-08-01	6	20	2	8	0.7499
三国記II	2022-07-08	13	20	2	15	0.7499
Furry Hentai Isekai	2022-05-11	5	20	2	7	0.7499
Hellway	2022-10-27	5	20	2	7	0.7499
Fly Tales	2022-08-19	2	20	2	4	0.7499
Coins Collector Sport Car	2022-08-22	3	20	2	5	0.7499
Dead Second	2022-10-15	5	20	2	7	0.7499
Bravery and Greed	2022-11-15	786	343	87	873	0.7497
Cursed to Golf	2022-08-18	341	300	75	416	0.7497
Anuchard	2022-04-21	14	64	12	26	0.7495999999999999
Spacelines From The Far Out	2022-06-09	172	231	56	228	0.7494
CYBERHUNK	2022-09-24	12	68	13	25	0.7494
Spearmint Goose	2022-04-01	2	34	5	7	0.7493000000000001
TEMPLE of RUBBO	2022-03-10	7	34	5	12	0.7493000000000001
Automaton Kingdom	2022-05-23	13	34	5	18	0.7493000000000001
Wheels of Duty	2022-09-01	37	80	16	53	0.7492000000000001
AI Roguelite	2022-03-02	46	168	39	85	0.7491
Chemists: Area of infection	2022-09-09	5	47	8	13	0.7490000000000001
Fantasy Fishing Town	2022-05-10	39	47	8	47	0.7490000000000001
CRUMB	2022-11-18	98	219	53	151	0.7488
烈山海贰	2022-01-05	30	51	9	39	0.7484999999999999
懒人修仙传2	2022-06-21	1423	521	139	1562	0.7484000000000001
GetsuFumaDen: Undying Moon	2022-02-17	662	678	185	847	0.7483
Beneath Oresa	2022-11-03	296	329	84	380	0.7483
Eville	2022-10-11	948	265	66	1014	0.7482
Koncolos: Prologue	2022-03-04	5	38	6	11	0.748
Andromeda Survivors	2022-10-14	8	38	6	14	0.748
Dark Secrets of Showbiz	2022-05-10	57	87	18	75	0.7479000000000001
Hero Realms	2022-06-06	120	159	37	157	0.7478
Upload Simulator	2022-09-09	119	59	11	130	0.7478
International Basketball Manager 23	2022-12-01	128	59	11	139	0.7478
ICEwall	2022-10-14	30	29	4	34	0.7478
Monster Girl Invasion RPG	2022-03-19	23	29	4	27	0.7478
Tower of Ardia	2022-09-24	174	79	16	190	0.7477
Voice of Cards: The Beasts of Burden	2022-09-13	92	63	12	104	0.7477
FILF	2022-04-14	60	67	13	73	0.7476
KINGDOM of the DEAD	2022-02-10	48	177	42	90	0.7474
Scorn	2022-10-14	7949	7672	2375	10324	0.7472
Eternal Evil	2022-11-01	75	302	77	152	0.7472
The Scarlet Demonslayer	2022-12-10	363	173	41	404	0.7472
Lords and Villeins	2022-11-10	349	403	106	455	0.7471
Bartender Hustle	2022-05-27	43	98	21	64	0.747
Godsbane	2022-03-04	75	98	21	96	0.747
天命奇御：歸途 Fate Seeker: Journey	2022-12-12	3170	799	223	3393	0.7468000000000001
Tower Princess: Knight's Trial	2022-06-23	370	208	51	421	0.7463
Hipster Cafe	2022-04-29	12	24	3	15	0.7463
NecroBoy : Path to Evilship	2022-10-31	5	24	3	8	0.7463
Bauer	2022-03-31	5	24	3	8	0.7463
SEARCH ALL - SUSHI	2022-02-04	3	24	3	6	0.7463
DOOM TOMB	2022-03-23	6	24	3	9	0.7463
Dungeons & Dragons: Ravenloft Series	2022-03-29	17	24	3	20	0.7463
4 Seasons Girls	2022-07-07	3	24	3	6	0.7463
Assassin Girls	2022-07-15	3	24	3	6	0.7463
Milf Toys 2	2022-04-08	3	24	3	6	0.7463
Observo	2022-10-21	4	24	3	7	0.7463
Sexual Summer	2022-12-09	12	24	3	15	0.7463
Open The Gates!	2022-10-17	46	50	9	55	0.7462000000000001
Pain Party	2022-08-22	22	50	9	31	0.7462000000000001
～Daydream～蝶が舞う頃に	2022-05-26	25	105	23	48	0.7461
Yakyosho	2022-05-27	5	33	5	10	0.7461
Hyper Gunsport	2022-12-22	7	33	5	12	0.7461
Mystery of Mortlake Mansion	2022-07-08	14	33	5	19	0.7461
秦殇	2022-01-11	1860	1542	451	2311	0.7459
Furry Sex: Poker 🃏♥️	2022-08-13	40	74	15	55	0.7459
Junkyard Truck	2022-07-27	390	468	126	516	0.7458
王牌对决	2022-07-28	256	427	114	370	0.7458
Road Defense: Outsiders	2022-09-23	17	58	11	28	0.7458
Qwilight	2022-06-11	48	93	20	68	0.7454000000000001
Limb Hunter	2022-03-04	3	14	1	4	0.7453000000000001
Bloody Paws Unleashed	2022-10-14	2	14	1	3	0.7453000000000001
Ad Wars	2022-05-20	4	14	1	5	0.7453000000000001
Boney's Research On Humans !	2022-08-24	2	14	1	3	0.7453000000000001
Failed Ninja Academy	2022-06-01	2	14	1	3	0.7453000000000001
流光記憶之灰 Grayscale Memories	2022-07-19	4	14	1	5	0.7453000000000001
Mango Mischief	2022-06-20	5	14	1	6	0.7453000000000001
Cool Animals	2022-06-21	3	14	1	4	0.7453000000000001
Seal of Evil	2022-01-27	4	14	1	5	0.7453000000000001
Terranova	2022-04-28	4	14	1	5	0.7453000000000001
Days with Ophelia: The Girl From Wind City	2022-03-24	3	14	1	4	0.7453000000000001
Alien Extraction	2022-03-28	5	14	1	6	0.7453000000000001
かつて私たちは地獄のまっただ中でした。	2022-01-20	18	14	1	19	0.7453000000000001
SKAZKA	2022-01-20	6	14	1	7	0.7453000000000001
Tokyo Onmyoji -The Tale of Rei Tengenjibashi-	2022-03-17	13	14	1	14	0.7453000000000001
Dawn of Kagura: Keika's Story	2022-01-08	5	14	1	6	0.7453000000000001
File Under Kingdom	2022-01-18	11	14	1	12	0.7453000000000001
Morph King	2022-08-26	2	14	1	3	0.7453000000000001
Light of Life	2022-11-14	3	14	1	4	0.7453000000000001
SlingStar	2022-01-28	3	14	1	4	0.7453000000000001
Robert: Space Stories and Battles	2022-03-08	3	14	1	4	0.7453000000000001
Covid Carl	2022-10-25	2	14	1	3	0.7453000000000001
Sweet Car Wash	2022-08-21	3	14	1	4	0.7453000000000001
StudioS Fighters: Climax Champions	2022-06-17	6	14	1	7	0.7453000000000001
Tobor Party	2022-04-24	8	14	1	9	0.7453000000000001
Square Keeper	2022-06-09	3	14	1	4	0.7453000000000001
Industrial Trouble	2022-05-08	2	14	1	3	0.7453000000000001
Moi Mei: Hidden Objects	2022-05-18	2	14	1	3	0.7453000000000001
Green Diver	2022-06-20	3	14	1	4	0.7453000000000001
Jettatura	2022-10-16	10	14	1	11	0.7453000000000001
TAXINAUT	2022-09-15	8	14	1	9	0.7453000000000001
Cats Yakuza - Online card game	2022-07-30	6	14	1	7	0.7453000000000001
All Hallows Evie	2022-10-06	3	14	1	4	0.7453000000000001
Noblesse Oblige	2022-08-25	28	14	1	29	0.7453000000000001
Superhero Girls	2022-08-24	2	14	1	3	0.7453000000000001
Ean's End	2022-09-21	5	14	1	6	0.7453000000000001
Demolish or Die	2022-11-10	6	14	1	7	0.7453000000000001
Me With Me	2022-11-03	3	14	1	4	0.7453000000000001
Two Skateboards Driving Simulator	2022-12-08	2	14	1	3	0.7453000000000001
Kalzoon	2022-11-23	2	14	1	3	0.7453000000000001
Golem Builder	2022-12-20	7	14	1	8	0.7453000000000001
WHAT THE BAT?	2022-11-17	9	37	6	15	0.7451000000000001
Sex Toys	2022-12-02	9	37	6	15	0.7451000000000001
Zerograve	2022-05-16	3	19	2	5	0.7451000000000001
Draco Knight	2022-04-25	3	19	2	5	0.7451000000000001
夢游仙境ロマネスク: Chronicles of Refugia	2022-08-27	20	19	2	22	0.7451000000000001
Legendary Tales: Сataclysm	2022-01-03	18	19	2	20	0.7451000000000001
BounceShot	2022-05-10	5	19	2	7	0.7451000000000001
Magitek VR	2022-10-11	4	19	2	6	0.7451000000000001
Catnight	2022-03-07	7	19	2	9	0.7451000000000001
Funtasia	2022-09-29	12	19	2	14	0.7451000000000001
THE GAME	2022-02-25	2	19	2	4	0.7451000000000001
The Duck Is In Danger	2022-01-11	3	19	2	5	0.7451000000000001
Phonetic	2022-02-25	4	19	2	6	0.7451000000000001
ALAN-13 Reformation	2022-05-11	17	19	2	19	0.7451000000000001
The Quintessential Quintuplets OMOIDE VR ~ITSUKI~	2022-10-13	14	19	2	16	0.7451000000000001
无神塔	2022-05-13	3	19	2	5	0.7451000000000001
Neko Girls	2022-08-25	3	19	2	5	0.7451000000000001
CyberHeroes Arena	2022-09-27	4	19	2	6	0.7451000000000001
Jigsaw Puzzle Best Places	2022-12-16	11	19	2	13	0.7451000000000001
Hentai Miko	2022-12-30	4	19	2	6	0.7451000000000001
Sker Ritual	2022-10-06	237	401	107	344	0.745
EBOLA 3	2022-09-18	60	199	49	109	0.745
RUINSMAGUS	2022-07-07	56	119	27	83	0.7449
Fargone	2022-12-23	54	104	23	77	0.7449
Omega Pilot	2022-09-02	9	77	16	25	0.7444
Mythicard	2022-11-06	23	41	7	30	0.7444
Acolyte	2022-06-28	15	41	7	22	0.7444
171	2022-11-17	1266	1861	556	1822	0.7441
Bail or Jail	2022-07-21	72	133	31	103	0.7441
Cute BAR	2022-01-06	4	28	4	8	0.7441
Dadish 3	2022-06-14	7	28	4	11	0.7441
The Tale of Onogoro	2022-09-28	10	28	4	14	0.7441
Hi Eggplant!	2022-09-16	5	28	4	9	0.7441
Villain's Legacy	2022-12-13	82	69	14	96	0.7440000000000001
Flock of Dogs	2022-11-30	24	61	12	36	0.7438
Race Condition	2022-03-01	7	61	12	19	0.7438
Goo Gladiators	2022-09-22	25	61	12	37	0.7438
Car Detailing Simulator	2022-04-13	1165	455	124	1289	0.7437
IFO	2022-05-19	14	53	10	24	0.7437
Outnumbered	2022-09-09	54	125	29	83	0.7434000000000001
Extremely Realistic Siege Warfare Simulator	2022-09-08	103	84	18	121	0.7434000000000001
Soundfall	2022-05-11	665	679	192	857	0.7431
Cyphers Game	2022-04-21	61	362	97	158	0.7431
Trash Patrol - Academic Version	2022-05-17	53	80	17	70	0.7431
Perseus: Titan Slayer - Free Trial	2022-11-16	1366	543	151	1517	0.743
Tracery of Fate	2022-07-29	10	95	21	31	0.7429000000000001
Mirror Forge	2022-12-06	38	95	21	59	0.7429000000000001
The Doll's Window	2022-09-20	10	32	5	15	0.7428
Baldur's Gate: Dark Alliance II	2022-07-20	638	327	87	725	0.7426
Like an Angel	2022-02-11	312	171	42	354	0.7426
Stranded Deep	2022-08-11	6036	30084	9874	15910	0.7425
Amazing Frog ? V3	2022-06-16	67	234	60	127	0.7425
风色旅人	2022-11-18	247	461	127	374	0.7424
Ascend- Reborn	2022-12-01	563	444	122	685	0.7423000000000001
Technicity	2022-09-15	103	113	26	129	0.7422
Legend of Kendor	2022-12-02	28	23	3	31	0.742
My Master's A Moron	2022-06-02	10	23	3	13	0.742
Medusa's Heart of Stone Chapter 01	2022-03-15	4	23	3	7	0.742
Cyclone	2022-06-23	4	23	3	7	0.742
Visionarium 2 - The Descent	2022-06-20	4	23	3	7	0.742
Extinction Eclipse	2022-11-17	4	23	3	7	0.742
Airport Administrator Simulator	2022-05-14	2	23	3	5	0.742
Quest Together	2022-12-24	15	64	13	28	0.7419
Tim-Tim 2	2022-05-09	2	8	0	2	0.7419
Effigy	2022-05-12	2	8	0	2	0.7419
Cock Soccer	2022-02-03	3	8	0	3	0.7419
Maggie the Magnet	2022-07-18	4	8	0	4	0.7419
Bounty	2022-06-16	5	8	0	5	0.7419
RainyCloud	2022-11-11	2	8	0	2	0.7419
Smash Crates	2022-06-06	4	8	0	4	0.7419
CAN ANDROIDS SURVIVE	2022-06-28	3	8	0	3	0.7419
We Are Live	2022-05-02	4	8	0	4	0.7419
Mezzanine	2022-10-07	4	8	0	4	0.7419
Cycled	2022-07-11	10	8	0	10	0.7419
A Mirror Puzzle	2022-07-15	2	8	0	2	0.7419
System Under Surveillance	2022-02-25	3	8	0	3	0.7419
Cepheus Protocol Anthology Season 1	2022-05-12	5	8	0	5	0.7419
Strange Investigations: Becoming Collector's Edition	2022-06-17	15	8	0	15	0.7419
History of Football World Cup	2022-05-12	2	8	0	2	0.7419
Whispers of Ancient Stone	2022-03-18	4	8	0	4	0.7419
Sword of Elpisia	2022-01-07	20	8	0	20	0.7419
Gem Rifts	2022-01-28	3	8	0	3	0.7419
Elemgate	2022-07-08	1	8	0	1	0.7419
HatMania	2022-11-15	3	8	0	3	0.7419
Love Accident	2022-01-07	2	8	0	2	0.7419
Galactic Racing Online	2022-03-08	4	8	0	4	0.7419
Rambell	2022-12-15	6	8	0	6	0.7419
月光のソードブレイカー ミナト編	2022-01-25	2	8	0	2	0.7419
Super Perils of Baking	2022-06-03	5	8	0	5	0.7419
Running on Empty	2022-09-10	4	8	0	4	0.7419
Athemore	2022-04-10	2	8	0	2	0.7419
Square Knight	2022-04-30	3	8	0	3	0.7419
Polar Bear Riding A Ninja	2022-06-01	2	8	0	2	0.7419
TumbleWeed	2022-05-13	3	8	0	3	0.7419
Mindfulness Simulator - ASMR Meditation Game	2022-06-21	3	8	0	3	0.7419
Space MOLMAE	2022-06-05	3	8	0	3	0.7419
The Detroit After	2022-12-16	2	8	0	2	0.7419
Sheep's Territory	2022-03-29	3	8	0	3	0.7419
Vayan	2022-11-30	9	8	0	9	0.7419
[Speer DX]	2022-06-03	4	8	0	4	0.7419
Rocket Mania	2022-06-18	3	8	0	3	0.7419
Chaos Law	2022-04-19	3	8	0	3	0.7419
Ukko & Guará: Stellarbound	2022-09-29	3	8	0	3	0.7419
Four Course Dungeon	2022-05-27	5	8	0	5	0.7419
Lenny Loosejocks in Space	2022-11-01	5	8	0	5	0.7419
Eternal Samurai	2022-05-31	2	8	0	2	0.7419
BEWBEWBEW	2022-06-12	4	8	0	4	0.7419
EpicRecovery	2022-06-15	4	8	0	4	0.7419
Otaku Engine	2022-12-01	5	8	0	5	0.7419
Plop Saga	2022-06-29	2	8	0	2	0.7419
LEEN	2022-06-17	10	8	0	10	0.7419
Immortelle	2022-11-15	2	8	0	2	0.7419
Wreck the Fed	2022-06-24	2	8	0	2	0.7419
Midnight Zone	2022-08-04	2	8	0	2	0.7419
Radii	2022-07-29	5	8	0	5	0.7419
Space Monkeys	2022-07-16	3	8	0	3	0.7419
The Empanada Protocol	2022-07-29	4	8	0	4	0.7419
Chicken Fall Prologue	2022-07-22	88	8	0	88	0.7419
Jelly In The Dark	2022-12-21	3	8	0	3	0.7419
NYYO	2022-07-27	3	8	0	3	0.7419
GirlPuzzle	2022-08-25	3	8	0	3	0.7419
Gummy Jump	2022-08-02	3	8	0	3	0.7419
European Football Dynasty 23	2022-09-22	7	8	0	7	0.7419
Super Casual Ultimate Fight Fest (Extra Deluxe)	2022-09-09	7	8	0	7	0.7419
Hidden in the Dark	2022-08-05	2	8	0	2	0.7419
Tiles II - Multiplayer	2022-08-12	7	8	0	7	0.7419
Drunk: Relapsed	2022-11-04	4	8	0	4	0.7419
Super Ball Mania	2022-08-15	5	8	0	5	0.7419
Synthalaxy	2022-09-10	3	8	0	3	0.7419
Flowers of Satsunai	2022-11-18	5	8	0	5	0.7419
CAPTROON	2022-08-23	2	8	0	2	0.7419
Interquel幕間折	2022-08-26	1	8	0	1	0.7419
Cosmotica	2022-09-02	3	8	0	3	0.7419
锻灵ElementForger	2022-09-22	3	8	0	3	0.7419
Dungeon in a Bottle	2022-10-24	5	8	0	5	0.7419
Ceaseless Night	2022-12-01	5	8	0	5	0.7419
Quarterstaff	2022-12-27	4	8	0	4	0.7419
Super Anime Waifu BBQ Simulator	2022-09-22	2	8	0	2	0.7419
New Yankee: Karma Tales	2022-12-28	36	8	0	36	0.7419
Input Chaos	2022-09-20	4	8	0	4	0.7419
Cage of Etha	2022-09-19	2	8	0	2	0.7419
A Smooth Game (Unlike... Life) 	2022-10-04	2	8	0	2	0.7419
流離之歌	2022-11-16	4	8	0	4	0.7419
Ballspell	2022-10-04	4	8	0	4	0.7419
I commissioned some bees 7	2022-09-30	8	8	0	8	0.7419
PHYAKH	2022-10-18	7	8	0	7	0.7419
Running into the Cyberpunk	2022-10-03	2	8	0	2	0.7419
SEARCH ALL - KEYS	2022-10-04	2	8	0	2	0.7419
Lost Amulets: Mystic Land	2022-10-03	5	8	0	5	0.7419
Quiz.com	2022-10-11	7	8	0	7	0.7419
Boo!	2022-10-17	6	8	0	6	0.7419
Step By Step Hero	2022-10-24	2	8	0	2	0.7419
Rift Rangers	2022-12-08	12	8	0	12	0.7419
I commissioned some bees 10	2022-11-17	6	8	0	6	0.7419
BOT.vinnik Chess: Prodigies	2022-10-27	2	8	0	2	0.7419
Theocracy	2022-11-25	4	8	0	4	0.7419
HellRazor64	2022-11-17	3	8	0	3	0.7419
Orbit	2022-12-07	5	8	0	5	0.7419
Surrealidade - Definitive Edition	2022-12-08	2	8	0	2	0.7419
One Wheel Guy	2022-11-30	19	8	0	19	0.7419
抵御者 Defender	2022-12-02	2	8	0	2	0.7419
WHERE IS A TOILET!?	2022-12-12	2	8	0	2	0.7419
Blacklight	2022-12-29	8	8	0	8	0.7419
Kaichu - A Kaiju Dating Sim	2022-09-07	31	60	12	43	0.7417
The Last Queen in the Wizard Kingdom	2022-03-24	26	40	7	33	0.7415999999999999
MY WOLF - Desktop Wild Pet	2022-06-11	83	152	37	120	0.7415
Again and Again	2022-09-15	8	56	11	19	0.7415
Escape First Alchemist: Prologue	2022-11-11	9	56	11	20	0.7415
Tactics Ogre: Reborn	2022-11-11	10677	1913	582	11259	0.7414000000000001
Ikai	2022-03-29	75	159	39	114	0.7414000000000001
Obsidian Prince	2022-05-24	108	105	24	132	0.7414000000000001
Sea Horizon	2022-10-20	83	105	24	107	0.7414000000000001
风色幻想4:圣战的终焉	2022-08-09	56	44	8	64	0.7414000000000001
In Woods	2022-11-23	35	44	8	43	0.7414000000000001
MEGA	2022-09-02	8	44	8	16	0.7414000000000001
Serious Sam: Tormental	2022-04-08	47	162	40	87	0.741
Deadwater Saloon Prologue	2022-08-04	111	112	26	137	0.741
SPACE ACCIDENT	2022-02-10	378	101	23	401	0.741
Out of Ore	2022-10-31	314	340	92	406	0.7409
天仙月	2022-07-13	112	137	33	145	0.7408
雪之本境S	2022-04-29	84	346	94	178	0.7406
Among Us VR	2022-11-10	1144	1541	467	1611	0.7403000000000001
European Air War	2022-06-16	6	27	4	10	0.7403000000000001
Lulu's Temple	2022-04-14	5	27	4	9	0.7403000000000001
Mouse People	2022-09-15	5	27	4	9	0.7403000000000001
Fly Fly Tuk Tuk	2022-08-08	3	27	4	7	0.7403000000000001
Asian Cargo Sim	2022-11-04	3	27	4	7	0.7403000000000001
Cantata	2022-05-12	62	63	13	75	0.74
Aladdin : Save The Princess	2022-02-23	4	18	2	6	0.74
Cato, the cat	2022-01-21	5	18	2	7	0.74
My Cute Girls	2022-01-06	3	18	2	5	0.74
GwenBlade	2022-02-07	2	18	2	4	0.74
Doki Doki House	2022-12-01	9	18	2	11	0.74
King Rabbit - Race	2022-06-22	10	18	2	12	0.74
Wet Cute Girls	2022-07-22	3	18	2	5	0.74
Molecule Make lab	2022-05-13	5	18	2	7	0.74
Blocks of Nature	2022-09-26	9	18	2	11	0.74
Super Geisha Neon	2022-12-07	4	18	2	6	0.74
cheesequest	2022-08-16	5	18	2	7	0.74
Mythic Frost Trials	2022-09-08	7	18	2	9	0.74
Degen Royale	2022-11-03	42	18	2	44	0.74
The Legend Of Tiger And Phoenix	2022-11-04	3	18	2	5	0.74
xdding	2022-12-23	3	18	2	5	0.74
My Grandparents Christmas Mystery	2022-12-30	3	18	2	5	0.74
Maurice: In The Predator's Nest	2022-12-05	221	503	142	363	0.7399
WW2: Bunker Simulator 	2022-10-10	92	199	51	143	0.7399
Serafina and the Key to the Egg	2022-06-25	169	78	17	186	0.7398
Black One Blood Brothers	2022-01-11	89	407	113	202	0.7397
Builder Simulator	2022-06-09	1571	850	250	1821	0.7395999999999999
PearPhone.io	2022-06-17	23	59	12	35	0.7395999999999999
Arcadius	2022-02-17	317	576	165	482	0.7394
Destroy All Humans! 2 - Reprobed	2022-08-30	2870	1297	392	3262	0.7393000000000001
Lords of Solgrund	2022-02-21	9	31	5	14	0.7393000000000001
Adventure of Leek	2022-02-24	7	31	5	12	0.7393000000000001
Legend of Edda Brasil	2022-12-26	25	31	5	30	0.7393000000000001
Lazy Galaxy 2	2022-03-15	444	114	27	471	0.7391
AQtion	2022-06-01	104	242	64	168	0.7390000000000001
SudoKube	2022-05-23	20	35	6	26	0.7389
Oppai Puzzle L	2022-07-21	5	35	6	11	0.7389
Sector Sweep	2022-11-03	12	13	1	13	0.7389
Strawhart	2022-03-11	7	13	1	8	0.7389
Rotatex 3	2022-12-09	2	13	1	3	0.7389
Programmer Dungeon	2022-09-22	5	13	1	6	0.7389
Nikola Tesla: War of the Currents	2022-05-12	17	13	1	18	0.7389
GearHead Caramel	2022-07-22	4	13	1	5	0.7389
Hyper-5	2022-01-28	4	13	1	5	0.7389
Soul Light	2022-08-19	3	13	1	4	0.7389
PAPER BIRDS	2022-02-20	3	13	1	4	0.7389
Die, A.I.	2022-12-05	3	13	1	4	0.7389
Starship Wars	2022-01-18	2	13	1	3	0.7389
Rise Of Enigmas	2022-02-08	4	13	1	5	0.7389
隐刺	2022-01-19	6	13	1	7	0.7389
CYBERSTELLAR	2022-04-08	2	13	1	3	0.7389
whale.	2022-02-27	4	13	1	5	0.7389
The Bad Son	2022-10-26	2	13	1	3	0.7389
Iku Iku Succubus	2022-07-19	5	13	1	6	0.7389
The Dark Realm	2022-03-22	6	13	1	7	0.7389
Haunted Hotel: The Thirteenth Collector's Edition	2022-03-14	10	13	1	11	0.7389
Light Bringer	2022-09-23	4	13	1	5	0.7389
Island of Aito	2022-05-09	4	13	1	5	0.7389
BYTE CATS	2022-10-19	3	13	1	4	0.7389
Stack by stack	2022-06-20	2	13	1	3	0.7389
不思議の大冒険 チルノ見参!	2022-12-26	29	13	1	30	0.7389
Rhythm Stones	2022-10-25	9	13	1	10	0.7389
Primordial Pain	2022-10-31	5	13	1	6	0.7389
Chinese Characters	2022-11-30	4	13	1	5	0.7389
Dwarfer	2022-11-21	2	13	1	3	0.7389
Interplayer	2022-11-25	8	13	1	9	0.7389
Don't Steal My Christmas!	2022-12-21	7	13	1	8	0.7389
Stones Keeper: King Aurelius	2022-07-14	163	128	31	194	0.7388
Backrooms: Escape Together	2022-10-18	248	975	291	539	0.7387
Retro Commander	2022-05-11	58	92	21	79	0.7387
Hello Puppets: Midnight Show	2022-10-19	36	43	8	44	0.7387
Rendezvous: Shadows of the Past	2022-05-26	9	43	8	17	0.7387
Who's Who?	2022-08-29	560	275	74	634	0.7386
Wayward Harbor	2022-02-25	14	81	18	32	0.7386
Eva: Final Mission	2022-09-30	51	81	18	69	0.7386
American Theft 80s	2022-06-15	773	479	136	909	0.7384999999999999
Yi Xian: The Cultivation Card Game	2022-12-07	10818	2164	675	11493	0.7383
Monark	2022-02-22	177	124	30	207	0.7383
Sweet Transit	2022-07-28	1210	507	145	1355	0.7382
ELEX II	2022-03-01	8233	3640	1161	9394	0.7381000000000001
Ring of Titans	2022-02-28	430	294	80	510	0.7381000000000001
MergeCrafter	2022-08-23	307	307	84	391	0.7379000000000001
Ultimate Fishing Simulator 2	2022-08-22	924	787	233	1157	0.7378
Vade Retro : Exorcist	2022-10-28	834	653	191	1025	0.7377
Aquaculture Land	2022-12-22	14	134	33	47	0.7377
Drone Wars	2022-03-11	53	84	19	72	0.7376
The Fantasy World of Mahjong Princess	2022-05-12	133	84	19	152	0.7376
AZUR BEAM	2022-04-01	21	102	24	45	0.7375
20b	2022-02-09	5	58	12	17	0.7375
Mimicry	2022-08-25	20	58	12	32	0.7375
Space Crusaders	2022-08-18	7	22	3	10	0.7375
Chaos Chain	2022-01-28	3	22	3	6	0.7375
Sigil of the Magi	2022-10-20	15	22	3	18	0.7375
阿龙与地下城	2022-03-04	3	22	3	6	0.7375
Final Space - The Rescue	2022-02-02	5	22	3	8	0.7375
Vamps For The Memories	2022-03-10	7	22	3	10	0.7375
Purgatory Dungeoneer	2022-10-06	9	22	3	12	0.7375
Mini Mecum	2022-05-02	3	22	3	6	0.7375
Archery Simulator	2022-09-21	2	22	3	5	0.7375
Hentai CyberGirl	2022-12-19	5	22	3	8	0.7375
Burg	2022-07-10	259	661	194	453	0.7373000000000001
Avani	2022-11-19	15	175	45	60	0.7373000000000001
Axis Football 2023	2022-09-07	77	175	45	122	0.7373000000000001
RitualSummon	2022-05-18	36	109	26	62	0.7373000000000001
No More Money	2022-12-27	564	348	97	661	0.7371
Spirit Hunters: Infinite Horde	2022-05-25	1816	905	273	2089	0.7363
Nelson and the Magic Cauldron: The Journey	2022-01-28	4	26	4	8	0.7363
Tiny Football	2022-11-15	11	26	4	15	0.7363
Dungeons & Dragons: Dark Sun Series	2022-03-29	31	26	4	35	0.7363
Elevator Action™ -Returns- S-Tribute	2022-11-30	10	26	4	14	0.7363
枝江小镇	2022-07-14	6	26	4	10	0.7363
F*ckable Kim	2022-09-05	3	26	4	7	0.7363
No men in this house	2022-11-05	3	26	4	7	0.7363
Wheel Of Naughtiness	2022-11-20	5	26	4	9	0.7363
WitchCraft TD	2022-10-02	5	26	4	9	0.7363
PumPum	2022-03-04	434	488	141	575	0.7362000000000001
Neodori Forever	2022-06-15	13	46	9	22	0.7362000000000001
Zombie Arena	2022-10-15	15	46	9	24	0.7362000000000001
Knights of Honor II: Sovereign	2022-12-06	6061	2212	701	6762	0.7359
Fap Goddess	2022-12-15	229	280	77	306	0.7359
会计模拟器	2022-11-22	123	61	13	136	0.7359
Anime Studio Story	2022-08-08	25	42	8	33	0.7359
Cult Of Babel : Prologue	2022-08-15	46	42	8	54	0.7359
STALCRAFT	2022-12-09	9097	11603	3879	12976	0.7358
Hitler Loves Anime	2022-01-20	5	72	16	21	0.7358
The Atlas Mystery: A VR Puzzle Game	2022-04-13	8	38	7	15	0.7356999999999999
史小坑花前月下	2022-12-29	26	38	7	33	0.7356999999999999
Trapped In Stone	2022-03-02	3	30	5	8	0.7356999999999999
Shapebreaker - Tower Defense Deckbuilder	2022-07-19	17	30	5	22	0.7356999999999999
Moth Lake	2022-12-03	13	30	5	18	0.7356999999999999
轻语谱	2022-07-01	10	34	6	16	0.7356
Five Nights at Sexy's	2022-07-15	3	34	6	9	0.7356
Forgive My SIns & Desires, Father	2022-10-22	9	34	6	15	0.7356
Party Pie	2022-08-27	17	57	12	29	0.7353000000000001
Golden Light of Rose	2022-10-24	676	186	49	725	0.7352
Imp of the Sun	2022-03-24	20	68	15	35	0.7352
Floor is Water	2022-03-18	17	86	20	37	0.7351000000000001
Steelrising	2022-09-08	2804	2092	665	3469	0.735
Evil West	2022-11-21	4594	3773	1229	5823	0.7347
AmongUs Challenger	2022-12-21	18	64	14	32	0.7345
Acretia - Guardians of Lian	2022-10-14	31	64	14	45	0.7345
Fingerbang: All Bullets Pointin'	2022-12-09	15	64	14	29	0.7345
Cosmic collapse	2022-02-10	2	17	2	4	0.7345
Forever Someday	2022-12-31	2	17	2	4	0.7345
RESEARCH and DESTROY	2022-04-25	10	17	2	12	0.7345
Last Gang Standing	2022-10-24	6	17	2	8	0.7345
Red Wings: American Aces	2022-03-31	17	17	2	19	0.7345
巫女契约	2022-10-07	4	17	2	6	0.7345
Everdine - A Lost Girl's Tale	2022-11-18	5	17	2	7	0.7345
Melodier	2022-03-18	6	17	2	8	0.7345
Cat Swap Tiles	2022-01-19	3	17	2	5	0.7345
Kokoro Clover Season1	2022-08-03	10	17	2	12	0.7345
From Heaven To Earth	2022-02-18	7	17	2	9	0.7345
Glamor & Girls	2022-02-17	3	17	2	5	0.7345
My Lovely Girls	2022-01-19	3	17	2	5	0.7345
Samurai of Hyuga Book 5	2022-09-01	68	17	2	70	0.7345
Snips & Snails	2022-02-01	5	17	2	7	0.7345
Ghost Castle	2022-02-23	7	17	2	9	0.7345
Mark's Magnificent Marble Maze	2022-08-02	6	17	2	8	0.7345
Natal Perdido	2022-04-21	3	17	2	5	0.7345
Pretty Girls Escape	2022-06-03	5	17	2	7	0.7345
Revenge of the Orcs: Flag of Conquest	2022-08-12	6	17	2	8	0.7345
The Futanati	2022-09-01	4	17	2	6	0.7345
The Wire Man	2022-07-21	6	17	2	8	0.7345
Witch Amelia	2022-10-21	7	17	2	9	0.7345
Easy Simple Game	2022-09-08	6	17	2	8	0.7345
FunnyPizzaLand	2022-10-08	2	17	2	4	0.7345
Fury of West	2022-10-14	3	17	2	5	0.7345
The Bogtavern	2022-12-30	3	17	2	5	0.7345
World of Haiku	2022-07-22	48	82	19	67	0.7343999999999999
Total War: WARHAMMER III	2022-02-17	166754	49835	17268	184022	0.7341
晴末置雨	2022-07-21	51	221	60	111	0.7341
 Симулятор Прыгания по Гаражам 	2022-12-23	60	452	132	192	0.7337
Recipe for Disaster	2022-08-05	307	436	127	434	0.7337
Cafe Owner Simulator: Prologue	2022-06-21	359	458	134	493	0.7336
MeiQi 2022	2022-09-06	24	85	20	44	0.7334999999999999
MotoGP™22	2022-04-21	673	676	204	877	0.7334
Fray Fight	2022-06-10	620	495	146	766	0.7333
Broken Pieces	2022-09-09	171	200	54	225	0.7332
Downtown Jam	2022-07-11	14	56	12	26	0.7331000000000001
Click To Sail	2022-09-29	9	41	8	17	0.733
Food Girls - Bubbles' Drink Stand	2022-07-19	15	102	25	40	0.7328
Lonesome Village	2022-11-01	66	88	21	87	0.7327
DARK MINUTE: Kira's Adventure	2022-01-20	3	21	3	6	0.7327
Barton Lynch Pro Surfing	2022-04-07	9	21	3	12	0.7327
FRAGROOM: Defenders	2022-02-03	12	21	3	15	0.7327
Parasite	2022-03-25	7	21	3	10	0.7327
Be	2022-08-01	5	21	3	8	0.7327
Locked in my darkness	2022-12-09	4	21	3	7	0.7327
Paranormal Observation	2022-10-25	8	21	3	11	0.7327
The Black Knight	2022-12-07	3	21	3	6	0.7327
Musical Range	2022-06-07	2	7	0	2	0.7326
Moonbase Down	2022-02-22	2	7	0	2	0.7326
Rotund Rebound	2022-04-01	3	7	0	3	0.7326
Rencia	2022-02-14	2	7	0	2	0.7326
Monster Breakout	2022-08-16	2	7	0	2	0.7326
GameLab UngAalborg	2022-09-08	4	7	0	4	0.7326
The Hero with a Thousand Arms	2022-12-27	2	7	0	2	0.7326
Time Patrol	2022-02-10	3	7	0	3	0.7326
Super Marxist Twins	2022-03-25	3	7	0	3	0.7326
Fillit	2022-06-02	4	7	0	4	0.7326
Tales From The Cache	2022-03-06	3	7	0	3	0.7326
Aquillanto	2022-10-13	1	7	0	1	0.7326
Nilspace	2022-12-05	5	7	0	5	0.7326
Purry Furry Adventurry	2022-02-08	2	7	0	2	0.7326
Coldage	2022-07-01	2	7	0	2	0.7326
On The Earth Shift :)	2022-02-21	2	7	0	2	0.7326
Dodge Dots	2022-02-02	18	7	0	18	0.7326
Happy Bones Infernal	2022-03-14	4	7	0	4	0.7326
Alec Adventure	2022-10-27	2	7	0	2	0.7326
Jumphobia: Homeward Bound	2022-04-06	5	7	0	5	0.7326
Boris the Sloth	2022-03-04	2	7	0	2	0.7326
UfoTofU Hex	2022-01-21	3	7	0	3	0.7326
Last Space Guardian	2022-02-12	2	7	0	2	0.7326
Blackjack Avenue	2022-06-21	2	7	0	2	0.7326
Tear of Time: Lost memory	2022-03-01	4	7	0	4	0.7326
ONE WAY	2022-02-18	2	7	0	2	0.7326
NEW TERRA	2022-05-06	1	7	0	1	0.7326
G-MODEアーカイブス+ 弾幕検定死験-大往生編-	2022-01-20	6	7	0	6	0.7326
How to Take Off Your Mask Remastered	2022-03-04	3	7	0	3	0.7326
Let's Cook	2022-01-10	5	7	0	5	0.7326
BOK	2022-01-14	3	7	0	3	0.7326
Groove Fit Island!!	2022-06-14	4	7	0	4	0.7326
Trigger Dungeon	2022-01-18	2	7	0	2	0.7326
Axiallis	2022-01-20	2	7	0	2	0.7326
Novalie	2022-03-19	2	7	0	2	0.7326
Hell Mission	2022-01-31	1	7	0	1	0.7326
Relics 2: The Crusader's Tomb	2022-04-08	8	7	0	8	0.7326
Avatar Raiders	2022-02-25	7	7	0	7	0.7326
Path to Ruin	2022-10-07	2	7	0	2	0.7326
A2 Zygon	2022-12-01	3	7	0	3	0.7326
Ink'n'Think	2022-03-11	2	7	0	2	0.7326
Robot-X	2022-11-25	2	7	0	2	0.7326
Little Ninja	2022-04-15	2	7	0	2	0.7326
M-1グランプリへの道　～俺たちの出囃子はもう鳴っている～	2022-03-24	8	7	0	8	0.7326
The Breadmaker	2022-06-06	2	7	0	2	0.7326
Horse and Go Seek	2022-04-21	2	7	0	2	0.7326
Oh Sheep!	2022-09-14	3	7	0	3	0.7326
SOOT	2022-05-27	3	7	0	3	0.7326
JellyMen	2022-04-23	4	7	0	4	0.7326
Entomophobia	2022-04-16	3	7	0	3	0.7326
PLASMATIC	2022-06-22	5	7	0	5	0.7326
Epic Vampire	2022-04-07	2	7	0	2	0.7326
polyemisokos	2022-06-23	3	7	0	3	0.7326
Recreation Room	2022-06-21	2	7	0	2	0.7326
Magic Tower (Destroy the Wormhole)	2022-04-26	3	7	0	3	0.7326
Mini Island: Cosmos	2022-07-01	3	7	0	3	0.7326
Bunny Hop : Eggstreme	2022-11-10	5	7	0	5	0.7326
Plank Road	2022-12-09	3	7	0	3	0.7326
Jacks or Better - Video Poker	2022-04-28	3	7	0	3	0.7326
AISZplus	2022-06-11	4	7	0	4	0.7326
Meteor Blasters	2022-04-29	4	7	0	4	0.7326
The Struggle of Combat	2022-05-06	2	7	0	2	0.7326
Some Synergy	2022-08-05	8	7	0	8	0.7326
Ukraine Defender	2022-05-12	1	7	0	1	0.7326
The Liminal	2022-05-10	2	7	0	2	0.7326
The Finally รักเราชั่วนิรันดร์	2022-05-18	2	7	0	2	0.7326
SANONTA - Finnish Proverb Game	2022-12-06	3	7	0	3	0.7326
Space Aces	2022-07-02	2	7	0	2	0.7326
Pentomino	2022-05-31	4	7	0	4	0.7326
Eat Fish, Get Achievements	2022-10-09	5	7	0	5	0.7326
God Edge	2022-05-31	3	7	0	3	0.7326
Mida's Adventure	2022-06-06	1	7	0	1	0.7326
Snacky Tower	2022-09-13	3	7	0	3	0.7326
AI UNDER TEST	2022-06-13	2	7	0	2	0.7326
Pizza Death	2022-07-09	3	7	0	3	0.7326
180 SECONDS	2022-09-10	2	7	0	2	0.7326
Shadow of Asha	2022-06-09	4	7	0	4	0.7326
Retrowave Rider	2022-10-18	2	7	0	2	0.7326
曦Lost Girl	2022-07-14	3	7	0	3	0.7326
Nightly Maintenance	2022-06-28	2	7	0	2	0.7326
A Game with a Kitty 1 & 2	2022-06-28	3	7	0	3	0.7326
Limited Lifetime Corp	2022-08-12	4	7	0	4	0.7326
Kokoro's Gensokyo Journey: The Lost Masks	2022-07-02	2	7	0	2	0.7326
Bomb Dolls	2022-07-13	3	7	0	3	0.7326
One Week By Car	2022-07-22	3	7	0	3	0.7326
ROGUELINE	2022-08-05	5	7	0	5	0.7326
Protocol Xeno	2022-08-13	4	7	0	4	0.7326
Spectre Of Eternity	2022-08-04	2	7	0	2	0.7326
Myth of Mirka	2022-07-28	2	7	0	2	0.7326
Furry Android Hentai	2022-08-01	4	7	0	4	0.7326
The Dancer - Definitive Edition	2022-08-01	2	7	0	2	0.7326
SONOHIGURASHI VS. TOUHOU UNIVERSE2	2022-08-25	3	7	0	3	0.7326
An Opportunity	2022-09-09	4	7	0	4	0.7326
minschima	2022-09-07	2	7	0	2	0.7326
The Top	2022-09-02	3	7	0	3	0.7326
Roll On Dice	2022-09-12	3	7	0	3	0.7326
Dodge	2022-08-14	3	7	0	3	0.7326
DreamCell: Lost in Nightmares	2022-11-25	3	7	0	3	0.7326
Lovelust: Project Stockholm	2022-09-16	6	7	0	6	0.7326
Ice Nosfe	2022-12-21	1	7	0	1	0.7326
Elves Christmas Hentai Puzzle	2022-12-16	4	7	0	4	0.7326
Detective tales: A Study in Scarlet	2022-10-31	4	7	0	4	0.7326
Crescent Cauldron Cafe	2022-09-12	3	7	0	3	0.7326
Survive The Troll	2022-10-05	7	7	0	7	0.7326
Lofi Waifu Jigsaw	2022-09-16	3	7	0	3	0.7326
Saga Cube	2022-12-17	3	7	0	3	0.7326
末日竟在我身边3 - Zombies Everywhere 3	2022-10-01	4	7	0	4	0.7326
Clutter's Greatest Hits - Collector's Edition	2022-12-07	11	7	0	11	0.7326
Space Cheetah Hyper Runner	2022-10-31	2	7	0	2	0.7326
Robot Programmer	2022-12-06	4	7	0	4	0.7326
Blessed Work	2022-12-20	5	7	0	5	0.7326
キミもvtuberにならないか？	2022-10-31	3	7	0	3	0.7326
Many Minigames	2022-11-22	2	7	0	2	0.7326
SEARCH ALL - BUDS	2022-11-08	2	7	0	2	0.7326
Metal March	2022-12-02	3	7	0	3	0.7326
Arenamania	2022-12-10	2	7	0	2	0.7326
Shanubis	2022-10-31	1040	7	0	1040	0.7326
Lie of Caelum	2022-12-12	6	7	0	6	0.7326
Princess Cage	2022-12-02	3	7	0	3	0.7326
Stray Cat Doors2	2022-12-19	3	7	0	3	0.7326
Project Survivor	2022-12-13	4	7	0	4	0.7326
Bavovna included!	2022-11-19	3	7	0	3	0.7326
Space Moonshiner	2022-12-07	3	7	0	3	0.7326
Dungeon: Faster & Deadlier	2022-12-13	23	37	7	30	0.7325
原点计划：序章	2022-12-02	117	37	7	124	0.7325
Age of Undead	2022-07-26	14	52	11	25	0.7323999999999999
MILF Conditioning	2022-12-06	192	139	36	228	0.7322
彷徨之街 The Street of Adrift	2022-09-01	1109	1158	364	1473	0.7321
Equinoxe	2022-02-18	7	33	6	13	0.7321
JAM GODS	2022-07-18	10	33	6	16	0.7321
Village of Zombies	2022-05-06	7	33	6	13	0.7321
Desktop Mars	2022-07-30	18	33	6	24	0.7321
War of Wizards	2022-09-21	12	33	6	18	0.7321
Home Run High	2022-10-11	109	33	6	115	0.7321
Labyrinth: The War on Terror	2022-10-21	66	98	24	90	0.7320000000000001
Ephemeral Tale	2022-01-18	7	25	4	11	0.7320000000000001
MetaCard：The Turing Test	2022-09-23	6	25	4	10	0.7320000000000001
Colors! Maze 2	2022-03-16	4	25	4	8	0.7320000000000001
Ody Mos	2022-07-14	7	25	4	11	0.7320000000000001
Hanako in the abandoned school	2022-06-30	14	25	4	18	0.7320000000000001
Quriocity	2022-10-14	10	25	4	14	0.7320000000000001
异世界的回响千雪之歌	2022-08-18	7	25	4	11	0.7320000000000001
Void Scrappers Prologue	2022-09-06	21	25	4	25	0.7320000000000001
Pumpkin Ripper	2022-12-16	5	25	4	9	0.7320000000000001
From The Rain	2022-12-20	4	25	4	8	0.7320000000000001
Runic	2022-09-30	111	132	34	145	0.7319
Attack of the Giant Crab	2022-01-28	17	29	5	22	0.7319
看谁先死	2022-03-01	4	29	5	9	0.7319
Wild Castle	2022-11-04	11	12	1	12	0.7319
The Dark Heart of Balor	2022-08-04	4	12	1	5	0.7319
RavenWeald	2022-09-08	5	12	1	6	0.7319
Russian Prison Tattoo Simulator	2022-04-15	2	12	1	3	0.7319
God of Riffs	2022-09-21	4	12	1	5	0.7319
Hex of the Lich	2022-07-29	8	12	1	9	0.7319
Crystal Plague	2022-08-30	3	12	1	4	0.7319
Burning Horns: A Bara Isekai JRPG	2022-03-04	5	12	1	6	0.7319
Relash	2022-03-29	6	12	1	7	0.7319
Lost but Lucid	2022-09-16	3	12	1	4	0.7319
Archery Land	2022-09-02	4	12	1	5	0.7319
Mysteria of the World: The forest of Death	2022-02-19	4	12	1	5	0.7319
Tor-tor cubes	2022-01-19	2	12	1	3	0.7319
The Sinking Structure, Clione, and Lost Child	2022-02-16	3	12	1	4	0.7319
Yoko Redux: Dreams	2022-07-29	2	12	1	3	0.7319
树莓战记	2022-02-14	4	12	1	5	0.7319
Dere-chat	2022-05-05	2	12	1	3	0.7319
Sahara's Underworld	2022-05-02	2	12	1	3	0.7319
SECOND WORLD	2022-03-08	4	12	1	5	0.7319
Mad Murder's Mystery Pie Shop	2022-04-11	2	12	1	3	0.7319
Pizza Synthwave	2022-05-03	3	12	1	4	0.7319
Vitality Girl Ⅲ:Pixel	2022-03-24	2	12	1	3	0.7319
Delusions of a Lost Soul	2022-08-30	2	12	1	3	0.7319
Burrow of the Fallen Bear: A Gay Furry Visual Novel	2022-08-05	8	12	1	9	0.7319
Memory Shards	2022-05-20	2	12	1	3	0.7319
Gem Setter	2022-05-19	4	12	1	5	0.7319
ROTA	2022-05-26	4	12	1	5	0.7319
来人 LIGHTWORKERS	2022-08-08	3	12	1	4	0.7319
Incoherence	2022-06-30	7	12	1	8	0.7319
Sexy Sharks	2022-06-21	3	12	1	4	0.7319
Shogunaria	2022-10-03	5	12	1	6	0.7319
Light Kin	2022-10-05	3	12	1	4	0.7319
Colorless World	2022-08-30	4	12	1	5	0.7319
Golden Rails: World’s Fair	2022-08-24	24	12	1	25	0.7319
The Silent Huntress	2022-10-31	4	12	1	5	0.7319
ギャルアンドチェーンソー～GirlAndChainsaw～	2022-10-01	8	12	1	9	0.7319
Viking Heroes 3	2022-11-16	23	12	1	24	0.7319
Magnus Positive Phototaxis	2022-11-30	5	12	1	6	0.7319
Masterchef Cakes Edition	2022-10-29	2	12	1	3	0.7319
Stickman's Arena	2022-11-14	3	12	1	4	0.7319
The Sentient Box	2022-12-22	7	12	1	8	0.7319
Mystic Forest	2022-11-24	3	12	1	4	0.7319
Cult of the Mask	2022-11-21	2	12	1	3	0.7319
Dungeon of Death	2022-12-02	5	12	1	6	0.7319
Myasoid	2022-11-19	2	12	1	3	0.7319
Medusa	2022-11-29	3	12	1	4	0.7319
Fears of Glasses o-o World War	2022-12-22	2	12	1	3	0.7319
College Kings 2 - Episode 1	2022-04-14	2372	898	279	2651	0.7317
Hentai Lagoon	2022-05-19	13	48	10	23	0.7316
Solargene	2022-01-31	253	313	90	343	0.7312000000000001
Bus World	2022-09-29	66	233	65	131	0.7312000000000001
Chenso Club	2022-09-01	49	138	36	85	0.7312000000000001
Occult	2022-05-19	256	1170	371	627	0.7308
Uninvited	2022-05-25	6	44	9	15	0.7308
Eyes in the Dark	2022-07-14	49	90	22	71	0.7304
MiniGolf Maker	2022-02-25	15	62	14	29	0.7304
Element-174	2022-01-03	86	76	18	104	0.7302
The Long Road North	2022-04-28	9	69	16	25	0.7302
별에게 소원을 (When you wish upon a star)	2022-05-06	32	40	8	40	0.73
The Pinball Wizard	2022-10-27	18	40	8	26	0.73
Hentai CatMaid	2022-11-06	6	40	8	14	0.73
Smart Factory Tycoon: Beginnings	2022-01-05	417	357	105	522	0.7297
Dungeons of Sundaria	2022-07-18	330	554	169	499	0.7295999999999999
Loopmancer	2022-07-13	525	400	119	644	0.7295
Green Hell VR	2022-06-09	236	532	162	398	0.7293999999999999
幻想三国志2	2022-01-09	129	133	35	164	0.7293999999999999
迷霧國度: 傳承 Myth of Mist：Legacy	2022-01-28	44	79	19	63	0.7293999999999999
Big Bia	2022-06-10	1840	984	312	2152	0.7293000000000001
BLINK: The Last Night	2022-01-03	14	65	15	29	0.7293000000000001
Slime Girl Smoothies	2022-08-29	16	36	7	23	0.7293000000000001
Alice!	2022-01-05	14	36	7	21	0.7293000000000001
Erebe	2022-11-06	28	36	7	35	0.7293000000000001
Defend The Bits	2022-06-16	36	36	7	43	0.7293000000000001
Slava Ukraini!	2022-05-24	199	916	290	489	0.7289
The Oregon Trail	2022-11-14	470	342	101	571	0.7286
Price of Power	2022-01-21	62	82	20	82	0.7286
Hard Times at Sequoia State Park	2022-04-25	101	82	20	121	0.7286
The Shadow Government Simulator	2022-10-17	29	32	6	35	0.7286
Cursed Exped	2022-07-10	11	32	6	17	0.7286
Perseverance Part: 2	2022-03-17	3	16	2	5	0.7286
Grammarian Ltd	2022-04-20	6	16	2	8	0.7286
The Niflhel Day	2022-02-12	8	16	2	10	0.7286
ARMS DOLL	2022-09-30	7	16	2	9	0.7286
Luna: Supernatural Hunter	2022-02-22	3	16	2	5	0.7286
BALLYGON	2022-05-18	6	16	2	8	0.7286
An Uninvited Guest	2022-07-12	5	16	2	7	0.7286
Wild Adventures	2022-03-25	8	16	2	10	0.7286
Drifting Kings	2022-09-01	3	16	2	5	0.7286
Rogue Door Defense	2022-08-16	9	16	2	11	0.7286
Blacken Slash: Prologue	2022-06-10	5	16	2	7	0.7286
Babysitter Simulator	2022-06-25	3	16	2	5	0.7286
Aero Striker - World Invasion	2022-10-19	8	16	2	10	0.7286
Chess Dungeons	2022-07-25	5	16	2	7	0.7286
The Van Game	2022-10-24	4	16	2	6	0.7286
Jotunn	2022-10-27	4	16	2	6	0.7286
RealFlight Evolution	2022-10-27	344	145	39	383	0.7282
Ancient	2022-02-04	30	43	9	39	0.728
BiblioMania	2022-06-20	12	43	9	21	0.728
Block Breaker	2022-04-16	5	28	5	10	0.7279000000000001
Extreme Truck Stunts	2022-10-21	5	28	5	10	0.7279000000000001
My Lovely Wife	2022-06-08	862	374	112	974	0.7277
Psychoscopy	2022-07-25	18	20	3	21	0.7276
Diptych	2022-02-18	2	20	3	5	0.7276
Square	2022-03-26	3	20	3	6	0.7276
illumizzle: Finding the lost light	2022-04-17	5	20	3	8	0.7276
Escape From Meat City	2022-09-07	4	20	3	7	0.7276
Metal Flame	2022-08-04	26	20	3	29	0.7276
Froggy's Farm & Friends	2022-08-06	3	20	3	6	0.7276
Hentai Neko	2022-11-03	3	20	3	6	0.7276
TOD Fragments: Special Fun	2022-12-01	5	20	3	8	0.7276
Sperma	2022-12-15	5	20	3	8	0.7276
Duelyst II	2022-12-17	1978	1024	329	2307	0.7275
Frog Fight	2022-02-05	6	24	4	10	0.7275
Suspect Enemy	2022-01-15	31	24	4	35	0.7275
Skiing VR	2022-03-02	4	24	4	8	0.7275
Desolation Tycoon	2022-01-14	23	24	4	27	0.7275
One Step After Fall	2022-03-15	5	24	4	9	0.7275
March to a Million	2022-10-31	30	24	4	34	0.7275
Liminus: The Silent Guard	2022-11-17	6	24	4	10	0.7275
Deneb: Across the Stars	2022-09-13	7	24	4	11	0.7275
Language Lab	2022-07-09	7	24	4	11	0.7275
DarkenDerek The last Fallen	2022-10-21	4	24	4	8	0.7275
Wolfskin's Curse	2022-10-18	3	24	4	7	0.7275
Lost Eidolons	2022-10-13	1489	798	253	1742	0.7273999999999999
Justice.exe	2022-07-22	24	71	17	41	0.7273999999999999
Resist	2022-12-09	17	39	8	25	0.7270000000000001
X-Plane 12	2022-12-17	489	935	300	789	0.7269
NOX TIMORE REMAKE	2022-09-28	18	81	20	38	0.7269
航海霸业	2022-09-28	122	101	26	148	0.7267
Life is Strange Remastered	2022-02-01	1227	1409	463	1690	0.7265
Nope Nope Nurses	2022-01-26	129	251	73	202	0.7265
Hot And Lovely 5	2022-08-05	65	140	38	103	0.7264
Nemesis: Lockdown	2022-11-17	381	331	99	480	0.7263
My Pleasure - Season 1	2022-12-15	176	84	21	197	0.7263
World of Warplanes	2022-02-10	688	2726	923	1611	0.7261
Hero Roy's Wedding	2022-12-29	37	53	12	49	0.726
Into the Sinkhole	2022-09-17	14	77	19	33	0.7259000000000001
Vincemus - Air Combat	2022-04-01	7	35	7	14	0.7259000000000001
Blue Oak Bridge	2022-11-30	21	35	7	28	0.7259000000000001
Monster	2022-09-02	177	149	41	218	0.7256999999999999
Furry Sex: Pirates 🏴‍☠️	2022-09-03	475	70	17	492	0.7255
Westwood Shadows	2022-07-15	20	42	9	29	0.7251000000000001
Dungeoneers	2022-11-15	36	42	9	45	0.7251000000000001
Routine Feat / Бытовой подвиг	2022-05-11	10	42	9	19	0.7251000000000001
雨夜屠夫	2022-11-01	62	49	11	73	0.7248
Spidersaurs	2022-07-14	9	31	6	15	0.7248
Rapture - The Beginning	2022-01-21	12	31	6	18	0.7248
万界之门	2022-03-08	76	73	18	94	0.7247
Rogue Frontiers	2022-12-23	5	11	1	6	0.7242000000000001
Kowloon High-School Chronicle: ORIGIN OF ADVENTURE	2022-11-10	35	11	1	36	0.7242000000000001
To Your Stations!	2022-07-01	6	11	1	7	0.7242000000000001
Puzzle Battler! Mirai	2022-04-21	7	11	1	8	0.7242000000000001
Somber	2022-10-12	4	11	1	5	0.7242000000000001
Mysteries Of Darkness	2022-01-31	7	11	1	8	0.7242000000000001
CESSPOOL	2022-10-28	4	11	1	5	0.7242000000000001
Isles of Cubes	2022-06-15	4	11	1	5	0.7242000000000001
Slime Crown	2022-01-17	2	11	1	3	0.7242000000000001
Au-Delà	2022-02-28	4	11	1	5	0.7242000000000001
Grid Leaper	2022-07-13	3	11	1	4	0.7242000000000001
Dandy & Randy DX	2022-04-29	4	11	1	5	0.7242000000000001
The Callisto	2022-07-07	4	11	1	5	0.7242000000000001
I deserve a happy ending	2022-06-30	7	11	1	8	0.7242000000000001
Project SNAQE	2022-02-04	2	11	1	3	0.7242000000000001
WHATEVER	2022-10-20	6	11	1	7	0.7242000000000001
Warlordocracy	2022-07-17	4	11	1	5	0.7242000000000001
边缘项目 / Living Island Project	2022-04-08	5	11	1	6	0.7242000000000001
Astral Flux	2022-10-28	3	11	1	4	0.7242000000000001
STIX: Combat Devolved	2022-02-07	7	11	1	8	0.7242000000000001
Edessa: School of Wizardry	2022-07-27	2	11	1	3	0.7242000000000001
如果还有明天	2022-01-14	5	11	1	6	0.7242000000000001
Blood Island	2022-02-10	3	11	1	4	0.7242000000000001
Freeze the time	2022-01-19	2	11	1	3	0.7242000000000001
Generic RPG Idle	2022-07-11	24	11	1	25	0.7242000000000001
Life of Pepe	2022-04-13	3	11	1	4	0.7242000000000001
ChestMate	2022-04-08	2	11	1	3	0.7242000000000001
Miami Sunset Drive	2022-03-02	4	11	1	5	0.7242000000000001
烈山海前传之黑帝君临	2022-08-03	5	11	1	6	0.7242000000000001
Burial Stone	2022-06-30	2	11	1	3	0.7242000000000001
VR HENTAI PLAY	2022-03-08	2	11	1	3	0.7242000000000001
Championship Wrestling Promoter	2022-11-09	8	11	1	9	0.7242000000000001
Lucky Villager	2022-04-09	5	11	1	6	0.7242000000000001
REPULSOR	2022-05-19	3	11	1	4	0.7242000000000001
Local Paper Small Town	2022-05-18	2	11	1	3	0.7242000000000001
Horse Club Adventures 2: Hazelwood Stories	2022-10-27	23	11	1	24	0.7242000000000001
The Hand of Glory - The Blowtorch Files	2022-05-09	6	11	1	7	0.7242000000000001
Simulacrum	2022-07-05	4	11	1	5	0.7242000000000001
Decorporation	2022-08-24	6	11	1	7	0.7242000000000001
Logica Emotica	2022-06-07	10	11	1	11	0.7242000000000001
MYRNEscapes	2022-05-18	3	11	1	4	0.7242000000000001
MAGITERRA	2022-08-25	4	11	1	5	0.7242000000000001
Jelly Forest	2022-05-26	5	11	1	6	0.7242000000000001
Crash Forts	2022-05-26	5	11	1	6	0.7242000000000001
impossiBot	2022-11-10	2	11	1	3	0.7242000000000001
Puzzles with nature	2022-06-09	3	11	1	4	0.7242000000000001
cookies СOOkies COOKIES	2022-06-30	2	11	1	3	0.7242000000000001
TOTEMS 2	2022-07-02	5	11	1	6	0.7242000000000001
Tower Defender VR: Last Adventure	2022-07-08	3	11	1	4	0.7242000000000001
Fortitude invasion	2022-07-20	5	11	1	6	0.7242000000000001
Asteroids	2022-07-17	3	11	1	4	0.7242000000000001
69 Berta Hot	2022-07-26	3	11	1	4	0.7242000000000001
Never ends acT	2022-07-17	4	11	1	5	0.7242000000000001
MAGNET EFFECT	2022-12-27	4	11	1	5	0.7242000000000001
rotatePDF: A Corporate Tale	2022-11-01	4	11	1	5	0.7242000000000001
Fix My Cat Doc	2022-09-19	2	11	1	3	0.7242000000000001
Mistress vs Slave	2022-09-29	12	11	1	13	0.7242000000000001
Orcen Axe	2022-11-15	3	11	1	4	0.7242000000000001
Two Cars Stunts Edition	2022-11-01	2	11	1	3	0.7242000000000001
Secret Agent 001	2022-12-02	2	11	1	3	0.7242000000000001
Stellar Echoes	2022-12-28	3	11	1	4	0.7242000000000001
Crazy City Driving	2022-12-13	3	11	1	4	0.7242000000000001
Family Business	2022-12-28	3	11	1	4	0.7242000000000001
POSTAL 4: No Regerts	2022-04-20	916	7015	2477	3393	0.7239
Toziuha Night: Dracula's Revenge	2022-03-21	8	27	5	13	0.7238
Into The Dark	2022-04-21	7	27	5	12	0.7238
Beautiful Mystic Survivors: Prologue	2022-09-28	594	169	48	642	0.7237
FURRY HITLER	2022-05-28	411	469	147	558	0.7236
Hindsight	2022-08-04	12	52	12	24	0.7236
Dwarven Skykeep	2022-12-01	73	69	17	90	0.7234999999999999
The Nightmare Catcher	2022-04-24	16	45	10	26	0.7234999999999999
Made in Abyss: Binary Star Falling into Darkness	2022-09-02	2052	831	271	2323	0.7232
Hentai Big Tits	2022-06-03	12	124	34	46	0.7229000000000001
Quake Champions	2022-08-18	17476	26649	9723	27199	0.7228
My Therapist is a Futanari	2022-01-21	8	95	25	33	0.7228
Vacancy Unlimited	2022-04-06	4	23	4	8	0.7228
GunsBox VR	2022-02-01	6	23	4	10	0.7228
Lillian Night: Exclusive Contract of Succubus	2022-12-16	5	23	4	9	0.7228
Space Dragons	2022-02-25	5	23	4	9	0.7228
Frequency Dissonance	2022-05-19	4	23	4	8	0.7228
Night Racer	2022-05-23	4	23	4	8	0.7228
Comrade Quack	2022-04-12	3	23	4	7	0.7228
Office Elevator	2022-04-02	3	23	4	7	0.7228
My Stepmom is a Futanari Chemist	2022-09-08	6	23	4	10	0.7228
Shinonome	2022-11-11	14	23	4	18	0.7228
The siege of Brimir	2022-10-27	6	23	4	10	0.7228
DO NOT OPEN	2022-11-30	10	23	4	14	0.7228
Lustful Ponies 2	2022-09-01	6	23	4	10	0.7228
Way of the Hunter	2022-08-16	9880	3822	1336	11216	0.7226
Fly Dangerous	2022-05-24	100	205	60	160	0.7226
Time on Frog Island	2022-07-12	94	111	30	124	0.7226
Covid Simulator	2022-01-25	49	55	13	62	0.7225
Fire Dogs	2022-10-18	5	34	7	12	0.7223999999999999
Void's Calling ep. 2	2022-10-14	104	189	55	159	0.7222
NeverSynth	2022-09-15	9	65	16	25	0.7222
Jennifer Wilde: Unlikely Revolutionaries	2022-10-18	6	15	2	8	0.7222
BIAS	2022-10-28	5	15	2	7	0.7222
Arctictopia	2022-08-09	6	15	2	8	0.7222
Mari and Bayu - The Road Home	2022-07-19	7	15	2	9	0.7222
Super Squidlit	2022-02-09	3	15	2	5	0.7222
From Red to Green	2022-01-03	3	15	2	5	0.7222
HelloWorld:ESCAPE	2022-02-17	2	15	2	4	0.7222
Dawn of Kagura: Hatsuka's Story	2022-01-08	4	15	2	6	0.7222
Dawn of Kagura: Natsu's Story	2022-01-08	4	15	2	6	0.7222
Psychic	2022-01-17	11	15	2	13	0.7222
I don't think I've walked this stretch of road before	2022-01-31	2	15	2	4	0.7222
Pixel Artist	2022-03-09	5	15	2	7	0.7222
Card Craft	2022-09-06	4	15	2	6	0.7222
Jewel Match Solitaire X Collector's Edition	2022-05-31	18	15	2	20	0.7222
Super Arkanoid	2022-05-31	4	15	2	6	0.7222
Sir Stretchalot - The Plight of the Elves	2022-09-15	10	15	2	12	0.7222
Just Sign!	2022-08-26	7	15	2	9	0.7222
Zombie Apocalypse - The Last Defense	2022-07-29	4	15	2	6	0.7222
Neon Circle	2022-08-10	2	15	2	4	0.7222
Southern Princesses	2022-08-24	2	15	2	4	0.7222
Umbra	2022-12-20	3	15	2	5	0.7222
Fishton: A Town to Remember	2022-09-29	6	15	2	8	0.7222
KungFu Kickball	2022-02-10	20	48	11	31	0.7221
IKO 39	2022-08-15	4	19	3	7	0.7221
Karm	2022-03-17	5	19	3	8	0.7221
Racing Outlaws	2022-01-24	6	19	3	9	0.7221
Faylinn's Quest	2022-05-17	24	19	3	27	0.7221
Live Waifu Wallpaper	2022-07-22	9	19	3	12	0.7221
Timewell: Trail of Celestes	2022-09-12	3	19	3	6	0.7221
Idling Idol	2022-01-06	12	19	3	15	0.7221
DESTROY Simulator	2022-01-28	5	19	3	8	0.7221
IRON GUARD	2022-04-26	14	19	3	17	0.7221
キラキラミラ　８人の遺伝子異常者と血の幽霊	2022-10-27	16	19	3	19	0.7221
国際指定怪異123号 廃村	2022-07-25	31	19	3	34	0.7221
作死吧！UP主！	2022-03-11	37	41	9	46	0.7220000000000001
White Paper	2022-07-12	50	41	9	59	0.7220000000000001
Animal Wish	2022-09-09	14	41	9	23	0.7220000000000001
TRADER LIFE SIMULATOR 2	2022-12-08	168	201	59	227	0.7219
How to Build a Magnificent Kingdom	2022-08-27	573	210	62	635	0.7218000000000001
Momo Mother Bird: Final Story	2022-07-28	30	210	62	92	0.7218000000000001
One Hell of a Week	2022-04-28	4	6	0	4	0.7217
Qorena	2022-07-06	11	6	0	11	0.7217
Stella Pastoris	2022-10-14	2	6	0	2	0.7217
Klondike Solitaire Collection	2022-03-29	5	6	0	5	0.7217
战地细胞（Battlefield Cell）	2022-08-04	2	6	0	2	0.7217
GrappleWell	2022-07-21	2	6	0	2	0.7217
The Legends of Tynedale	2022-02-24	3	6	0	3	0.7217
Hotel Transylvania: Scary-Tale Adventures	2022-03-11	4	6	0	4	0.7217
If Fusion Were That Easy	2022-10-31	7	6	0	7	0.7217
On Key Up: A Game for Keyboards	2022-03-08	4	6	0	4	0.7217
GOC Royale	2022-05-19	9	6	0	9	0.7217
The Last Bastion	2022-06-15	3	6	0	3	0.7217
Mages Defense	2022-09-09	2	6	0	2	0.7217
Evasive Maneuvers	2022-08-31	8	6	0	8	0.7217
Roze Blud	2022-02-02	7	6	0	7	0.7217
Minigolf	2022-12-22	5	6	0	5	0.7217
Islandville: A New Home	2022-04-29	17	6	0	17	0.7217
DotStrike	2022-04-23	3	6	0	3	0.7217
Get-A-Grip Chip and the Body Bugs	2022-05-12	3	6	0	3	0.7217
The Forgotten Isles	2022-04-17	2	6	0	2	0.7217
Run, Doodleguy!	2022-11-21	5	6	0	5	0.7217
Castle Greyrot	2022-07-11	3	6	0	3	0.7217
Stellona	2022-07-29	3	6	0	3	0.7217
Empire Chronicles	2022-09-22	5	6	0	5	0.7217
Animal Rivals: Up In The Air	2022-04-04	16	6	0	16	0.7217
Silver Blue	2022-11-11	7	6	0	7	0.7217
Our Mountain	2022-09-27	2	6	0	2	0.7217
Asteroid 5	2022-01-14	2	6	0	2	0.7217
Heroes of Yore	2022-10-06	3	6	0	3	0.7217
Gedaria	2022-01-08	6	6	0	6	0.7217
The Ancient Art of War in the Skies	2022-01-20	3	6	0	3	0.7217
Aspect	2022-05-20	4	6	0	4	0.7217
Deep Space Outpost	2022-05-06	5	6	0	5	0.7217
12 Labours of Hercules XIII: Wonder-ful Builder	2022-01-03	25	6	0	25	0.7217
Her Jentle Hi-ness	2022-03-24	7	6	0	7	0.7217
Pandea Stones	2022-08-18	1	6	0	1	0.7217
Perish Song	2022-11-03	5	6	0	5	0.7217
Spectrum	2022-03-01	4	6	0	4	0.7217
I Love Finding MORE Cats	2022-02-10	7	6	0	7	0.7217
Laboratory of Nightmares	2022-03-10	2	6	0	2	0.7217
Batsumaru	2022-06-11	2	6	0	2	0.7217
Hamster Blitz!	2022-02-27	3	6	0	3	0.7217
Precursors: Armored Angels	2022-04-08	3	6	0	3	0.7217
Fembot Jigsaw	2022-03-30	2	6	0	2	0.7217
うんこタイピング	2022-11-15	20	6	0	20	0.7217
Screaming Loaf	2022-03-17	2	6	0	2	0.7217
A Noite Sem Fim	2022-01-15	2	6	0	2	0.7217
Nonstop	2022-02-01	2	6	0	2	0.7217
Maximum Fighterz: Direct Offensive Action	2022-01-11	3	6	0	3	0.7217
Two of us	2022-01-11	3	6	0	3	0.7217
Game Dev Arcade	2022-05-10	3	6	0	3	0.7217
風の祝子 ～早苗さんの妖怪退治～	2022-02-19	3	6	0	3	0.7217
Escape From Hard Drive	2022-07-11	3	6	0	3	0.7217
Cursed Quest	2022-03-23	2	6	0	2	0.7217
The Paper Game	2022-06-21	2	6	0	2	0.7217
巨 ~Gigantify~	2022-01-23	2	6	0	2	0.7217
Nevedomo	2022-01-17	2	6	0	2	0.7217
B-1LL1	2022-03-19	3	6	0	3	0.7217
Mini Putt Camelot	2022-06-01	4	6	0	4	0.7217
MotorSim 3	2022-02-01	3	6	0	3	0.7217
INTO THE CTHULHU MYTHOLOGY	2022-02-04	2	6	0	2	0.7217
Yeah Yeah Beebiss II	2022-02-03	2	6	0	2	0.7217
Blobbs: Remastered	2022-07-11	2	6	0	2	0.7217
Watashi Suzume	2022-11-14	3	6	0	3	0.7217
Potions!	2022-12-04	5	6	0	5	0.7217
Armchair Racer	2022-02-09	9	6	0	9	0.7217
Perfect Balance Collection	2022-02-11	3	6	0	3	0.7217
她曾经活过啊	2022-02-11	1	6	0	1	0.7217
Gun Ugly	2022-02-22	2	6	0	2	0.7217
Familiar	2022-04-19	2	6	0	2	0.7217
Bitlands	2022-04-29	3	6	0	3	0.7217
Race On Ice 2022 Pro	2022-02-28	16	6	0	16	0.7217
Fung Guys	2022-06-04	25	6	0	25	0.7217
The Lost Oregon City Gold	2022-04-12	2	6	0	2	0.7217
Frite Medium	2022-04-05	3	6	0	3	0.7217
Expansion Core	2022-10-10	5	6	0	5	0.7217
Running in the Y2K	2022-05-10	4	6	0	4	0.7217
Elephant's Graveyard	2022-05-06	2	6	0	2	0.7217
Mini Island: Aroma	2022-03-01	3	6	0	3	0.7217
Vetrex	2022-04-01	3	6	0	3	0.7217
Saikoro Saiko Seventh Heaven	2022-12-31	9	6	0	9	0.7217
Ganbaru	2022-06-24	1	6	0	1	0.7217
Tales of Novariel	2022-03-09	3	6	0	3	0.7217
Four Winds Fantasy	2022-03-09	2	6	0	2	0.7217
A Factory Job	2022-03-17	1	6	0	1	0.7217
侦查故事：风声	2022-11-11	3	6	0	3	0.7217
Jasper Vice: Legends Untold	2022-08-04	2	6	0	2	0.7217
Prototype TD 2	2022-03-18	4	6	0	4	0.7217
The Ambassador's Coterie	2022-03-21	1	6	0	1	0.7217
Dashing Orange	2022-06-21	2	6	0	2	0.7217
Galpa the no limbs guy	2022-03-31	1	6	0	1	0.7217
Lilium	2022-11-11	4	6	0	4	0.7217
dweeMIXED: Thwee Pack	2022-03-31	2	6	0	2	0.7217
Tomb Robbing with Friends	2022-07-28	9	6	0	9	0.7217
Timmy l'escargot	2022-03-30	3	6	0	3	0.7217
Simple Boxing Drills VR	2022-05-14	3	6	0	3	0.7217
Arcis Ultima	2022-04-15	2	6	0	2	0.7217
Goblin Gladiators	2022-08-23	15	6	0	15	0.7217
Achievement Cage	2022-09-14	3	6	0	3	0.7217
Cosmic Ascension	2022-04-22	3	6	0	3	0.7217
Wibble	2022-05-27	4	6	0	4	0.7217
K9 UPRISING	2022-05-18	2	6	0	2	0.7217
Your Computer Might Be At Risk	2022-06-17	2	6	0	2	0.7217
New Year's Eve Miracle	2022-06-20	1	6	0	1	0.7217
Thieves' Paradise	2022-05-21	4	6	0	4	0.7217
NEOGEO POCKET COLOR SELECTION Vol.2	2022-11-09	6	6	0	6	0.7217
Tom's Adventure	2022-05-30	1	6	0	1	0.7217
Elspell	2022-07-08	2	6	0	2	0.7217
Little Rhapsody of Game	2022-06-03	5	6	0	5	0.7217
Beautiful Ukraine	2022-05-27	1	6	0	1	0.7217
It's Time	2022-06-15	2	6	0	2	0.7217
Death Bowl	2022-10-28	6	6	0	6	0.7217
Bonk'd Audio Visualizer	2022-06-16	2	6	0	2	0.7217
Putin Orcs Defender	2022-07-15	2	6	0	2	0.7217
Rooftop Garden Simulator	2022-08-01	2	6	0	2	0.7217
Crush them!碾碎它们！	2022-06-07	8	6	0	8	0.7217
STRIKERS	2022-10-10	5	6	0	5	0.7217
Crazy Traffic Racer	2022-07-19	3	6	0	3	0.7217
Push The Blocks	2022-07-14	3	6	0	3	0.7217
Don't Die, Mr. Robot! DX	2022-08-17	2	6	0	2	0.7217
The Monster Under Your Skin	2022-08-29	1	6	0	1	0.7217
徹夜報告書	2022-08-30	22	6	0	22	0.7217
Chompies!	2022-08-23	5	6	0	5	0.7217
Flying Ruckus - Multiplayer	2022-07-19	5	6	0	5	0.7217
Mikaira (Archived)	2022-11-18	1	6	0	1	0.7217
At Home With Step-Sis Simulator	2022-08-24	4	6	0	4	0.7217
MISSING_CAT	2022-07-19	2	6	0	2	0.7217
1001 Jigsaw. Cute Cats 2	2022-08-01	2	6	0	2	0.7217
SHAFTED	2022-10-13	7	6	0	7	0.7217
PunchBots	2022-09-01	2	6	0	2	0.7217
OneHanded	2022-07-29	2	6	0	2	0.7217
Math Tower 2	2022-10-30	2	6	0	2	0.7217
Hero Hours Contract 2: A Factory for Magical Girls	2022-09-07	3	6	0	3	0.7217
Odd Guy Meets Odd Farmers	2022-09-08	3	6	0	3	0.7217
Space Voyage: The Puzzle Game	2022-12-20	3	6	0	3	0.7217
Monstir Iradicator	2022-10-18	1	6	0	1	0.7217
Project XLOWS: Keyboard Apocalypse TM	2022-12-01	2	6	0	2	0.7217
Spam Text	2022-09-01	8	6	0	8	0.7217
CyberBlocker Complete Edition	2022-10-13	2	6	0	2	0.7217
Be My Loyal Subject	2022-10-13	4	6	0	4	0.7217
HUNDRED FIRES: The rising of red star - EPISODE 2	2022-09-09	2	6	0	2	0.7217
CapoeiRogue: Dandara Cordão de Ouro	2022-09-20	2	6	0	2	0.7217
Living Legends: The Blue Chamber Collector's Edition	2022-09-12	7	6	0	7	0.7217
Hallway Defender	2022-10-07	5	6	0	5	0.7217
Trash Panda: The Adventures of Ricky and Boxman	2022-11-30	3	6	0	3	0.7217
Gust	2022-10-14	3	6	0	3	0.7217
Spin Quest	2022-11-30	6	6	0	6	0.7217
百獣エスケープ	2022-12-25	4	6	0	4	0.7217
I commissioned some bees 9	2022-11-04	5	6	0	5	0.7217
Jewel Match Twilight	2022-10-27	16	6	0	16	0.7217
Missing Pictures : Lee Myung Se	2022-12-01	2	6	0	2	0.7217
Wrapped With a Kiss	2022-12-12	2	6	0	2	0.7217
Cat Herders: Couch Coop Cat Corralling!	2022-11-07	4	6	0	4	0.7217
New Hire	2022-11-15	2	6	0	2	0.7217
Boat Train	2022-11-25	1	6	0	1	0.7217
黑匣 Dark Box	2022-12-26	4	6	0	4	0.7217
One Last Time	2022-11-30	4	6	0	4	0.7217
Ghost Guy	2022-11-28	3	6	0	3	0.7217
Eggcelerate! to the North Pole	2022-12-15	3	6	0	3	0.7217
Ecosphere - Prologue	2022-12-12	2	6	0	2	0.7217
The Children's Friend	2022-12-24	17	6	0	17	0.7217
Vampire: The Masquerade - Bloodhunt	2022-04-27	29475	35425	13083	42558	0.7212999999999999
九州战歌	2022-01-07	597	421	133	730	0.7211
The Sexorcist	2022-07-28	10	51	12	22	0.721
STHELL	2022-03-11	6	30	6	12	0.7209000000000001
Yurukill: The Calumniation Games	2022-07-08	20	30	6	26	0.7209000000000001
Territory	2022-07-09	6	30	6	12	0.7209000000000001
DIMENSIONAL SLAUGHTER	2022-10-11	7	30	6	13	0.7209000000000001
Sneak Thief	2022-05-07	59	1151	388	447	0.7206999999999999
Solace Crafting	2022-08-02	274	548	177	451	0.7206
Skullborn	2022-11-05	21	44	10	31	0.7206
Run Build Pew!	2022-06-06	377	334	104	481	0.7205
Furry Survivals 18+	2022-11-09	31	37	8	39	0.7205
Afterlife VR	2022-09-15	10	103	28	38	0.7204
League Manager 2022	2022-03-24	468	622	203	671	0.7203
The Living Remain	2022-04-05	28	125	35	63	0.7203
Kardboard Kings	2022-02-10	203	265	81	284	0.7202
Tor Eternum	2022-07-15	84	54	13	97	0.7201000000000001
Buccaneers! The New Age of Piracy	2022-03-02	52	77	20	72	0.7199
Gorilla Soccer	2022-08-13	17	67	17	34	0.7195
Revenge of the Killer Octopus	2022-11-16	85	47	11	96	0.7194
Groove Gunner	2022-02-10	7	26	5	12	0.7194
Grid Force - Mask of the Goddess	2022-09-15	15	26	5	20	0.7194
Mind Rite	2022-02-20	8	26	5	13	0.7194
Lewd Life with my Doggy Wife	2022-06-10	10	26	5	15	0.7194
SCP: Nine-Tailed Fox	2022-02-02	1164	1782	618	1782	0.7192000000000001
Ganryu 2	2022-04-22	9	57	14	23	0.7192000000000001
After the Collapse	2022-09-09	66	124	35	101	0.7191
战国异闻录	2022-11-16	100	124	35	135	0.7191
IXION	2022-12-07	17189	7345	2669	19858	0.7189
Aka	2022-12-15	337	230	70	407	0.7188
Bouncy Goat Climb	2022-01-10	55	227	69	124	0.7188
Kung Fu Grand King	2022-04-09	143	105	29	172	0.7188
Arena 3D	2022-03-02	5	33	7	12	0.7187
Champion of Venus	2022-04-18	17	33	7	24	0.7187
Idle Skilling	2022-09-15	6466	1184	405	6871	0.7184999999999999
Hubris	2022-12-07	104	280	87	191	0.7184999999999999
Pleasure Party	2022-01-14	90	145	42	132	0.7184999999999999
Good Company	2022-06-21	1745	1113	380	2125	0.7183
Soulash	2022-03-04	486	288	90	576	0.7181000000000001
Requisition VR	2022-10-20	107	220	67	174	0.7181000000000001
BLACK WITCHCRAFT	2022-09-27	74	76	20	94	0.7181000000000001
River City Girls Zero	2022-09-21	22	76	20	42	0.7181000000000001
僵尸塔防(Zombie Defence TD)	2022-12-10	364	763	256	620	0.7179000000000001
Dummynation	2022-04-15	48	276	86	134	0.7179000000000001
Destiny of the World	2022-08-22	14	22	4	18	0.7178
Caapora Adventure - Ojibe's Revenge	2022-04-18	5	22	4	9	0.7178
What Is Love?	2022-09-30	7	22	4	11	0.7178
Dreamy Planet	2022-09-15	6	22	4	10	0.7178
Walk with the Living	2022-01-21	5	22	4	9	0.7178
The Redress of Mira	2022-07-07	6	22	4	10	0.7178
Space Ducks: The great escape	2022-05-19	3	22	4	7	0.7178
Lost Alone Ep.3 - Nonnina	2022-06-17	8	22	4	12	0.7178
ALPHA-NIGHTHAWK	2022-10-28	5	22	4	9	0.7178
Torecower	2022-12-23	12	22	4	16	0.7178
Alchemy Garden	2022-12-12	76	398	128	204	0.7177
Tvö	2022-08-01	53	255	79	132	0.7177
Robo Revenge Squad	2022-08-17	26	101	28	54	0.7176
CEO	2022-05-20	21	53	13	34	0.7176
Crawl Tactics	2022-12-09	31	43	10	41	0.7176
純愛貓娘的同居生活	2022-10-11	25	43	10	35	0.7176
Dreams with Furry 🦊	2022-08-18	13	43	10	23	0.7176
Batora: Lost Haven	2022-10-20	71	147	43	114	0.7173999999999999
Chrono Survival	2022-12-09	71	66	17	88	0.7173999999999999
Earthling's Undertaking	2022-08-25	1405	577	191	1596	0.7173
GUILT: The Deathless	2022-04-28	16	36	8	24	0.7170000000000001
Soulflow	2022-03-18	11	36	8	19	0.7170000000000001
Strip'Em II	2022-07-29	30	36	8	38	0.7170000000000001
Cuties Hacked: Oh no someone stole my photos!	2022-08-17	10	36	8	18	0.7170000000000001
Golazo 2	2022-09-01	11	56	14	25	0.7169
侵入：源代码	2022-04-29	7	29	6	13	0.7169
Transcendence Legacy - Voidswept	2022-04-04	31	29	6	37	0.7169
Sisters_Possession1	2022-04-14	17	29	6	23	0.7169
Crown Delights Deli	2022-02-16	9	46	11	20	0.7166
Narvas	2022-09-03	3	18	3	6	0.7162999999999999
Sausage Fest	2022-03-08	14	18	3	17	0.7162999999999999
TIME BREAKER	2022-05-16	3	18	3	6	0.7162999999999999
Keng's Little Universe	2022-01-14	12	18	3	15	0.7162999999999999
Milf Toys	2022-02-11	4	18	3	7	0.7162999999999999
Decay - a real time interactive experience	2022-02-07	4	18	3	7	0.7162999999999999
ManServant: Yaoi BL Gay Visual Novel	2022-09-21	22	18	3	25	0.7162999999999999
Quest: Escape Dungeon	2022-08-01	6	18	3	9	0.7162999999999999
Put Your Brain On	2022-05-10	2	18	3	5	0.7162999999999999
The Search for Fran 2	2022-06-07	4	18	3	7	0.7162999999999999
Tennis Club Story	2022-11-28	33	18	3	36	0.7162999999999999
Europe Bus Driver	2022-11-18	4	18	3	7	0.7162999999999999
The Shadow People	2022-10-27	6	18	3	9	0.7162999999999999
MagicShop3D	2022-06-19	23	75	20	43	0.7162000000000001
Superior	2022-11-16	36	59	15	51	0.7162000000000001
The Knight Witch	2022-11-29	225	223	69	294	0.716
Tower Princess	2022-09-08	87	106	30	117	0.7159000000000001
WWE 2K22	2022-03-11	9535	6909	2550	12085	0.7158
Godlike Burger	2022-04-21	597	359	116	713	0.7158
My Boss is a Futanari	2022-02-24	6	62	16	22	0.7156999999999999
King 'n Knight	2022-01-07	30	49	12	42	0.7156999999999999
Hentai Dream	2022-01-17	4	39	9	13	0.7156999999999999
IN THE BUILDING: CATS	2022-11-16	7	39	9	16	0.7156999999999999
Alaloth - Champions of The Four Kingdoms	2022-06-30	472	529	176	648	0.7156
HALF DEAD 3	2022-09-09	107	324	104	211	0.7156
Metacell: Genesis	2022-08-19	5	10	1	6	0.7155
We'll Always Have Paris	2022-04-27	2	10	1	3	0.7155
新城镇	2022-06-03	3	10	1	4	0.7155
Fragments Of A Mind	2022-03-25	2	10	1	3	0.7155
CYNOROID FORSAKEN	2022-06-03	6	10	1	7	0.7155
I wanna go home	2022-11-04	3	10	1	4	0.7155
Lofty Quest	2022-03-28	2	10	1	3	0.7155
The Spanish Privateer	2022-09-16	10	10	1	11	0.7155
Runnyk	2022-05-04	3	10	1	4	0.7155
Kombinera	2022-04-07	4	10	1	5	0.7155
Shootball Arena	2022-12-23	6	10	1	7	0.7155
Lastone: Behind the Choice	2022-01-21	2	10	1	3	0.7155
Bubbles shot	2022-01-19	2	10	1	3	0.7155
Extreme Race	2022-01-21	12	10	1	13	0.7155
ColdSun	2022-02-09	4	10	1	5	0.7155
Prayer of the Faithless	2022-05-27	4	10	1	5	0.7155
Kojimachi	2022-08-09	16	10	1	17	0.7155
DANGER OF LOSS	2022-02-21	4	10	1	5	0.7155
Al-Qadim: The Genie's Curse	2022-03-29	8	10	1	9	0.7155
Chaos Girl	2022-03-10	2	10	1	3	0.7155
Armored Firestorm	2022-04-04	7	10	1	8	0.7155
SnakeByte	2022-03-19	2	10	1	3	0.7155
Harriet: From Slave To Hero	2022-04-02	4	10	1	5	0.7155
QUIJOTE: Quest for Glory	2022-03-31	2	10	1	3	0.7155
Puzzle: Nature	2022-04-16	5	10	1	6	0.7155
KONGEER	2022-05-31	2	10	1	3	0.7155
One Last Memory - Reimagined	2022-06-10	2	10	1	3	0.7155
Pitchfork Kingdom	2022-09-23	2	10	1	3	0.7155
Mechabot Defender	2022-08-03	10	10	1	11	0.7155
Dark Slime	2022-05-26	5	10	1	6	0.7155
Crazy Zoo	2022-06-03	2	10	1	3	0.7155
Bots Crusher Arena	2022-09-01	3	10	1	4	0.7155
Magneko	2022-08-20	4	10	1	5	0.7155
Pretty Girls Breakout! PLUS	2022-07-29	3	10	1	4	0.7155
Climb and Fight: Mafia	2022-09-21	2	10	1	3	0.7155
Stories school	2022-08-30	2	10	1	3	0.7155
Spooky Mansion Manager	2022-09-01	4	10	1	5	0.7155
The Lost Abyss	2022-09-03	3	10	1	4	0.7155
PUSSY 6	2022-08-26	2	10	1	3	0.7155
蛮王与女武神	2022-11-18	6	10	1	7	0.7155
Guilty	2022-09-15	4	10	1	5	0.7155
Up & Away	2022-11-16	2	10	1	3	0.7155
Ace Pilot Europe	2022-10-24	4	10	1	5	0.7155
SEARCH ALL - MICE	2022-11-08	3	10	1	4	0.7155
Inner Call	2022-10-14	3	10	1	4	0.7155
Puny BOB	2022-11-17	2	10	1	3	0.7155
Trader of the Night	2022-10-17	15	10	1	16	0.7155
CampNight	2022-11-05	3	10	1	4	0.7155
Lust Colony	2022-12-22	14	10	1	15	0.7155
Battle of the Lost Continent	2022-11-29	3	10	1	4	0.7155
VR Jurassic Adventure HD	2022-12-16	1	10	1	2	0.7155
Purple War	2022-10-21	28	84	23	51	0.7154
Influence, Inc.	2022-05-31	7	14	2	9	0.7152
Black Lotus Motel	2022-04-20	6	14	2	8	0.7152
DESKTOP MONKEY	2022-07-15	2	14	2	4	0.7152
Big Booty Adventures	2022-01-05	7	14	2	9	0.7152
POORLY drawn but HORNY	2022-03-28	3	14	2	5	0.7152
Magnus Imago	2022-02-02	4	14	2	6	0.7152
Ninja Noboken	2022-05-03	3	14	2	5	0.7152
Tumblefire	2022-02-09	2	14	2	4	0.7152
Deep Night Runner	2022-02-21	3	14	2	5	0.7152
Lab Remnants	2022-04-15	3	14	2	5	0.7152
Thread	2022-10-18	3	14	2	5	0.7152
Witch Epoch	2022-06-13	3	14	2	5	0.7152
8-Bit Farm	2022-10-31	25	14	2	27	0.7152
Pixxxel	2022-08-24	3	14	2	5	0.7152
City Construction Simulator	2022-10-28	2	14	2	4	0.7152
MikotoRemake / 铭日记重制版	2022-11-27	3	14	2	5	0.7152
Nanali in another world	2022-11-19	2	14	2	4	0.7152
Power Driver	2022-11-21	2	14	2	4	0.7152
Mist Legacy	2022-09-13	1065	881	303	1368	0.7151000000000001
Yaengard	2022-05-05	101	90	25	126	0.715
World Seed	2022-05-17	409	236	74	483	0.7149
2076 Midway Multiverse	2022-02-03	5	32	7	12	0.7149
Ship Simulator Realistic	2022-01-11	7	32	7	14	0.7149
RFVR	2022-07-18	8	32	7	15	0.7149
Izmir: An Independence Simulator	2022-04-29	6	32	7	13	0.7149
RO-BOUNCE	2022-05-27	6	32	7	13	0.7149
Internet Cafe Simulator 2	2022-01-07	3527	6038	2233	5760	0.7148000000000001
主宰飞仙	2022-08-19	54	96	27	81	0.7148000000000001
Archipelago	2022-01-14	16	25	5	21	0.7148000000000001
Dungeon Reels Tactics	2022-05-02	22	25	5	27	0.7148000000000001
Desert Revenant	2022-09-22	7	25	5	12	0.7148000000000001
Sinner 97	2022-11-22	5	25	5	10	0.7148000000000001
In The Darkness	2022-09-13	9	25	5	14	0.7148000000000001
Agarta	2022-10-21	35	230	72	107	0.7147
Monuments Flipper	2022-11-14	222	111	32	254	0.7143
Destroyer: The U-Boat Hunter	2022-09-28	325	287	92	417	0.7142000000000001
Beholgar	2022-02-04	14	123	36	50	0.7142000000000001
Passed Out: Prologue	2022-10-10	220	301	97	317	0.7140000000000001
Hacker Simulator: Free Trial	2022-02-15	331	298	96	427	0.7140000000000001
Forever To You!	2022-07-26	29	58	15	44	0.7139
RetroDrift: Retrowave Online Road	2022-01-20	9	58	15	24	0.7139
BrainBread 2	2022-03-09	1123	3571	1309	2432	0.7138
星塔星夜MONOBEHEVO	2022-05-31	11	45	11	22	0.7137000000000001
龙魂大冒险	2022-06-10	194	260	83	277	0.7134999999999999
A Hero's Rest	2022-10-12	78	61	16	94	0.7134999999999999
BYTE FYTE (MULTIPLAYER)	2022-11-19	9	35	8	17	0.7134999999999999
War Robots: Frontiers	2022-11-24	100	158	48	148	0.7134
Angel's Awakening	2022-08-26	89	89	25	114	0.7134
Refund Me If You Can	2022-07-22	19	92	26	45	0.7133
Virtual Aquarium - Overlay Desktop Game	2022-04-02	83	95	27	110	0.7132
Desktopia: A Desktop Village Simulator	2022-08-05	247	134	40	287	0.7131000000000001
远征契约	2022-10-21	32	64	17	49	0.7131000000000001
The Backrooms	2022-10-29	8	48	12	20	0.713
Lost Ark	2022-02-11	1325305	137424	53849	1379154	0.7129000000000001
Who Pressed Mute on Uncle Marcus?	2022-03-18	60	347	114	174	0.7129000000000001
Dwerve	2022-05-31	610	389	129	739	0.7127
World Fighting Soccer 22	2022-08-30	9	28	6	15	0.7126
Trigo	2022-02-18	7	28	6	13	0.7126
The Last Secret	2022-08-30	7	28	6	13	0.7126
Crocodile Transformator	2022-10-23	3	28	6	9	0.7126
Peepo Island	2022-07-18	854	163	50	904	0.7125
Harlow	2022-03-14	4	21	4	8	0.7125
Pets and Girls	2022-02-17	3	21	4	7	0.7125
Grid Slayer	2022-02-02	7	21	4	11	0.7125
Deadly Infestation	2022-02-14	3	21	4	7	0.7125
剑冢 Swords Tomb	2022-05-06	22	21	4	26	0.7125
Chords Enchanter	2022-06-17	5	21	4	9	0.7125
Goat's Tale 2	2022-11-09	100	21	4	104	0.7125
Robot Resistors	2022-10-22	8	21	4	12	0.7125
ACHIEVEMENTS CITY	2022-09-12	3	21	4	7	0.7125
姬恋~缚羽的欠片 纯净中文版	2022-11-14	9	21	4	13	0.7125
Rhythm Journey	2022-04-17	20	73	20	40	0.7123999999999999
Hentai War	2022-12-09	5	38	9	14	0.7123
Pinch of Fighting Girls	2022-08-09	19	38	9	28	0.7123
Hentai Bodysuit	2022-10-28	7	38	9	16	0.7123
SILT	2022-06-01	142	255	82	224	0.7122
Knights of the Chalice 2	2022-03-25	51	76	21	72	0.7122
AfterHours	2022-02-18	93	306	100	193	0.7121
Bombagun	2022-01-26	36	79	22	58	0.7121
Tower of Fantasy	2022-10-20	7210	4779	1785	8995	0.7119
Esse Proxy	2022-07-11	41	85	24	65	0.7118000000000001
Hazel Sky	2022-07-20	49	115	34	83	0.7117
Deadness	2022-02-22	11	103	30	41	0.7116
Argentum 20	2022-04-29	500	271	88	588	0.7115
There Is No Light	2022-09-19	612	366	122	734	0.7112
ReFactory	2022-04-08	54	60	16	70	0.7112
BITGUN	2022-04-29	4	31	7	11	0.711
The Pizza Courier	2022-09-23	6	31	7	13	0.711
AOI	2022-12-15	14	31	7	21	0.711
Train Life - A Railway Simulator	2022-08-25	407	879	310	717	0.7109000000000001
Hot Lap League	2022-08-23	21	63	17	38	0.7109000000000001
Eclipse	2022-09-27	9	132	40	49	0.7108
Endless waves survival	2022-06-14	132	132	40	172	0.7108
Soul Scathe	2022-02-18	10	44	11	21	0.7107
Three Kingdom: The Journey	2022-01-07	21	44	11	32	0.7107
Void Marauders	2022-03-29	23	44	11	34	0.7107
The Hentai Memory	2022-03-09	60	44	11	71	0.7107
Brave survivors	2022-09-30	15	44	11	26	0.7107
Haisonmeguri	2022-07-16	81	69	19	100	0.7105
Dungeons of Edera	2022-06-16	326	690	241	567	0.7104
谜语女孩	2022-06-17	32	81	23	55	0.7101999999999999
刻印战记：冰冻之剑 RE	2022-09-29	94	99	29	123	0.7101000000000001
Dark Quest 3	2022-05-04	84	93	27	111	0.7101000000000001
Kamikaze Kommittee Ouka 2	2022-02-05	163	90	26	189	0.7101000000000001
Pro Basketball Manager 2023	2022-11-10	83	90	26	109	0.7101000000000001
Mage Rage	2022-03-22	3	17	3	6	0.71
Queenchantment	2022-03-04	9	17	3	12	0.71
Fragmented Memories	2022-05-09	7	17	3	10	0.71
Late photographer 2	2022-02-03	9	17	3	12	0.71
LIP! Lewd Idol Project Vol. 2	2022-12-15	19	17	3	22	0.71
Banana Hunter	2022-03-02	3	17	3	6	0.71
Digital Diamond Baseball V10	2022-03-31	26	17	3	29	0.71
Emorrior	2022-10-01	6	17	3	9	0.71
Odd One Out	2022-06-26	5	17	3	8	0.71
69 Penny Hot	2022-08-08	5	17	3	8	0.71
Death in the Night	2022-11-21	4	17	3	7	0.71
Reilla ~Sweets Adventure~	2022-10-04	5	17	3	8	0.71
Port Cranes : Container Age	2022-10-21	13	17	3	16	0.71
Police Radar	2022-09-02	2	17	3	5	0.71
伏魔天师	2022-11-04	10	17	3	13	0.71
Contrast & Girls	2022-08-25	2	17	3	5	0.71
Geometric Sniper - Z	2022-12-19	4	24	5	9	0.7099
The Tribulation Entanglement	2022-02-06	3	24	5	8	0.7099
Anime Armpits	2022-05-25	3	24	5	8	0.7099
Meat & Greed	2022-06-07	5	24	5	10	0.7099
Noclipped	2022-10-04	11	24	5	16	0.7099
ToS Gamepad Tester	2022-08-27	8	24	5	13	0.7099
Funeral	2022-11-23	3	24	5	8	0.7099
Gladius	2022-10-29	14	186	59	73	0.7098000000000001
River City Saga: Three Kingdoms	2022-07-20	436	137	42	478	0.7098000000000001
Swarm the City	2022-06-16	131	137	42	173	0.7098000000000001
NOBUNAGA'S AMBITION: Awakening	2022-07-21	11783	940	335	12118	0.7097
Magicians And Monsters	2022-08-29	26	50	13	39	0.7097
房地产大亨	2022-08-05	1113	307	102	1215	0.7095999999999999
大富翁少女	2022-01-11	158	217	70	228	0.7095
百年王国	2022-02-03	72	53	14	86	0.7093
Her Name Was Fire	2022-10-11	162	171	54	216	0.7091
Miner Ultra Adventures 2	2022-05-12	34	275	91	125	0.7089
TombStar	2022-07-20	64	59	16	80	0.7088
Re:Turn 2 - Runaway	2022-01-28	10	37	9	19	0.7088
The Lord of the Parties	2022-06-30	34	37	9	43	0.7088
Crown of Pain	2022-02-15	21	37	9	30	0.7088
无双剑士的后宫生活	2022-06-18	290	136	42	332	0.7086
No man`s Island Prologue	2022-08-01	115	65	18	133	0.7084999999999999
F1® Manager 2022	2022-08-30	25575	6784	2605	28180	0.7084
Dinosaur Fossil Hunter	2022-05-04	855	461	159	1014	0.7084
Cowboy Life Simulator: Prologue	2022-01-06	91	153	48	139	0.7084
The Gametrekking Omnibus	2022-12-05	2	5	0	2	0.7084
SKYRAID	2022-09-07	9	5	0	9	0.7084
Be Vigilant!	2022-01-24	13	5	0	13	0.7084
N-GON	2022-10-11	2	5	0	2	0.7084
Beauty Paradise	2022-05-20	11	5	0	11	0.7084
Dofense	2022-05-16	4	5	0	4	0.7084
Music_is_the_Language	2022-05-18	1	5	0	1	0.7084
Beyond Hope	2022-11-17	4	5	0	4	0.7084
Push Blox	2022-06-02	3	5	0	3	0.7084
Presidential Running Games	2022-01-21	2	5	0	2	0.7084
GreedyCorgi	2022-01-21	3	5	0	3	0.7084
Death Cube	2022-05-12	2	5	0	2	0.7084
Personal Rocket	2022-01-31	2	5	0	2	0.7084
The Dream of Shadowlands Episode 2	2022-06-23	3	5	0	3	0.7084
Stream Toys by Zokya	2022-07-01	4	5	0	4	0.7084
Re:Kuroi	2022-01-06	4	5	0	4	0.7084
Pandemic Pandemonium	2022-01-21	1	5	0	1	0.7084
Abridge	2022-10-14	3	5	0	3	0.7084
ZONERS	2022-08-02	2	5	0	2	0.7084
Endless Thief: a fluffy stealth adventure	2022-05-26	2	5	0	2	0.7084
Panmorphia: Awakened	2022-04-28	4	5	0	4	0.7084
DROPSHIP	2022-11-30	2	5	0	2	0.7084
Poulet Poulet	2022-07-28	3	5	0	3	0.7084
James Peris 2: The fountain of eternal drunkenness - UNCUT AND UNCENSORED	2022-11-23	3	5	0	3	0.7084
Mrs. Fantastic's Freaky Figurine Shop	2022-06-24	4	5	0	4	0.7084
Battery-ouT	2022-03-13	3	5	0	3	0.7084
My Story	2022-01-08	6	5	0	6	0.7084
Barn Finders VR	2022-06-02	5	5	0	5	0.7084
NeverDeath	2022-04-25	2	5	0	2	0.7084
Volcanon	2022-03-31	6	5	0	6	0.7084
Daydream	2022-06-02	7	5	0	7	0.7084
Strings of Divinity | The Spell Plague	2022-01-27	3	5	0	3	0.7084
Pirated Code: Admin Edition	2022-11-03	3	5	0	3	0.7084
Ari's Journey	2022-03-03	2	5	0	2	0.7084
Captain Diarrhea and The Shartening	2022-06-22	1	5	0	1	0.7084
Ultimaze	2022-06-28	2	5	0	2	0.7084
I Am 1	2022-06-17	3	5	0	3	0.7084
SquareMan	2022-02-05	4	5	0	4	0.7084
Stop the Saturnians!	2022-02-18	3	5	0	3	0.7084
Book Hunter	2022-02-04	2	5	0	2	0.7084
Argonauts Agency: Missing Daughter	2022-01-17	8	5	0	8	0.7084
Fuchian Chronicles	2022-01-06	3	5	0	3	0.7084
Ambition Record	2022-02-04	9	5	0	9	0.7084
Nora: The Wannabe Alchemist	2022-05-26	5	5	0	5	0.7084
Spartan	2022-10-17	9	5	0	9	0.7084
Blankiball: The Drinking Game	2022-09-14	4	5	0	4	0.7084
How to Fool a Liar King Remastered	2022-04-07	4	5	0	4	0.7084
Retro TV Game Collection	2022-02-21	2	5	0	2	0.7084
HOSTLIGHT	2022-07-22	3	5	0	3	0.7084
Jester Street : Card-Counting Trainer	2022-01-22	2	5	0	2	0.7084
Perfect Balance	2022-01-01	48	5	0	48	0.7084
Breaking Newton	2022-03-02	1	5	0	1	0.7084
Quest for Cathay Kingdom	2022-03-18	2	5	0	2	0.7084
Run Run Piñata	2022-01-30	5	5	0	5	0.7084
Bunny Box Breakout	2022-10-26	1	5	0	1	0.7084
Safe and Sound - Indie Game	2022-02-25	2	5	0	2	0.7084
Jules	2022-01-21	2	5	0	2	0.7084
Omi Oh My AI	2022-09-02	4	5	0	4	0.7084
Orbital Mechanics	2022-05-06	2	5	0	2	0.7084
欢迎回家-Welcome Home	2022-02-15	5	5	0	5	0.7084
Elven Warmaiden	2022-02-03	2	5	0	2	0.7084
ELEVATED	2022-04-14	22	5	0	22	0.7084
CellSar	2022-04-26	3	5	0	3	0.7084
Cute Snake	2022-03-15	3	5	0	3	0.7084
Juno 06	2022-11-04	3	5	0	3	0.7084
Ploc	2022-02-17	2	5	0	2	0.7084
Love on Beach	2022-03-03	3	5	0	3	0.7084
Everplast	2022-02-24	3	5	0	3	0.7084
Undeads vs Humans	2022-03-01	2	5	0	2	0.7084
DuolBots	2022-08-31	5	5	0	5	0.7084
Reversilly	2022-04-14	8	5	0	8	0.7084
12 Labours of Hercules XIV: Message in a Bottle	2022-10-24	28	5	0	28	0.7084
Path Of Destruction	2022-08-13	6	5	0	6	0.7084
Mythic Defender	2022-04-23	2	5	0	2	0.7084
Calmie Dots	2022-05-16	2	5	0	2	0.7084
Quoin	2022-10-03	2	5	0	2	0.7084
Zap Dem Rats	2022-03-30	2	5	0	2	0.7084
Fruit Basket TV	2022-06-16	7	5	0	7	0.7084
Light The Lamp Hockey	2022-11-15	2	5	0	2	0.7084
OUTLANDER	2022-04-04	1	5	0	1	0.7084
Down n' Up	2022-07-07	2	5	0	2	0.7084
STAR MATH: Interstellar Rogue 2	2022-07-21	4	5	0	4	0.7084
Neon Flash II	2022-04-11	3	5	0	3	0.7084
Lovely Moments: Dad and daughter	2022-07-09	2	5	0	2	0.7084
Paranormal Simulator	2022-05-12	3	5	0	3	0.7084
Pirates - Digital Strategy Game	2022-12-02	7	5	0	7	0.7084
The Last Man	2022-05-20	3	5	0	3	0.7084
Beat The Clock	2022-06-01	3	5	0	3	0.7084
Project Nautilus	2022-05-06	3	5	0	3	0.7084
Dash Shooters	2022-08-01	1	5	0	1	0.7084
Arsilon	2022-05-26	2	5	0	2	0.7084
Edge Run	2022-04-25	2	5	0	2	0.7084
Doggo Estates	2022-12-01	4	5	0	4	0.7084
Sisters_Possession2	2022-05-17	5	5	0	5	0.7084
HopDodge	2022-06-01	5	5	0	5	0.7084
Eshe's Wish Adventure	2022-05-09	3	5	0	3	0.7084
Running Over Zombies	2022-07-06	5	5	0	5	0.7084
Chronicle of Forgotten Times: Pawn of the Gods	2022-06-02	2	5	0	2	0.7084
CARROT: Pancakes and Waffles	2022-08-27	2	5	0	2	0.7084
Metal World: Street Scraps	2022-05-20	2	5	0	2	0.7084
Fight For It	2022-08-03	4	5	0	4	0.7084
Blitz in the Paper Kingdom	2022-06-17	3	5	0	3	0.7084
NanoHive	2022-09-30	4	5	0	4	0.7084
Enter the Cum™: an Erotic Porn Sexual Pleasure!	2022-06-10	1	5	0	1	0.7084
FunnyPizzaLand 2	2022-10-08	2	5	0	2	0.7084
BOOM!	2022-06-03	2	5	0	2	0.7084
Wizcave	2022-08-19	1	5	0	1	0.7084
Nade Nade Onna no Ko 7: Imprisonment Sex Story	2022-09-09	5	5	0	5	0.7084
Hide And Seek Scramble!	2022-06-14	7	5	0	7	0.7084
Ye Olde Cribbage Club	2022-06-15	3	5	0	3	0.7084
Niravasi	2022-07-06	2	5	0	2	0.7084
L-Racers	2022-07-03	2	5	0	2	0.7084
KaBoom!	2022-08-22	1	5	0	1	0.7084
Junkyard War	2022-07-01	2	5	0	2	0.7084
Vain Ascendance	2022-08-05	3	5	0	3	0.7084
Tater Spud	2022-07-29	2	5	0	2	0.7084
Streamers' Secret Life	2022-11-16	2	5	0	2	0.7084
Harry Is A Porter	2022-08-13	2	5	0	2	0.7084
Acanthoceras	2022-07-21	2	5	0	2	0.7084
FREM Sprite32!	2022-10-17	4	5	0	4	0.7084
传颂的种族 The Celebrated Race	2022-07-12	3	5	0	3	0.7084
Cat Dungeon	2022-08-05	3	5	0	3	0.7084
DodgeKing	2022-10-07	2	5	0	2	0.7084
Try Again	2022-10-07	2	5	0	2	0.7084
Tap the Blocks	2022-09-22	3	5	0	3	0.7084
Klaystar	2022-09-17	6	5	0	6	0.7084
Apollo's Adventure	2022-08-09	6	5	0	6	0.7084
STARR RINGER	2022-10-07	3	5	0	3	0.7084
Redhot Rabbit	2022-08-16	2	5	0	2	0.7084
EvoLife	2022-09-16	6	5	0	6	0.7084
Little Hellions	2022-10-31	3	5	0	3	0.7084
Moving Jigsaw Puzzles	2022-11-22	2	5	0	2	0.7084
进入后室Get into Backrooms	2022-08-24	2	5	0	2	0.7084
Bogey Brian	2022-09-30	4	5	0	4	0.7084
Furry Hentai Tangram	2022-11-25	2	5	0	2	0.7084
Square Off	2022-10-01	4	5	0	4	0.7084
Double Trouble	2022-09-13	3	5	0	3	0.7084
DeerHunterFan.com TV - The Season	2022-10-07	3	5	0	3	0.7084
路地を曲がれば～海峡の故郷～	2022-10-14	2	5	0	2	0.7084
SGS Okinawa	2022-11-21	4	5	0	4	0.7084
Decopins	2022-11-04	4	5	0	4	0.7084
Don't Hide	2022-09-13	2	5	0	2	0.7084
荆轲新传（重制版）	2022-10-01	10	5	0	10	0.7084
牌师	2022-09-26	7	5	0	7	0.7084
Milita Aventuro	2022-09-29	3	5	0	3	0.7084
Planet Barren Objective	2022-09-26	2	5	0	2	0.7084
Hidden Object Vacation	2022-09-19	6	5	0	6	0.7084
Strength & Virtue: Lord of Midchester	2022-12-16	3	5	0	3	0.7084
Horror Hotel	2022-10-23	1	5	0	1	0.7084
Crush Penguin	2022-10-15	1	5	0	1	0.7084
What They Don't Sea	2022-11-01	3	5	0	3	0.7084
Duck Race	2022-11-12	2	5	0	2	0.7084
Super Jumpy Ball	2022-11-11	3	5	0	3	0.7084
I Love Finding Birds	2022-12-19	5	5	0	5	0.7084
Orbtangle	2022-10-28	3	5	0	3	0.7084
Frog In the Well	2022-10-18	2	5	0	2	0.7084
A Potion For Chamomile	2022-10-21	1	5	0	1	0.7084
Banana Quest	2022-10-23	2	5	0	2	0.7084
Missing Pictures: Tsai Ming-Lang	2022-12-01	1	5	0	1	0.7084
Missing Pictures : Abel Ferrara	2022-12-02	2	5	0	2	0.7084
CAMPING	2022-11-03	2	5	0	2	0.7084
Princess Dating Sim	2022-12-05	2	5	0	2	0.7084
Planet Breakout 2	2022-12-13	3	5	0	3	0.7084
circloO	2022-11-14	3	5	0	3	0.7084
リフトピア　もうひとのせ！	2022-11-29	1	5	0	1	0.7084
My Boss' Wife is My Ex ~Reluctantly Drowning in Sex Deals After Hours~	2022-12-20	3	5	0	3	0.7084
Obscene Medical Records of a Married Nurse	2022-12-20	1	5	0	1	0.7084
Jump Dash Soar	2022-12-09	4	5	0	4	0.7084
Robbie's Tale	2022-12-07	4	5	0	4	0.7084
CodingPack	2022-12-25	2	5	0	2	0.7084
Lost Abroad Café	2022-12-31	3	5	0	3	0.7084
ThanksKilling Day	2022-12-31	2	5	0	2	0.7084
Grievous Survivors	2022-12-21	3	5	0	3	0.7084
ResttW	2022-12-25	2	5	0	2	0.7084
GRID Legends	2022-02-24	455	1171	425	880	0.7083
PunjiVR	2022-07-15	6	40	10	16	0.7081000000000001
Rising Mist	2022-02-24	10	27	6	16	0.7081000000000001
Firelight Fantasy: Vengeance	2022-05-06	7	27	6	13	0.7081000000000001
PIXELS: Digital Creatures	2022-07-11	10	27	6	16	0.7081000000000001
Bouldeurdache	2022-02-05	4	27	6	10	0.7081000000000001
Naxos	2022-05-09	6	27	6	12	0.7081000000000001
Gamebook Edgar A. Poe: The Oval Portrait	2022-06-23	5	27	6	11	0.7081000000000001
Microbes and Machines	2022-09-03	11	27	6	17	0.7081000000000001
Super Weapon Master	2022-08-22	8	27	6	14	0.7081000000000001
Afterglitch	2022-12-09	4	13	2	6	0.7075
get REKTorized	2022-07-07	7	13	2	9	0.7075
Hirilun	2022-03-14	4	13	2	6	0.7075
Hope's Journey: A Therapeutic Experience	2022-04-15	2	13	2	4	0.7075
Camp Palut	2022-06-15	5	13	2	7	0.7075
BangBang PewPew	2022-04-08	4	13	2	6	0.7075
VRkanoid - Brick Breaking Game	2022-03-16	2	13	2	4	0.7075
Road Cards	2022-01-23	3	13	2	5	0.7075
Alchemist of War	2022-01-17	3	13	2	5	0.7075
Total CATastrophe	2022-02-06	4	13	2	6	0.7075
Timberman VR	2022-08-16	5	13	2	7	0.7075
Rescue Team: Heist of the Century	2022-03-30	23	13	2	25	0.7075
Pixel Trouble	2022-03-02	4	13	2	6	0.7075
Roxy Raccoon's Bowling Bash	2022-08-23	2	13	2	4	0.7075
Pixel Pirate	2022-03-18	3	13	2	5	0.7075
Tales of Fire	2022-06-17	3	13	2	5	0.7075
The Kobolds Left Behind	2022-07-07	2	13	2	4	0.7075
Shadelight	2022-09-23	3	13	2	5	0.7075
For What Will Come	2022-10-29	5	13	2	7	0.7075
New Tanks	2022-08-08	3	13	2	5	0.7075
终末方舟 序	2022-07-19	5	13	2	7	0.7075
Harpoon	2022-07-23	3	13	2	5	0.7075
Die O' Clock	2022-11-29	7	13	2	9	0.7075
Robot Tormod	2022-12-20	2	13	2	4	0.7075
Hook&Loop	2022-12-01	3	13	2	5	0.7075
Nick Bounty - The Goat in the Grey Fedora: Remastered	2022-10-03	6	13	2	8	0.7075
Let's Park Backyard Edition	2022-09-05	2	13	2	4	0.7075
Actua Soccer 2	2022-10-10	6	13	2	8	0.7075
Lion King Simulator	2022-10-19	3	13	2	5	0.7075
ISO	2022-11-28	5	13	2	7	0.7075
PUB FASCINATION	2022-11-22	5	13	2	7	0.7075
Geolosys	2022-11-19	2	13	2	4	0.7075
Jewel Match Winter Wonderland 2 Collector's Edition	2022-12-15	23	13	2	25	0.7075
Metal Mind	2022-04-25	343	286	96	439	0.7072
Bard Idle	2022-09-22	1012	275	92	1104	0.7072
VR NSFW	2022-03-17	7	100	30	37	0.7072
Levitation Simulator	2022-01-27	27	46	12	39	0.7072
Idle TD: Heroes vs Zombies	2022-01-25	122	97	29	151	0.7071
无二解药	2022-06-22	6	30	7	13	0.7068000000000001
Logicality	2022-06-14	9	30	7	16	0.7068000000000001
Mutant Meltdown	2022-09-09	18	30	7	25	0.7068000000000001
Alchemist Tris's Desire	2022-10-27	19	30	7	26	0.7068000000000001
The Lost and The Wicked	2022-03-24	3	20	4	7	0.7068000000000001
Firekeep	2022-04-19	4	20	4	8	0.7068000000000001
Coins Invaders	2022-02-15	3	20	4	7	0.7068000000000001
PAW Patrol: Grand Prix	2022-09-30	21	20	4	25	0.7068000000000001
Dead No Head	2022-01-20	3	20	4	7	0.7068000000000001
Dead End Aegis: Gaiden	2022-01-02	8	20	4	12	0.7068000000000001
EXIT - The Curse of Ophir	2022-06-29	13	20	4	17	0.7068000000000001
CARDMON	2022-05-19	7	20	4	11	0.7068000000000001
CATAIRE	2022-09-23	6	20	4	10	0.7068000000000001
Winning Post 9 2022	2022-04-14	4727	85	25	4752	0.7067
WoMen in Science	2022-08-15	27	52	14	41	0.7067
The Monster Within	2022-10-22	19	52	14	33	0.7067
My Yandere is a Futanari	2022-04-04	5	52	14	19	0.7067
Circus Electrique	2022-09-06	280	157	50	330	0.7066
ORX	2022-08-30	925	364	125	1050	0.7065
SOL CRESTA	2022-02-22	44	61	17	61	0.7064
Beasts of Burden	2022-04-06	31	61	17	48	0.7064
Indecent Details - Find the Difference	2022-04-05	43	111	34	77	0.7062999999999999
Fueled Up	2022-10-13	207	67	19	226	0.7062999999999999
Child of Lothian	2022-06-16	31	67	19	50	0.7062999999999999
KAREN SEES	2022-02-04	3	33	8	11	0.7059000000000001
MetälBörn	2022-07-21	9	33	8	17	0.7059000000000001
Succubus Girl Story	2022-03-04	12	102	31	43	0.7058
WTC : Relentless Protagonist	2022-09-28	2	9	1	3	0.7057
Social Services of the Doomed	2022-06-23	24	9	1	25	0.7057
Crazy Chicken Xtreme	2022-08-22	4	9	1	5	0.7057
Frisbros	2022-03-18	4	9	1	5	0.7057
Venice 2089 	2022-10-14	9	9	1	10	0.7057
HeadCount	2022-04-18	2	9	1	3	0.7057
Ortheo	2022-05-21	2	9	1	3	0.7057
Being Loved	2022-02-17	2	9	1	3	0.7057
The Evolving World: Catalyst Wake	2022-02-10	3	9	1	4	0.7057
Papertris	2022-03-01	6	9	1	7	0.7057
Mayflower Reflections	2022-02-24	12	9	1	13	0.7057
Froggo Swing 'n Grapple	2022-11-30	3	9	1	4	0.7057
Professor of Magical Studies	2022-12-08	40	9	1	41	0.7057
Tribal.Games	2022-04-14	7	9	1	8	0.7057
Dream Of The Hikikomori	2022-02-04	2	9	1	3	0.7057
Word of the Law: Death Mask Collector's Edition	2022-01-11	7	9	1	8	0.7057
Japanese DoJo	2022-02-02	2	9	1	3	0.7057
System Critical: The Race Against Time	2022-07-15	3	9	1	4	0.7057
VIrus Killer	2022-01-24	2	9	1	3	0.7057
Super Rolling Heroes	2022-03-23	5	9	1	6	0.7057
New Century Galaxy Legend	2022-02-23	4	9	1	5	0.7057
Pasajeros	2022-03-12	2	9	1	3	0.7057
Battle of Finland: Winter War	2022-03-14	2	9	1	3	0.7057
Yosemite Forest Ranger	2022-05-26	6	9	1	7	0.7057
Cosmoblaster Exodia	2022-03-14	4	9	1	5	0.7057
Golfing In Aether	2022-09-23	6	9	1	7	0.7057
Slackline VR	2022-03-25	2	9	1	3	0.7057
Shady Business	2022-03-30	4	9	1	5	0.7057
Tilefinder	2022-07-12	4	9	1	5	0.7057
Narcotics Ninja	2022-05-02	4	9	1	5	0.7057
Gemlands	2022-04-10	2	9	1	3	0.7057
Dino-D	2022-05-06	3	9	1	4	0.7057
Collapsed	2022-08-09	3	9	1	4	0.7057
New Yankee: Battle for the Bride	2022-05-11	25	9	1	26	0.7057
Lunatia Covenant -Pale White Agent-	2022-05-10	6	9	1	7	0.7057
Spacemancer	2022-05-18	4	9	1	5	0.7057
Fucking Hell	2022-06-02	3	9	1	4	0.7057
Zaxterion - Space Frenzy	2022-09-10	3	9	1	4	0.7057
BTank	2022-09-01	3	9	1	4	0.7057
Ready or Not	2022-07-08	3	9	1	4	0.7057
Astro	2022-09-21	3	9	1	4	0.7057
My Agent is a Futanari	2022-09-26	5	9	1	6	0.7057
No Time For Caution	2022-12-09	3	9	1	4	0.7057
Escape	2022-08-16	4	9	1	5	0.7057
Get the Ball Rolling	2022-08-25	2	9	1	3	0.7057
Jade Order	2022-08-25	2	9	1	3	0.7057
DragonScales 1-7 Collection	2022-08-26	3	9	1	4	0.7057
Missile Command: Recharged	2022-11-01	4	9	1	5	0.7057
Arcane Arts Academy 2	2022-09-22	6	9	1	7	0.7057
Korean BBQ Simulator	2022-10-14	2	9	1	3	0.7057
VR Rock Climbing	2022-09-28	2	9	1	3	0.7057
STRAY CAT	2022-10-01	2	9	1	3	0.7057
Ankora: Lost Days - Prologue	2022-10-28	4	9	1	5	0.7057
Hoiwa Hub	2022-10-15	2	9	1	3	0.7057
Each Other	2022-10-31	3	9	1	4	0.7057
Dark Sweeper	2022-11-17	4	9	1	5	0.7057
Palladise Island：Legendary Space	2022-12-08	6	9	1	7	0.7057
I commissioned some bees (advent)	2022-12-01	6	9	1	7	0.7057
Истории ужасов: Воскрешение	2022-02-19	23	113	35	58	0.7051000000000001
Engine Evolution 2021	2022-01-12	158	529	188	346	0.705
Arctico	2022-02-15	132	826	301	433	0.7048000000000001
De'Vine: Heavenly Acres	2022-07-29	13	23	5	18	0.7048000000000001
SUPER NANARU	2022-03-24	6	23	5	11	0.7048000000000001
Stardust Valkyries	2022-09-15	15	23	5	20	0.7048000000000001
Divinus Vanitas	2022-09-14	6	23	5	11	0.7048000000000001
Fairy Girl	2022-11-11	5	23	5	10	0.7048000000000001
The Pegasus Expedition	2022-10-20	123	66	19	142	0.7041
ERRANTE	2022-02-04	18	48	13	31	0.7041
Tuin	2022-08-26	46	54	15	61	0.7039
Weird Hat Fight	2022-05-16	90	26	6	96	0.7034
Riki's Risky Ride	2022-03-15	14	26	6	20	0.7034
VaporBall	2022-03-02	6	16	3	9	0.7033
Revenants	2022-10-27	3	16	3	6	0.7033
Brave Deeds of Rescue Team	2022-06-08	25	16	3	28	0.7033
Automation	2022-01-24	6	16	3	9	0.7033
Grandma's Footsteps	2022-02-22	4	16	3	7	0.7033
The House On Holland Hill	2022-03-01	2	16	3	5	0.7033
Avocado Love	2022-01-17	12	16	3	15	0.7033
Furry Boys Jigsaw	2022-01-24	3	16	3	6	0.7033
HardWorker Simulator	2022-02-18	7	16	3	10	0.7033
Shadow Running	2022-01-31	5	16	3	8	0.7033
Monsterlands	2022-06-14	10	16	3	13	0.7033
STEIIARIA	2022-06-25	2	16	3	5	0.7033
SEARCH ALL - BITCOIN	2022-06-12	3	16	3	6	0.7033
The Last Fighter	2022-07-30	3	16	3	6	0.7033
Big Bad Futanari Wolf	2022-12-15	5	16	3	8	0.7033
Missing Pieces	2022-10-19	5	16	3	8	0.7033
Super Clown 3: Revenge	2022-11-08	4	16	3	7	0.7033
IN THE BUILDING: CATS 2	2022-12-19	6	16	3	9	0.7033
CRIMESIGHT	2022-04-14	572	484	173	745	0.7031000000000001
Voice of Chernobyl	2022-09-18	666	80	24	690	0.7029000000000001
Handyman Corporation: Prologue	2022-12-16	574	117	37	611	0.7028
Spiders Everywhere	2022-01-22	24	97	30	54	0.7026000000000001
The Adventures of Poppe	2022-08-05	5	29	7	12	0.7025
Harem of Nurses	2022-07-15	48	71	21	69	0.7023
Master of Magic	2022-12-13	1028	489	176	1204	0.7021
Black Hole Pool	2022-08-02	44	65	19	63	0.7019
Take the Throne	2022-04-20	153	119	38	191	0.7018000000000001
风色幻想3:罪与罚的镇魂歌	2022-08-09	138	85	26	164	0.7016
Ancient Wars: Sparta Definitive Edition	2022-01-28	44	163	54	98	0.7015000000000001
Letina's Odyssey	2022-09-17	85	35	9	94	0.7015000000000001
Vanaris Tactics - Prologue	2022-04-21	10	35	9	19	0.7015000000000001
TimeMelters - Challenges	2022-08-04	11	35	9	20	0.7015000000000001
Reborn	2022-10-28	37	35	9	46	0.7015000000000001
Hentai Furry 3	2022-08-24	6	35	9	15	0.7015000000000001
Survival Academy	2022-11-08	57	56	16	73	0.7014
The Triumphant Return of Diabolos	2022-06-11	124	41	11	135	0.7012
My Pet Sitter is a Futanari	2022-05-27	5	41	11	16	0.7012
Secrets of the Temple	2022-03-14	8	41	11	19	0.7012
Garfield Lasagna Party	2022-11-10	12	41	11	23	0.7012
Firelight Fantasy: Force Energy	2022-02-18	7	44	12	19	0.7011000000000001
Little Orpheus	2022-09-13	49	157	52	101	0.701
Nero The Sniper	2022-07-22	59	124	40	99	0.701
Space Roguelike Adventure	2022-10-11	6	19	4	10	0.7008
Hatsumira -from the future undying-	2022-04-28	37	19	4	41	0.7008
Soul In the Chamber	2022-04-25	5	19	4	9	0.7008
Under The Moon	2022-12-06	9	19	4	13	0.7008
SIMBA THE CAT	2022-06-24	3	19	4	7	0.7008
Age of Solitaire : Build Civilization	2022-07-27	9	19	4	13	0.7008
THE FATE OF MIRADOR CHAPTER ONE	2022-07-23	14	19	4	18	0.7008
Coin Pusher Casino	2022-12-28	35	19	4	39	0.7008
Emma - In the Library	2022-12-01	6	19	4	10	0.7008
A Sinful Camp	2022-02-15	92	173	58	150	0.7006
My Museum Prologue: Treasure Hunter	2022-09-16	153	118	38	191	0.7004
Demon Sword: Incubus	2022-06-17	89	90	28	117	0.7004
Halftime Heroes	2022-03-11	388	197	67	455	0.7003
Ultrawings 2	2022-10-27	25	67	20	45	0.6999
Colony Simulator	2022-02-08	92	247	86	178	0.6997
精靈之妊 -用懷孕征服所有傲慢的精靈-	2022-11-16	452	247	86	538	0.6997
Vostok 2061	2022-10-07	7	22	5	12	0.6994
DreamBig 3	2022-03-31	4	22	5	9	0.6994
PISTOLA	2022-06-21	7	22	5	12	0.6994
Animals Transport Simulator	2022-05-26	2	22	5	7	0.6994
Be My Girlfriends	2022-04-13	167	278	98	265	0.6992
Black Geyser: Couriers of Darkness	2022-03-17	330	527	194	524	0.6990999999999999
My Loving Wife	2022-12-06	9	58	17	26	0.6990999999999999
Fight,to the last	2022-11-28	4	12	2	6	0.6990999999999999
Essence Of The Tjikko - Prologue	2022-02-02	4	12	2	6	0.6990999999999999
Tower of the sage	2022-07-28	3	12	2	5	0.6990999999999999
Kamigami: Clash of the Gods	2022-07-25	7	12	2	9	0.6990999999999999
Haunted Hotel: Silent Waters Collector's Edition	2022-01-07	13	12	2	15	0.6990999999999999
SAVE BILLY	2022-01-24	4	12	2	6	0.6990999999999999
Blastocitos	2022-03-02	4	12	2	6	0.6990999999999999
Frog Fall Down	2022-03-08	4	12	2	6	0.6990999999999999
Night Blood : Avenger's Tide	2022-07-11	4	12	2	6	0.6990999999999999
Sex Adventures - Mile High Club	2022-03-04	5	12	2	7	0.6990999999999999
Alexandria - Port of Worlds	2022-05-14	8	12	2	10	0.6990999999999999
Space egg shooter	2022-05-06	3	12	2	5	0.6990999999999999
Mount Wingsuit 2	2022-08-25	4	12	2	6	0.6990999999999999
Lander Odyssey	2022-05-17	5	12	2	7	0.6990999999999999
Cryptr	2022-08-31	2	12	2	4	0.6990999999999999
Flora and Sauna	2022-06-06	9	12	2	11	0.6990999999999999
Ancient Aliens	2022-09-28	11	12	2	13	0.6990999999999999
Penguins Can Fly	2022-07-19	5	12	2	7	0.6990999999999999
Hero of war	2022-09-01	2	12	2	4	0.6990999999999999
Bots City	2022-07-11	2	12	2	4	0.6990999999999999
SUN SHOT	2022-09-03	2	12	2	4	0.6990999999999999
The Letter: Classic Edition	2022-11-08	2	12	2	4	0.6990999999999999
Virtual Sailor NG	2022-10-06	18	12	2	20	0.6990999999999999
Blood Exile	2022-11-21	1	12	2	3	0.6990999999999999
Gravity Magician	2022-11-19	3	12	2	5	0.6990999999999999
ZAVOD	2022-12-26	5	12	2	7	0.6990999999999999
LOST EPIC	2022-07-27	1175	705	264	1439	0.6988
Prosperous Universe	2022-04-20	183	361	130	313	0.6988
Siren Head: The Horror Experience	2022-11-23	37	144	48	85	0.6987000000000001
Vanaris Tactics	2022-08-04	47	89	28	75	0.6987000000000001
Achilles: Legends Untold	2022-05-12	266	345	124	390	0.6986
Holomento	2022-04-27	93	100	32	125	0.6985
Charon's Staircase	2022-10-28	8	25	6	14	0.6985
My Nemesis and Hero	2022-01-11	6	25	6	12	0.6985
Sword of Atlas	2022-04-27	6	25	6	12	0.6985
Lawnmower game: Mortal Race	2022-06-01	6	25	6	12	0.6985
Save Daddy Trump 3: Rise Of Evil	2022-09-01	6	25	6	12	0.6985
Ballads and Romances	2022-12-21	4	25	6	10	0.6985
Zoey: My Hentai Sex Doll	2022-09-09	43	111	36	79	0.6984
The Backroom Project	2022-05-15	9	97	31	40	0.6981
Monorail Stories	2022-09-30	16	28	7	23	0.698
The Dark Prophecy	2022-02-28	4	28	7	11	0.698
Lustful Pussies	2022-06-01	2	28	7	9	0.698
绯色物语	2022-10-28	23	28	7	30	0.698
Star Melody Yumemi Dreamer	2022-01-21	18	43	12	30	0.6979000000000001
Tennis Manager 2022	2022-05-17	277	94	30	307	0.6977
RTX Sweeper	2022-03-17	10	37	10	20	0.6977
ConflictCraft 2	2022-02-10	7	37	10	17	0.6977
Rogue Arrows	2022-06-06	44	31	8	52	0.6977
Idle Superpowers	2022-01-05	149	31	8	157	0.6977
生人症候群	2022-05-09	4	31	8	12	0.6977
Infiltraliens	2022-01-13	14	34	9	23	0.6976000000000001
Will Die Alone	2022-05-20	5	34	9	14	0.6976000000000001
Lustful Ponies	2022-04-11	6	34	9	15	0.6976000000000001
Beautiful Mystic Survivors	2022-10-14	1461	730	276	1737	0.6975
Desktop Girlfriend	2022-08-24	392	530	197	589	0.6975
守护女神	2022-11-11	181	175	60	241	0.6973999999999999
LakeSide	2022-09-28	93	77	24	117	0.6972
Bakery Simulator	2022-05-03	428	539	201	629	0.6970999999999999
Heads Will Roll: Downfall	2022-10-20	447	217	76	523	0.6970999999999999
Frozenheim	2022-06-16	2523	2025	800	3323	0.6970000000000001
Ed-0: Zombie Uprising	2022-04-04	113	82	26	139	0.6961
Stardust Origins	2022-02-02	4	15	3	7	0.6959000000000001
Project Dagger	2022-07-25	5	15	3	8	0.6959000000000001
Storyblocks: The King	2022-01-24	3	15	3	6	0.6959000000000001
Just in Slime	2022-03-01	8	15	3	11	0.6959000000000001
Semiconductor	2022-05-20	5	15	3	8	0.6959000000000001
DEAD GUN	2022-02-03	4	15	3	7	0.6959000000000001
Instant Artist: Puzzle Mashup	2022-03-17	5	15	3	8	0.6959000000000001
Pretty Girls Four Kings Solitaire	2022-03-18	9	15	3	12	0.6959000000000001
Elemental Angel Ⅱ	2022-03-17	3	15	3	6	0.6959000000000001
2D Brick Breaker Game | REMASTERED	2022-07-05	5	15	3	8	0.6959000000000001
Cowboy Girl	2022-07-08	2	15	3	5	0.6959000000000001
Night Gate	2022-10-14	5	15	3	8	0.6959000000000001
Midnight Saga: The Monster	2022-10-06	26	15	3	29	0.6959000000000001
Dark Maidens	2022-11-02	5	15	3	8	0.6959000000000001
Cookie Clicker But You Type	2022-09-13	5	15	3	8	0.6959000000000001
Space Runaway	2022-12-22	12	15	3	15	0.6959000000000001
Weird Japan	2022-09-23	6	15	3	9	0.6959000000000001
The Exorcist's Story	2022-11-11	7	15	3	10	0.6959000000000001
3D Lover	2022-03-08	13	79	25	38	0.6957
Pumping Simulator	2022-04-06	78	256	92	170	0.6951999999999999
Hell is Others	2022-10-20	942	708	271	1213	0.6951
Movie Night	2022-01-27	91	217	77	168	0.6951
Estella's Nightmare: Sealed Space and a Succubus's Curse	2022-08-09	125	266	96	221	0.6950000000000001
Golden Axe Idol	2022-07-15	50	45	13	63	0.6950000000000001
Eternal Edge	2022-05-08	68	327	120	188	0.6947
AccrO	2022-05-24	3	42	12	15	0.6946
One True Hero	2022-10-20	4	18	4	8	0.6944
Grimstar: Welcome to the savage planet	2022-10-26	7	18	4	11	0.6944
Funny Panda	2022-02-09	3	18	4	7	0.6944
1000 Needles	2022-02-11	7	18	4	11	0.6944
The Conqueror of Battles	2022-03-25	8	18	4	12	0.6944
WONDER POT - Texas Holdem	2022-05-18	18	18	4	22	0.6944
The World of a Mermaid	2022-06-01	2	18	4	6	0.6944
Monster Showdown Prologue	2022-06-17	15	18	4	19	0.6944
Riding Away	2022-05-18	1	8	1	2	0.6944
Invasion Vill	2022-05-31	2	8	1	3	0.6944
Fake Racing	2022-06-23	2	8	1	3	0.6944
Worshippers Of The Gain	2022-03-01	9	8	1	10	0.6944
Rift World	2022-02-12	3	8	1	4	0.6944
Azrael	2022-05-17	3	8	1	4	0.6944
Find the Cats	2022-07-29	3	8	1	4	0.6944
DC League of Super-Pets: The Adventures of Krypto and Ace	2022-07-15	3	8	1	4	0.6944
Dark Tales from México: Prelude. Just a Dream... with The Sack Man	2022-10-25	3	8	1	4	0.6944
Tarot: Theo's Quest	2022-05-25	3	8	1	4	0.6944
Tigey's Gift	2022-04-28	2	8	1	3	0.6944
ARTISAN	2022-02-03	4	8	1	5	0.6944
Blink Planets	2022-01-13	6	8	1	7	0.6944
Lovely Girls	2022-01-06	3	8	1	4	0.6944
Nova Odessa - The Demon Trainer	2022-06-02	5	8	1	6	0.6944
Great Deer	2022-04-21	5	8	1	6	0.6944
Slime Village VR	2022-01-24	4	8	1	5	0.6944
Vortex	2022-06-23	1	8	1	2	0.6944
Who Shuffled My Shapes?	2022-07-08	3	8	1	4	0.6944
NecroFarm	2022-03-25	2	8	1	3	0.6944
A Tale About Flowers	2022-02-04	3	8	1	4	0.6944
PATIENT	2022-06-01	2	8	1	3	0.6944
Vonbit	2022-03-31	3	8	1	4	0.6944
Aces Under the Moonlight	2022-06-03	3	8	1	4	0.6944
Underground Dungeon	2022-03-09	4	8	1	5	0.6944
Magnetic Structures	2022-10-18	2	8	1	3	0.6944
Freshman Magic: Spellbooks and Tangled Sheets	2022-05-26	21	8	1	22	0.6944
Royal Duality	2022-08-29	6	8	1	7	0.6944
Erroneous	2022-06-01	5	8	1	6	0.6944
Ultimate Obstacle Course	2022-05-16	6	8	1	7	0.6944
Trade Sails	2022-05-19	2	8	1	3	0.6944
RPG BOYS FANTASY	2022-06-16	3	8	1	4	0.6944
Intrusion of Alice	2022-10-28	10	8	1	11	0.6944
Spermination: Cream of the Crop	2022-07-15	4	8	1	5	0.6944
Youmandriver	2022-06-28	3	8	1	4	0.6944
Long Drop	2022-12-02	4	8	1	5	0.6944
Special Gulag Rescue Operation	2022-07-07	2	8	1	3	0.6944
Terror Brain: Night Out	2022-09-25	3	8	1	4	0.6944
Unichrome: a 1-Bit Unicorn Adventure	2022-09-16	3	8	1	4	0.6944
Astra Protocol 2	2022-12-01	3	8	1	4	0.6944
미연시 시뮬레이터 : 미소녀 게임의 주인공을 조종하는 게임	2022-07-21	3	8	1	4	0.6944
Eris and the fading kingdom	2022-07-22	3	8	1	4	0.6944
Goblin Rules Football	2022-10-20	6	8	1	7	0.6944
Battle Part	2022-07-21	9	8	1	10	0.6944
Humans Are Useless	2022-07-28	3	8	1	4	0.6944
Neon Fighter	2022-08-09	4	8	1	5	0.6944
Where's the Bathroom!?!	2022-09-09	2	8	1	3	0.6944
Nude Crisis	2022-08-10	3	8	1	4	0.6944
Western Girls	2022-08-27	2	8	1	3	0.6944
Mythlands: Dragon Flight VR	2022-08-31	2	8	1	3	0.6944
Droneboi 2	2022-09-10	5	8	1	6	0.6944
Hikki Girls	2022-08-27	2	8	1	3	0.6944
Slurpies FREE	2022-12-02	2	8	1	3	0.6944
Soldier	2022-09-01	1	8	1	2	0.6944
Paragonian 3 : The Warrior of Light	2022-11-08	3	8	1	4	0.6944
Eraser	2022-10-24	7	8	1	8	0.6944
Devolution 魔剣の王としもべたち	2022-09-29	6	8	1	7	0.6944
DEATHWATCH - PRELUDE	2022-10-20	9	8	1	10	0.6944
Hot Milf 9	2022-10-30	2	8	1	3	0.6944
The Slothgate Experiment	2022-12-17	3	8	1	4	0.6944
Bubbles Swimsuit	2022-11-01	2	8	1	3	0.6944
Doughball Descent	2022-11-30	13	8	1	14	0.6944
Undercover - Blood Bonds	2022-11-17	8	8	1	9	0.6944
クラウディ・デイズ	2022-12-22	6	8	1	7	0.6944
1 Day Later: Escape Zombie Hospital	2022-12-02	2	8	1	3	0.6944
Space Mercenary Defense Force	2022-12-16	3	8	1	4	0.6944
Holiday Haywire	2022-12-31	17	8	1	18	0.6944
Live by the Sword: Tactics	2022-10-28	10	39	11	21	0.6943
ESPIONAGE: Mafia Evolved	2022-08-12	61	81	26	87	0.6942
Do You See the Waving Cape	2022-06-03	4	36	10	14	0.6939000000000001
Crafting Town	2022-07-28	11	36	10	21	0.6939000000000001
For The Warp	2022-03-28	123	246	89	212	0.6937000000000001
Zold:out 鍛造屋的物語	2022-11-30	650	158	55	705	0.6937000000000001
Cursed Treasure 2 Ultimate Edition	2022-07-14	110	97	32	142	0.6937000000000001
Showbiz Tycoon	2022-02-25	10	33	9	19	0.6936
Night Signal	2022-11-07	4	21	5	9	0.6936
Aegis Descent	2022-07-08	14	21	5	19	0.6936
Forsaken Portals	2022-08-07	8	21	5	13	0.6936
Ash & Rust	2022-04-01	9	21	5	14	0.6936
M1 Tank Platoon II	2022-05-04	5	21	5	10	0.6936
Cascade Tactics	2022-02-17	11	21	5	16	0.6936
Skeletal Skism	2022-01-04	10	21	5	15	0.6936
Aery - Dreamscape	2022-01-14	7	21	5	12	0.6936
World of Mines Creator's Edition	2022-05-10	7	21	5	12	0.6936
Still Heroes	2022-04-22	3	21	5	8	0.6936
The Tales of Imjin War	2022-11-30	12	21	5	17	0.6936
Aristocunts II Re:ERECTION	2022-07-22	15	21	5	20	0.6936
NoAmmo	2022-08-05	3	21	5	8	0.6936
The Demon Within Me	2022-10-25	4	21	5	9	0.6936
JaDa Fishin'	2022-10-26	4	21	5	9	0.6936
HOTEL GREENWOOD	2022-08-10	10	86	28	38	0.6934
Unyielding	2022-09-22	29	30	8	37	0.6934
Monster Showdown	2022-01-27	6	27	7	13	0.6933
Mountain Offroad Simulator	2022-07-18	4	27	7	11	0.6933
Empire of Empires	2022-07-29	2	27	7	9	0.6933
Trails of the Black Sun	2022-10-04	3	24	6	9	0.6933
REPTRAILS	2022-06-17	10	24	6	16	0.6933
Witch Strandings	2022-07-07	30	24	6	36	0.6933
Seeking Light	2022-07-27	7	24	6	13	0.6933
Vermis Orbita	2022-07-29	5	24	6	11	0.6933
Argentum Online Forever (AOF)	2022-10-04	39	24	6	45	0.6933
Shovel Knight Dig	2022-09-23	800	440	166	966	0.6931999999999999
捕鱼王国Fishing Kingdom	2022-04-05	33	75	24	57	0.6931999999999999
Kilta	2022-07-10	21	50	15	36	0.693
Those Who Crawl	2022-12-26	12	72	23	35	0.6926000000000001
Trek to Yomi	2022-05-05	855	1037	410	1265	0.6924
THE HOUSE OF THE DEAD: Remake	2022-04-28	505	937	369	874	0.6924
Blue Fire: Void Maker	2022-02-04	23	47	14	37	0.6924
beat refle	2022-07-31	455	141	49	504	0.6923
LEGO® Brawls	2022-09-02	85	96	32	117	0.6920999999999999
Pursuit of Power 2 : The Chaos Dimension	2022-10-26	4	4	0	4	0.6920000000000001
Tank Tactics	2022-04-02	3	4	0	3	0.6920000000000001
VRpatients	2022-02-09	6	4	0	6	0.6920000000000001
Cahertis	2022-08-16	5	4	0	5	0.6920000000000001
Pharao Reloaded	2022-08-01	4	4	0	4	0.6920000000000001
As Aventuras do Cueca Listrada	2022-07-12	2	4	0	2	0.6920000000000001
The Ancient Art of Staying Alive	2022-01-19	1	4	0	1	0.6920000000000001
Ryclaw: Hope	2022-10-05	1	4	0	1	0.6920000000000001
Voyager	2022-01-14	3	4	0	3	0.6920000000000001
One Drunken Knight	2022-11-23	2	4	0	2	0.6920000000000001
Quester	2022-06-23	4	4	0	4	0.6920000000000001
Mickey Storm and the Cursed Mask	2022-04-29	3	4	0	3	0.6920000000000001
warDrive	2022-04-01	6	4	0	6	0.6920000000000001
Vesper: Ether Saga	2022-08-16	4	4	0	4	0.6920000000000001
Puzzle Box	2022-01-30	3	4	0	3	0.6920000000000001
Orbi's chronicles	2022-02-08	4	4	0	4	0.6920000000000001
Spellbound : The Magic Within	2022-09-02	4	4	0	4	0.6920000000000001
Agent Roswell : Tactics	2022-04-01	3	4	0	3	0.6920000000000001
Mollycoddle Mayhem	2022-07-14	5	4	0	5	0.6920000000000001
Sonucido: The Mage	2022-12-02	2	4	0	2	0.6920000000000001
Shooty	2022-01-12	2	4	0	2	0.6920000000000001
Dialogue Box: The Road Less Traveled	2022-04-28	3	4	0	3	0.6920000000000001
ShapeVS	2022-09-29	7	4	0	7	0.6920000000000001
AbyssMemory	2022-04-27	7	4	0	7	0.6920000000000001
Re-Spawn Tournament	2022-09-01	8	4	0	8	0.6920000000000001
Magic Exposure – Yuri Visual Novel	2022-12-09	3	4	0	3	0.6920000000000001
Keep It Live	2022-04-08	6	4	0	6	0.6920000000000001
Anyway	2022-02-22	2	4	0	2	0.6920000000000001
Cube	2022-03-05	2	4	0	2	0.6920000000000001
Solitaire Bonbon	2022-03-01	4	4	0	4	0.6920000000000001
The Case of Maneki	2022-03-21	2	4	0	2	0.6920000000000001
ANIQUILATION	2022-07-29	3	4	0	3	0.6920000000000001
Metal and Hauling RPG Simulator	2022-01-07	2	4	0	2	0.6920000000000001
Book of Adventum	2022-02-18	3	4	0	3	0.6920000000000001
Redux	2022-02-11	2	4	0	2	0.6920000000000001
Crystalreach Islands	2022-11-09	4	4	0	4	0.6920000000000001
Highway Rampage	2022-08-29	2	4	0	2	0.6920000000000001
Platformer::Execute();	2022-08-16	4	4	0	4	0.6920000000000001
Cube Runk	2022-02-25	2	4	0	2	0.6920000000000001
Dann Fox & The Time Machine	2022-08-17	1	4	0	1	0.6920000000000001
UC SIM ～unity-chan simulator～	2022-02-28	2	4	0	2	0.6920000000000001
Pirates of Gravitae	2022-03-31	3	4	0	3	0.6920000000000001
Inferno	2022-04-29	3	4	0	3	0.6920000000000001
Dogfight: 80 Years of Aerial Warfare	2022-01-21	2	4	0	2	0.6920000000000001
Super Liquid Soccer	2022-11-30	2	4	0	2	0.6920000000000001
Sumo Seals	2022-10-22	3	4	0	3	0.6920000000000001
CAPTAIN STARONE	2022-10-20	20	4	0	20	0.6920000000000001
Dyflexion	2022-03-09	2	4	0	2	0.6920000000000001
Chameleon - DYH	2022-07-25	4	4	0	4	0.6920000000000001
Fira	2022-07-15	2	4	0	2	0.6920000000000001
Reed The Robotanist Plus	2022-08-18	2	4	0	2	0.6920000000000001
Hymns of Resurrection	2022-02-11	4	4	0	4	0.6920000000000001
Pocket Rocket PC	2022-01-16	3	4	0	3	0.6920000000000001
Press D to Die	2022-08-07	3	4	0	3	0.6920000000000001
The Song Out of Space	2022-02-04	2	4	0	2	0.6920000000000001
Drunken Fist 2: Zombie Hangover	2022-06-22	2	4	0	2	0.6920000000000001
The Video Game Machine	2022-11-08	3	4	0	3	0.6920000000000001
Gruta: Prologue of the Gloomy Whispers	2022-12-24	2	4	0	2	0.6920000000000001
蛋-腾	2022-02-04	1	4	0	1	0.6920000000000001
Momo's Mansion	2022-02-14	2	4	0	2	0.6920000000000001
青鳥樂園 Blue Bird Land EP.2 下篇	2022-10-25	2	4	0	2	0.6920000000000001
The Dead Prince	2022-10-17	3	4	0	3	0.6920000000000001
Short Circuit	2022-02-17	3	4	0	3	0.6920000000000001
Stretchy-Man: The Video Game	2022-03-31	2	4	0	2	0.6920000000000001
Praecantor Lila ~ Bell Spell	2022-03-12	3	4	0	3	0.6920000000000001
Graveyard Spells	2022-01-12	1	4	0	1	0.6920000000000001
Bounce Ball: Neon Party Arcade	2022-02-04	4	4	0	4	0.6920000000000001
The Pest	2022-05-18	2	4	0	2	0.6920000000000001
Save the Llama	2022-04-22	4	4	0	4	0.6920000000000001
GoKart - NewMexico	2022-02-17	3	4	0	3	0.6920000000000001
Invisible Crush	2022-05-16	3	4	0	3	0.6920000000000001
Amshay	2022-05-09	2	4	0	2	0.6920000000000001
Conveyance	2022-01-31	3	4	0	3	0.6920000000000001
Snakepit Larry	2022-01-02	1	4	0	1	0.6920000000000001
Re;quartz零度	2022-08-12	2	4	0	2	0.6920000000000001
Note of Janus	2022-08-05	5	4	0	5	0.6920000000000001
Cannon Canines	2022-08-22	4	4	0	4	0.6920000000000001
OtterQuest	2022-01-31	1	4	0	1	0.6920000000000001
DRAGON NINJA BYOKA	2022-05-05	2	4	0	2	0.6920000000000001
Pixa Clicker	2022-07-29	3	4	0	3	0.6920000000000001
Ryclaw: Save Yourself	2022-01-21	1	4	0	1	0.6920000000000001
White	2022-12-21	2	4	0	2	0.6920000000000001
armageddon war: old era wreckers	2022-05-06	4	4	0	4	0.6920000000000001
生還者日	2022-03-22	3	4	0	3	0.6920000000000001
Circuit: Laser Maze	2022-03-01	2	4	0	2	0.6920000000000001
Tactical Recon	2022-10-03	3	4	0	3	0.6920000000000001
Labyrinth deLux - A Crusoe Quest	2022-03-02	2	4	0	2	0.6920000000000001
Escape Purgatory	2022-10-22	3	4	0	3	0.6920000000000001
I Am Gangster	2022-03-18	2	4	0	2	0.6920000000000001
Spirits Chronicles: Born in Flames Collector's Edition	2022-02-08	6	4	0	6	0.6920000000000001
The House of Big people	2022-02-02	1	4	0	1	0.6920000000000001
滴答	2022-04-06	1	4	0	1	0.6920000000000001
My Kindergarten Learning Adventure	2022-03-13	3	4	0	3	0.6920000000000001
Explosion™	2022-06-30	2	4	0	2	0.6920000000000001
Maze: Pedestal of Trials	2022-06-23	2	4	0	2	0.6920000000000001
Jumpy Ball Happy Fun Time	2022-02-16	2	4	0	2	0.6920000000000001
Coins, Chests and Loot	2022-02-17	3	4	0	3	0.6920000000000001
Nova Slash: Unparalleled Power	2022-03-24	2	4	0	2	0.6920000000000001
Radio Free Europa	2022-04-22	4	4	0	4	0.6920000000000001
Blob Boy	2022-03-04	4	4	0	4	0.6920000000000001
Aster Force	2022-04-04	2	4	0	2	0.6920000000000001
Escape To School	2022-03-07	1	4	0	1	0.6920000000000001
Wordies	2022-03-01	3	4	0	3	0.6920000000000001
Roly Poly	2022-04-19	3	4	0	3	0.6920000000000001
Polychromia	2022-05-31	3	4	0	3	0.6920000000000001
COPS 2170	2022-06-10	2	4	0	2	0.6920000000000001
SpectrumGames	2022-03-21	7	4	0	7	0.6920000000000001
Ball Pain	2022-03-14	2	4	0	2	0.6920000000000001
DreamPusher	2022-03-16	5	4	0	5	0.6920000000000001
Psycho Crab	2022-03-29	3	4	0	3	0.6920000000000001
cyVeRpunk	2022-09-01	1	4	0	1	0.6920000000000001
LAB	2022-05-11	3	4	0	3	0.6920000000000001
GlassBox	2022-04-12	2	4	0	2	0.6920000000000001
Adventures of Samuel: The Worst Game Ever Made	2022-03-23	1	4	0	1	0.6920000000000001
Die Die Die And Try	2022-04-04	4	4	0	4	0.6920000000000001
Planet Conqueror	2022-04-08	2	4	0	2	0.6920000000000001
Stoney's Adventure	2022-12-26	2	4	0	2	0.6920000000000001
Dickie A Cumming: The Prequel (Part I)	2022-04-21	2	4	0	2	0.6920000000000001
Mirages of Winter	2022-11-22	2	4	0	2	0.6920000000000001
Shape Puzzle	2022-07-16	2	4	0	2	0.6920000000000001
鸟兽幻戏图 Bird and Beast Fantasy	2022-04-07	2	4	0	2	0.6920000000000001
The Horror Story: Remastered - The Prequel	2022-05-18	2	4	0	2	0.6920000000000001
Vacation Adventures: Park Ranger 13	2022-04-28	6	4	0	6	0.6920000000000001
All Alone with Mannie	2022-06-02	2	4	0	2	0.6920000000000001
PIPIISYOU	2022-04-15	2	4	0	2	0.6920000000000001
Other	2022-06-24	4	4	0	4	0.6920000000000001
bluem	2022-05-06	2	4	0	2	0.6920000000000001
TERROVOX	2022-05-04	2	4	0	2	0.6920000000000001
Scandal Notes	2022-12-01	15	4	0	15	0.6920000000000001
River Rush	2022-05-03	3	4	0	3	0.6920000000000001
Elemental Angel Ⅲ	2022-06-17	2	4	0	2	0.6920000000000001
WFO World Football Online	2022-09-12	3	4	0	3	0.6920000000000001
Curro	2022-05-21	2	4	0	2	0.6920000000000001
Food Fight	2022-05-03	2	4	0	2	0.6920000000000001
Spell Welders	2022-05-06	4	4	0	4	0.6920000000000001
Purrate Adventure: Volcano Isle	2022-05-12	2	4	0	2	0.6920000000000001
tiltfire	2022-11-14	3	4	0	3	0.6920000000000001
Dominate - Board Game	2022-09-14	2	4	0	2	0.6920000000000001
MazezaM - Puzzle Game	2022-07-05	1	4	0	1	0.6920000000000001
Alone	2022-07-22	5	4	0	5	0.6920000000000001
Dreams of Pain	2022-11-11	3	4	0	3	0.6920000000000001
Super Indiemania	2022-11-02	2	4	0	2	0.6920000000000001
Coalescence	2022-09-30	3	4	0	3	0.6920000000000001
Spacewing War	2022-06-08	2	4	0	2	0.6920000000000001
Palmas	2022-05-18	3	4	0	3	0.6920000000000001
Chromatic	2022-05-20	2	4	0	2	0.6920000000000001
Grizelda: Lynx and the Nine Lives	2022-10-06	4	4	0	4	0.6920000000000001
Knights of the Exploding Table	2022-05-29	4	4	0	4	0.6920000000000001
The Trials Of Beadie	2022-09-23	2	4	0	2	0.6920000000000001
Tiny Arcade Racers	2022-05-20	2	4	0	2	0.6920000000000001
Eschew	2022-06-12	2	4	0	2	0.6920000000000001
Breakyo	2022-07-25	3	4	0	3	0.6920000000000001
Keita's Adventures on the African Savannah	2022-06-12	2	4	0	2	0.6920000000000001
♡beAt! -After the Summer-	2022-08-09	2	4	0	2	0.6920000000000001
Elohim Eternal - Prologue	2022-07-13	3	4	0	3	0.6920000000000001
我感染HIV了吗	2022-06-20	1	4	0	1	0.6920000000000001
Martial Story	2022-06-09	1	4	0	1	0.6920000000000001
Roomli	2022-06-10	3	4	0	3	0.6920000000000001
Dis Pontibus 2	2022-06-15	3	4	0	3	0.6920000000000001
Heart Lake心湖	2022-06-16	3	4	0	3	0.6920000000000001
Gift from the Gods	2022-06-20	1	4	0	1	0.6920000000000001
Defenders of Asteria	2022-07-12	2	4	0	2	0.6920000000000001
Blastonier	2022-08-25	1	4	0	1	0.6920000000000001
你与选择 You and Choice	2022-06-25	2	4	0	2	0.6920000000000001
凶宅 HouseHaunting	2022-07-08	4	4	0	4	0.6920000000000001
By the Vine	2022-07-16	2	4	0	2	0.6920000000000001
Hitstream	2022-10-31	2	4	0	2	0.6920000000000001
Wormmy	2022-10-21	2	4	0	2	0.6920000000000001
Alien Gladiator	2022-07-07	2	4	0	2	0.6920000000000001
Hold Controller	2022-07-19	2	4	0	2	0.6920000000000001
WalkBot	2022-08-25	2	4	0	2	0.6920000000000001
Cyber Drift	2022-07-04	2	4	0	2	0.6920000000000001
わんおぺ寿司	2022-07-16	5	4	0	5	0.6920000000000001
夺宝蠢兵	2022-08-17	1	4	0	1	0.6920000000000001
Rush Rush Rally Reloaded	2022-08-04	2	4	0	2	0.6920000000000001
Auf Wiedersehen Monty	2022-07-18	3	4	0	3	0.6920000000000001
The Apple Tree	2022-12-30	3	4	0	3	0.6920000000000001
Ansiolisis	2022-07-19	2	4	0	2	0.6920000000000001
OrbiTank	2022-08-12	6	4	0	6	0.6920000000000001
魔法少女が殺された。-名誉の死と陰の迷宮-	2022-08-24	4	4	0	4	0.6920000000000001
PASSAGE	2022-07-22	2	4	0	2	0.6920000000000001
Controller Sync	2022-07-21	2	4	0	2	0.6920000000000001
Energy Tail	2022-09-18	3	4	0	3	0.6920000000000001
Just Shoot: Slimes	2022-10-14	2	4	0	2	0.6920000000000001
A Frog's Job	2022-10-07	1	4	0	1	0.6920000000000001
Mongrel Games Minigames	2022-10-25	1	4	0	1	0.6920000000000001
Pathogen: Survival	2022-11-03	3	4	0	3	0.6920000000000001
Canfield Solitaire Collection	2022-08-31	2	4	0	2	0.6920000000000001
Pussies Wrestling Dicks	2022-08-18	1	4	0	1	0.6920000000000001
Dork	2022-10-25	3	4	0	3	0.6920000000000001
graveyard keeper	2022-08-13	2	4	0	2	0.6920000000000001
Stanislav	2022-10-20	3	4	0	3	0.6920000000000001
Neon Dungeon	2022-08-26	2	4	0	2	0.6920000000000001
Terrorform	2022-09-05	4	4	0	4	0.6920000000000001
PERCNOPS VIRTUAL RIG	2022-11-20	2	4	0	2	0.6920000000000001
Beam Splitter	2022-08-29	4	4	0	4	0.6920000000000001
Puck Runner	2022-09-01	1	4	0	1	0.6920000000000001
Hooligan James	2022-09-12	2	4	0	2	0.6920000000000001
Mr.Addon Game Maker	2022-09-01	1	4	0	1	0.6920000000000001
Discvivors	2022-09-05	3	4	0	3	0.6920000000000001
Christmas Blaster	2022-12-07	2	4	0	2	0.6920000000000001
Tankron	2022-11-19	3	4	0	3	0.6920000000000001
ALPHA BOX	2022-09-08	3	4	0	3	0.6920000000000001
Save and Conquer : 8 Years	2022-09-01	2	4	0	2	0.6920000000000001
Hero's Journey	2022-09-21	2	4	0	2	0.6920000000000001
Asteroids and more asteroids	2022-09-30	1	4	0	1	0.6920000000000001
Super Jagger Bomb	2022-10-06	3	4	0	3	0.6920000000000001
Slide Girls	2022-09-14	2	4	0	2	0.6920000000000001
Learning Geography: Countries of the World	2022-09-30	2	4	0	2	0.6920000000000001
Mycorrhiza	2022-09-30	2	4	0	2	0.6920000000000001
Heartless	2022-10-09	1	4	0	1	0.6920000000000001
Ant in Training	2022-09-15	1	4	0	1	0.6920000000000001
Super hamsterball	2022-11-25	2	4	0	2	0.6920000000000001
Catherine Ragnor - Blackbeards Fury	2022-09-14	3	4	0	3	0.6920000000000001
32 in 1 Game Special	2022-10-13	2	4	0	2	0.6920000000000001
MIRACLE SWEEPER	2022-12-23	3	4	0	3	0.6920000000000001
ボクらのウィンタースポーツ	2022-12-08	2	4	0	2	0.6920000000000001
Soul Searching	2022-10-06	3	4	0	3	0.6920000000000001
Jam Above Jam Below	2022-09-21	2	4	0	2	0.6920000000000001
ALIEN WAR	2022-09-23	1	4	0	1	0.6920000000000001
Dodge The Missionaries	2022-09-20	2	4	0	2	0.6920000000000001
Maskonauts: Chat'Attack	2022-12-05	2	4	0	2	0.6920000000000001
Score Gun	2022-09-27	3	4	0	3	0.6920000000000001
Dancing Pandas	2022-12-25	6	4	0	6	0.6920000000000001
Masterchef Ice Cream Edition	2022-10-12	2	4	0	2	0.6920000000000001
Petty's Adventure: Desert	2022-09-30	2	4	0	2	0.6920000000000001
Camouflet	2022-10-31	2	4	0	2	0.6920000000000001
Big Adventure: Trip to Europe 3 - Collector's Edition	2022-10-16	3	4	0	3	0.6920000000000001
Road Trip USA 2: West	2022-11-29	4	4	0	4	0.6920000000000001
It's Locked	2022-10-31	2	4	0	2	0.6920000000000001
Pogo Rage	2022-10-17	2	4	0	2	0.6920000000000001
Candice DeBébé's Tantalising Tricks	2022-11-16	4	4	0	4	0.6920000000000001
Brisk Square	2022-12-23	2	4	0	2	0.6920000000000001
五代十国之玉知	2022-12-12	2	4	0	2	0.6920000000000001
LOCOSOCCER	2022-12-07	7	4	0	7	0.6920000000000001
Brutal TD	2022-12-16	2	4	0	2	0.6920000000000001
Cozy Corner	2022-11-06	3	4	0	3	0.6920000000000001
Jewel Match Twilight 2	2022-10-27	8	4	0	8	0.6920000000000001
Uproot	2022-11-04	3	4	0	3	0.6920000000000001
Teresa Moontyners - In the lair of the beast	2022-12-14	5	4	0	5	0.6920000000000001
你微笑的一百种样子	2022-11-10	2	4	0	2	0.6920000000000001
Talesworth Adventure: The Lost Artifacts	2022-11-21	2	4	0	2	0.6920000000000001
A meeting of dreams	2022-12-16	2	4	0	2	0.6920000000000001
Super Crazy Chickens	2022-11-01	3	4	0	3	0.6920000000000001
Illumina Girls	2022-10-26	2	4	0	2	0.6920000000000001
Martian Invaders	2022-11-24	1	4	0	1	0.6920000000000001
The Witch's House	2022-10-27	2	4	0	2	0.6920000000000001
sunny-place-2	2022-11-30	6	4	0	6	0.6920000000000001
Princess Ruby	2022-12-08	2	4	0	2	0.6920000000000001
Outworld Patrol	2022-12-12	2	4	0	2	0.6920000000000001
简单滚动	2022-12-26	1	4	0	1	0.6920000000000001
Finding Fifi	2022-12-01	3	4	0	3	0.6920000000000001
Velocity Rift	2022-12-31	2	4	0	2	0.6920000000000001
Graceward - Complete Edition	2022-12-26	2	4	0	2	0.6920000000000001
Extinction / Zombie İnvasion 1	2022-12-08	2	4	0	2	0.6920000000000001
Beau & Bow	2022-12-21	4	4	0	4	0.6920000000000001
Word x Word	2022-12-25	3	4	0	3	0.6920000000000001
Pot Farmer	2022-12-29	2	4	0	2	0.6920000000000001
Sword of Fargoal	2022-12-16	4	4	0	4	0.6920000000000001
CulixCupric's Temeritus: Dark Scion	2022-12-27	3	4	0	3	0.6920000000000001
Amanda's Magic Book 5: Hansel and Gretel	2022-12-23	3	4	0	3	0.6920000000000001
Cartoon Cagematch	2022-12-30	2	4	0	2	0.6920000000000001
Flat Eye👁️‍🗨️	2022-11-14	90	77	25	115	0.6917
Bulanci	2022-11-14	234	148	52	286	0.6914
Tyrant's Blessing	2022-08-08	235	135	47	282	0.6914
My Bunny Girl	2022-08-08	7	55	17	24	0.6914
STRANGER	2022-08-11	11	41	12	23	0.6912
Sunline	2022-05-16	6	41	12	18	0.6912
I Am Jesus Christ: Prologue	2022-12-01	178	591	230	408	0.6907
Rover Builder	2022-03-28	52	52	16	68	0.6907
ELIF	2022-01-10	18	52	16	34	0.6907
Welcome to Chornobayivka VR	2022-08-08	8	52	16	24	0.6907
Talent Club ~ Match 3 Puzzle	2022-11-18	40	52	16	56	0.6907
Trip In Another World	2022-06-17	729	768	303	1032	0.6905
My Newborn Life In A Harem	2022-03-29	187	198	72	259	0.6901
My Stepsis is a Furry Futa Fox	2022-10-06	6	60	19	25	0.6901
Animallica	2022-03-05	126	613	240	366	0.6900000000000001
Farmland Realm	2022-07-09	12	49	15	27	0.6900000000000001
Escape	2022-01-15	32	92	31	63	0.6899
HideAlone	2022-08-12	28	84	28	56	0.6898000000000001
Rescuing You in the Infinite Loop	2022-06-23	34	68	22	56	0.6898000000000001
Rift Loopers	2022-09-22	111	68	22	133	0.6898000000000001
神都不良探	2022-04-28	1565	1696	693	2258	0.6897
Fleet Commander: Pacific	2022-07-21	11	11	2	13	0.6897
Basketball Madness	2022-06-03	3	11	2	5	0.6897
Drunken Nuke'em	2022-07-28	11	11	2	13	0.6897
Blazend	2022-01-07	3	11	2	5	0.6897
Strangest.io's My Megamix '21	2022-04-06	5	11	2	7	0.6897
Refraction: Beyond the Mirror	2022-01-07	3	11	2	5	0.6897
Would you like to run an idol café? 3	2022-05-09	4	11	2	6	0.6897
Catch them!	2022-01-21	8	11	2	10	0.6897
安特卫普的尼洛 Nello in Antwerp	2022-02-12	5	11	2	7	0.6897
Surreal Experience	2022-08-02	2	11	2	4	0.6897
Mire	2022-05-05	6	11	2	8	0.6897
The Doll Beneath	2022-08-16	8	11	2	10	0.6897
The Ultimate Shot	2022-03-15	2	11	2	4	0.6897
Spelldash	2022-08-19	2	11	2	4	0.6897
Wind Angel Ⅲ	2022-03-31	3	11	2	5	0.6897
DIRTYBLOCK	2022-05-17	3	11	2	5	0.6897
The Smash Cars Tournament	2022-04-11	2	11	2	4	0.6897
This is a game	2022-04-26	2	11	2	4	0.6897
Wands Alliances	2022-10-05	7	11	2	9	0.6897
SpearFrog	2022-05-26	2	11	2	4	0.6897
My Furry Maid	2022-11-19	7	11	2	9	0.6897
Space Turbo	2022-05-24	5	11	2	7	0.6897
Isolania	2022-07-14	3	11	2	5	0.6897
Over City	2022-06-08	2	11	2	4	0.6897
Metapilot	2022-09-10	4	11	2	6	0.6897
Road Stones	2022-10-20	7	11	2	9	0.6897
Dagger of heroes	2022-08-30	2	11	2	4	0.6897
PARKET Evolution	2022-08-25	3	11	2	5	0.6897
Stunts Contest Beach Edition	2022-10-10	3	11	2	5	0.6897
ParkTo	2022-09-13	14	11	2	16	0.6897
Air defenders	2022-10-03	5	11	2	7	0.6897
Slippery Richard! ~ He's Taller Than My Husband ~	2022-10-25	4	11	2	6	0.6897
Feathered Run: Worlds	2022-11-08	2	11	2	4	0.6897
Hidden Harbor 2 Top-Down 3D	2022-11-15	2	11	2	4	0.6897
仙侠世界2	2022-01-21	122	285	107	229	0.6894
Guns N' Boxes	2022-01-20	45	57	18	63	0.6894
Cliff & Field Tower Defense	2022-11-04	20	32	9	29	0.6894
Grid Miner	2022-05-03	11	32	9	20	0.6894
Cyberpunk Girls	2022-02-05	22	32	9	31	0.6894
Force of Warships	2022-08-09	50	110	38	88	0.6893000000000001
Hello Neighbor 2	2022-12-06	674	1062	429	1103	0.6888
Rugby 22	2022-01-27	125	161	58	183	0.6888
HEXAD	2022-07-28	22	29	8	30	0.6888
ZHP: Unlosing Ranger vs. Darkdeath Evilman	2022-05-10	57	29	8	65	0.6888
Pirate Booty and the Bukkake Buccaneer	2022-03-11	20	29	8	28	0.6888
Hokko Life	2022-09-27	1020	1341	547	1567	0.6886
Titanic: Fall Of A Legend	2022-02-11	19	43	13	32	0.6885
Pirate Jam	2022-02-16	4	26	7	11	0.6883
Nightfall	2022-04-08	6	26	7	13	0.6883
Food Factory	2022-08-20	16	26	7	23	0.6883
Frozen Flame	2022-11-17	5499	1654	681	6180	0.6881999999999999
Sky Haven	2022-11-21	674	691	275	949	0.6881
Dolly Wars - Auto Tactics	2022-12-16	20	14	3	23	0.688
Beat Stickman: Beyond	2022-09-06	11	14	3	14	0.688
Burnit Quest	2022-04-01	3	14	3	6	0.688
REDSHOT	2022-08-02	4	14	3	7	0.688
Enigmarella	2022-02-28	3	14	3	6	0.688
YUZA	2022-06-05	3	14	3	6	0.688
Rivalia: Dungeon Raiders	2022-10-05	4	14	3	7	0.688
PH0B0S	2022-07-10	5	14	3	8	0.688
Portal Defense	2022-07-12	4	14	3	7	0.688
Worker Riot	2022-06-13	2	14	3	5	0.688
Nuclear Fighter	2022-07-04	2	14	3	5	0.688
Paresis	2022-07-18	2	14	3	5	0.688
Futa University	2022-07-21	8	14	3	11	0.688
Cube Adventure	2022-08-26	7	14	3	10	0.688
Lawnmower Game: Space Race	2022-09-05	4	14	3	7	0.688
함부로 소설 쓰지 맙시다	2022-11-18	9	14	3	12	0.688
DICE GAME	2022-11-23	1	14	3	4	0.688
Lab Inspect	2022-11-21	3	14	3	6	0.688
Hentai Ojou	2022-12-16	5	14	3	8	0.688
Kingdom's Life	2022-02-28	79	150	54	133	0.6879000000000001
Territory	2022-05-31	10	23	6	16	0.6878000000000001
Lust&Magic -Chisalla in a Flower Basket-	2022-06-04	35	23	6	41	0.6878000000000001
The Tree	2022-03-17	5	23	6	11	0.6878000000000001
Mare	2022-04-01	6	23	6	12	0.6878000000000001
Yokai Hunter Shintaro	2022-05-03	4	23	6	10	0.6878000000000001
Yokai's Wish	2022-12-08	5	23	6	11	0.6878000000000001
Odd Woods	2022-11-01	10	23	6	16	0.6878000000000001
Killer in the cabin	2022-05-12	49	75	25	74	0.6877
无尽守卫	2022-07-08	35	40	12	47	0.6877
The Hand of Merlin	2022-06-14	150	220	82	232	0.6876000000000001
Unexplored 2: The Wayfarer's Legacy	2022-05-27	157	180	66	223	0.6876000000000001
From Space	2022-11-03	4402	1074	437	4839	0.6875
Scuffy Game	2022-02-18	43	88	30	73	0.6875
Caravan Trade Tycoon	2022-09-14	5	20	5	10	0.6875
Gigant	2022-08-12	6	20	5	11	0.6875
Bobbi Adventure	2022-05-20	4	20	5	9	0.6875
Valkyrie Champions	2022-10-12	9	20	5	14	0.6875
Village Monsters	2022-03-22	9	17	4	13	0.6875
It'sRoachTime!	2022-03-08	16	17	4	20	0.6875
Carnage Cross	2022-11-25	3	17	4	7	0.6875
Hot Milf 4	2022-03-05	3	17	4	7	0.6875
Koncolos	2022-08-02	8	17	4	12	0.6875
HexTD	2022-09-30	5	17	4	9	0.6875
Sleep Paralysis: The Uncanny Valley	2022-12-14	7	17	4	11	0.6875
FETUS	2022-07-04	7	17	4	11	0.6875
Police on Duty	2022-07-25	2	17	4	6	0.6875
Galaxy Survivors	2022-08-17	12	17	4	16	0.6875
Basement of Hellish	2022-12-02	3	17	4	7	0.6875
Isla Sinaloa	2022-10-10	174	93	32	206	0.6870999999999999
修仙立志传	2022-06-21	1732	934	379	2111	0.687
孙美琪疑案：雨儿胡同	2022-11-11	52	48	15	67	0.687
Wizard's Wheel 2	2022-12-23	356	72	24	380	0.6869
Zorya	2022-02-08	14	37	11	25	0.6869
Ballfrog	2022-01-28	9	37	11	20	0.6869
Spirit Of The Island	2022-08-17	665	729	293	958	0.6868000000000001
Idle Baker Boss	2022-08-15	138	56	18	156	0.6868000000000001
타워 오브 판타지	2022-10-19	528	164	60	588	0.6867
Phantom Breaker: Omnia	2022-03-14	109	121	43	152	0.6867
LAZ3RZ	2022-08-24	29	90	31	60	0.6864
DEADCRAFT	2022-05-19	203	77	26	229	0.6864
Great Deceiver	2022-08-05	54	77	26	80	0.6864
LiMiT's Escape Room Games	2022-04-17	18	45	14	32	0.6861
Roboplant	2022-11-10	26	34	10	36	0.6859999999999999
Painting VR	2022-04-14	8	34	10	18	0.6859999999999999
Veggie Menace	2022-07-30	20	34	10	30	0.6859999999999999
Ouija Rumours	2022-02-13	7	31	9	16	0.6851
Shadow Era	2022-04-04	17	31	9	26	0.6851
Legend of Feather	2022-12-16	224	31	9	233	0.6851
COGEN: Sword of Rewind / COGEN: 大鳥こはくと刻の剣	2022-01-26	72	58	19	91	0.685
Timeline Walker Dark World	2022-09-26	375	58	19	394	0.685
Maestro VR	2022-11-05	9	50	16	25	0.6849
Farm Defense	2022-08-01	338	50	16	354	0.6849
Second Thoughts	2022-07-12	7	50	16	23	0.6849
Torchlight: Infinite	2022-10-11	21030	4897	2113	23143	0.6848000000000001
Werewolf: The Apocalypse - Earthblood	2022-02-07	87	282	109	196	0.6846
Incremental Epic Hero 2	2022-07-22	3100	500	200	3300	0.6845
MAGICAL ANGEL FAIRY HEART	2022-05-12	20	63	21	41	0.6844
Mutant Alley: Dinohazard	2022-04-15	9	39	12	21	0.6840999999999999
重回哩世界	2022-12-04	13	28	8	21	0.6840999999999999
Package Inspector	2022-04-15	33	28	8	41	0.6840999999999999
Ocean Is Home : Island Life Simulator	2022-12-09	25	68	23	48	0.6839000000000001
Retrieving The Past Steam EDITION	2022-04-08	61	47	15	76	0.6839000000000001
Blind Fate: Edo no Yami	2022-09-15	33	86	30	63	0.6838
looK INside - Chapter 2	2022-09-19	41	25	7	48	0.6831
YouRiding - Surfing and Bodyboarding Game	2022-09-15	11	25	7	18	0.6831
Elf Wives Cheat to Ride my Meat	2022-02-18	14	25	7	21	0.6831
VEREDA - Mystery Escape Room Adventure	2022-02-26	9	25	7	16	0.6831
Office Run	2022-06-01	12	25	7	19	0.6831
Relayer Advanced	2022-10-26	46	36	11	57	0.6829999999999999
Chance at Life	2022-06-09	5	36	11	16	0.6829999999999999
Thunder League	2022-05-02	31	65	22	53	0.6829000000000001
PUNCH FIT	2022-09-12	11	65	22	33	0.6829000000000001
Linguist FPS - The Language Learning FPS	2022-05-20	31	88	31	62	0.6828000000000001
The Dark Pictures Anthology: House of Ashes - Friend's Pass	2022-01-28	114	165	62	176	0.6826000000000001
Loot River	2022-05-03	274	235	91	365	0.6822
Furry Cyberfucker	2022-04-09	161	230	89	250	0.6820999999999999
The Demon Lord Is New in Town!	2022-01-25	158	80	28	186	0.6820999999999999
Throbax TD	2022-11-17	10	22	6	16	0.682
Blown Away	2022-01-24	16	22	6	22	0.682
DOGE TO THE MOON	2022-05-07	42	22	6	48	0.682
The Tribe Game	2022-03-25	18	22	6	24	0.682
Cooking Festival	2022-05-19	14	22	6	20	0.682
Dismantled Director's cut	2022-07-01	8	22	6	14	0.682
Ruadh: Warbands	2022-12-16	8	22	6	14	0.682
Cosplay Collection	2022-11-11	90	120	44	134	0.6819
ValiDate: Volume 1	2022-09-29	80	62	21	101	0.6819
Before The Last Hour	2022-05-16	24	33	10	34	0.6818000000000001
Meet Cute: Cafe	2022-03-12	7	41	13	20	0.6817000000000001
Nitroverse	2022-02-12	2	7	1	3	0.6815000000000001
Beastie Land	2022-02-27	4	7	1	5	0.6815000000000001
Rimebeard	2022-01-03	3	7	1	4	0.6815000000000001
PushOps	2022-04-11	3	7	1	4	0.6815000000000001
Dancing Cube	2022-08-12	5	7	1	6	0.6815000000000001
Fairground Power Polyp Simulator	2022-12-02	6	7	1	7	0.6815000000000001
LiveScream	2022-10-27	2	7	1	3	0.6815000000000001
Roll For Initiative	2022-03-08	2	7	1	3	0.6815000000000001
Insect Seeker	2022-10-11	2	7	1	3	0.6815000000000001
Fantasteroids	2022-09-26	2	7	1	3	0.6815000000000001
Paranormal Organization: Magic Academy	2022-06-20	4	7	1	5	0.6815000000000001
Sakura Segment 0.3	2022-11-04	4	7	1	5	0.6815000000000001
Unriddle	2022-01-20	44	7	1	45	0.6815000000000001
BACK and BACK to Hell	2022-01-17	3	7	1	4	0.6815000000000001
The Vortex	2022-03-18	9	7	1	10	0.6815000000000001
MaDevil	2022-05-31	2	7	1	3	0.6815000000000001
Xolotl	2022-06-27	3	7	1	4	0.6815000000000001
Click Quest 3D 2: Plus	2022-03-27	4	7	1	5	0.6815000000000001
CASTILLO - SHATTERED MIRRORS	2022-03-25	3	7	1	4	0.6815000000000001
Tremblay Island	2022-05-24	3	7	1	4	0.6815000000000001
Vacuum Ball	2022-02-23	2	7	1	3	0.6815000000000001
Super Slinger	2022-03-01	2	7	1	3	0.6815000000000001
Ultimate Super Bean	2022-03-16	4	7	1	5	0.6815000000000001
Medieval Sex Jigsaw	2022-04-29	3	7	1	4	0.6815000000000001
1001 Jigsaw. Cute Cats	2022-03-14	6	7	1	7	0.6815000000000001
New Lands Paradise Island Collector's Edition	2022-03-29	8	7	1	9	0.6815000000000001
Trivia Party	2022-04-01	4	7	1	5	0.6815000000000001
HRD 3 Pegasus Island	2022-04-28	3	7	1	4	0.6815000000000001
Operation Pill	2022-05-02	2	7	1	3	0.6815000000000001
Easter Eggstravaganza	2022-04-15	2	7	1	3	0.6815000000000001
The Ducksuckers	2022-04-09	3	7	1	4	0.6815000000000001
Bubble Shot	2022-06-20	15	7	1	16	0.6815000000000001
K3LVN	2022-08-09	5	7	1	6	0.6815000000000001
Down Fast VR	2022-12-15	3	7	1	4	0.6815000000000001
Bloodied Fear	2022-05-03	1	7	1	2	0.6815000000000001
Charmareians	2022-06-17	4	7	1	5	0.6815000000000001
Suddenly Meow 2	2022-04-27	3	7	1	4	0.6815000000000001
Deep	2022-05-18	2	7	1	3	0.6815000000000001
Find Your Wings	2022-10-25	12	7	1	13	0.6815000000000001
Future Mirror	2022-11-01	2	7	1	3	0.6815000000000001
死亡旅店Ⅱ亡者归来-Death Inn Ⅱ The Immortal Is Coming	2022-06-21	4	7	1	5	0.6815000000000001
Sakura Alien 2	2022-09-19	8	7	1	9	0.6815000000000001
Protect My Cheese	2022-10-10	3	7	1	4	0.6815000000000001
Mini Arenas	2022-11-25	4	7	1	5	0.6815000000000001
Milf Toys 3	2022-08-05	3	7	1	4	0.6815000000000001
Outatime	2022-09-14	4	7	1	5	0.6815000000000001
Gyro Gear Tournament+	2022-09-28	2	7	1	3	0.6815000000000001
Demong Hunter	2022-10-05	5	7	1	6	0.6815000000000001
Folktale	2022-09-02	1	7	1	2	0.6815000000000001
Science Girls	2022-08-27	3	7	1	4	0.6815000000000001
Peregrine	2022-09-20	2	7	1	3	0.6815000000000001
Chris Isn't Alone	2022-09-12	8	7	1	9	0.6815000000000001
Ami's Room	2022-09-19	4	7	1	5	0.6815000000000001
Memory's Abyss	2022-09-22	2	7	1	3	0.6815000000000001
ネクロサーガ	2022-11-03	4	7	1	5	0.6815000000000001
Taxi Taxi Sim	2022-11-02	2	7	1	3	0.6815000000000001
Cold Massacre	2022-10-18	4	7	1	5	0.6815000000000001
Stealth	2022-11-16	4	7	1	5	0.6815000000000001
Jack	2022-10-19	3	7	1	4	0.6815000000000001
Epic Princess	2022-11-18	2	7	1	3	0.6815000000000001
Fallen Stars	2022-11-25	4	7	1	5	0.6815000000000001
Vega	2022-12-21	1	7	1	2	0.6815000000000001
Mystery of Fortune 2 Refine	2022-01-25	397	72	25	422	0.6813
Smart Factory Tycoon	2022-03-26	118	112	41	159	0.6811
Magi: Mind Game	2022-05-04	34	19	5	39	0.6809999999999999
Where is Paradise?	2022-01-19	25	19	5	30	0.6809999999999999
ClayTown Horror	2022-10-25	8	19	5	13	0.6809999999999999
Cthulhu Dungeon	2022-02-18	11	19	5	16	0.6809999999999999
Follow the Black Kitten	2022-01-17	4	19	5	9	0.6809999999999999
人中怪物	2022-05-13	8	19	5	13	0.6809999999999999
Slaughter Cannon	2022-01-05	5	19	5	10	0.6809999999999999
Reality Simulator	2022-08-02	3	19	5	8	0.6809999999999999
Quantum Tripper	2022-05-27	5	19	5	10	0.6809999999999999
Shining Jump Jump	2022-06-13	6	19	5	11	0.6809999999999999
Neuro Horror	2022-10-06	3	19	5	8	0.6809999999999999
Drag and Drop	2022-11-21	2	19	5	7	0.6809999999999999
Furry Killer	2022-11-19	3	19	5	8	0.6809999999999999
Rebellion	2022-02-04	11	46	15	26	0.6807
Demented	2022-07-26	4507	64	22	4529	0.6805
The Hunsa Magic	2022-05-19	31	30	9	40	0.6805
Deer Journey	2022-07-21	4	30	9	13	0.6805
Who Knocks	2022-12-26	12	30	9	21	0.6805
Ankora: Lost Days	2022-09-16	30	38	12	42	0.6804000000000001
Broken Banners	2022-03-31	21	38	12	33	0.6804000000000001
Itchy Scratchy	2022-09-05	7	51	17	24	0.6801
Valand	2022-11-04	4	51	17	21	0.6801
Starsand	2022-11-17	541	583	241	782	0.68
CuVRball	2022-11-27	10	16	4	14	0.68
Vaporwave World	2022-10-08	2	16	4	6	0.68
Unlife	2022-06-07	5	16	4	9	0.68
Her Heart's Desire: A Landlord Epic	2022-11-18	28	16	4	32	0.68
The Guardian Stone	2022-10-22	6	16	4	10	0.68
Intense Love Shot	2022-01-07	6	16	4	10	0.68
Christmas Panic	2022-01-18	6	16	4	10	0.68
Kakureza Library	2022-01-24	17	16	4	21	0.68
Monsters and Weapons	2022-02-09	16	16	4	20	0.68
Rugby Union Team Manager 4	2022-11-30	25	16	4	29	0.68
Goddess Of War Ashley Ⅱ	2022-03-04	4	16	4	8	0.68
Die drei ??? - Plan der Chamäleonbande	2022-04-06	16	16	4	20	0.68
Underscore	2022-10-11	7	16	4	11	0.68
Kaz's Adventure	2022-09-05	8	16	4	12	0.68
Voxrush	2022-09-01	3	16	4	7	0.68
Spin Time	2022-12-02	4	16	4	8	0.68
Save the Kingdom	2022-10-12	18	16	4	22	0.68
Ants of Duty	2022-11-21	2	16	4	6	0.68
My Soul Forever	2022-11-21	2	16	4	6	0.68
Social Credit Simulator	2022-11-23	4	16	4	8	0.68
Castaway of the Ardusta Sea	2022-07-09	126	56	19	145	0.6797
Age of Grit	2022-05-03	14	43	14	28	0.6795
Adventures of the Old Testament - The Bible Video Game	2022-09-14	13	43	14	27	0.6795
末路希冀	2022-04-28	9	13	3	12	0.6793000000000001
雾尽时分	2022-03-04	9	13	3	12	0.6793000000000001
Treasure Temples	2022-02-03	5	13	3	8	0.6793000000000001
Happy Island Life	2022-03-29	4	13	3	7	0.6793000000000001
Spooky Story	2022-02-02	5	13	3	8	0.6793000000000001
Kapellmeister	2022-05-13	2	13	3	5	0.6793000000000001
SCALEPLANET	2022-05-24	5	13	3	8	0.6793000000000001
En•Fem•E No. 9: Reborn	2022-03-23	8	13	3	11	0.6793000000000001
Sway	2022-04-26	3	13	3	6	0.6793000000000001
Yuonger Adventure	2022-06-25	2	13	3	5	0.6793000000000001
Eternal Pinball RPG	2022-06-11	4	13	3	7	0.6793000000000001
Ragedanger Earth	2022-06-25	2	13	3	5	0.6793000000000001
Bring It On!	2022-06-20	17	13	3	20	0.6793000000000001
Mystical Island	2022-07-15	8	13	3	11	0.6793000000000001
Another World Quest	2022-08-03	5	13	3	8	0.6793000000000001
Blacksmith Weapon Merchant	2022-08-24	8	13	3	11	0.6793000000000001
Let's Go Camping	2022-09-30	2	13	3	5	0.6793000000000001
Highway Cross	2022-10-17	2	13	3	5	0.6793000000000001
Station 117	2022-11-23	9	13	3	12	0.6793000000000001
Halt	2022-11-19	1	13	3	4	0.6793000000000001
Lethal Running	2022-10-19	7	10	2	9	0.6793000000000001
Pixel Happy Game Girls	2022-12-17	3	10	2	5	0.6793000000000001
VOID: Arena (alpha)	2022-04-22	3	10	2	5	0.6793000000000001
Ruggnar	2022-06-23	6	10	2	8	0.6793000000000001
JumpBeard	2022-05-12	3	10	2	5	0.6793000000000001
Crossing Guard Joe	2022-03-04	3	10	2	5	0.6793000000000001
Guardian Force - Saturn Tribute	2022-02-09	5	10	2	7	0.6793000000000001
无限战魂 Infinity BattleSoul	2022-01-28	8	10	2	10	0.6793000000000001
Turn off the light	2022-01-27	4	10	2	6	0.6793000000000001
Tekla	2022-10-03	4	10	2	6	0.6793000000000001
Vitality Girl Ⅱ:Fire	2022-02-25	3	10	2	5	0.6793000000000001
Chicken Coop	2022-05-17	2	10	2	4	0.6793000000000001
『絵話 -kaiwa-』	2022-06-08	6	10	2	8	0.6793000000000001
Minebot expedition	2022-04-02	6	10	2	8	0.6793000000000001
Spoils Of War	2022-03-30	7	10	2	9	0.6793000000000001
Fun Quest	2022-03-30	5	10	2	7	0.6793000000000001
Surface Rush	2022-06-02	2	10	2	4	0.6793000000000001
Cowboy Hell	2022-09-22	4	10	2	6	0.6793000000000001
Toe To Toe Party Games	2022-04-20	4	10	2	6	0.6793000000000001
soul	2022-06-17	6	10	2	8	0.6793000000000001
Nocturama	2022-04-21	4	10	2	6	0.6793000000000001
AIRBORNE	2022-04-16	3	10	2	5	0.6793000000000001
Hypnosis Reveries	2022-05-20	3	10	2	5	0.6793000000000001
Run n Jump	2022-05-08	3	10	2	5	0.6793000000000001
SPLAIT RAGE	2022-06-25	1	10	2	3	0.6793000000000001
Brain Exam with Benefits 2	2022-07-04	7	10	2	9	0.6793000000000001
69 Andariel Hot	2022-07-18	4	10	2	6	0.6793000000000001
Slime Rule	2022-07-14	10	10	2	12	0.6793000000000001
Elementals: The Magic Key	2022-07-22	5	10	2	7	0.6793000000000001
Freestyle Mage 无穷秘法师	2022-09-26	6	10	2	8	0.6793000000000001
Tribe Explorer	2022-08-24	3	10	2	5	0.6793000000000001
Puzzle: Nature 2	2022-08-30	3	10	2	5	0.6793000000000001
Platonically Mauled by a Magic Cougar	2022-10-25	5	10	2	7	0.6793000000000001
Crossword World Puzzle	2022-12-12	11	10	2	13	0.6793000000000001
Battle Robots	2022-11-17	4	10	2	6	0.6793000000000001
My Darkest Witch	2022-11-19	2	10	2	4	0.6793000000000001
Digital Frida	2022-11-25	3	10	2	5	0.6793000000000001
Furry Arena [18+]	2022-12-01	251	283	113	364	0.6792
Doors of Insanity	2022-01-27	92	152	58	150	0.6790999999999999
中国战疫	2022-01-22	11	27	8	19	0.6790999999999999
Desktop Dog	2022-04-07	10	27	8	18	0.6790999999999999
山海天下：熊猫战纪	2022-09-09	6	27	8	14	0.6790999999999999
Ellisar	2022-05-09	32	93	34	66	0.6784
TFM: The First Men	2022-11-02	473	218	86	559	0.6783
FreestyleFootball R	2022-09-13	1166	884	376	1542	0.6781
Wrath of Anias	2022-03-02	12	40	13	25	0.6781
Virago: Herstory	2022-11-24	12	40	13	25	0.6781
Spire of Glory	2022-12-03	210	73	26	236	0.6779999999999999
F1® 22	2022-07-01	25172	14922	6802	31974	0.6776000000000001
Derpy Conga	2022-02-10	4	24	7	11	0.6776000000000001
Hentai Possess-Her	2022-01-07	4	24	7	11	0.6776000000000001
Cat Adventure 2	2022-03-16	3	24	7	10	0.6776000000000001
Hentai Pussy 3	2022-06-10	3	24	7	10	0.6776000000000001
Delivery Man	2022-11-25	13	24	7	20	0.6776000000000001
Tank Mechanic Simulator VR: Prologue	2022-04-15	20	45	15	35	0.6775
Perfect Date	2022-11-08	17	45	15	32	0.6775
Machina Blade	2022-09-07	23	32	10	33	0.6775
Noctem	2022-07-01	9	32	10	19	0.6775
In to the 029	2022-07-11	10	32	10	20	0.6775
Truck Mechanic: Dangerous Paths - Prologue	2022-06-02	931	336	137	1068	0.6774
MIGHT'N MOW'EM	2022-10-24	64	90	33	97	0.6774
HordeCore	2022-03-02	57	85	31	88	0.6773
Mage Noir - Infinity	2022-06-30	22	85	31	53	0.6773
Z-Collapse	2022-09-01	51	50	17	68	0.6770999999999999
Spooky Starlets	2022-06-23	190	335	137	327	0.6769
Ignited Steel	2022-03-09	42	55	19	61	0.6769
Monster Outbreak	2022-10-03	98	65	23	121	0.6768000000000001
One More Island	2022-05-16	259	133	51	310	0.6765000000000001
Paper Cut Mansion	2022-10-27	25	37	12	37	0.6765000000000001
Phantom Hysteria	2022-10-13	50	37	12	62	0.6765000000000001
Wing Breakers	2022-03-11	68	104	39	107	0.6764
Aero Tales Online: The World - Anime MMORPG	2022-08-01	533	373	154	687	0.6763
CardMaker	2022-01-27	79	147	57	136	0.6762
The Dragoness: Command of the Flame	2022-09-01	223	82	30	253	0.6762
Summer Crush	2022-11-25	115	82	30	145	0.6762
Jelle's Marble League	2022-10-05	57	94	35	92	0.6759000000000001
Path of Kami: Journey begins	2022-11-09	9	21	6	15	0.6759000000000001
Everblade	2022-05-06	11	21	6	17	0.6759000000000001
My Giant Friend	2022-11-10	8	21	6	14	0.6759000000000001
Sakura Mirror	2022-12-16	6	21	6	12	0.6759000000000001
Bloody Efforts	2022-09-16	22	29	9	31	0.6758
The Darkest Tales	2022-10-13	147	252	102	249	0.6757
ITRP _ Volatile Vertex	2022-03-02	72	47	16	88	0.6757
Tuk Tuk Extreme Simulator	2022-05-02	3	47	16	19	0.6757
JBMod	2022-10-22	120	1629	717	837	0.6756000000000001
EdgeOfTheAbyssAwaken	2022-06-19	593	399	166	759	0.6756000000000001
Ancient Witch Arena	2022-10-14	124	62	22	146	0.6756000000000001
Hentai Houseparty: Gyaru Gangbang	2022-01-18	18	57	20	38	0.6755
Clown Of Duty	2022-11-26	28	74	27	55	0.6748999999999999
Mercenaries Rebirth	2022-06-30	65	34	11	76	0.6748000000000001
Everything Is For Humanity	2022-06-24	13	86	32	45	0.6745
World Empire 2027	2022-03-24	13	39	13	26	0.6743000000000001
Chinatown Detective Agency	2022-04-07	78	81	30	108	0.6742
世界の為の全ての少女	2022-02-23	209	81	30	239	0.6742
Mad Pack	2022-02-10	55	192	77	132	0.6741
TEMPUS	2022-03-02	6	44	15	21	0.6741
守卫英雄	2022-10-14	21	44	15	36	0.6741
Curse of Eternity	2022-12-01	6	18	5	11	0.674
Race me now	2022-08-26	3	18	5	8	0.674
ModBots	2022-03-16	4	18	5	9	0.674
Mannequin The Passing	2022-03-04	4	18	5	9	0.674
SnakeGame	2022-02-24	2	18	5	7	0.674
三国群英之兵临天下	2022-07-15	8	18	5	13	0.674
Lands of Sorcery	2022-06-10	23	26	8	31	0.6739
Hot Cam	2022-07-28	24	26	8	32	0.6739
Dark Waters: Gino and the Witch of the Black Swamp	2022-03-29	4	26	8	12	0.6739
Rolando The Majestic	2022-05-23	304	26	8	312	0.6739
Witch Story	2022-09-11	6	26	8	14	0.6739
Nordicandia	2022-09-02	293	286	118	411	0.6738
SCP: Nukalypse	2022-08-15	72	453	192	264	0.6735
SCP: Daybreak	2022-07-23	33	133	52	85	0.6735
小虎传：大菠萝深渊	2022-08-26	556	83	31	587	0.6734
Gotham Knights	2022-10-21	24138	9906	4586	28724	0.6733
Castle Morihisa	2022-02-10	391	260	107	498	0.6731999999999999
Gunvolt Chronicles: Luminous Avenger iX 2	2022-01-27	339	246	101	440	0.6729999999999999
Picontier	2022-04-01	173	90	34	207	0.6729999999999999
En Route: Space	2022-05-06	10	31	10	20	0.6729999999999999
Late photographer 4	2022-05-11	7	31	10	17	0.6729999999999999
Die After Sunset	2022-02-11	37	56	20	57	0.6728000000000001
Draconia	2022-01-13	282	350	147	429	0.6727
Raubritter	2022-07-22	148	144	57	205	0.6726000000000001
Mists of Noyah	2022-05-22	211	482	206	417	0.6725
Lodestar	2022-07-08	44	46	16	60	0.6724
Life on the hook	2022-02-21	5	41	14	19	0.6724
An Elder Scrolls Legend: Battlespire	2022-04-26	9	41	14	23	0.6724
Sacrifice Your Friends	2022-10-25	13	15	4	17	0.672
One Gun Guy	2022-03-11	2	15	4	6	0.672
Age of Jura	2022-10-31	9	15	4	13	0.672
Peril	2022-03-15	2	15	4	6	0.672
Россия наизнанку: Новый год	2022-02-01	3	15	4	7	0.672
PINK ELEPHANT	2022-01-04	3	15	4	7	0.672
HexoJago	2022-01-26	4	15	4	8	0.672
Rock Snake	2022-03-14	2	15	4	6	0.672
RUNES Magica	2022-05-02	8	15	4	12	0.672
LogiNode	2022-04-19	4	15	4	8	0.672
Hot Milf 5	2022-04-01	2	15	4	6	0.672
Date Ariane Remastered	2022-06-10	14	15	4	18	0.672
U96	2022-07-05	5	15	4	9	0.672
ESCAPE IT	2022-08-15	8	15	4	12	0.672
Hear Your Path	2022-08-30	4	15	4	8	0.672
The Block	2022-12-16	15	63	23	38	0.6718999999999999
RaceLeague	2022-07-26	222	141	56	278	0.6718000000000001
OnlyFap Simulator 3 💦	2022-10-29	968	134	53	1021	0.6718000000000001
嗜憶 Swallow	2022-06-29	4	23	7	11	0.6718000000000001
Puzzle Park	2022-10-05	9	23	7	16	0.6718000000000001
Oathbreakers	2022-10-18	7	23	7	14	0.6718000000000001
The Story of The Flood	2022-12-23	16	53	19	35	0.6712
Gold Wiper	2022-04-25	65	65	24	89	0.6709
幻想三国志4外传	2022-01-09	45	48	17	62	0.6709
Human Apocalypse - Reverse Horror Zombie Indie RPG Adventure	2022-02-28	20	48	17	37	0.6709
Split	2022-04-06	11	28	9	20	0.6709
Noah and Blackmagician	2022-02-14	29	28	9	38	0.6709
PSYCHO	2022-03-11	7	28	9	16	0.6709
Sushi Clicker	2022-12-10	4	28	9	13	0.6709
Secrets of the Past: Mother's Diary	2022-01-13	3	3	0	3	0.6706000000000001
Tank Warz!	2022-11-14	3	3	0	3	0.6706000000000001
La Maledizione dell'Uccello Serpente	2022-02-22	2	3	0	2	0.6706000000000001
Leviathan's Sword	2022-05-02	3	3	0	3	0.6706000000000001
Luna Sky RDX	2022-08-08	2	3	0	2	0.6706000000000001
R42	2022-06-18	3	3	0	3	0.6706000000000001
Mystic	2022-03-08	4	3	0	4	0.6706000000000001
MagiCarnage	2022-09-16	4	3	0	4	0.6706000000000001
Sycamore	2022-06-30	4	3	0	4	0.6706000000000001
Deep Abyss	2022-10-12	2	3	0	2	0.6706000000000001
Grand Theft Rome	2022-02-16	1	3	0	1	0.6706000000000001
Roadkill	2022-08-10	2	3	0	2	0.6706000000000001
First Hero - Epic of Gilgamesh	2022-04-18	4	3	0	4	0.6706000000000001
Self gunsbase	2022-11-17	1	3	0	1	0.6706000000000001
Slide Stars	2022-04-29	2	3	0	2	0.6706000000000001
Amazething	2022-03-22	2	3	0	2	0.6706000000000001
Monolith	2022-03-13	1	3	0	1	0.6706000000000001
Chompy Chomp Chomp Party	2022-11-17	7	3	0	7	0.6706000000000001
Orpheus: Fall For Eurydice	2022-03-01	3	3	0	3	0.6706000000000001
FREUS	2022-02-27	2	3	0	2	0.6706000000000001
Oplitak	2022-02-04	3	3	0	3	0.6706000000000001
Super Stupid Game	2022-06-17	4	3	0	4	0.6706000000000001
AnotherQuizzGame	2022-07-26	3	3	0	3	0.6706000000000001
Chunkers	2022-12-07	3	3	0	3	0.6706000000000001
Kartoffl	2022-11-03	2	3	0	2	0.6706000000000001
Juno's Journey	2022-01-21	2	3	0	2	0.6706000000000001
Park Story	2022-10-20	2	3	0	2	0.6706000000000001
Woods of Death 2	2022-04-08	2	3	0	2	0.6706000000000001
Pair of Aces	2022-05-04	2	3	0	2	0.6706000000000001
SYRAK: the War in the Middle-East	2022-05-16	2	3	0	2	0.6706000000000001
Far Away Horse	2022-11-01	2	3	0	2	0.6706000000000001
Tag Hop	2022-01-21	13	3	0	13	0.6706000000000001
Objective H.A.S.T.E. - Survival Horror Escape	2022-03-03	1	3	0	1	0.6706000000000001
Zahalia: The Curse of Zezor	2022-09-07	2	3	0	2	0.6706000000000001
Dungeon Tactics	2022-04-25	5	3	0	5	0.6706000000000001
Summer In Memoria	2022-04-20	1	3	0	1	0.6706000000000001
Albert and Puzzle Mansion	2022-07-08	1	3	0	1	0.6706000000000001
Side Effect	2022-03-10	4	3	0	4	0.6706000000000001
Sexy Heroine! Part 3	2022-04-21	7	3	0	7	0.6706000000000001
Ninja Usagimaru: Two Tails of Adventure	2022-01-26	3	3	0	3	0.6706000000000001
AFTERGLOW	2022-10-11	1	3	0	1	0.6706000000000001
Siren Head Horror Bunker VR	2022-03-31	2	3	0	2	0.6706000000000001
Pico Islands	2022-02-28	3	3	0	3	0.6706000000000001
Rebels - Under the Spell of Magic (Chapter 2)	2022-03-23	1	3	0	1	0.6706000000000001
Hoverbike Escape	2022-05-06	2	3	0	2	0.6706000000000001
Run Ninja Run	2022-02-01	1	3	0	1	0.6706000000000001
Bull3000VRTS	2022-08-22	2	3	0	2	0.6706000000000001
YARG	2022-09-16	2	3	0	2	0.6706000000000001
Seaside Driving	2022-03-16	3	3	0	3	0.6706000000000001
Chill Panda	2022-03-31	2	3	0	2	0.6706000000000001
Notoris: The Goblin War	2022-07-01	2	3	0	2	0.6706000000000001
Dream of Light	2022-09-01	2	3	0	2	0.6706000000000001
Hop Skip and Thump	2022-01-18	1	3	0	1	0.6706000000000001
Bad Guy: Neighborhood	2022-06-16	5	3	0	5	0.6706000000000001
Airborne Motocross	2022-04-08	2	3	0	2	0.6706000000000001
Don't Get Distracted	2022-08-19	2	3	0	2	0.6706000000000001
Where Is Here: New Home	2022-09-30	1	3	0	1	0.6706000000000001
Blade Crusade	2022-09-30	2	3	0	2	0.6706000000000001
Monster Fighter	2022-05-10	2	3	0	2	0.6706000000000001
The Holy Chalice	2022-04-20	2	3	0	2	0.6706000000000001
cursor0x0	2022-09-23	3	3	0	3	0.6706000000000001
Curses of Tarot	2022-01-11	3	3	0	3	0.6706000000000001
Letters from the Moon	2022-01-05	2	3	0	2	0.6706000000000001
Station-Z	2022-12-22	3	3	0	3	0.6706000000000001
How to Sing to Open Your Heart Remastered	2022-05-05	3	3	0	3	0.6706000000000001
Spaceship Hunters	2022-01-31	4	3	0	4	0.6706000000000001
Steph's Revenge	2022-01-04	1	3	0	1	0.6706000000000001
遺跡冒險RelicAdventure	2022-01-29	2	3	0	2	0.6706000000000001
Dream/strung - Blossoming Love	2022-02-12	5	3	0	5	0.6706000000000001
Bathtime Toys	2022-03-03	3	3	0	3	0.6706000000000001
Urchins & Ink	2022-07-29	2	3	0	2	0.6706000000000001
Chromarena	2022-02-02	1	3	0	1	0.6706000000000001
Beatus Creation Solitaire	2022-05-25	9	3	0	9	0.6706000000000001
Primasia	2022-12-08	1	3	0	1	0.6706000000000001
Spy Robot: Gateways To Humanity	2022-11-18	1	3	0	1	0.6706000000000001
Netherspace 2	2022-01-07	2	3	0	2	0.6706000000000001
Two World Portal	2022-01-14	3	3	0	3	0.6706000000000001
Possession Obsession	2022-07-22	4	3	0	4	0.6706000000000001
Slette Mette	2022-01-06	1	3	0	1	0.6706000000000001
Brain Bait	2022-01-11	2	3	0	2	0.6706000000000001
Khoros	2022-05-18	2	3	0	2	0.6706000000000001
Milo	2022-02-02	1	3	0	1	0.6706000000000001
Connected Hearts: The Full Moon Curse Collector's Edition	2022-01-25	5	3	0	5	0.6706000000000001
Operation S	2022-01-11	3	3	0	3	0.6706000000000001
Winter and People	2022-08-15	1	3	0	1	0.6706000000000001
Pushing Crates	2022-09-06	2	3	0	2	0.6706000000000001
American Christmas	2022-01-06	2	3	0	2	0.6706000000000001
Fireflies & Figments: A Willow's Journey	2022-03-07	3	3	0	3	0.6706000000000001
.G	2022-01-11	1	3	0	1	0.6706000000000001
Helm or High Water	2022-02-17	3	3	0	3	0.6706000000000001
Find the Gnome 2	2022-12-13	2	3	0	2	0.6706000000000001
Bessarabian Nightmares	2022-02-09	2	3	0	2	0.6706000000000001
Dark Paradise Nigelopia: Mini Mix	2022-01-21	2	3	0	2	0.6706000000000001
Squarena	2022-03-01	4	3	0	4	0.6706000000000001
The Hierophant	2022-02-02	2	3	0	2	0.6706000000000001
FORTRESS OF FEAR	2022-02-01	2	3	0	2	0.6706000000000001
Natural	2022-02-14	2	3	0	2	0.6706000000000001
Fighting Heart	2022-02-11	2	3	0	2	0.6706000000000001
素数ガール	2022-02-16	1	3	0	1	0.6706000000000001
Dubu Rush	2022-03-19	1	3	0	1	0.6706000000000001
Fantasy Mosaics 35: Day at the Museum	2022-01-27	6	3	0	6	0.6706000000000001
Pillars of Sorrow	2022-09-23	2	3	0	2	0.6706000000000001
Witch sacrifice	2022-02-13	2	3	0	2	0.6706000000000001
Peep Invasion - Tower Defense	2022-05-04	1	3	0	1	0.6706000000000001
Reds Adventure A Seasons New Beginning	2022-02-04	2	3	0	2	0.6706000000000001
REAL LIFE OF SOLDIER	2022-02-18	2	3	0	2	0.6706000000000001
ボクロボ ~Boxed Cell Robot Armies~	2022-05-25	10	3	0	10	0.6706000000000001
Nuts Protocol	2022-07-12	2	3	0	2	0.6706000000000001
Ark Defender	2022-07-11	3	3	0	3	0.6706000000000001
Might of the Stones	2022-02-15	3	3	0	3	0.6706000000000001
Skycliffs	2022-11-03	2	3	0	2	0.6706000000000001
Lazerball	2022-12-09	3	3	0	3	0.6706000000000001
Guns and Roses	2022-02-24	2	3	0	2	0.6706000000000001
Journey To Destiny	2022-11-09	4	3	0	4	0.6706000000000001
Fun Machine	2022-02-21	2	3	0	2	0.6706000000000001
One Life	2022-12-16	2	3	0	2	0.6706000000000001
MacShot	2022-03-10	2	3	0	2	0.6706000000000001
Crupt	2022-04-28	4	3	0	4	0.6706000000000001
Dumb Little Robots	2022-08-24	2	3	0	2	0.6706000000000001
Master Show VR	2022-03-03	2	3	0	2	0.6706000000000001
Hyperstrix	2022-05-10	1	3	0	1	0.6706000000000001
SønderDø	2022-05-13	4	3	0	4	0.6706000000000001
HellFull - The Last Hope	2022-03-15	2	3	0	2	0.6706000000000001
俺に地球は狭すぎる	2022-03-04	3	3	0	3	0.6706000000000001
Princess Pyro	2022-04-20	2	3	0	2	0.6706000000000001
Alien Decimation	2022-09-02	1	3	0	1	0.6706000000000001
Perfect Ball	2022-03-07	2	3	0	2	0.6706000000000001
Hacking for Hermann	2022-05-11	3	3	0	3	0.6706000000000001
Meliora	2022-10-31	4	3	0	4	0.6706000000000001
Search and Rescue	2022-11-11	3	3	0	3	0.6706000000000001
Super Gosu Cars	2022-09-23	6	3	0	6	0.6706000000000001
Back 2 School	2022-03-10	2	3	0	2	0.6706000000000001
Xpraize Beta for GameMaster	2022-05-31	3	3	0	3	0.6706000000000001
Immortal Love: True Treasure Collector's Edition	2022-03-02	7	3	0	7	0.6706000000000001
Spiriat	2022-08-02	2	3	0	2	0.6706000000000001
Laruaville 12	2022-03-17	7	3	0	7	0.6706000000000001
Voxquest: The Firebird	2022-03-17	1	3	0	1	0.6706000000000001
Vacation Paradise: California Collector's Edition	2022-03-09	4	3	0	4	0.6706000000000001
Reset Memory	2022-03-16	1	3	0	1	0.6706000000000001
Space Voyager	2022-04-29	1	3	0	1	0.6706000000000001
Pet Vet 3D Wild Animal Hospital	2022-04-21	4	3	0	4	0.6706000000000001
Mystery Solitaire. Powerful Alchemist 2	2022-03-07	5	3	0	5	0.6706000000000001
Underliner	2022-05-05	3	3	0	3	0.6706000000000001
村雨のソードブレイカー	2022-04-03	3	3	0	3	0.6706000000000001
Girbal	2022-11-01	3	3	0	3	0.6706000000000001
Terry Poorflyer	2022-04-07	2	3	0	2	0.6706000000000001
Darkness Of The Coast	2022-04-05	1	3	0	1	0.6706000000000001
I wanna Reach the TOP	2022-12-31	2	3	0	2	0.6706000000000001
Find And Kill The Evil King	2022-05-05	2	3	0	2	0.6706000000000001
Holiday Jigsaw Easter 2	2022-03-30	1	3	0	1	0.6706000000000001
GunQuest	2022-07-02	1	3	0	1	0.6706000000000001
Groovy	2022-12-23	2	3	0	2	0.6706000000000001
First Time in Rome	2022-08-26	6	3	0	6	0.6706000000000001
Merge Cats - Idle Game	2022-04-13	3	3	0	3	0.6706000000000001
Rotten Apple - New York Fallen	2022-09-02	4	3	0	4	0.6706000000000001
Dash And Slash	2022-07-04	1	3	0	1	0.6706000000000001
OneShotRogue	2022-06-20	2	3	0	2	0.6706000000000001
Reforger	2022-11-01	4	3	0	4	0.6706000000000001
怯懦 Cowardice	2022-11-16	2	3	0	2	0.6706000000000001
Kokoro Ultimate	2022-05-16	2	3	0	2	0.6706000000000001
Maps: U.S.A.	2022-05-30	2	3	0	2	0.6706000000000001
I Love Finding MORE Pups	2022-07-15	3	3	0	3	0.6706000000000001
Tower Of Wishes 2: Vikings	2022-05-28	6	3	0	6	0.6706000000000001
Mist Monkey: wanderer	2022-09-13	2	3	0	2	0.6706000000000001
午时已到	2022-05-02	3	3	0	3	0.6706000000000001
HRS (Devil Game)	2022-07-07	3	3	0	3	0.6706000000000001
Automata Ecosystem	2022-05-31	2	3	0	2	0.6706000000000001
Corridor Sigma	2022-05-04	2	3	0	2	0.6706000000000001
Connected Hearts: Fortune Play Collector's Edition	2022-09-06	9	3	0	9	0.6706000000000001
The Rhythm of the Knight	2022-05-26	1	3	0	1	0.6706000000000001
Virtual Hunting Experience	2022-05-13	2	3	0	2	0.6706000000000001
1001 Jigsaw. Legends of Mystery 6	2022-08-08	2	3	0	2	0.6706000000000001
HyperNova	2022-06-20	2	3	0	2	0.6706000000000001
Heart is Muscle	2022-10-14	1	3	0	1	0.6706000000000001
Mosaics Galore. Glorious Journey	2022-08-08	2	3	0	2	0.6706000000000001
Caterpillar	2022-06-02	1	3	0	1	0.6706000000000001
The Twilight of Infinity	2022-07-01	2	3	0	2	0.6706000000000001
Lost Bits	2022-06-22	4	3	0	4	0.6706000000000001
Symmetry Lines	2022-05-18	4	3	0	4	0.6706000000000001
Dungeon Fall	2022-05-16	1	3	0	1	0.6706000000000001
封妖录	2022-05-18	3	3	0	3	0.6706000000000001
Sky Captain's Return	2022-10-31	3	3	0	3	0.6706000000000001
The Life of Arthur	2022-10-03	1	3	0	1	0.6706000000000001
Lorethem	2022-05-25	1	3	0	1	0.6706000000000001
Spellarium 8	2022-05-27	7	3	0	7	0.6706000000000001
Arsolid Productions	2022-05-27	1	3	0	1	0.6706000000000001
30 days in red army	2022-06-22	2	3	0	2	0.6706000000000001
Chaotic Loop	2022-06-08	1	3	0	1	0.6706000000000001
Death Bind	2022-07-07	4	3	0	4	0.6706000000000001
Just Another Runner	2022-06-30	2	3	0	2	0.6706000000000001
Nightmare Hunter	2022-08-16	1	3	0	1	0.6706000000000001
Arcade Flight	2022-06-06	1	3	0	1	0.6706000000000001
Don't Stop the Camera! ~Hidden Desires of a Young Wife~	2022-06-24	2	3	0	2	0.6706000000000001
Eternal	2022-12-22	2	3	0	2	0.6706000000000001
Meat Beating: The Second Coming	2022-06-15	4	3	0	4	0.6706000000000001
The Horace Trilogy	2022-06-24	1	3	0	1	0.6706000000000001
Lil' Horror Stories: The Camp Fire	2022-06-28	2	3	0	2	0.6706000000000001
Strange Investigations: Two for Solitaire Collector's Edition	2022-06-17	5	3	0	5	0.6706000000000001
Cube Decider	2022-06-23	2	3	0	2	0.6706000000000001
Doodle Drive	2022-07-26	2	3	0	2	0.6706000000000001
Knights of the Kitchen Table	2022-07-01	2	3	0	2	0.6706000000000001
Against All Odds	2022-12-04	2	3	0	2	0.6706000000000001
Cat Lovescapes	2022-06-20	2	3	0	2	0.6706000000000001
Trippy Tavern	2022-11-17	1	3	0	1	0.6706000000000001
Project:EagleBeak	2022-09-02	4	3	0	4	0.6706000000000001
Invasive	2022-07-20	1	3	0	1	0.6706000000000001
Internet Exploring	2022-12-20	2	3	0	2	0.6706000000000001
Quick Tower Defence Ultimate	2022-08-23	3	3	0	3	0.6706000000000001
Operation: Forge the Deep	2022-11-29	3	3	0	3	0.6706000000000001
Ein's Sword	2022-07-14	3	3	0	3	0.6706000000000001
Alien Time	2022-09-22	2	3	0	2	0.6706000000000001
Desstroke	2022-07-20	1	3	0	1	0.6706000000000001
Wanted! Monty Mole	2022-07-01	2	3	0	2	0.6706000000000001
Rock Wrecker	2022-07-14	6	3	0	6	0.6706000000000001
Toggle Cube	2022-07-20	2	3	0	2	0.6706000000000001
Space FURY - The Phantom Menace	2022-10-11	2	3	0	2	0.6706000000000001
Platfuzzles	2022-09-05	2	3	0	2	0.6706000000000001
Smash	2022-07-16	1	3	0	1	0.6706000000000001
Rezzil Player	2022-12-21	3	3	0	3	0.6706000000000001
Cursed Colors	2022-09-19	4	3	0	4	0.6706000000000001
Jack the Nipper	2022-07-21	1	3	0	1	0.6706000000000001
CYCLEBREAKER	2022-07-27	1	3	0	1	0.6706000000000001
Berserker	2022-08-24	2	3	0	2	0.6706000000000001
Shufflepoker	2022-08-30	3	3	0	3	0.6706000000000001
Super Nova Party	2022-10-04	4	3	0	4	0.6706000000000001
Slingshot Adventure	2022-08-22	1	3	0	1	0.6706000000000001
Sleepy Sheep	2022-09-02	2	3	0	2	0.6706000000000001
Lewis Carroll's Alice	2022-08-02	1	3	0	1	0.6706000000000001
Retro Invasion	2022-08-24	2	3	0	2	0.6706000000000001
MonkeyMilk	2022-08-08	1	3	0	1	0.6706000000000001
Maze Ablaze	2022-08-10	2	3	0	2	0.6706000000000001
Vacation Adventures: Park Ranger 14	2022-09-22	7	3	0	7	0.6706000000000001
Path	2022-11-15	1	3	0	1	0.6706000000000001
Angry Angus	2022-11-04	1	3	0	1	0.6706000000000001
Cold Way	2022-11-11	2	3	0	2	0.6706000000000001
Sharp Eyed	2022-09-05	2	3	0	2	0.6706000000000001
Legend of Zero	2022-08-04	1	3	0	1	0.6706000000000001
Nature Escapes	2022-11-07	5	3	0	5	0.6706000000000001
天剑局剑士	2022-08-14	3	3	0	3	0.6706000000000001
77 Oleander Avenue	2022-12-19	2	3	0	2	0.6706000000000001
Jigsaw Puzzle - Futanari Pool Party	2022-07-31	2	3	0	2	0.6706000000000001
Ash Battle	2022-09-16	3	3	0	3	0.6706000000000001
ARROW	2022-09-08	2	3	0	2	0.6706000000000001
Kaiju Klash	2022-11-08	2	3	0	2	0.6706000000000001
Sticky Steve's Sticky Situation	2022-10-12	1	3	0	1	0.6706000000000001
GasolineGypsiesGame	2022-09-16	2	3	0	2	0.6706000000000001
星际王八传奇	2022-08-27	1	3	0	1	0.6706000000000001
Blood and Sorcery	2022-09-15	1	3	0	1	0.6706000000000001
Kardun	2022-09-01	2	3	0	2	0.6706000000000001
Spliced	2022-10-31	3	3	0	3	0.6706000000000001
Crash Override	2022-09-14	2	3	0	2	0.6706000000000001
Petite Adventure	2022-12-09	1	3	0	1	0.6706000000000001
Swords & Adventures	2022-09-30	3	3	0	3	0.6706000000000001
Astro VR	2022-11-25	3	3	0	3	0.6706000000000001
Hexcross	2022-09-20	5	3	0	5	0.6706000000000001
Catch Them If You Can	2022-09-12	4	3	0	4	0.6706000000000001
Waking Knightmare	2022-10-31	2	3	0	2	0.6706000000000001
My House Is Haunted	2022-10-28	4	3	0	4	0.6706000000000001
Salt Game	2022-10-14	4	3	0	4	0.6706000000000001
Todd's Adventures in Slime World	2022-10-07	2	3	0	2	0.6706000000000001
Mr. Healer	2022-11-16	3	3	0	3	0.6706000000000001
Eclipse of the Moon	2022-09-30	2	3	0	2	0.6706000000000001
机でバスケ	2022-12-08	2	3	0	2	0.6706000000000001
Super Ball Arena	2022-09-17	7	3	0	7	0.6706000000000001
Fright Knight Legend	2022-12-14	2	3	0	2	0.6706000000000001
Stunt Legends	2022-10-06	4	3	0	4	0.6706000000000001
Nameless - The Departed Cycle	2022-11-02	1	3	0	1	0.6706000000000001
LLAMA THE FARM DRAMA	2022-10-21	2	3	0	2	0.6706000000000001
Don't Get Eaten!	2022-10-12	1	3	0	1	0.6706000000000001
Parlor	2022-11-15	3	3	0	3	0.6706000000000001
Waste It	2022-10-01	1	3	0	1	0.6706000000000001
Zombies	2022-09-29	2	3	0	2	0.6706000000000001
Rubble	2022-11-15	3	3	0	3	0.6706000000000001
Run Foxy, Run!	2022-11-11	2	3	0	2	0.6706000000000001
The Waterflame Brothers	2022-10-06	4	3	0	4	0.6706000000000001
Witch Potion	2022-10-14	1	3	0	1	0.6706000000000001
Astraea	2022-10-10	2	3	0	2	0.6706000000000001
Geese And Gats	2022-09-30	2	3	0	2	0.6706000000000001
Zombie Slapper	2022-11-28	2	3	0	2	0.6706000000000001
Alice with Gatling	2022-11-09	4	3	0	4	0.6706000000000001
Necroffense	2022-11-30	2	3	0	2	0.6706000000000001
Crimson Phoenix Rise	2022-10-09	2	3	0	2	0.6706000000000001
Flappy Bat 2	2022-10-31	1	3	0	1	0.6706000000000001
VariDungeon	2022-10-20	2	3	0	2	0.6706000000000001
拯救公主-宿命的破除	2022-11-19	3	3	0	3	0.6706000000000001
VR Run	2022-11-05	2	3	0	2	0.6706000000000001
Samurai's Journey: Shifting of the Guard	2022-11-30	2	3	0	2	0.6706000000000001
Puzzle Pieces 5: Fairy Ring	2022-11-24	2	3	0	2	0.6706000000000001
Crazy Drift	2022-11-18	2	3	0	2	0.6706000000000001
Oylinder	2022-11-23	2	3	0	2	0.6706000000000001
Horny Witch: Crusade	2022-11-17	2	3	0	2	0.6706000000000001
Broken In Time	2022-10-25	3	3	0	3	0.6706000000000001
Fire of Life: New Day	2022-12-02	3	3	0	3	0.6706000000000001
Loser's Romance	2022-10-27	1	3	0	1	0.6706000000000001
Nemesis Island	2022-12-13	2	3	0	2	0.6706000000000001
MetaMorphic Rippers	2022-10-25	2	3	0	2	0.6706000000000001
Space Adventure	2022-11-29	1	3	0	1	0.6706000000000001
DobbyxEscape: Halloween Adventure	2022-10-27	2	3	0	2	0.6706000000000001
Bad-Draw	2022-12-13	2	3	0	2	0.6706000000000001
Tales of Therapy	2022-11-18	3	3	0	3	0.6706000000000001
Alphadia Neo	2022-12-16	7	3	0	7	0.6706000000000001
Vispo - The Video Spot the Difference game	2022-12-01	4	3	0	4	0.6706000000000001
Mission: Aliens	2022-11-04	2	3	0	2	0.6706000000000001
A Path to the Princess	2022-11-10	1	3	0	1	0.6706000000000001
无尽战线 Infinity War	2022-11-16	3	3	0	3	0.6706000000000001
Funplace: After Hours	2022-11-08	2	3	0	2	0.6706000000000001
Cymut X Mutrobo RPG	2022-11-18	1	3	0	1	0.6706000000000001
Monster Hunters: Frost Giant	2022-11-09	3	3	0	3	0.6706000000000001
查理公馆事件簿	2022-11-11	1	3	0	1	0.6706000000000001
Maintenance Safety (Pipes and Acids)	2022-11-15	2	3	0	2	0.6706000000000001
Cuana	2022-11-26	1	3	0	1	0.6706000000000001
WITCH'S	2022-12-01	1	3	0	1	0.6706000000000001
Beat the Heat	2022-11-30	2	3	0	2	0.6706000000000001
Grabitoons!	2022-12-26	3	3	0	3	0.6706000000000001
Skybox	2022-12-23	2	3	0	2	0.6706000000000001
POG X	2022-11-19	2	3	0	2	0.6706000000000001
Festive Finds: Happy Holidays Calendar	2022-11-28	2	3	0	2	0.6706000000000001
Ricky's Rockin' Arcade	2022-12-09	4	3	0	4	0.6706000000000001
Tetris Christmas	2022-12-02	2	3	0	2	0.6706000000000001
Cat + Dog	2022-12-16	2	3	0	2	0.6706000000000001
Space Haste 2	2022-12-02	2	3	0	2	0.6706000000000001
Dissolved - Chapter One	2022-12-08	1	3	0	1	0.6706000000000001
Winfray	2022-12-10	4	3	0	4	0.6706000000000001
Trouble In Space	2022-12-17	1	3	0	1	0.6706000000000001
Deadly Platform	2022-12-25	3	3	0	3	0.6706000000000001
AutoSim 2	2022-12-30	13	3	0	13	0.6706000000000001
Super Hoopers	2022-12-21	2	3	0	2	0.6706000000000001
Grim Knight	2022-12-28	1	3	0	1	0.6706000000000001
Momo is Here	2022-02-18	7	38	13	20	0.6705
The Backrooms: Found Footage	2022-07-04	10	38	13	23	0.6705
Soul Harvest	2022-10-31	4	12	3	7	0.6698000000000001
Sakura Melody	2022-10-24	12	12	3	15	0.6698000000000001
Ashland Dossier	2022-04-20	7	12	3	10	0.6698000000000001
The Last Sunshine: Rekindled	2022-03-22	14	12	3	17	0.6698000000000001
Krut: The Mythic Wings	2022-07-12	4	12	3	7	0.6698000000000001
Faith	2022-11-01	4	12	3	7	0.6698000000000001
DREAMVIBE	2022-04-08	3	12	3	6	0.6698000000000001
Dice vs Dice	2022-08-25	2	12	3	5	0.6698000000000001
Eyes Over Us	2022-08-18	2	12	3	5	0.6698000000000001
Last Threshold	2022-03-24	5	12	3	8	0.6698000000000001
Deadly Racing Duel	2022-01-31	5	12	3	8	0.6698000000000001
Tiny Hill	2022-03-10	4	12	3	7	0.6698000000000001
Tonikk Tycoon	2022-04-13	11	12	3	14	0.6698000000000001
Bonza Boom	2022-07-02	6	12	3	9	0.6698000000000001
Heroes of Time	2022-05-20	8	12	3	11	0.6698000000000001
Welcome To The Backrooms	2022-10-27	4	12	3	7	0.6698000000000001
Pirates Things	2022-06-15	3	12	3	6	0.6698000000000001
Assassins Guild	2022-11-06	5	12	3	8	0.6698000000000001
Refuge	2022-11-30	3	12	3	6	0.6698000000000001
Explore the forest Kill!!!	2022-11-29	3	12	3	6	0.6698000000000001
The Future Ends	2022-12-05	6	12	3	9	0.6698000000000001
WRC Generations - The FIA WRC Official Game	2022-11-03	1241	1190	535	1776	0.6697
Distant Worlds 2	2022-03-10	4974	1637	744	5718	0.6695000000000001
FemDomination 2	2022-02-13	10	50	18	28	0.6695000000000001
逐鹿	2022-10-26	138	139	56	194	0.6694
黑暗之岛	2022-05-27	18	20	6	24	0.6694
Couch Combat	2022-07-13	6	20	6	12	0.6694
Satan's puzzle 666	2022-03-29	3	20	6	9	0.6694
Furry Futanari Jigsaw	2022-03-15	5	20	6	11	0.6694
Summer With You	2022-05-11	6	20	6	12	0.6694
Samurai Story	2022-05-20	4	20	6	10	0.6694
Heaven Snakes	2022-06-01	37	20	6	43	0.6694
Naval Battle Online	2022-11-17	104	20	6	110	0.6694
Cyberdunk Anime Edition	2022-05-02	3	45	16	19	0.6691
Iron Jaw	2022-05-24	18	45	16	34	0.6691
Valkie 64	2022-11-25	22	57	21	43	0.6688
HAITENAI RPG	2022-11-11	212	83	32	244	0.6687000000000001
Spirit Detective	2022-03-16	162	395	171	333	0.6685
A Series of Temporal Mishaps	2022-03-31	6	25	8	14	0.6685
Oceans	2022-11-16	13	25	8	21	0.6685
Japanese goblins	2022-12-16	11	25	8	19	0.6685
So Below	2022-10-25	26	25	8	34	0.6685
Stronghold's Dungeon	2022-11-17	72	35	12	84	0.6684
SenS	2022-05-20	9	35	12	21	0.6684
风色幻想SP:封神之刻	2022-08-09	72	52	19	91	0.6683
Smash MAGA! Trump Zombie Apocalypse	2022-01-06	6	30	10	16	0.6683
Oxide Room 104	2022-06-16	51	99	39	90	0.6681999999999999
This Time	2022-03-22	54	59	22	76	0.6678000000000001
Decision: Red Daze	2022-05-19	500	303	130	630	0.6677
Track and Burn	2022-08-05	102	221	93	195	0.6677
Carrot Heart	2022-02-05	4	9	2	6	0.6676000000000001
Fech The Ferret	2022-09-21	9	9	2	11	0.6676000000000001
Interplanetary Gardener	2022-01-13	4	9	2	6	0.6676000000000001
Teraphobia	2022-03-24	11	9	2	13	0.6676000000000001
Titanium Hound	2022-10-26	2	9	2	4	0.6676000000000001
CAPITALISM The action board game for one player	2022-09-02	3	9	2	5	0.6676000000000001
canVERSE	2022-06-07	17	9	2	19	0.6676000000000001
Hover The Edge	2022-06-02	3	9	2	5	0.6676000000000001
Pangaroids	2022-04-01	2	9	2	4	0.6676000000000001
Communist Clicker	2022-02-10	3	9	2	5	0.6676000000000001
La Jetée	2022-05-04	2	9	2	4	0.6676000000000001
Swinging-Man	2022-04-18	3	9	2	5	0.6676000000000001
Scavenger's Deep	2022-05-27	3	9	2	5	0.6676000000000001
Virtual AI - Lily	2022-05-04	3	9	2	5	0.6676000000000001
Sharp Trouble	2022-03-14	4	9	2	6	0.6676000000000001
Heaven Keepers	2022-03-10	3	9	2	5	0.6676000000000001
Kly-Kly	2022-03-14	5	9	2	7	0.6676000000000001
CLOUDED	2022-10-14	3	9	2	5	0.6676000000000001
The Hidden Ghost	2022-04-15	2	9	2	4	0.6676000000000001
C&T	2022-06-07	11	9	2	13	0.6676000000000001
Wormhole Adventurer	2022-10-14	6	9	2	8	0.6676000000000001
Loskop	2022-05-12	3	9	2	5	0.6676000000000001
Case #1472	2022-10-15	5	9	2	7	0.6676000000000001
Thrice in a row: Last Adventure	2022-08-26	2	9	2	4	0.6676000000000001
Futanari Sex - Unexpected Roomate	2022-05-19	2	9	2	4	0.6676000000000001
Awake	2022-06-10	5	9	2	7	0.6676000000000001
Puzzle World: Cute Monsters	2022-06-22	5	9	2	7	0.6676000000000001
HordounD	2022-08-01	2	9	2	4	0.6676000000000001
TSE: Reloaded	2022-07-10	10	9	2	12	0.6676000000000001
FERD	2022-11-18	3	9	2	5	0.6676000000000001
Yandere Goddess: A Snatch Made in Heaven	2022-08-12	11	9	2	13	0.6676000000000001
PLANETOIDS	2022-08-05	4	9	2	6	0.6676000000000001
Underwater battles	2022-08-09	3	9	2	5	0.6676000000000001
TAKIBI	2022-10-21	9	9	2	11	0.6676000000000001
Slime Hero	2022-10-17	3	9	2	5	0.6676000000000001
时无烬	2022-10-13	9	9	2	11	0.6676000000000001
Treekeepers	2022-09-30	4	9	2	6	0.6676000000000001
Futanari of the Apocalypse	2022-12-08	5	9	2	7	0.6676000000000001
Lost Between the Lines	2022-11-08	2	9	2	4	0.6676000000000001
I Fought the Lawn	2022-11-15	6	9	2	8	0.6676000000000001
PARADISE CLEANING - Conquering Married Women through Sex -	2022-12-30	3	9	2	5	0.6676000000000001
Harvest Days: My Dream Farm	2022-05-12	78	80	31	109	0.6674
异星前哨	2022-12-16	641	236	100	741	0.6673
Succubus x Saint	2022-03-29	188	54	20	208	0.6670999999999999
Highrise City	2022-03-24	435	260	111	546	0.667
Masks Of Deception	2022-06-17	82	112	45	127	0.6668999999999999
Beyond the Storm	2022-10-04	11	17	5	16	0.6666
Are You Smarter than a 5th Grader?	2022-08-23	26	17	5	31	0.6666
Chester	2022-03-14	3	17	5	8	0.6666
PURGE - Three vs Blood	2022-05-26	7	17	5	12	0.6666
Incursion: Reforged	2022-12-09	6	17	5	11	0.6666
Hot Tentacles Shooter	2022-09-09	4	17	5	9	0.6666
Burning Requiem: Fates	2022-07-20	6	17	5	11	0.6666
Alone Again	2022-09-05	2	17	5	7	0.6666
Brave Heroes	2022-10-02	8	17	5	13	0.6666
Selobus Fantasy	2022-02-17	23	37	13	36	0.6665000000000001
Elden Gunfire 2	2022-10-17	6	37	13	19	0.6665000000000001
Conquer: Napoleonic Wars	2022-12-05	7	37	13	20	0.6665000000000001
The Wraith of the Galaxy: Free Trial	2022-11-12	10	37	13	23	0.6665000000000001
苦主救助中心Ⅰ	2022-11-11	616	1261	578	1194	0.6664
【NekoGakuen】《MatthiolaReverieVerse:LostIsland》	2022-06-11	5	6	1	6	0.6662
B99	2022-05-03	2	6	1	3	0.6662
One Last Try	2022-10-07	8	6	1	9	0.6662
BlitzKeep Unleashed	2022-07-30	3	6	1	4	0.6662
The Long Sky VR	2022-05-13	1	6	1	2	0.6662
Spellbearers	2022-10-14	4	6	1	5	0.6662
BATTLE OF REBELS	2022-02-20	2	6	1	3	0.6662
Basketing	2022-06-09	5	6	1	6	0.6662
MP5	2022-07-18	2	6	1	3	0.6662
Paper Glider	2022-01-17	2	6	1	3	0.6662
Professor Crackbrain - And the awakening of the weredog	2022-12-02	4	6	1	5	0.6662
Two against the Legion	2022-03-06	5	6	1	6	0.6662
NARGUL - Humans are among us	2022-04-30	2	6	1	3	0.6662
Dreamlands	2022-09-16	3	6	1	4	0.6662
Fractured	2022-04-15	3	6	1	4	0.6662
Park Rangers of The Undead	2022-10-26	2	6	1	3	0.6662
Solo Flight	2022-01-21	1	6	1	2	0.6662
The Lonely Helmet	2022-06-08	3	6	1	4	0.6662
Crusade of Deitra	2022-08-06	3	6	1	4	0.6662
Let It Slide	2022-02-04	4	6	1	5	0.6662
University stories	2022-07-21	3	6	1	4	0.6662
Dungeon Masters	2022-01-13	3	6	1	4	0.6662
Asteroides	2022-01-11	2	6	1	3	0.6662
Aberration	2022-01-17	2	6	1	3	0.6662
XO Evolved	2022-01-26	4	6	1	5	0.6662
Legacy of Aeroja	2022-03-04	2	6	1	3	0.6662
Microbrewery Tycoon	2022-08-13	4	6	1	5	0.6662
Monkey Barrels	2022-09-26	3	6	1	4	0.6662
Aim God	2022-06-06	3	6	1	4	0.6662
Our Battle Has Just Begun! episode 2	2022-03-02	2	6	1	3	0.6662
Shinogi Chess Club	2022-05-31	3	6	1	4	0.6662
Dungeon Maker	2022-01-07	6	6	1	7	0.6662
Untitled Survival Game	2022-06-30	5	6	1	6	0.6662
消失的纪元	2022-01-22	1	6	1	2	0.6662
Drop one NPC to another	2022-01-21	2	6	1	3	0.6662
Shajra Namla	2022-02-27	3	6	1	4	0.6662
Siienaa	2022-03-18	2	6	1	3	0.6662
Rolling Valley	2022-02-16	3	6	1	4	0.6662
Crown Claimer	2022-01-23	4	6	1	5	0.6662
EVERING	2022-05-05	3	6	1	4	0.6662
Lo-Fi: THEXNERXXM	2022-03-18	1	6	1	2	0.6662
No Way Up	2022-06-12	2	6	1	3	0.6662
Maze Twister	2022-03-01	2	6	1	3	0.6662
Mupple	2022-02-18	3	6	1	4	0.6662
The Hepatica Spring	2022-02-28	3	6	1	4	0.6662
11 Islands 2: Story of Love	2022-02-24	3	6	1	4	0.6662
Coral Drive	2022-03-10	3	6	1	4	0.6662
Sexy Furry	2022-07-17	3	6	1	4	0.6662
Bombardier	2022-07-22	4	6	1	5	0.6662
Henshinko!	2022-06-24	3	6	1	4	0.6662
Cards of the Dreaming Dragons	2022-07-08	5	6	1	6	0.6662
Desaturation Point	2022-04-28	3	6	1	4	0.6662
Harmony Overture	2022-05-17	2	6	1	3	0.6662
Saimai Rd	2022-04-18	2	6	1	3	0.6662
FITRIZ	2022-07-28	2	6	1	3	0.6662
Farmer's slow life	2022-05-07	3	6	1	4	0.6662
GAMEDOG	2022-04-08	2	6	1	3	0.6662
Destoria: The Withering	2022-08-10	4	6	1	5	0.6662
MEARTH	2022-04-21	2	6	1	3	0.6662
Our Fate Forsaken	2022-05-20	4	6	1	5	0.6662
Damien Crawford's Golf Experience 2022	2022-04-26	2	6	1	3	0.6662
Portobugia	2022-11-23	4	6	1	5	0.6662
Friendly Blonding	2022-09-29	7	6	1	8	0.6662
Vintage Records from Hell	2022-10-31	4	6	1	5	0.6662
미니언 슬레이어	2022-05-21	6	6	1	7	0.6662
Pixel Gangsters	2022-11-14	5	6	1	6	0.6662
Mad Bullz	2022-06-01	2	6	1	3	0.6662
Not Your Mama's Autobattler	2022-10-11	2	6	1	3	0.6662
Cazzarion: Demon Hunting	2022-06-09	1	6	1	2	0.6662
Pizza Delivery Bagel	2022-07-29	2	6	1	3	0.6662
Bulletkour	2022-08-03	3	6	1	4	0.6662
PUT PUD Nudli's Adventure	2022-05-27	3	6	1	4	0.6662
Operation Defensive!	2022-06-01	3	6	1	4	0.6662
Dreamland	2022-06-29	2	6	1	3	0.6662
VR Aventura Antartica	2022-07-14	2	6	1	3	0.6662
Dick Ranger	2022-07-22	3	6	1	4	0.6662
Kawaii Hentai Sexy Girls	2022-07-11	3	6	1	4	0.6662
Endless Nightmare	2022-09-29	7	6	1	8	0.6662
Wits of Gods - Prologue	2022-09-01	9	6	1	10	0.6662
Cooper's Cleanup	2022-08-20	3	6	1	4	0.6662
69 Natasha Hot	2022-08-16	3	6	1	4	0.6662
Hive	2022-09-14	2	6	1	3	0.6662
Light	2022-08-19	2	6	1	3	0.6662
Furry Femmes: Making an Obedient Bitch	2022-12-15	4	6	1	5	0.6662
The Past Rhapsody	2022-08-05	3	6	1	4	0.6662
Magnet Block	2022-11-11	8	6	1	9	0.6662
NEAVE 2	2022-08-08	5	6	1	6	0.6662
Shattered Star	2022-10-02	3	6	1	4	0.6662
Snow Problem	2022-10-07	3	6	1	4	0.6662
Street & Girls	2022-08-30	2	6	1	3	0.6662
Fighter X Fighter	2022-08-12	3	6	1	4	0.6662
Rainbow Heights Academy: Year 1	2022-11-11	2	6	1	3	0.6662
Hentai Fantasy World	2022-11-30	2	6	1	3	0.6662
PUTIN IN JAIL	2022-08-25	2	6	1	3	0.6662
The First Step	2022-09-21	3	6	1	4	0.6662
Across The Globe	2022-09-01	4	6	1	5	0.6662
Zimmer	2022-09-12	3	6	1	4	0.6662
Noracam's Slider Challenge	2022-09-09	6	6	1	7	0.6662
Murders at Tealwoods Manor	2022-09-14	3	6	1	4	0.6662
Waste Life 1 消耗阳寿1	2022-09-28	2	6	1	3	0.6662
Night Light	2022-10-10	3	6	1	4	0.6662
西部幻想 West Fantasy	2022-09-30	4	6	1	5	0.6662
Missing Pictures : Naomi Kawase	2022-12-01	2	6	1	3	0.6662
Tiny Detour	2022-12-09	1	6	1	2	0.6662
Drive West Coast	2022-11-07	2	6	1	3	0.6662
Waifu Museum	2022-11-03	2	6	1	3	0.6662
PESTICIDE	2022-11-11	2	6	1	3	0.6662
Sexy Elf	2022-11-22	1	6	1	2	0.6662
Combine And Conquer	2022-12-27	5	6	1	6	0.6662
Time Thief	2022-12-28	2	6	1	3	0.6662
Isles of Yore	2022-02-10	77	77	30	107	0.6659999999999999
Last Farewell	2022-04-19	22	56	21	43	0.6659999999999999
Car Parking Simulator VR	2022-01-07	5	32	11	16	0.6659999999999999
Fractal Fly	2022-02-10	13	63	24	37	0.6659
Ready Action	2022-04-21	70	63	24	94	0.6659
STAR OCEAN THE DIVINE FORCE	2022-10-27	4420	1065	487	4907	0.6658
Tile Tale	2022-06-18	13	27	9	22	0.6657
Zombie Shooting Star: ARCADE	2022-12-01	8	27	9	17	0.6657
Demolition race	2022-09-09	4	22	7	11	0.6657
Everything Has Arms	2022-08-09	17	22	7	24	0.6657
My Sugar Mommy is a Futanari	2022-09-15	4	22	7	11	0.6657
Five Nights At Furry's	2022-11-04	6	22	7	13	0.6657
Words Can Kill	2022-09-29	49	44	16	65	0.6656000000000001
Discord Rich Me!	2022-09-13	19	120	49	68	0.6653
Climber: Sky is the Limit	2022-11-21	197	79	31	228	0.6653
Line Strike	2022-02-02	112	149	62	174	0.6651
End State	2022-12-01	68	65	25	93	0.6651
theBlu	2022-12-28	143	65	25	168	0.6651
Kronos: Titan of Time	2022-05-19	26	39	14	40	0.6648999999999999
Rescue Party: Live!	2022-01-13	144	124	51	195	0.6646
Senpai and the Mysterious Dungeon	2022-09-30	44	34	12	56	0.6641
CounterSide	2022-09-01	5199	1708	801	6000	0.6636
TEST RE	2022-04-29	13	69	27	40	0.6636
Gray Zone	2022-12-16	18	41	15	33	0.6634000000000001
The Sword of Rhivenia	2022-07-07	130	41	15	145	0.6634000000000001
Ragnarok: Fallen Legends	2022-12-15	29	41	15	44	0.6634000000000001
BrawlQuest	2022-06-28	9	62	24	33	0.6633
Mython Island	2022-05-12	9	29	10	19	0.6633
暗黑的克蘿薇	2022-01-06	10	29	10	20	0.6633
DYMENSION Prologue:Scary Horror Survival Shooter	2022-02-03	12	29	10	22	0.6633
Idle Hamburgers Save the World	2022-11-11	14	29	10	24	0.6633
Supernova Tactics	2022-08-01	16	14	4	20	0.6633
Thalamus	2022-04-29	5	14	4	9	0.6633
Shadowgate VR: The Mines of Mythrok	2022-06-17	5	14	4	9	0.6633
月夜赞歌 Melody in the moonlight	2022-02-11	6	14	4	10	0.6633
Furry Girlfriend Simulator	2022-02-05	3	14	4	7	0.6633
Lord of the Click 3	2022-09-23	8	14	4	12	0.6633
Love and Guillotines	2022-03-27	3	14	4	7	0.6633
Hidden Harbor Top-Down 3D	2022-04-13	3	14	4	7	0.6633
Rue la résistance	2022-06-15	4	14	4	8	0.6633
Scared Tube	2022-11-17	4	14	4	8	0.6633
Rich Taste of Ecchi	2022-06-17	2	14	4	6	0.6633
Agile firefighter	2022-07-23	3	14	4	7	0.6633
Moto Pizza Courier	2022-11-25	2	14	4	6	0.6633
Moto Offroad Simulator	2022-11-30	3	14	4	7	0.6633
Cosplay Fever!!	2022-12-06	12	14	4	16	0.6633
Car Parking	2022-11-17	4	14	4	8	0.6633
Beholder 3	2022-03-03	1023	990	458	1481	0.6631999999999999
Absolute Tactics: Daughters of Mercy	2022-09-15	102	78	31	133	0.6631999999999999
Gordon Streaman 2	2022-02-07	13	48	18	31	0.6631999999999999
Denos City: Complete Game	2022-05-05	77	71	28	105	0.6629
Chinese Driving Test Simulator	2022-01-01	96	353	157	253	0.6628000000000001
Cafe Owner Simulator	2022-12-05	533	254	111	644	0.6628000000000001
Camp Canyonwood	2022-08-04	43	24	8	51	0.6627
Leman	2022-04-01	8	24	8	16	0.6627
I AM BUTTER VR	2022-05-18	6	24	8	14	0.6627
Contrablade: Stadium Rush	2022-03-30	4	24	8	12	0.6627
Deadwater Saloon	2022-09-13	405	127	53	458	0.6626000000000001
Last Wood	2022-01-27	356	376	168	524	0.6625
Gaze Into Fate	2022-11-29	5	19	6	11	0.6625
Retired Hero Gets Slaves	2022-12-01	17	19	6	23	0.6625
Metal Max Xeno Reborn	2022-06-10	445	208	90	535	0.6624
Invention 3	2022-01-24	6	36	13	19	0.6624
Pls Kill it.	2022-03-16	14	36	13	27	0.6624
LEZ	2022-05-27	21	43	16	37	0.6620999999999999
Trigon: Space Story	2022-04-28	1701	752	347	2048	0.6619
Beneath the Mountain	2022-09-27	137	102	42	179	0.6618
Ancient Gods	2022-08-04	214	183	79	293	0.6614
Project Wunderwaffe: Prologue	2022-08-03	219	183	79	298	0.6614
TowersRTS	2022-03-04	11	31	11	22	0.6614
Tep The Destroyer	2022-07-09	8	31	11	19	0.6614
神徒	2022-01-21	7	31	11	18	0.6614
Colonize Prologue	2022-05-25	475	286	127	602	0.6611
Survivor Of The Journey	2022-08-12	52	52	20	72	0.6611
Lust from Beyond: M Edition	2022-02-10	65	139	59	124	0.6609999999999999
Stones Keeper	2022-09-15	50	45	17	67	0.6609
Grimace Run	2022-03-07	15	38	14	29	0.6609
Nirvana Game Of Life	2022-01-02	27	38	14	41	0.6609
Psycho Reign	2022-10-06	9	38	14	23	0.6609
Victoria 3	2022-10-25	70100	19772	9816	79916	0.6607
Zombie Shooting Star	2022-07-23	35	108	45	80	0.6607
Liberté	2022-02-15	44	79	32	76	0.6606000000000001
Gamer Girls: Dating Sim	2022-05-14	342	70	28	370	0.6606000000000001
Skeleton Crew	2022-06-16	33	26	9	42	0.6603
Clash II	2022-10-28	19	26	9	28	0.6603
Bjorn	2022-06-03	5	26	9	14	0.6603
Hot Cleopatra	2022-10-14	8	26	9	17	0.6603
Dream Cycle	2022-08-08	64	158	68	132	0.6602
Runeverse	2022-12-23	19	40	15	34	0.6596
World of Talesworth: Idle MMO Simulator	2022-08-18	1894	194	85	1979	0.6595000000000001
Far Lands	2022-04-22	31	56	22	53	0.6595000000000001
VRUSEUM	2022-03-11	14	56	22	36	0.6595000000000001
Assault Bots	2022-04-16	56	74	30	86	0.6594
Fury Fight	2022-04-13	6	21	7	13	0.6593000000000001
Cave Guessers	2022-10-07	50	21	7	57	0.6593000000000001
Timothy and the Tower of Mu	2022-08-09	11	21	7	18	0.6593000000000001
The Curse Of Mantras	2022-03-14	20	11	3	23	0.6593000000000001
Unbinary	2022-02-17	3	11	3	6	0.6593000000000001
Enionax	2022-09-28	4	11	3	7	0.6593000000000001
Pleim	2022-06-14	3	11	3	6	0.6593000000000001
Gravity Game	2022-01-22	53	11	3	56	0.6593000000000001
MARY	2022-02-11	5	11	3	8	0.6593000000000001
Aoihana	2022-04-05	2	11	3	5	0.6593000000000001
MissPedaling Simulator	2022-03-27	4	11	3	7	0.6593000000000001
The Jelly Adventure	2022-04-28	2	11	3	5	0.6593000000000001
Asmodeus's Hell: Devil in the Sunshine State	2022-11-18	3	11	3	6	0.6593000000000001
My NAUGHTY Shotgun	2022-04-12	3	11	3	6	0.6593000000000001
Bear Adventure	2022-04-25	3	11	3	6	0.6593000000000001
Tearstone: Thieves of the Heart	2022-05-05	4	11	3	7	0.6593000000000001
Heart of Battle	2022-08-18	34	11	3	37	0.6593000000000001
2Week:DeathWorld	2022-05-03	12	11	3	15	0.6593000000000001
Long Journey	2022-05-13	2	11	3	5	0.6593000000000001
CowboysShowdown	2022-05-25	3	11	3	6	0.6593000000000001
Uligo: A Slime's Hike	2022-05-13	5	11	3	8	0.6593000000000001
GunBoxing	2022-05-11	4	11	3	7	0.6593000000000001
Mortmentum	2022-06-01	5	11	3	8	0.6593000000000001
Monkey Adventure	2022-05-24	6	11	3	9	0.6593000000000001
StarMech	2022-08-01	14	11	3	17	0.6593000000000001
Smokyflex	2022-07-11	2	11	3	5	0.6593000000000001
Sakura Gym Girls	2022-12-19	8	11	3	11	0.6593000000000001
DUCK Mission	2022-06-25	2	11	3	5	0.6593000000000001
Red Hood Adventure	2022-08-10	5	11	3	8	0.6593000000000001
Invader Signal	2022-08-10	3	11	3	6	0.6593000000000001
Road Draftsman	2022-07-27	4	11	3	7	0.6593000000000001
Obedient Servant	2022-09-19	4	11	3	7	0.6593000000000001
Horror Girls	2022-08-27	3	11	3	6	0.6593000000000001
8 Ball 2	2022-10-07	7	11	3	10	0.6593000000000001
CHAQS	2022-11-01	5	11	3	8	0.6593000000000001
Cocktail Rush	2022-11-09	3	11	3	6	0.6593000000000001
Call of the Abyss	2022-12-22	14	11	3	17	0.6593000000000001
Longvinter	2022-02-24	1441	2550	1235	2676	0.6592
Arcane Waters	2022-11-14	218	109	46	264	0.6587999999999999
KnightOut	2022-06-03	8	16	5	13	0.6586
Smooth Operators 2	2022-09-22	14	16	5	19	0.6586
Golf Pool VR	2022-07-19	6	16	5	11	0.6586
Cannon Jump	2022-12-12	5	16	5	10	0.6586
69 Summon Succubus	2022-05-18	5	16	5	10	0.6586
Skelton	2022-01-31	3	16	5	8	0.6586
Tower Words	2022-04-08	4	16	5	9	0.6586
HyperPortals	2022-03-17	4	16	5	9	0.6586
Gasnator	2022-05-01	4	16	5	9	0.6586
AstraX	2022-05-25	7	16	5	12	0.6586
Faraway	2022-07-15	8	16	5	13	0.6586
Beyond The Wire	2022-08-31	2312	4592	2258	4570	0.6584000000000001
Bug Dolls: Soviet Project	2022-08-02	5	28	10	15	0.6581999999999999
The Tarnishing of Juxtia	2022-07-26	275	256	115	390	0.658
Bikini Armour Explorers	2022-02-05	138	84	35	173	0.6572
无限投影	2022-11-08	401	136	59	460	0.6570999999999999
幻想三国志	2022-01-09	295	189	84	379	0.6568
Pizza Ghest	2022-01-21	5	23	8	13	0.6567000000000001
Quest room	2022-10-21	10	23	8	18	0.6567000000000001
iles	2022-08-19	19	23	8	27	0.6567000000000001
LEMURIA	2022-05-10	11	30	11	22	0.6565000000000001
Barista: Take Away	2022-07-07	11	30	11	22	0.6565000000000001
Divine Knockout (DKO)	2022-12-06	12491	3516	1741	14232	0.6559999999999999
Food Truck Simulator	2022-09-14	1115	599	283	1398	0.6559
NFL Pro Era	2022-12-23	53	79	33	86	0.6559
Art of Destruction	2022-02-15	6	39	15	21	0.6557
Meat Madness	2022-11-24	6	39	15	21	0.6557
Trolley Problem, Inc.	2022-04-21	150	542	256	406	0.6552
RWBY: Arrowfell	2022-11-16	140	96	41	181	0.6552
SENSEs: Midnight	2022-07-22	10	18	6	16	0.6551
Malyshka	2022-02-09	4	18	6	10	0.6551
Spy Rumble	2022-06-23	74	18	6	80	0.6551
Outmode	2022-06-22	7	18	6	13	0.6551
The Nightmare Inside	2022-04-01	5	18	6	11	0.6551
Into The Underdusk	2022-05-03	6	18	6	12	0.6551
The Meaning	2022-10-22	4	18	6	10	0.6551
Avocado Puzzle Quest	2022-07-26	3	18	6	9	0.6551
Among Ass: Trilogy	2022-08-26	4	18	6	10	0.6551
Amnesia	2022-01-14	427	388	181	608	0.655
Roller Champions™	2022-12-13	141	164	73	214	0.655
My Ass Pass to Succubus Sexland!	2022-05-20	19	32	12	31	0.655
The Feast	2022-12-15	116	289	133	249	0.6548999999999999
Devil's Deck 恶魔秘境	2022-03-24	108	187	84	192	0.6548999999999999
Glory of Rome	2022-01-07	7	25	9	16	0.6546
Traffic City	2022-02-18	6	25	9	15	0.6546
HyperLeague Heroes	2022-11-10	55	25	9	64	0.6546
Tour de France 2022	2022-06-09	313	87	37	350	0.6545000000000001
Party Maker	2022-10-24	52	63	26	78	0.6542
The Godkiller - Chapter 1	2022-01-01	6	8	2	8	0.6542
BrightSeeker	2022-09-30	4	8	2	6	0.6542
TravelRacer	2022-02-18	3	8	2	5	0.6542
Martin and the Magic Staff	2022-12-13	2	8	2	4	0.6542
Kung Fu Er San	2022-07-13	3	8	2	5	0.6542
Life is Paine	2022-02-01	3	8	2	5	0.6542
ProBee	2022-07-22	8	8	2	10	0.6542
Guntech 2	2022-02-16	3	8	2	5	0.6542
Desolate Shores	2022-05-12	3	8	2	5	0.6542
Rick and Josh adventures	2022-04-29	2	8	2	4	0.6542
Plunder Dungeons	2022-06-17	3	8	2	5	0.6542
棋物语 Stick Go story	2022-06-09	2	8	2	4	0.6542
Skeletons VS Nadia	2022-06-07	3	8	2	5	0.6542
Space Shells	2022-12-06	3	8	2	5	0.6542
Lofi Ball	2022-06-09	5	8	2	7	0.6542
TITS OKAY TITS FINE MILKSHAKE	2022-07-05	3	8	2	5	0.6542
Mine Seeker	2022-08-07	3	8	2	5	0.6542
The Lobster Game	2022-06-21	2	8	2	4	0.6542
言++	2022-10-08	3	8	2	5	0.6542
Spiderbro	2022-07-04	3	8	2	5	0.6542
Disc Golf Online	2022-10-19	7	8	2	9	0.6542
Pest Control	2022-09-01	3	8	2	5	0.6542
Picot Ether	2022-08-26	11	8	2	13	0.6542
Belt Colony	2022-09-09	9	8	2	11	0.6542
Streamer Future Wars	2022-10-03	6	8	2	8	0.6542
Ice Cream Killer	2022-09-12	7	8	2	9	0.6542
Everest Truck Simulator	2022-11-06	1	8	2	3	0.6542
Pixel chan	2022-10-05	3	8	2	5	0.6542
Pastel Putter	2022-10-21	3	8	2	5	0.6542
Rhythm Any Music	2022-10-03	2	8	2	4	0.6542
The Story of Barker	2022-10-15	4	8	2	6	0.6542
Idle Shapes	2022-11-23	16	8	2	18	0.6542
Ranger Quest: The Adventure Begins	2022-12-20	4	8	2	6	0.6542
Oddworld: Soulstorm Enhanced Edition	2022-06-21	136	182	82	218	0.6541
Entodrive	2022-02-15	3	13	4	7	0.6537999999999999
Scary Buddies	2022-07-08	8	13	4	12	0.6537999999999999
Meet Cute: Delivery	2022-06-11	5	13	4	9	0.6537999999999999
Directly Drink Milk from Cow	2022-03-30	6	13	4	10	0.6537999999999999
Batho[tel]	2022-06-16	2	13	4	6	0.6537999999999999
Cows&Co	2022-07-08	3	13	4	7	0.6537999999999999
Restaurant Manager Simulator	2022-08-12	3	13	4	7	0.6537999999999999
刻一刻ト浦	2022-08-19	7	13	4	11	0.6537999999999999
Hidden Cube World Top-Down 3D	2022-08-18	3	13	4	7	0.6537999999999999
FEATHERED RUN	2022-10-20	2	13	4	6	0.6537999999999999
Digit Factory	2022-11-04	6	13	4	10	0.6537999999999999
Reality Noclip: The Backrooms	2022-10-31	3	13	4	7	0.6537999999999999
Computer Cats	2022-11-29	4	13	4	8	0.6537999999999999
King Smash	2022-11-19	2	13	4	6	0.6537999999999999
Doggerfall	2022-12-10	4	13	4	8	0.6537999999999999
Read Clock Time	2022-12-27	5	13	4	9	0.6537999999999999
Egghead Gumpty	2022-09-04	10	34	13	23	0.6537000000000001
Fire Commander	2022-07-27	269	169	76	345	0.6536
Mantra	2022-10-23	12	54	22	34	0.6536
再刷一把 PlayAgain	2022-07-21	12812	2880	1439	14251	0.6534000000000001
Empire of Ember	2022-01-20	60	97	42	102	0.6531
EDENGATE: The Edge of Life	2022-11-15	36	56	23	59	0.653
​Triple Fantasy	2022-08-22	114	56	23	137	0.653
Orph - The Lost Boy	2022-05-16	7	27	10	17	0.6529
The Last Job	2022-12-07	67	164	74	141	0.6527
Starcube MMO	2022-08-16	9	36	14	23	0.6526000000000001
Deadly Flare	2022-03-11	33	86	37	70	0.6525
TV189	2022-08-07	3	20	7	10	0.6525
Underground Life	2022-04-19	7	20	7	14	0.6525
Bunker 2322	2022-04-20	2	20	7	9	0.6525
CORGI	2022-05-29	4	20	7	11	0.6525
Soul Hackers 2	2022-08-26	5692	1514	750	6442	0.6522
Project Xandata	2022-03-22	233	90	39	272	0.652
SEX & DRIFT	2022-12-15	98	90	39	137	0.652
雀皇麻雀	2022-11-11	44	109	48	92	0.6519
Inside Jennifer - Season 1	2022-10-02	339	241	112	451	0.6515000000000001
ZooKeeper	2022-08-18	34	29	11	45	0.6514
Tournament of Beans	2022-04-18	14	29	11	25	0.6514
AI: Art Impostor	2022-11-03	793	208	96	889	0.6513
Chimeraland	2022-07-14	2264	1398	695	2959	0.6511
Expedition Agartha	2022-08-18	996	630	306	1302	0.6509999999999999
幸运麻将	2022-08-19	103	285	134	237	0.6509
杀戮地城 Dungeon Adventure	2022-03-03	174	125	56	230	0.6508
Life after Death	2022-09-29	14	66	28	42	0.6508
Exotica: Petshop Simulator	2022-10-01	17	40	16	33	0.6508
LONN	2022-11-17	21	83	36	57	0.6507
Gamer Girls: Futanari	2022-08-27	316	53	22	338	0.6506000000000001
Hostile Planet: Survival	2022-05-12	8	68	29	37	0.6505
Escape from the 70's	2022-05-11	6	22	8	14	0.6503
Coding Learn	2022-07-13	5	22	8	13	0.6503
Voice of Cards: The Forsaken Maiden	2022-02-17	212	110	49	261	0.6502
Horny Sakura	2022-02-16	14	31	12	26	0.6502
MODERN NAVAL COMBAT	2022-12-02	26	42	17	43	0.6501
Tales of Tomorrow: Experiment	2022-09-23	17	15	5	22	0.65
Right Way	2022-04-01	6	15	5	11	0.65
Those Who Came: Healing Solarus	2022-08-30	9	15	5	14	0.65
COTTOn 2 - Saturn Tribute	2022-02-09	4	15	5	9	0.65
Finger Football	2022-02-17	4	15	5	9	0.65
Disinfection	2022-06-01	13	15	5	18	0.65
Blade Jumper	2022-09-09	5	15	5	10	0.65
The Devil's Chosen	2022-06-17	3	15	5	8	0.65
Underwater World - Idle Desktop Colony Building Simulator	2022-09-09	4	15	5	9	0.65
A Clumsy Flight	2022-08-23	37	44	18	55	0.6494
World Boss	2022-10-19	1378	1443	725	2103	0.6492
Hollow's Land	2022-01-13	1041	128	58	1099	0.6492
Holy Purge	2022-02-16	27	130	59	86	0.6491
黑白棋：昼夜纷争/Othello：Daynight Time Clash	2022-06-14	22	84	37	59	0.6485
Warhammer 40,000: Battle Sister	2022-03-08	56	239	113	169	0.6484000000000001
Koumajou Remilia: Scarlet Symphony	2022-07-28	128	170	79	207	0.6481
Rogue System	2022-06-10	26	174	81	107	0.648
Numbers and Letters VR	2022-10-06	2	5	1	3	0.6478
The Inn Between: Prologue	2022-05-09	4	5	1	5	0.6478
The Shepherd	2022-03-22	2	5	1	3	0.6478
Rangers	2022-06-28	6	5	1	7	0.6478
Legendary BOXING Belt	2022-04-30	2	5	1	3	0.6478
Demon Purge Saga	2022-02-19	1	5	1	2	0.6478
Super Donald World 2024	2022-07-08	2	5	1	3	0.6478
Shuzzler	2022-01-20	2	5	1	3	0.6478
HangOutGame	2022-06-27	4	5	1	5	0.6478
BouncyBoi in Puzzle Land	2022-03-24	2	5	1	3	0.6478
Gladihaters	2022-02-21	2	5	1	3	0.6478
ScreamCap	2022-05-13	1	5	1	2	0.6478
WishWorld	2022-05-11	4	5	1	5	0.6478
Blipz	2022-02-10	3	5	1	4	0.6478
Last Shape Standing	2022-12-15	3	5	1	4	0.6478
Grim Tranquility	2022-06-01	6	5	1	7	0.6478
Timewreck Tales	2022-11-07	5	5	1	6	0.6478
Ghost Terminator	2022-09-20	2	5	1	3	0.6478
Idiot Brain Evolution	2022-01-10	36	5	1	37	0.6478
Jousting VR	2022-10-25	3	5	1	4	0.6478
Mine Upgrade	2022-11-17	7	5	1	8	0.6478
Cosmo Player Z	2022-03-18	7	5	1	8	0.6478
Mandala	2022-03-11	2	5	1	3	0.6478
Argonauts Agency: Chair of Hephaestus	2022-01-24	7	5	1	8	0.6478
Panda Punch	2022-12-16	3	5	1	4	0.6478
Carrier Command	2022-12-24	3	5	1	4	0.6478
神将●华容道	2022-01-16	11	5	1	12	0.6478
this House	2022-06-30	1	5	1	2	0.6478
7 Days To Save The World	2022-02-14	3	5	1	4	0.6478
与我签订契约，成为救世勇者吧！	2022-10-15	4	5	1	5	0.6478
Last Bastion	2022-01-07	3	5	1	4	0.6478
超越海盗	2022-01-01	3	5	1	4	0.6478
Game 78	2022-02-18	2	5	1	3	0.6478
The Living Handra	2022-01-07	2	5	1	3	0.6478
[Tongue kissing Specialization] My girlfriend's here for a visit.	2022-02-25	2	5	1	3	0.6478
Tuktuk	2022-04-15	3	5	1	4	0.6478
Magic City Detective: Wings Of Revenge Collector's Edition	2022-02-05	6	5	1	7	0.6478
FitStrike	2022-01-18	2	5	1	3	0.6478
Sabbuth	2022-02-07	2	5	1	3	0.6478
Rorys Restaurant Origins	2022-01-26	5	5	1	6	0.6478
Shrine of Tails	2022-11-04	2	5	1	3	0.6478
My Destiny	2022-08-11	1	5	1	2	0.6478
Detective Max - Double Clues	2022-06-23	2	5	1	3	0.6478
Comixxx Flirtatious	2022-02-12	1	5	1	2	0.6478
The Sinking Structure, Clione, and Lost Child -Log3	2022-03-09	3	5	1	4	0.6478
The Chronicles of Hercules II - Wrath of Kronos	2022-02-21	4	5	1	5	0.6478
THE NEW CHRONICLES OF NOAH'S ARK	2022-03-08	5	5	1	6	0.6478
HYDE	2022-03-07	3	5	1	4	0.6478
最適解 Saitekikai Spy Simulator	2022-05-08	2	5	1	3	0.6478
Maneater and the Golden Teacher	2022-05-10	2	5	1	3	0.6478
Popplings	2022-05-26	3	5	1	4	0.6478
Story of You: The Allied Kingdoms	2022-03-06	1	5	1	2	0.6478
Ghosts of Hollow Creek	2022-06-21	3	5	1	4	0.6478
R'lyeh	2022-12-01	3	5	1	4	0.6478
Big Tower Tiny Square 2	2022-03-17	3	5	1	4	0.6478
My student loves me!	2022-06-29	3	5	1	4	0.6478
Dragon's Dilemma	2022-07-01	3	5	1	4	0.6478
Raccoon Tales	2022-05-16	2	5	1	3	0.6478
ME_iON	2022-04-28	3	5	1	4	0.6478
RoastTogether	2022-06-03	4	5	1	5	0.6478
Space Survival	2022-05-15	2	5	1	3	0.6478
Ante Mortem	2022-05-31	4	5	1	5	0.6478
369	2022-06-13	2	5	1	3	0.6478
CAT GAME🐱	2022-06-21	2	5	1	3	0.6478
Memory Hunters	2022-11-08	4	5	1	5	0.6478
血色病院 | Blood Hospital	2022-09-09	3	5	1	4	0.6478
Ghost Doll	2022-10-15	2	5	1	3	0.6478
WOE	2022-10-20	3	5	1	4	0.6478
DnD Adventure: Rogue's Choice	2022-10-10	8	5	1	9	0.6478
Dimwarper	2022-09-15	2	5	1	3	0.6478
Brigadoon	2022-07-06	3	5	1	4	0.6478
Quadrobat	2022-07-07	5	5	1	6	0.6478
Underway	2022-08-09	3	5	1	4	0.6478
Timmy Types	2022-09-05	5	5	1	6	0.6478
Aim Trainer X	2022-08-09	4	5	1	5	0.6478
Maze Of The Gamja	2022-07-27	2	5	1	3	0.6478
Ashen Will	2022-08-09	2	5	1	3	0.6478
MYAOSOFT GAMES COLLECTION	2022-08-14	6	5	1	7	0.6478
Coffee Break: A sip away from doom	2022-08-12	4	5	1	5	0.6478
NONOGRAM - KAWAII CUTIES	2022-08-18	3	5	1	4	0.6478
异界双子 -Twin Souls-	2022-10-14	3	5	1	4	0.6478
NOTALONE	2022-10-26	2	5	1	3	0.6478
The Imaginary Circle	2022-09-23	1	5	1	2	0.6478
POP SURVIVOR	2022-09-14	2	5	1	3	0.6478
My Dear Sister	2022-08-24	5	5	1	6	0.6478
Talon City: Death from Above	2022-11-03	5	5	1	6	0.6478
モノマギア	2022-09-12	4	5	1	5	0.6478
Blockpop Heroes	2022-10-10	2	5	1	3	0.6478
ClearIt 13	2022-09-09	6	5	1	7	0.6478
Poly Parkour	2022-11-03	2	5	1	3	0.6478
Shooting Waltz	2022-09-14	3	5	1	4	0.6478
Pregnant Ogre	2022-12-22	8	5	1	9	0.6478
MITTIN	2022-10-12	5	5	1	6	0.6478
The Night Of The Penanggalan	2022-11-12	2	5	1	3	0.6478
MindHunt	2022-11-14	13	5	1	14	0.6478
Spinout Drifter	2022-12-07	2	5	1	3	0.6478
Nightmare	2022-10-21	2	5	1	3	0.6478
Hexa Rhythm	2022-12-16	2	5	1	3	0.6478
Mission In Space	2022-10-20	3	5	1	4	0.6478
Missing Pictures : Catherine Hardwicke	2022-12-01	2	5	1	3	0.6478
KICK MASTER	2022-11-01	2	5	1	3	0.6478
Perfect Inventory	2022-10-27	4	5	1	5	0.6478
勇者被委託幹掉可惡的魔王，卻發現魔王有五個！？	2022-11-10	3	5	1	4	0.6478
Minesweeper Arcade	2022-11-04	4	5	1	5	0.6478
CHARGED: RC Racing	2022-11-08	2	5	1	3	0.6478
What A Ball	2022-12-12	2	5	1	3	0.6478
laf the game.	2022-11-17	2	5	1	3	0.6478
Rocket Escape	2022-12-02	2	5	1	3	0.6478
GODDESS OF VICTORY	2022-11-29	3	5	1	4	0.6478
VataZombie	2022-12-09	2	5	1	3	0.6478
Disavowed	2022-12-16	5	5	1	6	0.6478
Your Otherworldly Harem	2022-12-08	5	5	1	6	0.6478
Chorus of the Night	2022-12-27	2	5	1	3	0.6478
Rounds of Zombies	2022-08-11	44	94	42	86	0.6476999999999999
Blackout Rugby	2022-07-15	26	69	30	56	0.6476999999999999
Frenzy VR	2022-07-29	23	96	43	66	0.6476000000000001
Shadow Madness	2022-02-15	5	10	3	8	0.6476000000000001
OneForAll	2022-02-02	4	10	3	7	0.6476000000000001
Roads Of Rome: Portals Collector's Edition	2022-01-24	31	10	3	34	0.6476000000000001
Mortals and Monsters: Blood Orc	2022-02-06	3	10	3	6	0.6476000000000001
KaRu	2022-10-31	4	10	3	7	0.6476000000000001
Save the bear cubs	2022-02-23	2	10	3	5	0.6476000000000001
drowning	2022-02-16	8	10	3	11	0.6476000000000001
Note Brawl	2022-03-18	7	10	3	10	0.6476000000000001
Foreign Galaxies	2022-04-22	4	10	3	7	0.6476000000000001
Robovenger	2022-03-10	5	10	3	8	0.6476000000000001
ENDRR	2022-05-17	4	10	3	7	0.6476000000000001
Hanna Must Run	2022-03-17	4	10	3	7	0.6476000000000001
DownTheDead	2022-05-08	4	10	3	7	0.6476000000000001
Magic War	2022-05-25	3	10	3	6	0.6476000000000001
Forward Defense	2022-06-01	9	10	3	12	0.6476000000000001
Block Breaker 2	2022-05-18	3	10	3	6	0.6476000000000001
Delete Virus;	2022-07-22	4	10	3	7	0.6476000000000001
Soul Night	2022-05-29	2	10	3	5	0.6476000000000001
Desert Things	2022-06-15	6	10	3	9	0.6476000000000001
TOTO Quest	2022-06-28	4	10	3	7	0.6476000000000001
Storekeeper Revenge	2022-10-11	3	10	3	6	0.6476000000000001
Dark Jungle	2022-07-08	6	10	3	9	0.6476000000000001
Dr.Pumpkin	2022-07-26	3	10	3	6	0.6476000000000001
Master of the Tattooverse	2022-08-30	4	10	3	7	0.6476000000000001
Artifact	2022-09-15	15	10	3	18	0.6476000000000001
Tower Fall	2022-08-10	5	10	3	8	0.6476000000000001
The King's Castle	2022-09-28	4	10	3	7	0.6476000000000001
Click For Points	2022-10-25	13	10	3	16	0.6476000000000001
Run Blob Run 2	2022-10-22	2	10	3	5	0.6476000000000001
Joy Flight	2022-12-01	4	10	3	7	0.6476000000000001
Futapunk 2069	2022-12-28	5	10	3	8	0.6476000000000001
The Piano That Stops Time	2022-02-20	9	37	15	24	0.6475
Kingdom Draw	2022-08-02	14	37	15	29	0.6475
A Violent Revelry	2022-09-12	25	52	22	47	0.6474
PEP	2022-12-14	61	52	22	83	0.6474
Senpa.io	2022-07-22	101	26	10	111	0.6473000000000001
Aztech Forgotten Gods	2022-03-10	13	26	10	23	0.6473000000000001
Hyperglide	2022-05-23	8	26	10	18	0.6473000000000001
Twilight Wars: Declassified	2022-05-31	8	26	10	18	0.6473000000000001
Chernobyl Trap	2022-02-10	5	26	10	15	0.6473000000000001
FREAKFIELD 2042	2022-04-01	9	26	10	19	0.6473000000000001
Interitus	2022-05-21	5	26	10	15	0.6473000000000001
Krusenstern: A Stellar Sail	2022-11-15	12	26	10	22	0.6473000000000001
CODE:VALKYRIE II	2022-01-24	12	17	6	18	0.6473000000000001
Bangman	2022-01-30	3	17	6	9	0.6473000000000001
RUNNER RTX	2022-02-09	2	17	6	8	0.6473000000000001
Mechaguard	2022-02-21	3	17	6	9	0.6473000000000001
Case Files: The Death of Paulette Williams	2022-10-26	3	17	6	9	0.6473000000000001
Alice | 愛莉澄	2022-04-14	6	17	6	12	0.6473000000000001
Obscene Mansion	2022-12-19	7	17	6	13	0.6473000000000001
Eros Fantasy	2022-05-18	128	155	72	200	0.6472
KILLRUN	2022-08-25	88	108	49	137	0.647
Nobody - The Turnaround	2022-11-17	82511	8454	4437	86948	0.6468
Penelope's Odyssey	2022-04-04	7	39	16	23	0.6468
Jacktus Green: The fluffy, the spiky and the spicy	2022-07-21	9	39	16	25	0.6468
Criminal Dissidia	2022-09-28	158	85	38	196	0.6463
Spell Cast	2022-05-10	11	28	11	22	0.6462000000000001
夜詛YASO curse of soirée	2022-07-08	33	28	11	44	0.6462000000000001
The Anointed: David Saves Keilah	2022-09-22	12	28	11	23	0.6462000000000001
Race Day Rampage: Streamer Edition	2022-09-20	20	28	11	31	0.6462000000000001
OnlyFap Simulator 2 💦	2022-08-06	173	254	122	295	0.6461
Sakura Alien	2022-01-10	8	30	12	20	0.6452
ゆうしゃvsドラゴン	2022-07-09	50	19	7	57	0.6452
Magic Click	2022-08-27	8	19	7	15	0.6452
百将群英传	2022-09-09	85	131	61	146	0.6448999999999999
Mauled	2022-04-29	20	47	20	40	0.6448999999999999
Bad Way	2022-09-22	6	32	13	19	0.6444
Return the Backrooms	2022-11-11	32	82	37	69	0.6443000000000001
超级捕鱼	2022-02-25	161	88	40	201	0.6441
To the Top	2022-12-28	30	53	23	53	0.644
Zodiac fantasy	2022-07-21	54	96	44	98	0.6437999999999999
Kurukshetra: Ascension	2022-02-25	16	34	14	30	0.6437999999999999
Coal Mining Simulator: Prologue	2022-04-21	265	166	79	344	0.6437
garage:VAMP	2022-05-16	50	102	47	97	0.6437
Flight 74	2022-08-26	3	21	8	11	0.6436000000000001
The Lizartian	2022-05-27	9	21	8	17	0.6436000000000001
The Dead City	2022-10-14	6	21	8	14	0.6436000000000001
Treehouse Riddle	2022-08-18	9	12	4	13	0.6435
Kisekimura	2022-02-28	11	12	4	15	0.6435
Alchemistry	2022-03-07	8	12	4	12	0.6435
Cute Waifu	2022-05-17	3	12	4	7	0.6435
Police Hot Pursuit	2022-01-02	3	12	4	7	0.6435
Mon-Musu Quest	2022-04-29	7	12	4	11	0.6435
Dr. Science quest	2022-02-24	3	12	4	7	0.6435
Cosmopoly	2022-07-22	5	12	4	9	0.6435
Slime Dungeon	2022-05-29	2	12	4	6	0.6435
诸神陨落	2022-08-05	11	12	4	15	0.6435
Japanese TeTris	2022-07-29	5	12	4	9	0.6435
Heavy Works	2022-09-03	9	12	4	13	0.6435
BloodPit: Skelton II	2022-07-19	3	12	4	7	0.6435
AIdventure	2022-09-12	6	12	4	10	0.6435
Dragon Princess Anastasia	2022-04-22	5	23	9	14	0.6424
Shark Assault Simulator	2022-06-10	3	23	9	12	0.6424
Hentai Pussy 4	2022-09-02	3	23	9	12	0.6424
The Billion Clicker	2022-09-23	14	23	9	23	0.6424
Capcom Arcade 2nd Stadium	2022-07-22	463928	270	133	464061	0.6421
Half-Life: VR Mod	2022-10-20	31	121	57	88	0.6421
Shadow Warrior 3: Definitive Edition	2022-03-01	1651	2138	1123	2774	0.642
FORGOTTEN: THE GAME	2022-02-13	21	99	46	67	0.642
Push Battle	2022-06-28	66	42	18	84	0.642
Video Horror Society	2022-07-18	6023	4419	2353	8376	0.6418
Afterinfection	2022-02-02	73	254	125	198	0.6417
Aierlon	2022-06-02	11	46	20	31	0.6414
开局一把剑	2022-06-27	132	25	10	142	0.6414
Death Damnation : Zombies, Ghosts and Vampires	2022-10-26	7	25	10	17	0.6414
Let's Play! Oink Games	2022-07-07	162	25	10	172	0.6414
Goblins Strike Back -Instant Fuck Heroines-	2022-11-03	90	25	10	100	0.6414
FLASHOUT 3D: Enhanced Edition	2022-09-02	64	50	22	86	0.6409999999999999
Plumb	2022-03-04	1	2	0	1	0.6408
ExtremeRetroArena	2022-12-08	1	2	0	1	0.6408
Collapsion	2022-02-19	2	2	0	2	0.6408
zeMa	2022-01-28	2	2	0	2	0.6408
Another Reigny Day	2022-10-28	2	2	0	2	0.6408
Science Simulator	2022-07-11	1	2	0	1	0.6408
Waveform Wipeout	2022-10-05	2	2	0	2	0.6408
Flip Tale	2022-10-07	2	2	0	2	0.6408
ALIVE	2022-11-11	2	2	0	2	0.6408
The United SPACE of America	2022-05-24	3	2	0	3	0.6408
Kooring VR Wonderland : Red Queen's Black Magic	2022-05-19	2	2	0	2	0.6408
Destructive Contraptions	2022-07-21	2	2	0	2	0.6408
Card escape: Plane crash	2022-01-26	1	2	0	1	0.6408
IMHA	2022-02-11	1	2	0	1	0.6408
Match Match Mania!	2022-11-01	1	2	0	1	0.6408
D.E.V Bloodline	2022-12-02	2	2	0	2	0.6408
Suspicious Shuffle	2022-10-29	4	2	0	4	0.6408
HotRobot	2022-09-09	2	2	0	2	0.6408
Kaverini Nuuk Adventures	2022-05-13	2	2	0	2	0.6408
Cosmo Clash	2022-12-21	4	2	0	4	0.6408
Theater of Carnage	2022-03-06	3	2	0	3	0.6408
Black Lazar	2022-01-19	2	2	0	2	0.6408
City Retreat	2022-01-28	4	2	0	4	0.6408
御寇三世：星图	2022-02-26	1	2	0	1	0.6408
Mysteries of Shaola: The Cave	2022-01-13	2	2	0	2	0.6408
Go Home	2022-08-03	4	2	0	4	0.6408
Project Kuragava	2022-04-22	1	2	0	1	0.6408
Broilers	2022-11-07	3	2	0	3	0.6408
Symbol Sudoku	2022-10-19	2	2	0	2	0.6408
The magic of three	2022-05-27	1	2	0	1	0.6408
VR Dream Girl	2022-08-09	2	2	0	2	0.6408
Electrogene	2022-03-10	1	2	0	1	0.6408
Master of Puppets	2022-12-27	2	2	0	2	0.6408
The Last Dance Saloon	2022-01-25	1	2	0	1	0.6408
Are You a Boat?	2022-02-09	2	2	0	2	0.6408
The Absorber	2022-01-16	1	2	0	1	0.6408
Made to be Crushed	2022-10-17	4	2	0	4	0.6408
Rumble Runners	2022-05-23	3	2	0	3	0.6408
Tales of Raetrethra - Legends of the Past	2022-01-07	2	2	0	2	0.6408
OverWall	2022-01-31	4	2	0	4	0.6408
Second Samurai	2022-02-16	2	2	0	2	0.6408
Reef Rumble	2022-02-11	5	2	0	5	0.6408
NMDC	2022-06-04	3	2	0	3	0.6408
Get Tanked!	2022-04-08	5	2	0	5	0.6408
Rogue Rising	2022-03-24	2	2	0	2	0.6408
Zone B Korosu	2022-04-21	2	2	0	2	0.6408
The Vaults of Minos	2022-08-29	1	2	0	1	0.6408
Crate Knight	2022-07-23	2	2	0	2	0.6408
Harrier Jump Jet	2022-01-21	1	2	0	1	0.6408
BorderCollie Game 2 - BorderCollie Blaster	2022-04-13	2	2	0	2	0.6408
Arpsic	2022-11-08	2	2	0	2	0.6408
Ramen or Jail	2022-03-14	2	2	0	2	0.6408
Flipping Beat	2022-01-06	2	2	0	2	0.6408
Midnight School Walk 真夜中学園さんぽ	2022-08-11	2	2	0	2	0.6408
Planet Hotpot	2022-01-15	4	2	0	4	0.6408
I, W.O.M.A.N.	2022-02-15	2	2	0	2	0.6408
学霸的星期天	2022-03-10	2	2	0	2	0.6408
BOOMER SLAYERS	2022-02-28	2	2	0	2	0.6408
Re: Summon	2022-01-22	2	2	0	2	0.6408
Warlocks Entanglement	2022-01-08	3	2	0	3	0.6408
Little Robo Climber	2022-03-26	2	2	0	2	0.6408
Fight Club - All Stars	2022-06-30	2	2	0	2	0.6408
First Time in Paris	2022-02-28	5	2	0	5	0.6408
アーキタイプ・アーカディア	2022-01-24	8	2	0	8	0.6408
Assassin at Crimson Keep	2022-01-07	2	2	0	2	0.6408
流放之域	2022-05-01	1	2	0	1	0.6408
Valley Knights	2022-05-06	4	2	0	4	0.6408
Crystal Souls: Fragment Hunters	2022-08-18	3	2	0	3	0.6408
OctoMaze	2022-05-09	1	2	0	1	0.6408
Bimous	2022-01-10	1	2	0	1	0.6408
Party Friends	2022-09-26	6	2	0	6	0.6408
A Contusion	2022-07-29	1	2	0	1	0.6408
Prepare For Warp: Unlimited Edition: Beyond Insanji	2022-08-04	2	2	0	2	0.6408
Sr.Empatia	2022-02-04	2	2	0	2	0.6408
World Up	2022-02-19	3	2	0	3	0.6408
Cardow!	2022-08-06	2	2	0	2	0.6408
Blockgeon	2022-03-03	1	2	0	1	0.6408
Vacation Adventures: Park Ranger 8	2022-02-02	5	2	0	5	0.6408
Marimo -VS- I.A.S.	2022-01-31	3	2	0	3	0.6408
Turk-A-Lurk	2022-01-13	1	2	0	1	0.6408
Break Through The Illusion	2022-02-18	1	2	0	1	0.6408
True Racing	2022-03-24	3	2	0	3	0.6408
Dive Bar Superstars	2022-01-24	2	2	0	2	0.6408
Gravix	2022-10-25	2	2	0	2	0.6408
Game Of Seven	2022-05-13	1	2	0	1	0.6408
Diamond Hands Arena	2022-05-15	1	2	0	1	0.6408
Straight Ahead	2022-01-19	1	2	0	1	0.6408
Vector Elite	2022-06-14	1	2	0	1	0.6408
Hellscape	2022-06-01	2	2	0	2	0.6408
79 Pompeii	2022-04-08	1	2	0	1	0.6408
Runewaker	2022-01-11	2	2	0	2	0.6408
Medieval Battlegrounds	2022-04-21	6	2	0	6	0.6408
Win by Definition	2022-01-17	4	2	0	4	0.6408
RedPixel	2022-01-06	2	2	0	2	0.6408
Einherjar	2022-03-15	1	2	0	1	0.6408
Swing the Universe	2022-02-24	2	2	0	2	0.6408
Nested Rooms	2022-01-13	2	2	0	2	0.6408
Hitozuma Netori Kannrinin	2022-02-25	2	2	0	2	0.6408
Hidden Treasures in the Forest of Dreams	2022-06-25	2	2	0	2	0.6408
Hot Pickle!	2022-01-14	1	2	0	1	0.6408
The Vision Of The Ant	2022-01-14	1	2	0	1	0.6408
Another Sight	2022-01-19	2	2	0	2	0.6408
Billiards of the Round Table (BRT)	2022-03-10	2	2	0	2	0.6408
Déjà Vu	2022-02-11	1	2	0	1	0.6408
Blue Jay Joyride	2022-03-26	1	2	0	1	0.6408
Polygon Hunter VR	2022-01-17	1	2	0	1	0.6408
Space Demon Combat Tactics III	2022-01-13	2	2	0	2	0.6408
Avalanches	2022-01-28	2	2	0	2	0.6408
Samurai Tactics	2022-01-25	2	2	0	2	0.6408
Horrifical Maze	2022-11-17	2	2	0	2	0.6408
Way On Where	2022-08-09	5	2	0	5	0.6408
Hell's Delivery	2022-05-19	1	2	0	1	0.6408
Dogs and Pigs	2022-01-22	1	2	0	1	0.6408
Zombie War	2022-01-21	2	2	0	2	0.6408
Lead the Way	2022-04-20	1	2	0	1	0.6408
Mysterious Adventure of Michael 2	2022-03-10	2	2	0	2	0.6408
I am on Fire (小小火神）	2022-02-02	2	2	0	2	0.6408
When I Die	2022-01-28	2	2	0	2	0.6408
PerformVR	2022-03-04	1	2	0	1	0.6408
Three Sons	2022-02-26	1	2	0	1	0.6408
Datascape	2022-10-10	1	2	0	1	0.6408
Don't Push Me	2022-01-31	2	2	0	2	0.6408
Mori	2022-02-11	1	2	0	1	0.6408
Ninjas Against the Machines	2022-02-18	2	2	0	2	0.6408
PARACHUTER	2022-02-17	1	2	0	1	0.6408
Jumping Knight	2022-02-16	2	2	0	2	0.6408
Victorian Debutante	2022-07-20	2	2	0	2	0.6408
NFT Museum	2022-06-10	1	2	0	1	0.6408
Exodus Vigil	2022-07-14	2	2	0	2	0.6408
小艺的异世界冒险	2022-02-15	2	2	0	2	0.6408
Clive vs Hives 2	2022-02-08	4	2	0	4	0.6408
Annual Intruders 2.0	2022-02-07	2	2	0	2	0.6408
魔物的迷宫探险	2022-04-02	1	2	0	1	0.6408
For Runner Night	2022-11-15	1	2	0	1	0.6408
Vaxomon	2022-05-09	1	2	0	1	0.6408
The Odarian Accounts	2022-10-02	1	2	0	1	0.6408
A Tale of Synapse : The Chaos Theories	2022-02-11	4	2	0	4	0.6408
Smashball	2022-02-21	1	2	0	1	0.6408
Quickflash - A Fabula Story	2022-03-09	2	2	0	2	0.6408
SURVIVAL SISTERS	2022-04-08	2	2	0	2	0.6408
Facility 386	2022-02-28	1	2	0	1	0.6408
Ruins & Switch	2022-02-21	1	2	0	1	0.6408
Battle Support	2022-04-17	1	2	0	1	0.6408
Jack Saves Easter	2022-03-04	1	2	0	1	0.6408
Galactoids - Galactic Invaders	2022-11-25	1	2	0	1	0.6408
Rising Sun VR	2022-03-03	1	2	0	1	0.6408
Soulbaby: Remastered	2022-09-15	2	2	0	2	0.6408
The Pathema 疫途	2022-09-24	3	2	0	3	0.6408
Maze Dungeon	2022-05-20	2	2	0	2	0.6408
Spirits Of Freedom - SOF	2022-03-19	3	2	0	3	0.6408
Lost in Place	2022-03-01	1	2	0	1	0.6408
Sokobear: Cave	2022-11-11	1	2	0	1	0.6408
Lil Splody: Look Out Below!	2022-06-20	2	2	0	2	0.6408
Adventure Trip: Wonders of the World	2022-03-04	5	2	0	5	0.6408
Hungry Zombies	2022-03-12	2	2	0	2	0.6408
Mission Twentyeight	2022-06-09	4	2	0	4	0.6408
Mana Chess	2022-04-17	2	2	0	2	0.6408
Dotto Botto	2022-03-09	2	2	0	2	0.6408
EVAN QUEST 2	2022-03-04	1	2	0	1	0.6408
Scapegoat	2022-04-27	1	2	0	1	0.6408
Twin Mind: Ghost Hunter Collector's Edition	2022-03-29	6	2	0	6	0.6408
Parasite	2022-03-19	2	2	0	2	0.6408
Edgar	2022-04-01	1	2	0	1	0.6408
Roaming The Stars	2022-12-23	1	2	0	1	0.6408
Max Traffic	2022-04-09	2	2	0	2	0.6408
BURNER	2022-05-10	2	2	0	2	0.6408
Hoverkitty in ... The Hoververse!	2022-03-25	1	2	0	1	0.6408
Solitaire Match 2 Cards. Thanksgiving Day	2022-04-18	4	2	0	4	0.6408
CyberScope	2022-04-21	1	2	0	1	0.6408
Duline	2022-05-03	2	2	0	2	0.6408
Dance of Decapods	2022-10-14	2	2	0	2	0.6408
Egg Bunny 2	2022-05-09	1	2	0	1	0.6408
The Game of Unknown	2022-04-07	1	2	0	1	0.6408
Snooze: A Sleeping Adventure	2022-04-20	1	2	0	1	0.6408
Collect the Cupcake	2022-04-09	3	2	0	3	0.6408
Peasant TD	2022-04-12	2	2	0	2	0.6408
Nora's AdventurEscape	2022-04-07	4	2	0	4	0.6408
Overdriven Evolution	2022-09-02	2	2	0	2	0.6408
Magic Griddlers 2	2022-03-29	3	2	0	3	0.6408
Let's MEAT Adam	2022-06-01	4	2	0	4	0.6408
Fruit Bonanza	2022-04-14	2	2	0	2	0.6408
Jigsaw Savant	2022-07-01	2	2	0	2	0.6408
MITS	2022-05-04	2	2	0	2	0.6408
Dandi World	2022-04-18	1	2	0	1	0.6408
Mapstermind	2022-05-17	4	2	0	4	0.6408
Arena Brutal	2022-04-22	2	2	0	2	0.6408
Crescent Bloom	2022-09-02	2	2	0	2	0.6408
Escape from Deathmark Dungeon	2022-04-13	2	2	0	2	0.6408
死亡地牢 Death Dungeon	2022-05-16	2	2	0	2	0.6408
Nightmare Rooms VR	2022-09-02	2	2	0	2	0.6408
Poker Loafer	2022-05-18	2	2	0	2	0.6408
A HAUNTED HISTORY	2022-05-27	1	2	0	1	0.6408
Catbusters	2022-11-24	3	2	0	3	0.6408
World of Music Interactive Simulator	2022-05-27	3	2	0	3	0.6408
TacTac Prologue	2022-05-02	1	2	0	1	0.6408
Card Girl Army Ⅱ	2022-05-26	3	2	0	3	0.6408
孤星蒲公英	2022-07-11	1	2	0	1	0.6408
La Vie La Rue	2022-04-28	1	2	0	1	0.6408
Deuces Wild - Video Poker	2022-05-26	3	2	0	3	0.6408
Isolate ME!	2022-08-29	1	2	0	1	0.6408
ZEROCRON	2022-06-12	2	2	0	2	0.6408
Galactic Explorers	2022-04-30	2	2	0	2	0.6408
Ninja Sneaking R	2022-05-20	5	2	0	5	0.6408
rododendron	2022-05-06	1	2	0	1	0.6408
Unknown	2022-08-04	2	2	0	2	0.6408
Art Mahjong 4	2022-05-05	2	2	0	2	0.6408
TDS - War Games	2022-06-07	1	2	0	1	0.6408
The Orb of Darkness	2022-05-05	2	2	0	2	0.6408
Commando Mountain Rescue	2022-05-13	1	2	0	1	0.6408
Armor Girl	2022-08-01	2	2	0	2	0.6408
Hexxagon - Board Game	2022-10-14	2	2	0	2	0.6408
Blade Bros ACTION!	2022-05-20	1	2	0	1	0.6408
ThanksTaking	2022-08-25	2	2	0	2	0.6408
Go To Heck	2022-08-30	2	2	0	2	0.6408
1001 Jigsaw. Home Sweet Home 3	2022-07-18	1	2	0	1	0.6408
WestFallen	2022-12-20	2	2	0	2	0.6408
LettersFall 110%™ - 100% FREE Word Game!	2022-05-09	3	2	0	3	0.6408
Under Waves	2022-08-10	2	2	0	2	0.6408
Cartographer	2022-05-13	2	2	0	2	0.6408
Village Guardians	2022-07-06	1	2	0	1	0.6408
Garbage Collect	2022-05-20	1	2	0	1	0.6408
Made Beaver	2022-09-21	6	2	0	6	0.6408
Dueledged	2022-06-15	2	2	0	2	0.6408
Goofy Man	2022-05-28	1	2	0	1	0.6408
KITBASHERS UNITED	2022-05-12	1	2	0	1	0.6408
Jigsaw Puzzle Beach Season 2	2022-08-15	3	2	0	3	0.6408
Brave Builder Construct A Climb	2022-06-17	1	2	0	1	0.6408
Baron of Blood	2022-08-03	1	2	0	1	0.6408
Chaste Tris	2022-05-31	1	2	0	1	0.6408
Sargasso on Steam	2022-08-16	2	2	0	2	0.6408
Lightfire Defense	2022-08-12	1	2	0	1	0.6408
Vacation Adventures: Cruise Director 6	2022-05-27	5	2	0	5	0.6408
Dream Walk: Mortgage	2022-06-03	2	2	0	2	0.6408
Robo Legend	2022-11-10	2	2	0	2	0.6408
Seasons	2022-05-31	1	2	0	1	0.6408
Flappy Butt	2022-07-11	1	2	0	1	0.6408
Upirja	2022-05-29	2	2	0	2	0.6408
Redemption Cemetery: The Stolen Time Collector's Edition	2022-05-13	4	2	0	4	0.6408
Rivalry warlord Sengoku	2022-06-27	1	2	0	1	0.6408
Easy Poetry	2022-08-18	2	2	0	2	0.6408
The Farnese Hercules	2022-10-15	2	2	0	2	0.6408
GleebGlob	2022-10-20	5	2	0	5	0.6408
Epic Jump!	2022-06-26	1	2	0	1	0.6408
Marpi ᵒˢ	2022-07-15	2	2	0	2	0.6408
Chuhou Joutai 3: Three Nights of Scarlet Abscess	2022-10-07	1	2	0	1	0.6408
FOG	2022-08-12	3	2	0	3	0.6408
Run4YourLight	2022-06-14	3	2	0	3	0.6408
Estrus Princess	2022-06-09	1	2	0	1	0.6408
Mugsy & Mugsy's Revenge	2022-06-13	2	2	0	2	0.6408
Sex Search 2: Ultimate	2022-06-14	2	2	0	2	0.6408
大分・別府ミステリー案内 歪んだ竹灯篭	2022-08-15	13	2	0	13	0.6408
Gilligan's Gold	2022-06-14	1	2	0	1	0.6408
Bad Chicken	2022-09-30	2	2	0	2	0.6408
Memory Puzzle - Futanari Mistress	2022-06-02	2	2	0	2	0.6408
RockSlide	2022-08-17	1	2	0	1	0.6408
Egg Hop	2022-08-11	2	2	0	2	0.6408
Bell Kingdom	2022-08-12	2	2	0	2	0.6408
Silver Wire	2022-06-22	1	2	0	1	0.6408
Zombies Attack	2022-12-16	4	2	0	4	0.6408
Fairy Elements	2022-09-01	7	2	0	7	0.6408
Mea的财布收集茶会	2022-07-03	2	2	0	2	0.6408
Classic Memory Game	2022-07-01	2	2	0	2	0.6408
Oxyjet	2022-12-01	4	2	0	4	0.6408
Artifacts of Eyru	2022-10-26	2	2	0	2	0.6408
Infinity Project: PATTERNS	2022-08-03	2	2	0	2	0.6408
Bounder	2022-07-04	1	2	0	1	0.6408
SharkDrag Episode 5: Uniting the 5 Kingdoms	2022-08-04	2	2	0	2	0.6408
NetaJump	2022-08-04	2	2	0	2	0.6408
Doctor Nanobot	2022-07-15	2	2	0	2	0.6408
Hidden Shapes Animals - VR	2022-10-27	2	2	0	2	0.6408
Bay Bell	2022-09-30	1	2	0	1	0.6408
John Brick	2022-07-15	1	2	0	1	0.6408
AirRaid	2022-09-30	1	2	0	1	0.6408
Score Game 2D	2022-07-21	3	2	0	3	0.6408
抓紧最后一朵	2022-07-20	1	2	0	1	0.6408
The Solar Ring	2022-07-18	2	2	0	2	0.6408
Earth's Center of Gravity	2022-07-29	2	2	0	2	0.6408
VANQUISH	2022-10-18	2	2	0	2	0.6408
数字猜猜乐 Bulls and Cows	2022-10-11	1	2	0	1	0.6408
An old school adventure fps - Go To Hell	2022-07-28	1	2	0	1	0.6408
Lofi Checkers	2022-09-16	2	2	0	2	0.6408
Hiddens Awakening	2022-08-19	2	2	0	2	0.6408
Obviously Inappropriate Content	2022-10-10	1	2	0	1	0.6408
Tribe War	2022-08-02	2	2	0	2	0.6408
Knights vs Nature	2022-10-07	3	2	0	3	0.6408
Circuito Lógico: Marble Puzzle	2022-08-03	1	2	0	1	0.6408
Planetary Defense: An Orbital Turret Defense System	2022-08-11	2	2	0	2	0.6408
The Pier Arcade	2022-11-18	2	2	0	2	0.6408
World Serpent	2022-08-15	1	2	0	1	0.6408
猟奇リスナー ～ 狙われた姫配信者 ～ Lunatic Viewer - Streamer Girl at Risk -	2022-09-14	2	2	0	2	0.6408
A Hero's Quest pt1	2022-08-26	2	2	0	2	0.6408
Kemomi-chan's Journey ~Enlightened Girl and the Innocent Doll~	2022-11-25	1	2	0	1	0.6408
Poly Memory: Primates	2022-08-09	2	2	0	2	0.6408
Infinity Pinball	2022-11-11	3	2	0	3	0.6408
City Legends: Trapped In Mirror Collector's Edition	2022-08-30	5	2	0	5	0.6408
Nature & Wildlife - Jigsaw Puzzle	2022-08-18	4	2	0	4	0.6408
BirdsBorough : Town of Alchemy	2022-09-05	1	2	0	1	0.6408
Mystery Solitaire. Dreamcatcher 2	2022-08-15	4	2	0	4	0.6408
Joey and Penguin's 2 Player Adventure	2022-09-14	2	2	0	2	0.6408
Classic Snake	2022-09-03	2	2	0	2	0.6408
Memory Puzzle - Futanari Gym	2022-08-06	2	2	0	2	0.6408
Chip Off The Ol' Stumbling Block	2022-11-03	1	2	0	1	0.6408
王子斗恶龙2	2022-09-13	1	2	0	1	0.6408
Elland: The Crystal Wars	2022-10-03	2	2	0	2	0.6408
Built Different	2022-09-19	2	2	0	2	0.6408
Froggin Up	2022-12-31	2	2	0	2	0.6408
Unify	2022-08-31	1	2	0	1	0.6408
Botanical TD	2022-11-30	2	2	0	2	0.6408
Amaya's Lost Soul	2022-08-30	1	2	0	1	0.6408
Cursed House 11	2022-09-02	9	2	0	9	0.6408
Grim Tales: Horizon Of Wishes Collector's Edition	2022-08-26	6	2	0	6	0.6408
reflex runner	2022-09-26	2	2	0	2	0.6408
Kings and Catapults	2022-09-12	1	2	0	1	0.6408
Alpaclands	2022-10-20	1	2	0	1	0.6408
STELLABITS	2022-10-26	3	2	0	3	0.6408
Frenzy	2022-09-30	1	2	0	1	0.6408
Bowling Hills	2022-09-28	3	2	0	3	0.6408
The Blood Amulet	2022-10-09	2	2	0	2	0.6408
Chilljong	2022-10-27	1	2	0	1	0.6408
Hunting grounds	2022-10-13	1	2	0	1	0.6408
Gold Of Lotusland	2022-10-25	1	2	0	1	0.6408
The Impossible Knight Runner	2022-09-15	1	2	0	1	0.6408
Bubbbles	2022-12-05	1	2	0	1	0.6408
Under Observation	2022-12-31	1	2	0	1	0.6408
Zombie Age	2022-09-30	3	2	0	3	0.6408
Lamp Simulator	2022-10-10	1	2	0	1	0.6408
/Conspiracy/ Girls >The Madness of Madison Delaroux	2022-10-20	1	2	0	1	0.6408
BLÖCK	2022-09-20	1	2	0	1	0.6408
The Tyler Tactics Anthology	2022-12-23	3	2	0	3	0.6408
Graviton	2022-10-28	2	2	0	2	0.6408
Athereon: Advent I	2022-09-28	2	2	0	2	0.6408
Boomshine Plus	2022-10-01	1	2	0	1	0.6408
Endless Engines	2022-10-10	5	2	0	5	0.6408
꿈을 빼앗긴 남자 - Dream invader	2022-11-16	2	2	0	2	0.6408
FukTopia 4	2022-10-25	2	2	0	2	0.6408
Twilight Of The Gods	2022-12-08	2	2	0	2	0.6408
Inversion Institute	2022-10-22	1	2	0	1	0.6408
Way Of Vulcan	2022-11-25	3	2	0	3	0.6408
Street volleyball - Invitation	2022-12-20	2	2	0	2	0.6408
Actua Ice Hockey 2	2022-11-30	3	2	0	3	0.6408
Dungeonoid	2022-10-28	3	2	0	3	0.6408
Toast The Ghost	2022-10-13	2	2	0	2	0.6408
Orbital Clash	2022-11-21	3	2	0	3	0.6408
Police Transporter Simulator	2022-11-21	1	2	0	1	0.6408
Azarine Heart	2022-10-05	2	2	0	2	0.6408
Underground Sheriff	2022-11-09	1	2	0	1	0.6408
Run Run Boy	2022-11-17	1	2	0	1	0.6408
Mike's Arcade	2022-12-01	3	2	0	3	0.6408
CRAP	2022-12-02	2	2	0	2	0.6408
SWAP	2022-12-08	1	2	0	1	0.6408
3 Crystals	2022-10-07	2	2	0	2	0.6408
Students of Light Bonds - Typing RPG with Character Creation -	2022-12-19	2	2	0	2	0.6408
Bones of Halloween	2022-10-28	1	2	0	1	0.6408
Classical Music Minesweeper	2022-11-03	1	2	0	1	0.6408
Gramm	2022-10-20	1	2	0	1	0.6408
Glass Hearts	2022-10-19	5	2	0	5	0.6408
TheCube	2022-11-02	2	2	0	2	0.6408
Blobek	2022-11-22	1	2	0	1	0.6408
Futtony y el Copón Mundial	2022-11-23	2	2	0	2	0.6408
Once in a Blue Moon	2022-11-21	1	2	0	1	0.6408
Pengreens	2022-11-03	4	2	0	4	0.6408
Black Cycle	2022-12-06	1	2	0	1	0.6408
SPACE DUDES vs ALIEN DUDES	2022-10-28	1	2	0	1	0.6408
Detective Solitaire The Ghost Agency 2	2022-10-17	4	2	0	4	0.6408
幻境恋人-Wonderland Lovers	2022-12-02	2	2	0	2	0.6408
Christmas Wonderland 6	2022-11-18	3	2	0	3	0.6408
TYKEN	2022-11-03	1	2	0	1	0.6408
Actua Golf	2022-12-13	3	2	0	3	0.6408
奇克八号盲目发射 Blind No.8 Chick Shoot	2022-11-07	2	2	0	2	0.6408
Kaiser	2022-11-03	1	2	0	1	0.6408
Zarlor Mercenary	2022-11-10	2	2	0	2	0.6408
Darkness Reborn	2022-11-03	1	2	0	1	0.6408
Conspiracy TD	2022-12-25	4	2	0	4	0.6408
Beam Cat	2022-11-08	3	2	0	3	0.6408
The Protea Cases	2022-11-10	2	2	0	2	0.6408
SmileXCorp III	2022-12-23	5	2	0	5	0.6408
Poly Memory: Dinosaurs	2022-11-03	1	2	0	1	0.6408
Beach Runner	2022-11-11	2	2	0	2	0.6408
VR Painting: Time	2022-11-08	1	2	0	1	0.6408
Sex Adventures - Vampire Express Train	2022-10-26	3	2	0	3	0.6408
Homerun Miko	2022-12-01	2	2	0	2	0.6408
Cluppets	2022-11-15	1	2	0	1	0.6408
Space Yugoslav 2D	2022-12-01	2	2	0	2	0.6408
Sex Adventures - The Naughty Maid	2022-11-10	3	2	0	3	0.6408
SoundStorm	2022-12-16	2	2	0	2	0.6408
Hank's Quest for Soup	2022-12-05	2	2	0	2	0.6408
Squid Fighter	2022-11-28	2	2	0	2	0.6408
BALLDVENTURE	2022-11-21	1	2	0	1	0.6408
Simulators2023	2022-12-12	2	2	0	2	0.6408
Town Girls	2022-12-05	2	2	0	2	0.6408
Boom 2020	2022-11-23	1	2	0	1	0.6408
The Asher Asylum	2022-11-28	2	2	0	2	0.6408
PinCOL	2022-12-05	1	2	0	1	0.6408
ShovelBear	2022-11-28	2	2	0	2	0.6408
すいころ	2022-12-15	2	2	0	2	0.6408
30-50 Feral Hogs	2022-12-01	2	2	0	2	0.6408
3 Households	2022-12-02	1	2	0	1	0.6408
Eye of D'akess	2022-12-16	2	2	0	2	0.6408
Candyboy	2022-12-19	1	2	0	1	0.6408
Last Eclipse	2022-12-24	1	2	0	1	0.6408
Ecocoru	2022-12-31	4	2	0	4	0.6408
Ansoku	2022-12-19	4	2	0	4	0.6408
MannyTD	2022-12-12	1	2	0	1	0.6408
EsoTarot VR	2022-12-23	2	2	0	2	0.6408
Lucy´s World	2022-12-22	2	2	0	2	0.6408
DICED Pilot	2022-12-22	1	2	0	1	0.6408
Helga the Viking Warrior 2: Ivar's Revenge	2022-12-29	5	2	0	5	0.6408
Lord of Bones	2022-12-30	2	2	0	2	0.6408
游戏策划面试模拟器	2022-12-29	1	2	0	1	0.6408
I commissioned some bees 12 Days	2022-12-27	4	2	0	4	0.6408
Jetpack George!	2022-12-27	2	2	0	2	0.6408
THE BYTE	2022-02-12	2	14	5	7	0.6406999999999999
Dear Althea	2022-04-09	7	14	5	12	0.6406999999999999
The Silent Sky Part I	2022-07-29	4	14	5	9	0.6406999999999999
Outbreak: Contagious Memories	2022-04-06	4	14	5	9	0.6406999999999999
All To Race	2022-07-11	7	14	5	12	0.6406999999999999
Rogue Dungeon	2022-01-28	6	14	5	11	0.6406999999999999
Recruit And Adventure	2022-01-25	11	14	5	16	0.6406999999999999
69 Lily Hot	2022-02-07	6	14	5	11	0.6406999999999999
Dickdown Duel	2022-03-01	18	14	5	23	0.6406999999999999
Draft Day Sports: College Basketball 2022	2022-03-11	66	14	5	71	0.6406999999999999
Day of the Dino Survival	2022-10-11	8	14	5	13	0.6406999999999999
The Tyrning Combat Challenge	2022-06-03	4	14	5	9	0.6406999999999999
Fire Truck Simulator	2022-07-05	2	14	5	7	0.6406999999999999
Where are my potatoes?	2022-07-05	5	14	5	10	0.6406999999999999
The Grim Nightmare of Nibras	2022-10-05	3	14	5	8	0.6406999999999999
Zombies Invasion	2022-06-23	2	14	5	7	0.6406999999999999
PIP	2022-08-09	3	14	5	8	0.6406999999999999
From atom to modern	2022-09-06	19	14	5	24	0.6406999999999999
Dungeon & Adventure	2022-10-14	3	14	5	8	0.6406999999999999
Tanks Logic	2022-11-16	2	14	5	7	0.6406999999999999
Super Toy Cars Offroad	2022-02-18	5	27	11	16	0.6406000000000001
New Home: Medieval Village	2022-01-14	189	100	47	236	0.6402
HORROR TYCOON	2022-10-20	40	64	29	69	0.6402
Booty Farm	2022-07-19	244	273	136	380	0.6401000000000001
No Place for Bravery	2022-09-22	75	82	38	113	0.6401000000000001
Piko Piko	2022-04-28	10	80	37	47	0.6401000000000001
Dream Girlfriend: Twitch Thot 18+ 💜	2022-02-04	10	78	36	46	0.6401000000000001
Speedrun	2022-05-18	21	29	12	33	0.64
Museum of Mechanics: Lockpicking	2022-01-13	16	31	13	29	0.6395000000000001
Neon Speed	2022-05-07	38	33	14	52	0.6391
Ranger Danger	2022-11-14	9	33	14	23	0.6391
Taiko Risshiden V DX	2022-05-19	10663	1295	683	11346	0.639
KILL YOUR FRIENDS	2022-04-18	12	7	2	14	0.6389
Gravity Chase	2022-10-14	2	7	2	4	0.6389
Goomanuvr	2022-02-09	6	7	2	8	0.6389
Chronicles of cyberpunk - Deep sleep	2022-08-21	3	7	2	5	0.6389
Karen	2022-03-25	2	7	2	4	0.6389
Starlight: Defence Command	2022-11-24	3	7	2	5	0.6389
Realms VR	2022-11-13	5	7	2	7	0.6389
METROPOCRE	2022-03-17	2	7	2	4	0.6389
Universe 51: Tannhäuser Wars	2022-05-13	10	7	2	12	0.6389
X Fugitive	2022-03-22	2	7	2	4	0.6389
New Lands 2 Collector's Edition	2022-03-09	7	7	2	9	0.6389
Adarin Farm	2022-01-21	16	7	2	18	0.6389
Red Bash	2022-01-21	7	7	2	9	0.6389
Dream Fruit Farm	2022-01-06	7	7	2	9	0.6389
Dummy Falls	2022-02-07	9	7	2	11	0.6389
矿老板模拟器	2022-08-24	16	7	2	18	0.6389
Hidden Frog	2022-01-19	3	7	2	5	0.6389
Sweet Collector	2022-01-28	2	7	2	4	0.6389
Slide Furry Futanari	2022-02-04	4	7	2	6	0.6389
Krek Da Frog	2022-03-23	2	7	2	4	0.6389
Lost Souls	2022-03-21	5	7	2	7	0.6389
Ableford	2022-02-11	4	7	2	6	0.6389
Battle for the Droid Station	2022-02-23	1	7	2	3	0.6389
Set Sail	2022-10-21	2	7	2	4	0.6389
PlanetA	2022-05-19	4	7	2	6	0.6389
The Sinking Structure, Clione, and Lost Child -Log4	2022-03-23	3	7	2	5	0.6389
Knightblade	2022-04-04	4	7	2	6	0.6389
Slime Corp	2022-05-25	8	7	2	10	0.6389
Homemade TCG	2022-07-15	2	7	2	4	0.6389
CUBEGRID	2022-05-30	2	7	2	4	0.6389
CubeShoot:LitteYellow	2022-06-18	4	7	2	6	0.6389
Playing with My Brother's Wife	2022-06-23	4	7	2	6	0.6389
Starting Life In Another World Naked	2022-07-02	4	7	2	6	0.6389
I'm Prop	2022-07-28	7	7	2	9	0.6389
TEND	2022-08-31	6	7	2	8	0.6389
都市媚影-CityFascination	2022-08-05	23	7	2	25	0.6389
Project: Swap	2022-08-18	6	7	2	8	0.6389
Dwarf's Adventure	2022-12-02	5	7	2	7	0.6389
Deathrun Guys	2022-08-22	12	7	2	14	0.6389
The Nameless	2022-10-31	4	7	2	6	0.6389
Terror Time	2022-10-14	3	7	2	5	0.6389
Winged Raider	2022-09-22	4	7	2	6	0.6389
Angels Bleeding	2022-11-18	2	7	2	4	0.6389
Candlehead	2022-10-17	2	7	2	4	0.6389
Desktop Farm Remastered	2022-11-19	5	7	2	7	0.6389
Howlbreath	2022-10-12	5	7	2	7	0.6389
그녀가 다시 노래할 때까지.(Until She sings again)	2022-11-14	2	7	2	4	0.6389
Scary pictures: Yavez - seven deadly sins	2022-12-14	3	7	2	5	0.6389
Simple Rally	2022-12-22	2	7	2	4	0.6389
Orphus - A Hentai CCG	2022-12-24	7	7	2	9	0.6389
HappySnowMan	2022-12-26	3	7	2	5	0.6389
Don't blame you	2022-12-30	3	7	2	5	0.6389
DarKnot	2022-11-03	10	35	15	25	0.6388
Enemy Remains	2022-02-06	2	16	6	8	0.6388
HUMANS CONNECT	2022-02-12	5	16	6	11	0.6388
Pixel Ground	2022-08-31	28	16	6	34	0.6388
Lazy Girl	2022-02-17	5	16	6	11	0.6388
The Dark Dwellers	2022-02-18	6	16	6	12	0.6388
Void Slayer	2022-01-24	20	16	6	26	0.6388
Lost Wish: In the desperate world	2022-03-25	3	16	6	9	0.6388
Iron Age	2022-03-18	7	16	6	13	0.6388
Lenin Simulator	2022-04-07	6	16	6	12	0.6388
Protect Ukraine	2022-04-09	2	16	6	8	0.6388
ハム★スピ！	2022-05-15	9	16	6	15	0.6388
救赎之渊	2022-09-05	7	16	6	13	0.6388
Caged Beast	2022-07-12	5	16	6	11	0.6388
The Eyes of Dr Kautzmann	2022-10-01	6	16	6	12	0.6388
The Dead End	2022-05-14	263	107	51	314	0.6386999999999999
Souldiers	2022-06-02	1415	1096	577	1992	0.6385000000000001
Legends of Kingdom Rush	2022-07-14	1535	642	333	1868	0.6385000000000001
元宇宙普信男生存指南	2022-01-16	36	142	69	105	0.6385000000000001
Maybe Immortal	2022-05-15	24	37	16	40	0.6385000000000001
Prime Horror II	2022-11-05	17	37	16	33	0.6385000000000001
Sword Reverie	2022-01-21	40	79	37	77	0.6379
Tavern Crawl	2022-04-27	14	43	19	33	0.6379
阿瑞斯病毒2	2022-06-09	540	264	133	673	0.6378
Bigfield 2042	2022-03-05	4	45	20	24	0.6378
Dransik	2022-09-03	85	53	24	109	0.6376
Dungeoneer	2022-04-27	7	18	7	14	0.6375000000000001
Wanderer	2022-06-28	4	18	7	11	0.6375000000000001
Syren and Friends Roast the Dev	2022-12-17	7	18	7	14	0.6375000000000001
PGA TOUR 2K23	2022-10-14	3538	1134	602	4140	0.637
Richman 4	2022-07-28	2049	633	331	2380	0.6368
Find your way	2022-12-19	370	215	108	478	0.6365999999999999
Crispy Puppy	2022-11-23	2	20	8	10	0.6365
Cannibal Crossing	2022-05-26	181	150	74	255	0.6364
The Oracle Land	2022-06-17	146	254	129	275	0.636
Metro Simulator 2	2022-12-15	113	117	57	170	0.636
CITY WARS: TOKYO REIGN	2022-08-31	14	22	9	23	0.6358
新三國 漢室復興	2022-02-17	63	22	9	72	0.6358
Zombie Scream	2022-06-03	18	22	9	27	0.6358
Layer Section™ & Galactic Attack™ S-Tribute	2022-04-27	21	24	10	31	0.6353
Sword&Magic	2022-11-24	18	24	10	28	0.6353
The Valiant	2022-10-19	371	149	74	445	0.6352000000000001
Scathe	2022-08-31	121	149	74	195	0.6352000000000001
Brookhaven Grimoire	2022-02-18	111	103	50	161	0.6352000000000001
Snowtopia	2022-12-14	577	520	273	850	0.6349
Trainz Plus	2022-05-31	33	26	11	44	0.6349
Bratz™: Flaunt your fashion	2022-11-04	150	122	60	210	0.6348
Wildcat Gun Machine	2022-05-04	33	62	29	62	0.6348
Barbershop Simulator VR	2022-10-07	12	28	12	24	0.6346
Tank Battle Heroes: Iron Warfare 	2022-02-03	3	9	3	6	0.6345000000000001
Awakened: Dark Space	2022-02-25	3	9	3	6	0.6345000000000001
Animal Babysister Fighter : Zombie Coming!	2022-05-18	5	9	3	8	0.6345000000000001
Terra Ventura	2022-09-05	6	9	3	9	0.6345000000000001
In Your Books	2022-08-03	2	9	3	5	0.6345000000000001
MIYAMOTO S	2022-01-30	4	9	3	7	0.6345000000000001
Cells of Immunity	2022-08-20	4	9	3	7	0.6345000000000001
Kukumushi Virtual Pet	2022-03-10	4	9	3	7	0.6345000000000001
Cat Adventure	2022-01-21	4	9	3	7	0.6345000000000001
Ella - a study in realism	2022-02-09	2	9	3	5	0.6345000000000001
Take Over Body 2	2022-03-20	4	9	3	7	0.6345000000000001
69 Estera Hot	2022-03-05	2	9	3	5	0.6345000000000001
The Sargosian Abyss	2022-05-27	4	9	3	7	0.6345000000000001
My Divorce Story	2022-08-30	8	9	3	11	0.6345000000000001
SGS Operation Downfall	2022-08-09	5	9	3	8	0.6345000000000001
GOOG	2022-07-30	8	9	3	11	0.6345000000000001
Fright Night	2022-06-21	3	9	3	6	0.6345000000000001
POG 8	2022-07-04	4	9	3	7	0.6345000000000001
Lust Dungeon	2022-07-26	5	9	3	8	0.6345000000000001
adventure_with_firefly	2022-10-03	3	9	3	6	0.6345000000000001
Slay The Zone	2022-12-09	4	9	3	7	0.6345000000000001
Make Them Naked	2022-09-22	4	9	3	7	0.6345000000000001
Electrical Safety VR Training	2022-11-18	4	9	3	7	0.6345000000000001
Halcyon	2022-12-08	3	9	3	6	0.6345000000000001
Baker Business 3	2022-12-14	7	9	3	10	0.6345000000000001
Bounty	2022-12-02	3	9	3	6	0.6345000000000001
Мольфар: Поклик Серця	2022-12-05	2	9	3	5	0.6345000000000001
Glory to the Robots	2022-12-16	4	9	3	7	0.6345000000000001
九州风流	2022-11-11	14	30	13	27	0.6344
Our Elusive Suffering	2022-03-26	15	48	22	37	0.6342
Mythic Origins	2022-07-14	36	48	22	58	0.6342
Witching Hour	2022-05-17	18	34	15	33	0.6342
SuperTotalCarnage!	2022-10-27	17	42	19	36	0.6341
DEMON GAZE EXTRA	2022-04-25	140	36	16	156	0.6341
Island Idle RPG	2022-08-19	16	36	16	32	0.6341
Мафия Онлайн	2022-07-13	55	131	65	120	0.634
Nemesis: Distress	2022-06-15	271	180	91	362	0.6338
Blood And Zombies	2022-07-26	39	176	89	128	0.6336
Escape From Monster	2022-07-11	30	157	79	109	0.6334000000000001
Matchpoint - Tennis Championships	2022-07-07	140	98	48	188	0.6331
Soccer Clubs 足球经理人	2022-12-20	165	88	43	208	0.6323
Tactical Combat Department	2022-04-28	15	61	29	44	0.6321
Club Soccer Director 2022	2022-03-02	71	61	29	100	0.6321
JACK 'N' HAT	2022-01-21	3	11	4	7	0.6321
Devastator	2022-03-25	6	11	4	10	0.6321
100 Doors - Escape from Prison	2022-06-15	7	11	4	11	0.6321
Zeitgeist	2022-01-30	3	11	4	7	0.6321
GunRunner	2022-01-07	4	11	4	8	0.6321
The Lewd of the Cock Rings	2022-02-01	4	11	4	8	0.6321
Far Far Away From Here	2022-01-24	4	11	4	8	0.6321
Soul Symphony	2022-04-20	4	11	4	8	0.6321
Zombie Good Guy	2022-02-03	3	11	4	7	0.6321
Bloody Rampage City	2022-02-24	2	11	4	6	0.6321
Gems of Destiny: Homeless Dwarf	2022-07-28	5	11	4	9	0.6321
Two Sedans Driving Simulator	2022-03-25	2	11	4	6	0.6321
The Otherwilde	2022-06-01	5	11	4	9	0.6321
MORLUSH	2022-06-15	5	11	4	9	0.6321
Table Ball	2022-08-03	4	11	4	8	0.6321
Sports Babes	2022-08-30	2	11	4	6	0.6321
Hot Milf 8	2022-09-09	2	11	4	6	0.6321
Tanks Battle	2022-12-15	4	11	4	8	0.6321
OnlyFap Simulator 4 💦	2022-11-12	470	234	121	591	0.632
电玩捕鱼	2022-03-25	48	59	28	76	0.6319
春秋	2022-06-02	247	193	99	346	0.6318
Derp Souls	2022-10-04	14	101	50	64	0.6317
OVERLORD: ESCAPE FROM NAZARICK	2022-06-15	484	274	143	627	0.6315
Life is Strange: Before the Storm Remastered	2022-02-01	469	580	311	780	0.6314000000000001
Assassin's Vol.	2022-10-26	28	51	24	52	0.6311
Winter	2022-03-15	102	74	36	138	0.6309
琉隐	2022-09-04	43	72	35	78	0.6307
Tales From Hoia Baciu Forest	2022-06-03	28	47	22	50	0.6307
The Last Oricru	2022-10-13	262	188	97	359	0.6306
Rock Star Manager	2022-01-07	5	13	5	10	0.6306
Off-Road Farming	2022-02-16	2	13	5	7	0.6306
JUNGLE RUNNER	2022-02-21	5	13	5	10	0.6306
My Fantastic Ranch	2022-11-17	7	13	5	12	0.6306
Adventures at the North Pole	2022-06-08	2	13	5	7	0.6306
From Hell	2022-10-04	6	13	5	11	0.6306
GasZilla	2022-11-21	2	13	5	7	0.6306
Stolen Dolls	2022-11-21	2	13	5	7	0.6306
Late photographer 6	2022-12-02	3	13	5	8	0.6306
A Lonely Cabin Trip	2022-12-16	3	13	5	8	0.6306
Master Arena	2022-05-27	88	106	53	141	0.6305
Aquamarine	2022-01-20	19	45	21	40	0.6305
Oraxum Trials	2022-08-10	97	41	19	116	0.6301
Fireteam	2022-04-15	27	39	18	45	0.63
Project Psycho	2022-02-17	5	39	18	23	0.63
Fire On Fight : Online Multiplayer Shooter	2022-03-15	4	15	6	10	0.6298
Write 'n' Fight	2022-08-23	9	15	6	15	0.6298
Claus Adventure	2022-02-07	2	15	6	8	0.6298
Supreme Race on Highway	2022-03-21	4	15	6	10	0.6298
谎月香格里拉	2022-07-22	22	15	6	28	0.6298
Late photographer 5	2022-05-20	3	15	6	9	0.6298
Mate	2022-07-07	8	15	6	14	0.6298
Aftertime	2022-10-31	3	15	6	9	0.6298
Soulsland: Last Fight	2022-09-30	4	15	6	10	0.6298
Breathspace	2022-11-21	2	15	6	8	0.6298
Tank Mechanic Simulator VR	2022-09-01	9	17	7	16	0.6293
Release The Bride	2022-03-12	5	17	7	12	0.6293
They Die Tomorrow	2022-02-25	50	17	7	57	0.6293
Farmer Toon	2022-05-03	7	17	7	14	0.6293
戛然而止的音符	2022-02-07	5	17	7	12	0.6293
Meth Master	2022-05-10	44	109	55	99	0.6292
风色幻想XX:交错的轨迹	2022-08-09	31	29	13	44	0.6291
SoulWorker	2022-03-17	7767	1499	833	8600	0.629
OLD Future: Post-Apocalyptic Times	2022-08-22	10	27	12	22	0.629
MOVEIT	2022-04-07	2	19	8	10	0.629
Lonely Knight	2022-04-06	2	19	8	10	0.629
Lord of Rigel	2022-10-04	29	25	11	40	0.6289
Card Survival: Tropical Island - The First Days	2022-10-04	28	25	11	39	0.6289
TD Worlds	2022-01-10	27	21	9	36	0.6289
The Asmodian Princesses and the Witch in the Forest	2022-06-18	46	21	9	55	0.6289
Timber Story	2022-02-25	8	21	9	17	0.6289
Shadow of Egypt	2022-02-25	7	21	9	16	0.6289
My Futanari Stepmom Impregnated Me	2022-10-20	6	21	9	15	0.6289
ANDERSON	2022-01-13	6	23	10	16	0.6288
Tails and Pines	2022-03-05	4	23	10	14	0.6288
SQUID GIRLS 18+	2022-02-06	331	118	60	391	0.6287
Neko Secret - Homecoming	2022-04-11	12	50	24	36	0.6278
Amok Runner	2022-11-05	345	106	54	399	0.6273
Nimbus INFINITY	2022-02-16	45	46	22	67	0.6271
Zombie Survivors	2022-11-05	49	46	22	71	0.6271
Survive The Hill	2022-01-21	23	44	21	44	0.6268
2310 seconds in HELL	2022-03-04	9	42	20	29	0.6264000000000001
Gungrave G.O.R.E	2022-11-22	138	187	99	237	0.6258
Workshop Simulator	2022-03-10	349	167	88	437	0.6257
Classified Stories: Color Out of Space	2022-07-08	32	70	35	67	0.6257
The Bathhouse | 地獄銭湯	2022-10-01	373	278	150	523	0.6254
我的坦克我的团	2022-10-01	22	36	17	39	0.6253000000000001
虫鸣	2022-03-11	76	79	40	116	0.6251
M1 Tank Platoon	2022-05-04	4	4	1	5	0.6251
CryptoRIG	2022-09-27	3	4	1	4	0.6251
Beasts Shall Rise	2022-10-26	2	4	1	3	0.6251
Iron Ruler	2022-07-30	4	4	1	5	0.6251
PIGROMANCE	2022-12-02	5	4	1	6	0.6251
TeamJumpers 2: New Reality	2022-02-11	3	4	1	4	0.6251
Anime Catgirl Runner	2022-11-15	2	4	1	3	0.6251
Across	2022-07-17	2	4	1	3	0.6251
Malfunction II	2022-12-29	2	4	1	3	0.6251
Lying Souls™	2022-12-20	3	4	1	4	0.6251
King of Heroes	2022-02-03	2	4	1	3	0.6251
Wild Souls	2022-05-09	3	4	1	4	0.6251
Stardom MiniGames	2022-03-31	10	4	1	11	0.6251
Zannon	2022-09-03	2	4	1	3	0.6251
小当家	2022-04-03	2	4	1	3	0.6251
P1441vr	2022-01-12	4	4	1	5	0.6251
Evelyn's Adventure	2022-12-28	3	4	1	4	0.6251
Laser Bounce	2022-01-08	3	4	1	4	0.6251
Inspector Detective: Private Eye	2022-10-31	2	4	1	3	0.6251
Faraway: Jungle Escape	2022-12-15	8	4	1	9	0.6251
Relumine	2022-08-05	2	4	1	3	0.6251
The Death Tree	2022-10-13	2	4	1	3	0.6251
Wormatozoa	2022-08-31	3	4	1	4	0.6251
Fall For You	2022-10-28	2	4	1	3	0.6251
The Monstrous Frontier	2022-01-21	3	4	1	4	0.6251
Gates of Troy	2022-10-13	8	4	1	9	0.6251
Casual Pixel Warrior	2022-05-25	2	4	1	3	0.6251
Dangerous Drift	2022-06-01	2	4	1	3	0.6251
Sabotris	2022-07-11	4	4	1	5	0.6251
Boat Simulator Apprentice	2022-02-21	2	4	1	3	0.6251
Apocalypse: Floodgates	2022-04-08	5	4	1	6	0.6251
Gummings	2022-01-11	2	4	1	3	0.6251
Tkium Exclusion Area	2022-01-05	2	4	1	3	0.6251
Spirits of Light	2022-01-31	2	4	1	3	0.6251
Color Lab	2022-02-25	4	4	1	5	0.6251
Double Time	2022-01-18	1	4	1	2	0.6251
Space Hopper	2022-01-20	2	4	1	3	0.6251
3D Solar System Simulator	2022-01-24	2	4	1	3	0.6251
Coin Operated Carnage	2022-07-20	4	4	1	5	0.6251
PEACE MAKER VR	2022-05-28	1	4	1	2	0.6251
Brick Cracker 3D	2022-02-09	1	4	1	2	0.6251
The Sinking Structure, Clione, and Lost Child -Log2	2022-02-23	2	4	1	3	0.6251
Cheat Day	2022-03-15	2	4	1	3	0.6251
The Exodus	2022-03-24	6	4	1	7	0.6251
Bout	2022-06-20	3	4	1	4	0.6251
Cat Follow Me	2022-02-21	2	4	1	3	0.6251
RoguePG	2022-03-15	4	4	1	5	0.6251
Edge of Reality: Lost Secrets of the Forest Collector's Edition	2022-02-08	9	4	1	10	0.6251
我死后的那些天-After Death	2022-03-14	3	4	1	4	0.6251
LAMBDA end THEORY	2022-03-08	2	4	1	3	0.6251
NeonHAT	2022-03-03	1	4	1	2	0.6251
Stone Protectors	2022-03-15	2	4	1	3	0.6251
Natalia	2022-03-02	2	4	1	3	0.6251
Divine Combat	2022-05-24	2	4	1	3	0.6251
Dungeon of Delights	2022-04-14	2	4	1	3	0.6251
PREDATOR AND WRECK 捕食者と崩壊	2022-05-18	7	4	1	8	0.6251
Towerland	2022-03-21	2	4	1	3	0.6251
1001 Jigsaw. Wild Animals	2022-03-28	2	4	1	3	0.6251
Eragon's Tale	2022-06-23	2	4	1	3	0.6251
The Thief In The Dark	2022-03-22	2	4	1	3	0.6251
Sentry City	2022-07-15	4	4	1	5	0.6251
HUNGRY PIGS	2022-10-08	8	4	1	9	0.6251
Tank Top Tactics	2022-08-18	4	4	1	5	0.6251
Sillage	2022-04-20	2	4	1	3	0.6251
KELVIN	2022-07-18	6	4	1	7	0.6251
Egg Over It	2022-05-23	5	4	1	6	0.6251
Rule The World CHESS	2022-05-26	2	4	1	3	0.6251
My Girlfriend is a Musician	2022-04-28	5	4	1	6	0.6251
The Immortal	2022-06-30	10	4	1	11	0.6251
LOONY	2022-04-26	20	4	1	21	0.6251
Deliver Us From Evil (DUFE): Masquerade	2022-10-31	3	4	1	4	0.6251
THERE'S A RIKISHI IN MY HOUSE	2022-04-27	2	4	1	3	0.6251
The Questing	2022-06-15	3	4	1	4	0.6251
Twogether: Project Indigos	2022-11-22	2	4	1	3	0.6251
Down the Drain	2022-06-09	2	4	1	3	0.6251
Jacob's Quest	2022-11-22	3	4	1	4	0.6251
Surflexers	2022-05-19	1	4	1	2	0.6251
异界生存	2022-05-27	1	4	1	2	0.6251
Candy Bar	2022-10-18	2	4	1	3	0.6251
Stickman Synthwave Escape	2022-06-05	2	4	1	3	0.6251
Lord of Darkness: Prologue	2022-06-21	3	4	1	4	0.6251
Police Scanner Radio	2022-08-19	2	4	1	3	0.6251
Midnight Renegade: Recollections	2022-06-03	2	4	1	3	0.6251
Lockdown VR: Circus of the Dead	2022-06-09	6	4	1	7	0.6251
Living Legends: Bound by Wishes Collector's Edition	2022-07-29	14	4	1	15	0.6251
Atria	2022-06-21	2	4	1	3	0.6251
Tawako The Forest Hedgehog	2022-07-04	1	4	1	2	0.6251
Pedro Land DX	2022-06-17	2	4	1	3	0.6251
Heavenly Puzzle	2022-11-17	2	4	1	3	0.6251
Neon Invaders	2022-06-15	2	4	1	3	0.6251
The Snow Fable: Mystery of the Flame	2022-07-06	6	4	1	7	0.6251
Dragon Fury	2022-11-30	4	4	1	5	0.6251
RecNavi Club	2022-09-15	2	4	1	3	0.6251
Siphonopolis	2022-08-31	3	4	1	4	0.6251
Monty on the Run	2022-07-07	2	4	1	3	0.6251
(square)	2022-08-08	1	4	1	2	0.6251
I am Bjorn	2022-09-28	2	4	1	3	0.6251
Dan el inmortal	2022-08-03	2	4	1	3	0.6251
Pinball Girlfriend	2022-07-15	3	4	1	4	0.6251
Totally Ratical Adventures	2022-09-08	2	4	1	3	0.6251
69 Naomi Hot	2022-10-28	1	4	1	2	0.6251
Pitch Black: A Dusklight Story - Episode One	2022-08-10	4	4	1	5	0.6251
Royal Idiots	2022-08-02	4	4	1	5	0.6251
CustomBullet	2022-10-04	3	4	1	4	0.6251
Senet	2022-11-04	4	4	1	5	0.6251
Steel Saviour Reloaded	2022-09-22	3	4	1	4	0.6251
Toynip	2022-10-04	2	4	1	3	0.6251
Pounce Cat	2022-09-02	6	4	1	7	0.6251
CRASH-SAN	2022-12-19	3	4	1	4	0.6251
Orebody: Binder's Tale	2022-11-30	3	4	1	4	0.6251
神武战略版	2022-10-11	6	4	1	7	0.6251
Are You Afraid of the Dark	2022-10-18	2	4	1	3	0.6251
Capsule Rush	2022-09-27	3	4	1	4	0.6251
Personal Chef to the Stars	2022-10-25	4	4	1	5	0.6251
Valora Survival	2022-10-20	3	4	1	4	0.6251
Sex Adventures - The Bar Hookup	2022-09-21	3	4	1	4	0.6251
Sorcerer Standoff	2022-10-15	3	4	1	4	0.6251
Epic Ninja	2022-10-12	2	4	1	3	0.6251
Never Rain	2022-10-16	2	4	1	3	0.6251
Eagle Hunting Journey	2022-10-22	3	4	1	4	0.6251
I commissioned some bees 8	2022-10-21	7	4	1	8	0.6251
Lost Amulets: Four Guardians	2022-10-28	5	4	1	6	0.6251
My Desktop Girlfriend	2022-12-07	2	4	1	3	0.6251
Distributor Simulator	2022-12-11	3	4	1	4	0.6251
Alien	2022-11-24	2	4	1	3	0.6251
Embracing Darkness	2022-12-01	2	4	1	3	0.6251
华夏五千年	2022-12-06	9	4	1	10	0.6251
GLOBE DRONE	2022-12-01	2	4	1	3	0.6251
That's a lot of pixels!	2022-12-28	1	4	1	2	0.6251
Trial Of Empires TD	2022-01-10	25	34	16	41	0.6249
V696	2022-01-11	7	51	25	32	0.6248
Bash the Teacher! - Classroom Clicker	2022-01-13	57	51	25	82	0.6248
Euryale's Gambit	2022-07-22	12	32	15	27	0.6245
Assassin's Creed Valhalla	2022-12-06	15679	5287	3064	18743	0.6243
Iron Order 1919	2022-08-24	149	97	50	199	0.6243
Eden Island	2022-10-01	34	62	31	65	0.6242
Darxanadon	2022-02-02	5	30	14	19	0.624
Sonic Origins	2022-06-23	2668	1660	947	3615	0.6239
So long as there is Mercy	2022-01-29	26	60	30	56	0.6238
Untitled Crossing Record	2022-08-16	82	58	29	111	0.6234000000000001
Airport Ground Handling Simulator	2022-08-25	55	58	29	84	0.6234000000000001
Moonshine Inc.	2022-12-01	241	80	41	282	0.6232
PaintballX	2022-03-04	43	80	41	84	0.6232
Dice & Dungeons	2022-05-20	12	26	12	24	0.6231
Cthulhu Mythos ADV Lunatic Whispers	2022-10-19	78	26	12	90	0.6231
Super Demon Survivors	2022-08-09	11	26	12	23	0.6231
Lost Scavenger	2022-01-18	76	136	72	148	0.623
Goonya Monster	2022-12-04	224	89	46	270	0.623
Hidden Objects with Edgar Allan Poe	2022-08-05	16	24	11	27	0.6226
Deep Fishing	2022-02-01	35	132	70	105	0.6225
universe_treasure	2022-09-30	60	41	20	80	0.6224000000000001
刀剑封魔录	2022-02-24	425	370	205	630	0.6223
Zombie Carnage 2	2022-02-03	345	530	297	642	0.6222
OnlyFap: Fitness Baby 🔞💦	2022-12-10	417	112	59	476	0.6221
Mage Tower	2022-01-16	51	22	10	61	0.6221
Operation8 Project	2022-06-17	13	22	10	23	0.6221
Champs TD	2022-08-03	13	22	10	23	0.6221
Limousine Parking Simulator	2022-08-10	2	22	10	12	0.6221
VALKYRIE ELYSIUM	2022-11-11	760	511	287	1047	0.6215999999999999
Trainz Railroad Simulator 2022	2022-05-31	111	72	37	148	0.6215
Ceramic Soul	2022-04-30	22	72	37	59	0.6215
Curse of the Deadwood	2022-07-28	9	20	9	18	0.6215
Office No.41	2022-01-07	5	20	9	14	0.6215
The Moonlight Circus	2022-05-05	6	20	9	15	0.6215
Slurpy Derpy	2022-03-16	93	20	9	102	0.6215
Cricket Captain 2022	2022-06-12	135	20	9	144	0.6215
Cow Girl 2	2022-12-09	7	20	9	16	0.6215
Grapple Gear	2022-03-22	28	70	36	64	0.6211
Honored	2022-02-04	8	18	8	16	0.621
MALFUNCTION FPS	2022-02-23	6	18	8	14	0.621
Paramnesia	2022-09-24	6	18	8	14	0.621
永恒至尊 Eternal Supreme	2022-08-05	4	18	8	12	0.621
Falsepine	2022-12-01	11	18	8	19	0.621
Mr. Triangle's Maze	2022-08-26	3	6	2	5	0.621
Forbidden Trip | 禁断の旅	2022-12-22	4	6	2	6	0.621
Waifu Fight Dango Style	2022-03-20	6	6	2	8	0.621
Escape Room Academy	2022-07-28	2	6	2	4	0.621
Rifle Storm	2022-02-11	3	6	2	5	0.621
Berserk Soccer	2022-08-19	3	6	2	5	0.621
Skydom	2022-06-24	2	6	2	4	0.621
Halley's Dream	2022-07-14	3	6	2	5	0.621
Little Obedient Robot	2022-03-14	4	6	2	6	0.621
schoolbreak.io	2022-07-22	10	6	2	12	0.621
Jeff Logar	2022-08-20	3	6	2	5	0.621
Ricochet	2022-01-11	348	6	2	350	0.621
Total Anarchy: Pavilion City	2022-05-31	2	6	2	4	0.621
Moshcave	2022-10-29	2	6	2	4	0.621
Nanook's Revenge	2022-02-08	5	6	2	7	0.621
It's On You	2022-01-28	2	6	2	4	0.621
Funny Street Football	2022-02-08	2	6	2	4	0.621
斯巴达战纪	2022-11-15	12	6	2	14	0.621
Am I?	2022-03-24	1	6	2	3	0.621
Video Game Tutorial	2022-07-25	2	6	2	4	0.621
The End of it All	2022-04-27	3	6	2	5	0.621
Scare Train VR	2022-08-11	4	6	2	6	0.621
Mystery Solitaire. The Black Raven 2	2022-02-23	4	6	2	6	0.621
30 Days to be the Best	2022-09-22	2	6	2	4	0.621
Ring War	2022-07-11	7	6	2	9	0.621
General Practitioner 2	2022-04-28	9	6	2	11	0.621
Alcohol Empire	2022-05-21	6	6	2	8	0.621
Fallen Legion Revenants	2022-08-23	4	6	2	6	0.621
Gabriel's Auditory Playground	2022-04-27	2	6	2	4	0.621
Wild Earth - Africa	2022-03-23	4	6	2	6	0.621
Until The End	2022-09-01	3	6	2	5	0.621
Captcha Kills	2022-07-17	5	6	2	7	0.621
Ambushed	2022-11-04	5	6	2	7	0.621
Space Bees	2022-06-01	7	6	2	9	0.621
Sex Adventures - Futanari Mistress	2022-05-01	3	6	2	5	0.621
ヒロイン忍法帖 姫影・ 壱／Pretty Ninja HIMEKAGE_01	2022-10-06	3	6	2	5	0.621
雀姬的异想世界 普通版	2022-07-04	8	6	2	10	0.621
Project Sundown	2022-09-25	4	6	2	6	0.621
Aquarist VR	2022-12-09	3	6	2	5	0.621
Happy's Clocks	2022-08-19	4	6	2	6	0.621
The Clown's Forest	2022-07-19	2	6	2	4	0.621
Sagger	2022-10-03	6	6	2	8	0.621
Azrael	2022-07-22	2	6	2	4	0.621
icosi-do	2022-11-11	4	6	2	6	0.621
MOAR - Appeteaser	2022-07-18	3	6	2	5	0.621
Physics Playground	2022-08-05	3	6	2	5	0.621
Deus Novum	2022-08-16	4	6	2	6	0.621
Future & Girls	2022-08-27	2	6	2	4	0.621
Bleeding Metal Rainbow	2022-12-22	1	6	2	3	0.621
Vajont VR	2022-10-31	1	6	2	3	0.621
Raid Healing	2022-09-23	9	6	2	11	0.621
荒土之上 On Wasteland	2022-09-24	2	6	2	4	0.621
Holiday with Gwen	2022-09-20	4	6	2	6	0.621
山间有点田-Sweet In the Mountains	2022-08-26	14	6	2	16	0.621
Super Pentagon	2022-09-22	3	6	2	5	0.621
Golden Egg	2022-10-20	2	6	2	4	0.621
Futa Paradise	2022-10-26	11	6	2	13	0.621
Anime Girls Trample	2022-12-08	3	6	2	5	0.621
SAVE THE EARTH	2022-10-28	5	6	2	7	0.621
Piranha	2022-11-01	2	6	2	4	0.621
Primal Age	2022-11-28	3	6	2	5	0.621
DNF DUEL	2022-06-28	12331	2291	1335	13666	0.6206
Winter Games 2023	2022-10-13	10	16	7	17	0.6204999999999999
Unlock Kimono Cuties	2022-04-08	3	16	7	10	0.6204999999999999
Celestial Project	2022-06-22	15	16	7	22	0.6204999999999999
Grand Hike	2022-08-19	4	16	7	11	0.6204999999999999
Sanctum Breach: Rebirth	2022-05-05	12	16	7	19	0.6204999999999999
Equinox	2022-06-12	8	16	7	15	0.6204999999999999
Kunai Strike	2022-06-18	5	16	7	12	0.6204999999999999
Neon Nights 2	2022-11-04	17	16	7	24	0.6204999999999999
Furry Pet Dog Yiff Hentai	2022-07-11	4	16	7	11	0.6204999999999999
Monster Energy Supercross - The Official Videogame 5	2022-03-17	339	243	134	473	0.6203000000000001
SD GUNDAM BATTLE ALLIANCE	2022-08-24	21909	3205	1882	23791	0.6201
Animals Collision	2022-05-02	14	33	16	30	0.62
Tilecraft	2022-10-27	9	33	16	25	0.62
Aethernaut	2022-03-15	9	14	6	15	0.62
Swimmer Admiration	2022-01-20	4	14	6	10	0.62
REDSIDE episode 1	2022-07-29	5	14	6	11	0.62
Barn Finders VR: The Pilot	2022-02-08	6	14	6	12	0.62
Touhou Kimono Blast	2022-12-14	13	14	6	19	0.62
Jean and Josie	2022-06-02	3	14	6	9	0.62
Prop Hunt 2.0	2022-07-13	25	14	6	31	0.62
Mon-Musu Master	2022-05-23	7	14	6	13	0.62
The Sych story: Human Being	2022-02-23	3	14	6	9	0.62
PARANECRO	2022-07-20	4	14	6	10	0.62
Slaughter Cannon 2	2022-05-18	4	14	6	10	0.62
Frog lands	2022-05-26	4	14	6	10	0.62
Villwars	2022-06-14	3	14	6	9	0.62
Holy Paladin Cynthia	2022-12-27	8	14	6	14	0.62
My Stepsis is a Futanari 2	2022-11-29	4	14	6	10	0.62
Magic Kingdom	2022-09-19	3	14	6	9	0.62
Fix My Legs Doc	2022-10-03	2	14	6	8	0.62
Outbreak 2030	2022-12-21	4	14	6	10	0.62
Ragnorium	2022-04-25	190	376	211	401	0.6199
Death Below	2022-12-15	9	44	22	31	0.6197
Silverwing	2022-06-14	3	8	3	6	0.6197
Operation: Pinkeye	2022-11-02	3	8	3	6	0.6197
Hunkenstein	2022-07-27	3	8	3	6	0.6197
From Lex to Rex	2022-03-18	2	8	3	5	0.6197
Doge Dimensions	2022-01-21	2	8	3	5	0.6197
Dragon Evo	2022-11-04	6	8	3	9	0.6197
Rockstar Life	2022-04-21	5	8	3	8	0.6197
My little sister: Prologue	2022-05-13	3	8	3	6	0.6197
欢乐金蟾捕鱼	2022-07-19	12	8	3	15	0.6197
PHOBOS Project	2022-10-24	3	8	3	6	0.6197
Dusk Hollow	2022-10-14	3	8	3	6	0.6197
Àrengard - Invasion	2022-12-11	10	8	3	13	0.6197
22 Racing Series	2022-11-30	6	12	5	11	0.6196
Project Apocalypse	2022-12-20	4	12	5	9	0.6196
Spells and Fellas	2022-11-07	7	12	5	12	0.6196
Rhythium	2022-03-01	9	12	5	14	0.6196
Royal Hentai - Boobs & Pussies	2022-02-07	5	12	5	10	0.6196
Highline Volleyball VR	2022-06-22	3	12	5	8	0.6196
Contact	2022-02-11	5	12	5	10	0.6196
GoodNight	2022-03-16	5	12	5	10	0.6196
Oil Invasion	2022-04-09	3	12	5	8	0.6196
Meekanoid	2022-05-19	2	12	5	7	0.6196
Station Osirius	2022-05-28	4	12	5	9	0.6196
Space Menace	2022-11-11	6	12	5	11	0.6196
Obelixes Tower Defense	2022-06-18	4	12	5	9	0.6196
Target React Force	2022-11-18	4	12	5	9	0.6196
My Mistress	2022-10-19	3	10	4	7	0.6195
Star Trek Prodigy: Supernova	2022-10-14	8	10	4	12	0.6195
Galaxy Citizen	2022-02-07	3	10	4	7	0.6195
SurvivalIsLand	2022-02-09	11	10	4	15	0.6195
Cygnus Racing League	2022-04-06	9	10	4	13	0.6195
Crabby Beach	2022-03-10	3	10	4	7	0.6195
Bard Trainer	2022-03-29	5	10	4	9	0.6195
Falling Elevator	2022-06-06	2	10	4	6	0.6195
Crash Forts 2	2022-07-02	2	10	4	6	0.6195
A LONEY	2022-08-30	3	10	4	7	0.6195
ラブトークス	2022-07-22	4	10	4	8	0.6195
Blooms: Roots of Renewal	2022-09-27	3	10	4	7	0.6195
Huge Jaws	2022-10-11	3	10	4	7	0.6195
Shelter 69	2022-05-16	566	695	398	964	0.6193
Frigore	2022-03-12	64	172	94	158	0.6193
自在逍遥：风起(Tales of TianYuan Dynasty)	2022-10-31	27	31	15	42	0.6193
Conan Chop Chop	2022-03-01	756	374	211	967	0.6189
Need for Speed™ Unbound	2022-12-02	14063	7565	4515	18578	0.6188
Neko Journey	2022-08-15	5	29	14	19	0.6186
Poptropica	2022-05-26	49	60	31	80	0.6185
NBA 2K23	2022-09-08	37213	16096	9694	46907	0.6183
KUR	2022-03-17	9	40	20	29	0.6183
Traitors in Salem	2022-09-14	548	634	365	913	0.6178
Mental Hospital - Child of Evil	2022-01-14	5	27	13	18	0.6178
FIGHTING GIRL SAKURA-R	2022-07-08	19	27	13	32	0.6178
生死狙击2-国服	2022-07-21	7987	11248	6775	14762	0.6176
A Last Will and Testament	2022-08-19	9	38	19	28	0.6176
Couroland	2022-11-07	51	38	19	70	0.6176
Stockwrk7	2022-10-28	392	65	34	426	0.6174000000000001
Godfall	2022-04-07	1762	1124	658	2420	0.617
Civitatem	2022-08-01	20	79	42	62	0.6169
Shibainu - VR Katana Simulator	2022-07-11	6	25	12	18	0.6169
Spectral Showdown	2022-08-15	14	25	12	26	0.6169
Kapital: Sparks of Revolution	2022-04-28	163	119	65	228	0.6163000000000001
Be Funny Now!	2022-05-17	1295	853	499	1794	0.616
Roy's Rugs	2022-05-31	37	23	11	48	0.616
Greed	2022-06-21	37	52	27	64	0.6159
Agelast	2022-11-10	12	34	17	29	0.6159
The Backrooms Footage	2022-09-02	23	43	22	45	0.6158
隐世神剑传	2022-04-25	854	352	202	1056	0.6152000000000001
Call of Duty®: Modern Warfare® II | Warzone™ 2.0	2022-10-28	491670	216172	133831	625501	0.6151
Pleasure Kingdom	2022-03-19	26	32	16	42	0.615
ALTAIR BREAKER	2022-08-18	33	32	16	49	0.615
The Gorcs' Forge	2022-02-14	4	21	10	14	0.6149
九型人格	2022-03-18	5	21	10	15	0.6149
With Good Intentions	2022-10-20	13	21	10	23	0.6149
Idle Factory	2022-07-28	31	21	10	41	0.6149
Mortal Online 2	2022-01-25	9657	6041	3672	13329	0.6143
The Guild 3	2022-06-14	3513	4024	2434	5947	0.6143
Dynamic Dungeons Editor	2022-08-01	78	83	45	123	0.6141
Magic Spellslingers	2022-08-05	1112	323	186	1298	0.614
Magna Fortuna	2022-03-19	179	62	33	212	0.614
Paths & Danger	2022-04-15	12	30	15	27	0.614
World Of Robots	2022-03-11	88	102	56	144	0.6139
Sing Together	2022-04-06	6	19	9	15	0.6138
侦探万事屋-庄园疑案	2022-07-26	15	19	9	24	0.6138
Lost Island	2022-02-02	6	19	9	15	0.6138
Try Me	2022-07-12	7	19	9	16	0.6138
Somerville	2022-11-15	274	334	193	467	0.6135
The Cycle: Frontier	2022-06-08	40854	25371	15671	56525	0.6133
Entasy Online	2022-12-28	45	28	14	59	0.6129
SPECWAR Tactics	2022-01-14	7	17	8	15	0.6125
BARK	2022-09-16	5	17	8	13	0.6125
Learn Programming: Python - Remake	2022-02-21	27	17	8	35	0.6125
Roots of Tomorrow	2022-05-11	20	35	18	38	0.6121
战地奇兵	2022-12-09	95	82	45	140	0.6119
DISGAEA RPG	2022-10-14	417	199	114	531	0.6117
防疫英雄	2022-06-23	46	49	26	72	0.6117
Mireille and Amrita, the Forest of Illusions	2022-01-28	10	15	7	17	0.6111
いせかいあどべんちゃー	2022-03-01	30	15	7	37	0.6111
DRUNKKNIGHT	2022-03-28	3	15	7	10	0.6111
Shell Girls in Puzzle Skulls	2022-04-23	3	15	7	10	0.6111
Hell Green Blue	2022-06-25	3	15	7	10	0.6111
First Sexy Night	2022-07-14	7	15	7	14	0.6111
Vilomah	2022-09-22	6	15	7	13	0.6111
冒险与魔法	2022-10-26	26	15	7	33	0.6111
Bot World	2022-11-21	2	15	7	9	0.6111
Abrissprofi Online	2022-11-17	24	33	17	41	0.611
Orbit.Industries	2022-04-21	102	47	25	127	0.6108
Late photographer 3	2022-03-04	7	24	12	19	0.6104999999999999
Eastern Europe Truck Simulator	2022-04-21	2	24	12	14	0.6104999999999999
Chronos Builder	2022-12-05	13	24	12	25	0.6104999999999999
The Cleaner	2022-05-05	17	59	32	49	0.6103000000000001
Streaming Girls [18+] - OnlyFap ●LIVE	2022-01-15	907	76	42	949	0.6099
Indecent Desires	2022-07-13	102	64	35	137	0.6098
Witchcrafty	2022-03-01	8	31	16	24	0.6098
TRUE SKATE™	2022-11-09	26	31	16	42	0.6098
enJoyTyping	2022-05-27	11	38	20	31	0.6097
NUC: After The Blast	2022-02-08	6	13	6	12	0.6095
Gran Premio	2022-08-14	20	13	6	26	0.6095
Search of Galaxy	2022-01-02	4	13	6	10	0.6095
PuckOFF	2022-05-13	8	13	6	14	0.6095
Space Beastz	2022-04-07	6	13	6	12	0.6095
Sould Dub	2022-02-21	2	13	6	8	0.6095
Zombie Crush Driver	2022-03-09	2	13	6	8	0.6095
New Horizon	2022-08-01	4	13	6	10	0.6095
七月	2022-05-11	3	13	6	9	0.6095
DOLPHIN HUSTLE	2022-05-19	2	13	6	8	0.6095
Mailman	2022-06-09	4	13	6	10	0.6095
Hidden Desert War Top-Down 3D	2022-06-17	3	13	6	9	0.6095
Magic and Elements	2022-06-30	2	13	6	8	0.6095
The Absolute Destroyer	2022-08-23	2	13	6	8	0.6095
Heroes Of The Dark	2022-04-06	255	123	70	325	0.6092000000000001
Darza's Dominion	2022-04-21	1529	575	345	1874	0.609
The Gallery	2022-09-08	11	22	11	22	0.609
Lightspeed Dating	2022-11-30	19	22	11	30	0.609
Scribbleman Army	2022-09-23	21	22	11	32	0.609
Disgaea 6 Complete	2022-06-28	630	191	111	741	0.6087
MAGLAM LORD	2022-05-30	67	36	19	86	0.6085
Grim Horde	2022-06-21	37	36	19	56	0.6085
TYPER GIRL	2022-05-23	12	36	19	31	0.6085
FireJumpers Inferno	2022-10-06	40	29	15	55	0.6085
Key Puss	2022-04-29	8	29	15	23	0.6085
Dread Hunger	2022-01-26	107982	26405	16689	124671	0.6082
Police Shootout: Prologue	2022-04-26	413	223	131	544	0.6078
Expedition Zero	2022-03-24	64	92	52	116	0.6078
Playback Trauma: The Beach	2022-01-26	2	11	5	7	0.6076
RPGolf Legends	2022-01-20	12	11	5	17	0.6076
早苗討魔伝X2 (Sanae Toumaden X2)	2022-11-13	4	11	5	9	0.6076
EPIC KNIGHT	2022-01-25	4	11	5	9	0.6076
Gods Of Isekai	2022-02-10	11	11	5	16	0.6076
VR Hentai Sex Party	2022-02-07	3	11	5	8	0.6076
Hypermind	2022-03-15	9	11	5	14	0.6076
Marble Ball Friends	2022-04-29	85	11	5	90	0.6076
Rage Night	2022-12-15	10	11	5	15	0.6076
Sex Adventures - Futanari Doctor	2022-03-18	3	11	5	8	0.6076
Brave Survivor	2022-05-13	3	11	5	8	0.6076
Mystery Quest	2022-05-20	3	11	5	8	0.6076
Miner of Minerals	2022-05-03	3	11	5	8	0.6076
TOTEMS	2022-05-30	3	11	5	8	0.6076
Napped	2022-10-05	4	11	5	9	0.6076
Ease Out	2022-11-18	5	11	5	10	0.6076
Mining Factory	2022-11-27	16	11	5	21	0.6076
Reverse Defenders	2022-04-11	44	20	10	54	0.6074
Bewildered	2022-06-20	12	20	10	22	0.6074
Crystal Goddess	2022-10-21	9	20	10	19	0.6074
WILD WEST	2022-02-04	5	20	10	15	0.6074
Goth Dating Sim 2022	2022-03-09	14	20	10	24	0.6074
Car Wash Simulator	2022-08-26	3	20	10	13	0.6074
The Callisto Protocol	2022-12-02	17580	16130	10201	27781	0.6073
战略三国	2022-10-21	22	34	18	40	0.6073
Aircraft Carrier Survival	2022-04-20	2342	507	306	2648	0.6072
Drakensang Online	2022-09-27	399	451	272	671	0.6067
Meat Saw	2022-03-12	18	76	43	61	0.6058
Horrors of Space	2022-09-30	9	25	13	22	0.6055
Flipstown	2022-02-21	6	18	9	15	0.6055
The Rusty Sword: Vanguard Island	2022-05-02	3	18	9	12	0.6055
Overrogue	2022-07-07	41	18	9	50	0.6055
Idle Maku	2022-07-29	10	18	9	19	0.6055
重装战线	2022-08-30	25	18	9	34	0.6055
Sinner 97: Prologue	2022-09-22	11	18	9	20	0.6055
Heroes of Eroticism - New Beginnings	2022-10-20	27	18	9	36	0.6055
Phantom Racing	2022-05-23	28	54	30	58	0.6054
Tournament: Blood & Steel	2022-08-27	2	9	4	6	0.6054
The Dragon and the Djinn	2022-07-28	30	9	4	34	0.6054
100 Doors: Escape from Work	2022-03-02	7	9	4	11	0.6054
Animation Studio Manager	2022-04-08	5	9	4	9	0.6054
Escape from Cronos X	2022-03-15	4	9	4	8	0.6054
灵子：重返荒野	2022-03-11	4	9	4	8	0.6054
Сrime Сity	2022-04-13	2	9	4	6	0.6054
小小商人传奇	2022-08-28	9	9	4	13	0.6054
Irritability & Mood Swings	2022-04-16	3	9	4	7	0.6054
Vacuum Story	2022-06-24	2	9	4	6	0.6054
Restaurant Simulator	2022-08-03	2	9	4	6	0.6054
BCI Horror Attraction	2022-06-06	4	9	4	8	0.6054
Demons Crusher	2022-05-26	5	9	4	9	0.6054
Ink World	2022-06-03	2	9	4	6	0.6054
Secret Backrooms	2022-05-30	3	9	4	7	0.6054
Art your brains	2022-06-23	4	9	4	8	0.6054
Night of the Wererat	2022-10-08	3	9	4	7	0.6054
Hentai Heaven's Slutty Salvation	2022-10-07	10	9	4	14	0.6054
Saturn Quest: R. U. N. E. 3000	2022-10-28	5	9	4	9	0.6054
Follow The Crown	2022-11-21	8	9	4	12	0.6054
Automatic war	2022-11-02	3	9	4	7	0.6054
Ragnarök TD	2022-12-09	7	9	4	11	0.6054
Nickelodeon Kart Racers 3: Slime Speedway	2022-10-14	39	42	23	62	0.6047
The Unliving	2022-11-07	1168	274	165	1333	0.6043000000000001
Retreat To Enen	2022-08-01	408	190	113	521	0.6043000000000001
Remoteness	2022-09-23	20	72	41	61	0.6042000000000001
浮生箓	2022-02-18	298	105	61	359	0.6041
My Furry Teacher	2022-03-19	12	35	19	31	0.6038
Twelve Floors Below.	2022-05-31	3	23	12	15	0.6037
Doxxed	2022-08-30	5	16	8	13	0.6034
Jetpackman	2022-01-25	4	16	8	12	0.6034
Wildlife Planet: The Incremental	2022-08-26	42	16	8	50	0.6034
Adrianne and Oliver	2022-12-01	40	16	8	48	0.6034
Third Power	2022-09-01	6	16	8	14	0.6034
Sinister Night	2022-06-09	187	106	62	249	0.603
Danganronpa S: Ultimate Summer Camp	2022-07-21	206	203	122	328	0.6028
Command & Control 3	2022-09-08	15	28	15	30	0.6028
McSpace Colosseum	2022-01-17	6	7	3	9	0.6028
Argonauts Agency: Glove of Midas	2022-01-05	7	7	3	10	0.6028
Bullet Bash	2022-06-23	138	7	3	141	0.6028
TypeOut	2022-11-30	27	7	3	30	0.6028
Fight Ascending	2022-06-09	2	7	3	5	0.6028
Super Kit: TO THE TOP	2022-07-12	3	7	3	6	0.6028
Fadry	2022-06-21	3	7	3	6	0.6028
Save Us	2022-02-10	6	7	3	9	0.6028
Funny Pets	2022-01-14	3	7	3	6	0.6028
Lost Artifacts Mysterious Book Collector's Edition	2022-03-18	5	7	3	8	0.6028
Loading Zone	2022-03-14	13	7	3	16	0.6028
Climax Heroines	2022-03-01	6	7	3	9	0.6028
Sex Adventures - The SPA	2022-02-21	3	7	3	6	0.6028
Retro Karting 22	2022-05-09	6	7	3	9	0.6028
Survirus	2022-05-12	5	7	3	8	0.6028
Drifter's Tales	2022-07-09	107	7	3	110	0.6028
Hard Block Girls: Sex Life	2022-05-11	2	7	3	5	0.6028
City Things	2022-06-09	2	7	3	5	0.6028
Milf Bar	2022-06-28	4	7	3	7	0.6028
Camp Laughter	2022-10-13	4	7	3	7	0.6028
AimX	2022-08-19	3	7	3	6	0.6028
江山如画	2022-08-31	11	7	3	14	0.6028
Poolgame	2022-10-21	4	7	3	7	0.6028
Detective Agency Gray Tie	2022-10-30	6	7	3	9	0.6028
Carpe Diem Project	2022-11-17	4	7	3	7	0.6028
Cyber Skirmish	2022-11-18	25	7	3	28	0.6028
Tower! Simulator 3	2022-12-13	117	117	69	186	0.6023
Netorious Neighbor Cumming for their Wives!	2022-04-15	20	33	18	38	0.6023
Cyber Car	2022-05-12	19	48	27	46	0.6020000000000001
Exorcist Charlotte	2022-06-10	34	43	24	58	0.6020000000000001
Moon Farming - Prologue	2022-01-06	298	170	102	400	0.6019
Nokta	2022-12-25	25	21	11	36	0.6017
Waifu Crush	2022-06-18	15	21	11	26	0.6017
Make Your Kingdom	2022-01-20	141	118	70	211	0.6013000000000001
After Dark VR	2022-01-21	19	56	32	51	0.6011
Girls Overboard	2022-06-02	54	74	43	97	0.601
Immortals Fenyx Rising	2022-12-15	909	586	366	1275	0.6009000000000001
Idle Monster Frontier	2022-10-24	229	121	72	301	0.6009000000000001
Brave Princess Milia	2022-04-08	11	14	7	18	0.6009000000000001
Aria and the Secret of the Labyrinth	2022-05-03	8	14	7	15	0.6009000000000001
Skullnight	2022-03-21	2	14	7	9	0.6009000000000001
Mayor T-Rex	2022-06-13	5	14	7	12	0.6009000000000001
BomberGuys	2022-10-03	13	14	7	20	0.6009000000000001
KAOS SurVival	2022-08-01	47	69	40	87	0.6007
Cyber Girl - Zombie Hentai 💀💖	2022-11-15	13	36	20	33	0.6006
The Red Hood	2022-03-14	3	31	17	20	0.6006
Agonize	2022-09-17	205	85	50	255	0.6001
麻雀一番街	2022-09-08	1010	452	282	1292	0.5999
天下镖局	2022-09-26	114	133	80	194	0.5997
Dark Throne : The Queen Rises	2022-10-14	47	67	39	86	0.5997
iaido	2022-12-26	2	5	2	4	0.5997
Super Rhythm Duel	2022-01-24	2	5	2	4	0.5997
Break	2022-01-20	3	5	2	5	0.5997
The Vaults	2022-04-15	6	5	2	8	0.5997
Peak Darkness	2022-10-31	36	5	2	38	0.5997
NaÀra: Contos de Resistência	2022-01-31	4	5	2	6	0.5997
Tree of Mu	2022-12-01	5	5	2	7	0.5997
Incubus Express	2022-09-27	5	5	2	7	0.5997
The Revival	2022-08-25	2	5	2	4	0.5997
Biggest Stream Hover Racing	2022-03-18	3	5	2	5	0.5997
修真元界	2022-10-28	4	5	2	6	0.5997
BasaultVR	2022-01-31	3	5	2	5	0.5997
退魔聖女マリベル～サキュバスの誘惑	2022-03-23	5	5	2	7	0.5997
超级公司（Super Company）	2022-10-24	5	5	2	7	0.5997
DarkBlood -Reborn-	2022-02-25	10	5	2	12	0.5997
BLANK SPACE	2022-12-03	5	5	2	7	0.5997
CrazyParty	2022-01-07	17	5	2	19	0.5997
Honey Homer	2022-04-21	2	5	2	4	0.5997
ZPlague	2022-07-24	4	5	2	6	0.5997
Memory Novel - Lesbian Romance	2022-01-30	2	5	2	4	0.5997
GEHENA	2022-03-12	2	5	2	4	0.5997
Escape Game - FORT BOYARD 2022	2022-07-07	6	5	2	8	0.5997
轮回之理	2022-11-05	6	5	2	8	0.5997
Bibi & Tina - New adventures with horses	2022-07-19	5	5	2	7	0.5997
Boat Simulator 2022	2022-05-03	4	5	2	6	0.5997
Spider Solitaire Collection	2022-05-26	8	5	2	10	0.5997
F.I.D.O.	2022-04-23	4	5	2	6	0.5997
Scary Husband HD	2022-04-20	2	5	2	4	0.5997
Nell Watson's Founder Life	2022-07-11	4	5	2	6	0.5997
Bean Story	2022-05-26	2	5	2	4	0.5997
Champ's Nightmare	2022-07-19	3	5	2	5	0.5997
三国英雄坛	2022-06-17	7	5	2	9	0.5997
The Dead Sea Scrolls Adventure	2022-06-13	2	5	2	4	0.5997
Under Siege 2	2022-06-18	4	5	2	6	0.5997
Mini Star Fishing	2022-09-01	6	5	2	8	0.5997
Madman Catcher	2022-06-15	3	5	2	5	0.5997
火辣极速	2022-06-17	7	5	2	9	0.5997
The Chicken Game	2022-12-17	7	5	2	9	0.5997
Prototypers	2022-07-12	3	5	2	5	0.5997
Northern Kingdoms	2022-09-28	2	5	2	4	0.5997
Star Devil	2022-12-02	3	5	2	5	0.5997
The In Between	2022-11-06	7	5	2	9	0.5997
ChatFight!	2022-10-04	4	5	2	6	0.5997
Ignite	2022-10-04	3	5	2	5	0.5997
山海长歌	2022-08-24	3	5	2	5	0.5997
Maze Blaze	2022-10-06	4	5	2	6	0.5997
Tsundere Girls	2022-08-31	2	5	2	4	0.5997
Didactic Jesus Game	2022-12-23	10	5	2	12	0.5997
The Game Store	2022-10-04	3	5	2	5	0.5997
1990	2022-10-03	2	5	2	4	0.5997
Insomnia	2022-11-11	2	5	2	4	0.5997
Soulslinger	2022-10-26	3	5	2	5	0.5997
妖精カードローグ ~ Fairy Card Rogue	2022-12-05	7	5	2	9	0.5997
Luna & Monsters TD -The deprived magical kingdom-	2022-12-20	4	5	2	6	0.5997
Levels	2022-11-23	3	5	2	5	0.5997
Scavenia Survivors	2022-12-11	3	5	2	5	0.5997
Mindworks: The Great Division	2022-11-30	2	5	2	4	0.5997
Dance Fight	2022-12-08	2	5	2	4	0.5997
Grinded Meat	2022-12-24	2	5	2	4	0.5997
MotorCubs RC	2022-12-30	2	5	2	4	0.5997
Battle of Kings	2022-10-17	16	19	10	26	0.5994
Horse Tales: Emerald Valley Ranch 	2022-11-03	614	333	207	821	0.5991
It's Dark	2022-07-15	27	34	19	46	0.5989
Serious Fun Football	2022-07-14	13	24	13	26	0.5989
ALUMNI	2022-07-08	9	24	13	22	0.5989
Era of Combat: Boxing	2022-02-26	15	29	16	31	0.5988
Crossfire: Legion	2022-12-08	383	426	267	650	0.5987
Elemental War 2	2022-05-06	10	12	6	16	0.598
PARTY RUSH!!	2022-03-24	5	12	6	11	0.598
Deep Space Salvage Crew VR	2022-07-08	7	12	6	13	0.598
Achromira	2022-01-24	10	12	6	16	0.598
Red Conquer	2022-01-28	3	12	6	9	0.598
Pirate treasure	2022-05-26	5	12	6	11	0.598
Ambulance Chauffeur Simulator	2022-08-25	2	12	6	8	0.598
四分之三空间站	2022-10-31	6	12	6	12	0.598
dot TANKI	2022-10-27	3	12	6	9	0.598
Dragon Blast	2022-09-15	24	42	24	48	0.5979
Super Life: Franchise Lord	2022-05-12	158	55	32	190	0.5978
Sex Gym 3D	2022-12-03	52	82	49	101	0.5970000000000001
Valthirian Arc: Hero School Story 2	2022-03-31	37	27	15	52	0.5968
Sheep in Dreams	2022-12-09	42	27	15	57	0.5968
物质与魔法	2022-03-18	59	17	9	68	0.5968
KickNSlap	2022-05-11	5	17	9	14	0.5968
Save the Girl	2022-08-29	2	17	9	11	0.5968
Doobi's Adventure	2022-12-06	33	17	9	42	0.5968
Winter Ember	2022-04-19	75	53	31	106	0.5966
STOLEN CITY	2022-05-20	12	22	12	24	0.5966
Penitence	2022-06-15	6	22	12	18	0.5966
The Last City	2022-06-04	6	22	12	18	0.5966
Ancient Witch Arena Prologue	2022-09-23	45	22	12	57	0.5966
ドラゴンクエストＸ　目覚めし五つの種族　オフライン	2022-09-14	3538	77	46	3584	0.5965
九天剑侠传Idle RPG	2022-03-24	61	40	23	84	0.5963
Godumas	2022-07-29	25	40	23	48	0.5963
Romance of the Three Kingdoms Hadou	2022-02-28	344	48	28	372	0.596
Zofia	2022-09-27	4	3	1	5	0.596
Danger Forever	2022-11-01	3	3	1	4	0.596
Camped Out!	2022-09-22	4	3	1	5	0.596
Neon Breaker	2022-07-20	2	3	1	3	0.596
VoidGate	2022-06-15	2	3	1	3	0.596
Player Goes Jump	2022-03-04	3	3	1	4	0.596
Chimeras: Wailing Waters Collector's Edition	2022-07-01	6	3	1	7	0.596
Wardens	2022-09-15	2	3	1	3	0.596
Seven Dunes: Curse on the Golden Sand	2022-01-08	1	3	1	2	0.596
Memory Illusions	2022-08-17	2	3	1	3	0.596
Cyberborn	2022-02-12	2	3	1	3	0.596
Kings0	2022-02-10	4	3	1	5	0.596
Monads II	2022-01-07	3	3	1	4	0.596
Deios I // Directors Cut	2022-05-12	1	3	1	2	0.596
Metal Tales: Overkill	2022-04-22	3	3	1	4	0.596
Emanate	2022-02-18	2	3	1	3	0.596
Super Space Serpent SE	2022-05-10	1	3	1	2	0.596
Ministry of Pandemic	2022-01-01	3	3	1	4	0.596
Contingency Creatures	2022-09-30	4	3	1	5	0.596
The Temple Of	2022-10-31	2	3	1	3	0.596
Kitsu's Destiny	2022-11-10	2	3	1	3	0.596
Tombstone	2022-07-06	2	3	1	3	0.596
Space Worthy	2022-06-07	2	3	1	3	0.596
Daldos	2022-04-18	2	3	1	3	0.596
Infested	2022-10-22	3	3	1	4	0.596
Droid404	2022-04-20	3	3	1	4	0.596
刺魔猎人THORN DEMON HUNTER	2022-05-13	2	3	1	3	0.596
Undying Lantern	2022-05-27	2	3	1	3	0.596
2030	2022-02-21	2	3	1	3	0.596
Shoot!	2022-02-25	2	3	1	3	0.596
Pusheep	2022-03-24	2	3	1	3	0.596
Hallowlands	2022-10-11	3	3	1	4	0.596
Ilum	2022-06-24	3	3	1	4	0.596
S&M Lessons with the Cute Masochist Maid: I’ll teach you the secret techniques of your clan in place of your father!	2022-01-21	4	3	1	5	0.596
Molecoole	2022-02-24	4	3	1	5	0.596
My Soldiers	2022-01-29	4	3	1	5	0.596
Alien Shepherd	2022-02-25	3	3	1	4	0.596
CubeHook VR	2022-01-07	1	3	1	2	0.596
黄金时代	2022-01-29	3	3	1	4	0.596
魔法少女ですがダンジョンで無限に強くなってもいいですか	2022-01-14	4	3	1	5	0.596
Solar Lewd Hollow starring Doug Fooker	2022-12-16	3	3	1	4	0.596
Salaryman Shi	2022-06-30	4	3	1	5	0.596
Project Myriad 2	2022-01-14	2	3	1	3	0.596
Spellcaster	2022-01-16	2	3	1	3	0.596
Ember Crusade IV	2022-08-19	3	3	1	4	0.596
The Augury House	2022-01-27	2	3	1	3	0.596
Space Penguins	2022-06-02	4	3	1	5	0.596
Royal Roads 3 Portal	2022-08-15	4	3	1	5	0.596
Cake4D	2022-09-12	2	3	1	3	0.596
SugarKiss!	2022-02-18	4	3	1	5	0.596
Villager comes alive	2022-12-27	1	3	1	2	0.596
Lucky Tlhalerwa - Super Incursion	2022-02-04	2	3	1	3	0.596
Hockey Shooter VR	2022-02-18	1	3	1	2	0.596
One Of The Victims	2022-04-04	1	3	1	2	0.596
The Soulstream Expansive: Prelude	2022-02-20	2	3	1	3	0.596
Big Screen Games - Pack 1	2022-03-18	16	3	1	17	0.596
Labyrinth	2022-04-07	1	3	1	2	0.596
Gaslamp Cases 3: Ancient Secrets	2022-02-10	5	3	1	6	0.596
Parasight Prologue	2022-03-19	2	3	1	3	0.596
A Night With Gigsjaw VR	2022-02-27	1	3	1	2	0.596
Diamon Jones and the Amulet of the World	2022-03-03	3	3	1	4	0.596
Lootbox RPG	2022-02-27	4	3	1	5	0.596
Lofi Hollow	2022-03-04	3	3	1	4	0.596
The Finnish War	2022-03-18	2	3	1	3	0.596
JoJo Siwa: Worldwide Party	2022-10-21	3	3	1	4	0.596
THE UNKNOWN HALLS	2022-03-07	2	3	1	3	0.596
Maximum Velocity	2022-10-29	8	3	1	9	0.596
Pop Top Adventure	2022-03-15	3	3	1	4	0.596
Permanence TD	2022-04-02	2	3	1	3	0.596
The Hole	2022-05-13	2	3	1	3	0.596
Miko no Kanata: Curious Tales from Oguni Shrine -Cycles-	2022-08-05	4	3	1	5	0.596
Brick Breaker	2022-04-06	3	3	1	4	0.596
The Infernal Return	2022-09-10	1	3	1	2	0.596
目标：登顶	2022-07-22	2	3	1	3	0.596
Quantum Apex	2022-04-29	2	3	1	3	0.596
Exterminate Zombies: Get Paid	2022-10-10	6	3	1	7	0.596
VOSS Turbo	2022-04-07	4	3	1	5	0.596
Solitaire Beach Season A Vacation Time	2022-05-23	2	3	1	3	0.596
楚汉争霸	2022-04-24	5	3	1	6	0.596
Movie Theater Simulator	2022-08-02	1	3	1	2	0.596
Anna VS the A.I.maze	2022-05-13	14	3	1	15	0.596
Horrid Henry's Krazy Karts	2022-06-30	3	3	1	4	0.596
Joker Poker - Video Poker	2022-05-14	3	3	1	4	0.596
MasterQ	2022-07-19	2	3	1	3	0.596
Krystals With A K	2022-12-08	2	3	1	3	0.596
Neko Girls: Hentai Jigsaw Photo Studio	2022-07-15	4	3	1	5	0.596
Tirsy's Tale	2022-09-26	4	3	1	5	0.596
Beanstalk	2022-06-01	4	3	1	5	0.596
Speaker of Worlds	2022-05-16	2	3	1	3	0.596
Watercolor Hell	2022-05-26	2	3	1	3	0.596
Tales of Ágaris	2022-05-23	67	3	1	68	0.596
Tiny Robo Puzzles	2022-06-21	2	3	1	3	0.596
TRESPASSER 2	2022-09-28	1	3	1	2	0.596
Silver Lines	2022-10-24	1	3	1	2	0.596
SnailQuest	2022-06-29	2	3	1	3	0.596
Astro Ike	2022-06-18	1	3	1	2	0.596
PieceWars	2022-07-01	2	3	1	3	0.596
Memory Puzzle - Futanari Doctor	2022-06-11	2	3	1	3	0.596
Rolling Rush	2022-12-20	4	3	1	5	0.596
Maelstrom	2022-07-01	2	3	1	3	0.596
Elemates	2022-07-08	2	3	1	3	0.596
Maze Mart	2022-08-01	3	3	1	4	0.596
Individualand	2022-10-14	5	3	1	6	0.596
哪吒三太子	2022-07-15	4	3	1	5	0.596
Nash Racing 3: Drifter	2022-07-26	2	3	1	3	0.596
Super Kenney	2022-08-11	3	3	1	4	0.596
Dice Roller VR	2022-11-08	2	3	1	3	0.596
Spirits Chronicles: Flower Of Hope Collector's Edition	2022-07-19	9	3	1	10	0.596
Our Hero! Last	2022-10-14	2	3	1	3	0.596
Bounce your Bullets!	2022-08-24	2	3	1	3	0.596
69 Yuuko Hot	2022-09-16	3	3	1	4	0.596
Dodge Mania	2022-07-29	4	3	1	5	0.596
Sexy Hentai Puzzle	2022-09-10	3	3	1	4	0.596
BombViking	2022-08-12	2	3	1	3	0.596
Twistingo Collector's Edition	2022-08-15	3	3	1	4	0.596
ProjectZombieSurvivors	2022-08-13	5	3	1	6	0.596
Futanari Sex - Office Whores	2022-08-02	3	3	1	4	0.596
Magus Pocus	2022-08-17	1	3	1	2	0.596
Memory Puzzle - Futanari Boss	2022-07-29	2	3	1	3	0.596
Sex Adventures - The Pool Party	2022-08-23	3	3	1	4	0.596
Dash FPS	2022-08-18	3	3	1	4	0.596
Kitty's Venture	2022-10-03	2	3	1	3	0.596
SKY TOMB	2022-11-22	3	3	1	4	0.596
Morning Kiss	2022-09-01	2	3	1	3	0.596
Pure Love	2022-09-01	1	3	1	2	0.596
Pixel Boy: The Legend of Tain	2022-10-07	1	3	1	2	0.596
最后四人-The last four	2022-10-05	1	3	1	2	0.596
Mortal Dark	2022-09-02	2	3	1	3	0.596
Space Bot	2022-11-08	3	3	1	4	0.596
Legend of Snake	2022-09-07	1	3	1	2	0.596
89	2022-09-13	3	3	1	4	0.596
Midnight Rhapsody	2022-11-02	3	3	1	4	0.596
Goliath: Playing With Reality	2022-10-13	2	3	1	3	0.596
Realm of Khaos	2022-11-29	3	3	1	4	0.596
Ruins	2022-11-07	2	3	1	3	0.596
Sumiii	2022-10-05	4	3	1	5	0.596
Da Tutu	2022-10-18	1	3	1	2	0.596
Fish the Detective!	2022-10-13	2	3	1	3	0.596
夢隠し - Dreamed Away	2022-10-07	3	3	1	4	0.596
Thief City	2022-10-15	8	3	1	9	0.596
Fading Light: Antiworld	2022-10-24	3	3	1	4	0.596
Transliminal	2022-11-15	2	3	1	3	0.596
Now you are the persecuted	2022-12-25	2	3	1	3	0.596
Blue Funk	2022-11-18	1	3	1	2	0.596
Angelic Wishes	2022-11-03	2	3	1	3	0.596
The Iron Union	2022-12-22	2	3	1	3	0.596
GrassGames Hearts 3	2022-11-10	3	3	1	4	0.596
Load Slinging VR Training	2022-11-15	1	3	1	2	0.596
Wintersdawn in the Deep	2022-12-02	1	3	1	2	0.596
Christmas Wonderland 13	2022-12-01	8	3	1	9	0.596
Bridge Engineer	2022-12-02	2	3	1	3	0.596
Shy Girl	2022-11-22	2	3	1	3	0.596
Head Basketball	2022-12-12	2	3	1	3	0.596
Amber Time Pocket	2022-11-21	1	3	1	2	0.596
Reflections of Life: Spindle of Fate Collector's Edition	2022-11-18	6	3	1	7	0.596
Neo Shock	2022-12-07	2	3	1	3	0.596
Artistic Girl 1	2022-05-04	55	56	33	88	0.5959000000000001
Mot De Pass	2022-01-11	10	35	20	30	0.5958
Dakar Desert Rally	2022-10-04	430	519	332	762	0.5955
MX vs ATV Legends	2022-06-28	464	516	330	794	0.5955
Airoheart	2022-09-30	55	30	17	72	0.5952000000000001
There Won't be Light	2022-09-25	11	30	17	28	0.5952000000000001
Ooglians	2022-12-15	64	111	68	132	0.595
大江湖之苍龙与白鸟	2022-08-16	4298	1706	1118	5416	0.5946
LOLLIPOP: SUMMER!	2022-11-20	28	54	32	60	0.5946
Sanctuary Island	2022-01-14	30	10	5	35	0.5943
Zleepy	2022-10-01	4	10	5	9	0.5943
Royal Frontier	2022-03-18	9	10	5	14	0.5943
Hot Milf 3	2022-01-06	4	10	5	9	0.5943
城堡与冒险	2022-01-16	5	10	5	10	0.5943
Van Van Up!	2022-01-26	2	10	5	7	0.5943
Surreal Nightmare	2022-01-31	4	10	5	9	0.5943
Magic crystals	2022-02-24	6	10	5	11	0.5943
Arena Drift Master	2022-03-09	2	10	5	7	0.5943
Cyber Bay	2022-05-20	6	10	5	11	0.5943
My Naughty Summer Vacation ~Days in Countryside and Memories of Summer~	2022-06-23	12	10	5	17	0.5943
CandySweet	2022-07-27	2	10	5	7	0.5943
时空旅法师	2022-12-15	5	10	5	10	0.5943
HÜDDAM	2022-11-12	2	10	5	7	0.5943
HOSPICE Vol. 1	2022-11-24	2	10	5	7	0.5943
UniverseV: Star Domination	2022-09-08	1	1	0	1	0.5942000000000001
Stream Games Deluxe	2022-04-15	2	1	0	2	0.5942000000000001
Set 'N Det	2022-01-14	6	1	0	6	0.5942000000000001
Space Betrayers	2022-01-26	22	1	0	22	0.5942000000000001
A Spooky Teaparty	2022-10-29	4	1	0	4	0.5942000000000001
Roojack	2022-06-01	2	1	0	2	0.5942000000000001
Rule The World	2022-07-07	1	1	0	1	0.5942000000000001
Pepper's Castle	2022-03-30	2	1	0	2	0.5942000000000001
The Curator	2022-04-06	3	1	0	3	0.5942000000000001
Japanese: A-N	2022-06-08	1	1	0	1	0.5942000000000001
Agtnan: Monster Shutdown Sequence	2022-07-22	2	1	0	2	0.5942000000000001
Cops Kissing Each Other	2022-02-22	2	1	0	2	0.5942000000000001
B.U.G. Force	2022-02-05	2	1	0	2	0.5942000000000001
The Unseen Fears: Stories Untold Collector's Edition	2022-05-20	7	1	0	7	0.5942000000000001
Myoubouh Catcher	2022-01-07	2	1	0	2	0.5942000000000001
Lock; In	2022-06-03	1	1	0	1	0.5942000000000001
A Thousand Years	2022-10-24	2	1	0	2	0.5942000000000001
佣兵之旅	2022-05-05	6	1	0	6	0.5942000000000001
Balkadia	2022-04-28	2	1	0	2	0.5942000000000001
The Maze	2022-06-07	2	1	0	2	0.5942000000000001
In Space	2022-12-29	3	1	0	3	0.5942000000000001
MYSTERY of the Missing Brigantine	2022-02-03	4	1	0	4	0.5942000000000001
Crossroads of Helmia	2022-08-31	1	1	0	1	0.5942000000000001
Wacky Wizarding Dungeon	2022-03-30	2	1	0	2	0.5942000000000001
御剑飞行射击训练空间	2022-09-26	1	1	0	1	0.5942000000000001
Gardens Of Celestial Globes	2022-07-20	3	1	0	3	0.5942000000000001
Godland : The Fire Quest	2022-05-31	1	1	0	1	0.5942000000000001
The Birthday	2022-09-01	1	1	0	1	0.5942000000000001
Tower	2022-10-17	1	1	0	1	0.5942000000000001
Zone Of War	2022-03-23	1	1	0	1	0.5942000000000001
The Deed of Deception	2022-02-18	4	1	0	4	0.5942000000000001
Apsis	2022-02-25	3	1	0	3	0.5942000000000001
Cavatus	2022-11-11	2	1	0	2	0.5942000000000001
Mothercore	2022-08-01	3	1	0	3	0.5942000000000001
Rowfall	2022-09-30	3	1	0	3	0.5942000000000001
Mauri Mursu's Hangover	2022-11-02	2	1	0	2	0.5942000000000001
folding maze	2022-04-04	3	1	0	3	0.5942000000000001
El Mucho	2022-02-20	1	1	0	1	0.5942000000000001
Asteroid Arena	2022-05-30	2	1	0	2	0.5942000000000001
Notebook Ninja Fights	2022-03-01	1	1	0	1	0.5942000000000001
10K & The Kriminal World - Sammy's Attack	2022-03-24	1	1	0	1	0.5942000000000001
Ragdoll Funhouse	2022-06-10	2	1	0	2	0.5942000000000001
Cardlike	2022-11-16	1	1	0	1	0.5942000000000001
Knight Flight	2022-12-22	1	1	0	1	0.5942000000000001
Phobyark	2022-03-24	1	1	0	1	0.5942000000000001
Society's Paradigms	2022-05-05	2	1	0	2	0.5942000000000001
Gedel Escape	2022-02-22	2	1	0	2	0.5942000000000001
Speedbreak Hyperdrive	2022-10-07	2	1	0	2	0.5942000000000001
Bloon Rush	2022-02-04	9	1	0	9	0.5942000000000001
Abyss	2022-03-30	2	1	0	2	0.5942000000000001
ShiningBlade	2022-01-05	1	1	0	1	0.5942000000000001
Abyss King	2022-05-03	1	1	0	1	0.5942000000000001
Sadness Of Valor	2022-12-30	2	1	0	2	0.5942000000000001
Sci-Fantasy Defence	2022-03-14	3	1	0	3	0.5942000000000001
Invasion: Neo Earth	2022-10-07	2	1	0	2	0.5942000000000001
Ace Breakout	2022-07-13	3	1	0	3	0.5942000000000001
奥术卡牌	2022-06-30	2	1	0	2	0.5942000000000001
Swoon!	2022-11-24	1	1	0	1	0.5942000000000001
Missing Love	2022-03-17	2	1	0	2	0.5942000000000001
Forever Alone	2022-09-16	2	1	0	2	0.5942000000000001
Dumb Bomb Game	2022-03-10	1	1	0	1	0.5942000000000001
F-15 Strike Eagle	2022-01-20	1	1	0	1	0.5942000000000001
LATAMAN	2022-02-08	1	1	0	1	0.5942000000000001
Dungeon Conqueror	2022-01-07	1	1	0	1	0.5942000000000001
Inertia	2022-02-24	1	1	0	1	0.5942000000000001
Finley's - The Colour of Radiation	2022-08-31	1	1	0	1	0.5942000000000001
Light Crawler	2022-02-25	1	1	0	1	0.5942000000000001
Ginger - The Tooth Fairy	2022-07-13	1	1	0	1	0.5942000000000001
BeeCraft	2022-09-09	6	1	0	6	0.5942000000000001
Lonely Tribes	2022-03-01	1	1	0	1	0.5942000000000001
SILO27: Crashlanded	2022-01-31	2	1	0	2	0.5942000000000001
Alien Colosseum	2022-11-25	1	1	0	1	0.5942000000000001
BarginToWin	2022-09-02	2	1	0	2	0.5942000000000001
Ultra Thunderball	2022-01-13	1	1	0	1	0.5942000000000001
Old Gods	2022-05-19	2	1	0	2	0.5942000000000001
Dungeon Delvers	2022-06-01	2	1	0	2	0.5942000000000001
Chronomaster	2022-02-03	2	1	0	2	0.5942000000000001
The Netrunner Awaken1ng	2022-05-24	4	1	0	4	0.5942000000000001
Chessie Chicken	2022-03-23	2	1	0	2	0.5942000000000001
Bombs Away	2022-07-16	1	1	0	1	0.5942000000000001
Levenium	2022-08-22	1	1	0	1	0.5942000000000001
Hovercraft Racing	2022-09-27	1	1	0	1	0.5942000000000001
Nodrog's Fortress	2022-10-30	12	1	0	12	0.5942000000000001
Faye: A Tale of Shadow	2022-02-14	1	1	0	1	0.5942000000000001
The Most Boring Life Ever 2 - Work From Home	2022-12-22	1	1	0	1	0.5942000000000001
Apré Lapli	2022-10-13	2	1	0	2	0.5942000000000001
Mad Trapper	2022-10-04	1	1	0	1	0.5942000000000001
Secret Garden	2022-03-08	1	1	0	1	0.5942000000000001
Emote Farming Simulator	2022-01-07	3	1	0	3	0.5942000000000001
Tank Sudoku	2022-04-29	1	1	0	1	0.5942000000000001
Shadow Life	2022-05-09	1	1	0	1	0.5942000000000001
Universal Enemies	2022-04-28	3	1	0	3	0.5942000000000001
L.O.L. Surprise! B.B.s BORN TO TRAVEL™	2022-10-07	4	1	0	4	0.5942000000000001
Asha	2022-10-26	1	1	0	1	0.5942000000000001
めだアビ～プシーニの謎～	2022-03-10	2	1	0	2	0.5942000000000001
Reflex	2022-03-26	1	1	0	1	0.5942000000000001
Underground escape 地底逃生	2022-01-15	1	1	0	1	0.5942000000000001
7 Days Of Rose	2022-12-09	2	1	0	2	0.5942000000000001
アニメ Parkour War	2022-03-07	1	1	0	1	0.5942000000000001
Ruin or Victory	2022-05-27	2	1	0	2	0.5942000000000001
accelerating hotkeys	2022-01-28	1	1	0	1	0.5942000000000001
PinballAdventure	2022-01-07	2	1	0	2	0.5942000000000001
Escape From Eternity	2022-02-23	1	1	0	1	0.5942000000000001
Magnet Crusher	2022-04-06	3	1	0	3	0.5942000000000001
Bomb Voyage	2022-01-05	3	1	0	3	0.5942000000000001
Bounty Hunters	2022-02-01	1	1	0	1	0.5942000000000001
VR Dodgeball Trainer	2022-04-30	3	1	0	3	0.5942000000000001
Seasons of the Sorcerer	2022-11-03	1	1	0	1	0.5942000000000001
Sakura Sunshine	2022-11-11	1	1	0	1	0.5942000000000001
World of Cube	2022-08-10	2	1	0	2	0.5942000000000001
遊んで囲碁が強くなる！銀星囲碁DX	2022-02-28	4	1	0	4	0.5942000000000001
The Wizardz Dungeon	2022-12-23	2	1	0	2	0.5942000000000001
Bethany's Talishop	2022-03-09	2	1	0	2	0.5942000000000001
Plentypede	2022-02-22	1	1	0	1	0.5942000000000001
Crates n' Mohawks	2022-01-03	1	1	0	1	0.5942000000000001
Tadahito：Story of Ellis Town Version	2022-07-29	2	1	0	2	0.5942000000000001
Blaster Alert	2022-01-27	1	1	0	1	0.5942000000000001
Kargo	2022-12-08	2	1	0	2	0.5942000000000001
CatMxn	2022-04-23	1	1	0	1	0.5942000000000001
Stealth Kart	2022-09-03	2	1	0	2	0.5942000000000001
Miss Agatha's Palace	2022-01-17	2	1	0	2	0.5942000000000001
Polyion	2022-11-09	1	1	0	1	0.5942000000000001
Cat Dimension	2022-11-25	2	1	0	2	0.5942000000000001
jingor 2048	2022-01-11	1	1	0	1	0.5942000000000001
Panzers on the Steppe	2022-01-13	3	1	0	3	0.5942000000000001
Ambition	2022-01-03	1	1	0	1	0.5942000000000001
VR Async Balls	2022-01-10	1	1	0	1	0.5942000000000001
Hunter A Hunter	2022-10-05	1	1	0	1	0.5942000000000001
镜世界	2022-01-31	1	1	0	1	0.5942000000000001
Fallen Spirit	2022-01-28	1	1	0	1	0.5942000000000001
Ver	2022-04-22	1	1	0	1	0.5942000000000001
Cellar	2022-01-28	3	1	0	3	0.5942000000000001
Squirrels are going nuts	2022-02-06	2	1	0	2	0.5942000000000001
Timings	2022-01-04	1	1	0	1	0.5942000000000001
A lost jellyfish: Return to its parents	2022-01-24	1	1	0	1	0.5942000000000001
Kitsune Slasher	2022-01-12	1	1	0	1	0.5942000000000001
Green Alert	2022-03-25	2	1	0	2	0.5942000000000001
PRINCESS	2022-01-19	2	1	0	2	0.5942000000000001
Birth Patrol	2022-02-03	1	1	0	1	0.5942000000000001
Elemental War - 元素大戦	2022-10-20	2	1	0	2	0.5942000000000001
Poker - Texas	2022-03-31	2	1	0	2	0.5942000000000001
Under Iron Water	2022-03-10	1	1	0	1	0.5942000000000001
Forest Kingdom	2022-01-20	3	1	0	3	0.5942000000000001
Clockwise Jinx	2022-01-13	3	1	0	3	0.5942000000000001
Go Fetch!	2022-01-17	2	1	0	2	0.5942000000000001
Pirate's Solitaire	2022-03-17	3	1	0	3	0.5942000000000001
The SCALING	2022-03-08	2	1	0	2	0.5942000000000001
Anges et Gardiens - Voyage au Centre de la Terre	2022-01-21	2	1	0	2	0.5942000000000001
Spryward	2022-05-31	2	1	0	2	0.5942000000000001
Dino Island Adventure	2022-02-08	2	1	0	2	0.5942000000000001
DuckHunt - Missouri	2022-03-21	1	1	0	1	0.5942000000000001
The Dreaming Fox	2022-03-31	2	1	0	2	0.5942000000000001
Dimension Shifter	2022-01-21	1	1	0	1	0.5942000000000001
Dimension Dash	2022-02-16	1	1	0	1	0.5942000000000001
赋灵牌	2022-01-27	4	1	0	4	0.5942000000000001
Death By Tomato	2022-02-10	1	1	0	1	0.5942000000000001
Mission: Santa	2022-01-24	1	1	0	1	0.5942000000000001
AstoriaVR	2022-05-20	1	1	0	1	0.5942000000000001
Crazi Lift	2022-04-18	1	1	0	1	0.5942000000000001
The Hollows Chapter 1 Multiplayer	2022-03-05	2	1	0	2	0.5942000000000001
Blind wizard's assistant	2022-06-10	1	1	0	1	0.5942000000000001
Qrabbles	2022-05-09	2	1	0	2	0.5942000000000001
Fresh Out The Oven	2022-06-15	2	1	0	2	0.5942000000000001
Missile Input	2022-11-30	1	1	0	1	0.5942000000000001
The Great War of Jorth	2022-02-14	1	1	0	1	0.5942000000000001
Inu's Adventure	2022-12-08	1	1	0	1	0.5942000000000001
Collect Objects	2022-04-25	1	1	0	1	0.5942000000000001
Loopback	2022-05-20	1	1	0	1	0.5942000000000001
Minecart Madness	2022-02-09	2	1	0	2	0.5942000000000001
Ink&Paper: Wandering	2022-02-10	2	1	0	2	0.5942000000000001
The Baleful Tower	2022-02-23	5	1	0	5	0.5942000000000001
Orc Vs Undead	2022-02-16	1	1	0	1	0.5942000000000001
喵险	2022-04-07	1	1	0	1	0.5942000000000001
Hero for Hire	2022-03-04	2	1	0	2	0.5942000000000001
Moonfall	2022-05-06	4	1	0	4	0.5942000000000001
Child of Hope	2022-05-12	4	1	0	4	0.5942000000000001
AstroNOTs	2022-02-07	2	1	0	2	0.5942000000000001
Healing Simulator	2022-04-05	2	1	0	2	0.5942000000000001
Anime Girls VS Soldiers	2022-02-13	2	1	0	2	0.5942000000000001
DELAY SIMULATOR	2022-05-13	1	1	0	1	0.5942000000000001
Fly&Poop	2022-07-16	2	1	0	2	0.5942000000000001
Golden Jetpackman	2022-02-14	1	1	0	1	0.5942000000000001
Sel Quinta - The Six City Quest	2022-03-10	2	1	0	2	0.5942000000000001
Bouldering Robot 3D	2022-03-03	1	1	0	1	0.5942000000000001
Find The Murderer 2	2022-03-03	2	1	0	2	0.5942000000000001
Skedaddle Out The Dungeon	2022-03-21	2	1	0	2	0.5942000000000001
Let's go to the moon	2022-02-19	3	1	0	3	0.5942000000000001
TRICK SHOT PING PONG	2022-03-23	2	1	0	2	0.5942000000000001
Pusher	2022-02-17	2	1	0	2	0.5942000000000001
Foreign Dreams	2022-02-22	2	1	0	2	0.5942000000000001
LAETUS.	2022-04-22	2	1	0	2	0.5942000000000001
Valkalim	2022-02-22	1	1	0	1	0.5942000000000001
Project:Sphere	2022-02-18	1	1	0	1	0.5942000000000001
Lulu Way	2022-04-29	1	1	0	1	0.5942000000000001
Buried	2022-02-28	1	1	0	1	0.5942000000000001
Brutal Rifters	2022-02-18	11	1	0	11	0.5942000000000001
灵异爱情.冷	2022-04-16	1	1	0	1	0.5942000000000001
Mystery Solitaire. Grimm's Tales 4	2022-02-14	4	1	0	4	0.5942000000000001
SworLd	2022-02-26	2	1	0	2	0.5942000000000001
Heroes of The Sacred Tree	2022-03-10	1	1	0	1	0.5942000000000001
Anime Manga Style Girl - Color By Number Pixel Art Coloring	2022-03-01	2	1	0	2	0.5942000000000001
Go Ace It	2022-05-28	2	1	0	2	0.5942000000000001
Chimeras: Mark of Death Collector's Edition	2022-02-18	11	1	0	11	0.5942000000000001
Jump Like An Egyptian	2022-02-26	4	1	0	4	0.5942000000000001
Pathogen	2022-07-21	2	1	0	2	0.5942000000000001
Planet after us	2022-03-24	1	1	0	1	0.5942000000000001
Super Ate in Wonderland	2022-03-31	1	1	0	1	0.5942000000000001
Fists of Stone	2022-10-06	2	1	0	2	0.5942000000000001
Empty War	2022-09-28	1	1	0	1	0.5942000000000001
Anicon - Animal Complex - Party	2022-03-08	1	1	0	1	0.5942000000000001
遗落迷途lost in tomorrow	2022-08-05	2	1	0	2	0.5942000000000001
Valley Dash	2022-03-21	3	1	0	3	0.5942000000000001
Red Yet Capers: Math vs Mayhem	2022-03-20	1	1	0	1	0.5942000000000001
STAY ALIVE	2022-06-08	1	1	0	1	0.5942000000000001
Simultaneous Control	2022-04-18	1	1	0	1	0.5942000000000001
Nagori Rokudo Striving to be her ideal self -The inexperienced love life of a hard-to-get psychology lecturer-	2022-05-07	4	1	0	4	0.5942000000000001
Cloud Heart	2022-08-07	1	1	0	1	0.5942000000000001
Dulce et Decorum	2022-03-29	2	1	0	2	0.5942000000000001
Space Out	2022-05-14	1	1	0	1	0.5942000000000001
Base Craft: Desolate Survival	2022-04-15	1	1	0	1	0.5942000000000001
Shooting Covid	2022-03-17	2	1	0	2	0.5942000000000001
King of the Savage Realms	2022-03-24	2	1	0	2	0.5942000000000001
Menace Labs	2022-05-06	1	1	0	1	0.5942000000000001
Ladder Larry	2022-11-04	1	1	0	1	0.5942000000000001
Cyber Dungeon: Excalibur	2022-11-25	1	1	0	1	0.5942000000000001
LillyMonster	2022-03-28	1	1	0	1	0.5942000000000001
同居創作人	2022-03-29	1	1	0	1	0.5942000000000001
Taya's Alphabet	2022-03-25	1	1	0	1	0.5942000000000001
Block KUZUSHI	2022-05-03	2	1	0	2	0.5942000000000001
Stranger Danger or Horror, Quest and Magic	2022-06-28	1	1	0	1	0.5942000000000001
Pixel Petkeeper	2022-12-09	3	1	0	3	0.5942000000000001
XpraizeBeta	2022-05-31	4	1	0	4	0.5942000000000001
Fever Dream	2022-04-22	1	1	0	1	0.5942000000000001
Z-STOP	2022-08-16	3	1	0	3	0.5942000000000001
Bleeding Abyss	2022-11-13	2	1	0	2	0.5942000000000001
Blocknator	2022-04-06	1	1	0	1	0.5942000000000001
Let's Go!	2022-03-23	2	1	0	2	0.5942000000000001
MindSweeper	2022-04-03	2	1	0	2	0.5942000000000001
Wildfox Surfing Paradise	2022-06-28	1	1	0	1	0.5942000000000001
HoopsFPS	2022-04-08	2	1	0	2	0.5942000000000001
Firewerx	2022-04-01	2	1	0	2	0.5942000000000001
Chased Around The World	2022-07-29	1	1	0	1	0.5942000000000001
Findme ～３０才の夢追い人～	2022-07-29	1	1	0	1	0.5942000000000001
The Pendant of Prosperity (U.C.H.E.W.S #1)	2022-03-30	3	1	0	3	0.5942000000000001
Blow Fish Music Quiz	2022-04-01	1	1	0	1	0.5942000000000001
Letter Bender	2022-04-05	2	1	0	2	0.5942000000000001
Cool People Club	2022-12-01	1	1	0	1	0.5942000000000001
The Slime	2022-06-18	3	1	0	3	0.5942000000000001
Going Into The Unknown	2022-07-11	2	1	0	2	0.5942000000000001
Cursed Fables: White as Snow Collector's Edition	2022-03-23	5	1	0	5	0.5942000000000001
Sunshower	2022-04-08	2	1	0	2	0.5942000000000001
Daydream Mosaics 3: Shards Of Hope	2022-11-10	5	1	0	5	0.5942000000000001
Holiday Jigsaw Halloween 3	2022-07-26	1	1	0	1	0.5942000000000001
Holiday Jigsaw Halloween 4	2022-08-22	2	1	0	2	0.5942000000000001
Escape Dark Tunnels	2022-05-13	1	1	0	1	0.5942000000000001
Rocco's Inferno	2022-04-22	1	1	0	1	0.5942000000000001
Small phrases Great stories	2022-04-21	1	1	0	1	0.5942000000000001
Bullet Quest	2022-07-26	4	1	0	4	0.5942000000000001
VEDETTE	2022-06-23	1	1	0	1	0.5942000000000001
CYCO	2022-07-15	2	1	0	2	0.5942000000000001
Sweet Solitaire. School Witch 2	2022-04-25	4	1	0	4	0.5942000000000001
Mystery Solitaire. The Black Raven 3	2022-05-02	3	1	0	3	0.5942000000000001
1001 Jigsaw. Interior Design	2022-07-11	2	1	0	2	0.5942000000000001
Spotted Garden Eel Adventure	2022-10-08	1	1	0	1	0.5942000000000001
Areigna Tactics	2022-09-20	2	1	0	2	0.5942000000000001
Pixel Game Maker Series OMA2RI ADVENTURE	2022-04-14	1	1	0	1	0.5942000000000001
Samurai Solitaire. Threads of Fate	2022-05-19	2	1	0	2	0.5942000000000001
Tamashi Party	2022-06-07	1	1	0	1	0.5942000000000001
Kids On Site - Hard Hat Edition	2022-09-26	2	1	0	2	0.5942000000000001
Dastardly	2022-04-22	2	1	0	2	0.5942000000000001
Bitch demon twins	2022-05-11	1	1	0	1	0.5942000000000001
Wathitdew Record™ Game Studio BATTLEFIELD	2022-04-25	1	1	0	1	0.5942000000000001
Bash Sports Online Bowling	2022-09-06	3	1	0	3	0.5942000000000001
Insanity Ice	2022-04-29	1	1	0	1	0.5942000000000001
Valera The Drunken Lobster	2022-05-10	2	1	0	2	0.5942000000000001
Rhythmic Keyboard	2022-05-06	1	1	0	1	0.5942000000000001
Dash Around Madly	2022-05-02	2	1	0	2	0.5942000000000001
Askaya: Remnants of Ajuna	2022-06-17	2	1	0	2	0.5942000000000001
True_Aim	2022-04-30	1	1	0	1	0.5942000000000001
Mortificare	2022-05-20	2	1	0	2	0.5942000000000001
Let's MEAT Adam 2	2022-06-01	4	1	0	4	0.5942000000000001
Heroes of Rome 2 - The Revenge of Discordia	2022-05-05	4	1	0	4	0.5942000000000001
Northland Heroes - The missing druid	2022-05-05	5	1	0	5	0.5942000000000001
Bounda	2022-05-03	1	1	0	1	0.5942000000000001
Ewephoria	2022-12-01	1	1	0	1	0.5942000000000001
Duterra	2022-12-29	2	1	0	2	0.5942000000000001
Conditus	2022-06-20	2	1	0	2	0.5942000000000001
Letux Game	2022-10-12	3	1	0	3	0.5942000000000001
Whispered Secrets: Tying the Knot Collector's Edition	2022-04-22	7	1	0	7	0.5942000000000001
Slimesventure: Your Destination	2022-09-29	13	1	0	13	0.5942000000000001
Infection - Board Game	2022-10-01	2	1	0	2	0.5942000000000001
Push the Box - Puzzle Game	2022-07-16	3	1	0	3	0.5942000000000001
魔法书起源	2022-08-12	4	1	0	4	0.5942000000000001
Jumping Jack	2022-05-10	2	1	0	2	0.5942000000000001
Defying Fate	2022-06-22	1	1	0	1	0.5942000000000001
The FED	2022-05-12	1	1	0	1	0.5942000000000001
Squarely Blue	2022-05-11	2	1	0	2	0.5942000000000001
Nuts Space Shooter	2022-06-01	2	1	0	2	0.5942000000000001
Royal Jigsaw 2	2022-05-16	2	1	0	2	0.5942000000000001
Volvalis	2022-05-17	2	1	0	2	0.5942000000000001
Breaking and Entering	2022-05-24	1	1	0	1	0.5942000000000001
Vowel Movements	2022-07-08	1	1	0	1	0.5942000000000001
Lunar Camp Glenn	2022-05-23	1	1	0	1	0.5942000000000001
Jim The Spy	2022-07-04	1	1	0	1	0.5942000000000001
虚幻宇宙：重启	2022-05-23	1	1	0	1	0.5942000000000001
Save All Monsters!	2022-05-26	1	1	0	1	0.5942000000000001
Arc Intelligence	2022-09-07	2	1	0	2	0.5942000000000001
That Which Was Lost	2022-07-22	5	1	0	5	0.5942000000000001
Hearts United	2022-08-05	4	1	0	4	0.5942000000000001
Phromg Game	2022-05-26	1	1	0	1	0.5942000000000001
Sciophobia: The Fear of Shadows	2022-05-22	1	1	0	1	0.5942000000000001
Night Escaper	2022-05-27	2	1	0	2	0.5942000000000001
Sudoqube	2022-06-20	3	1	0	3	0.5942000000000001
GUN BLADE	2022-07-29	1	1	0	1	0.5942000000000001
Ah Diddums	2022-05-27	1	1	0	1	0.5942000000000001
Jacob Larkin's Wild Europe	2022-05-31	2	1	0	2	0.5942000000000001
Zoo Chess	2022-09-07	2	1	0	2	0.5942000000000001
Grid Words	2022-07-08	2	1	0	2	0.5942000000000001
Pumpkin head	2022-05-30	1	1	0	1	0.5942000000000001
Arcadia	2022-05-30	1	1	0	1	0.5942000000000001
Heroes of Time 2 - Aizack's Return	2022-09-01	2	1	0	2	0.5942000000000001
Make It In Time	2022-12-16	2	1	0	2	0.5942000000000001
Get Trolled	2022-07-20	1	1	0	1	0.5942000000000001
Skies Of Blue: Remake	2022-06-23	3	1	0	3	0.5942000000000001
Stonkers	2022-06-06	1	1	0	1	0.5942000000000001
Samurai Solitaire. Return of the Ronin	2022-07-22	2	1	0	2	0.5942000000000001
GameZero	2022-07-15	4	1	0	4	0.5942000000000001
Blade Bros IMPACT!	2022-09-10	2	1	0	2	0.5942000000000001
Slime Jumper Adventure	2022-06-09	1	1	0	1	0.5942000000000001
Whore Dealer™ an Wet Porn Erotic Puzzle	2022-06-10	2	1	0	2	0.5942000000000001
Boxman Adventures	2022-11-02	2	1	0	2	0.5942000000000001
Leave a Light	2022-10-31	1	1	0	1	0.5942000000000001
The Cute Fighter	2022-10-14	2	1	0	2	0.5942000000000001
Highway Driving	2022-06-16	3	1	0	3	0.5942000000000001
Blocked!	2022-09-01	1	1	0	1	0.5942000000000001
Mello Haunted House	2022-08-05	1	1	0	1	0.5942000000000001
Privateer Escape	2022-06-26	1	1	0	1	0.5942000000000001
Emi's Country Store & Farm	2022-09-29	2	1	0	2	0.5942000000000001
Pimania	2022-06-28	1	1	0	1	0.5942000000000001
Tower of Darkness	2022-10-13	2	1	0	2	0.5942000000000001
Non Fingo VR	2022-08-29	1	1	0	1	0.5942000000000001
ATurd	2022-07-08	2	1	0	2	0.5942000000000001
Home Sick	2022-07-01	2	1	0	2	0.5942000000000001
Telos Pragmaton	2022-07-29	2	1	0	2	0.5942000000000001
A toad well travelled	2022-07-03	2	1	0	2	0.5942000000000001
Travel The Words	2022-07-16	2	1	0	2	0.5942000000000001
Bubble Wars	2022-09-12	1	1	0	1	0.5942000000000001
Elves Fantasy Hentai Puzzle	2022-07-08	3	1	0	3	0.5942000000000001
The Western Rooms	2022-07-11	2	1	0	2	0.5942000000000001
冥界崛起	2022-08-04	1	1	0	1	0.5942000000000001
Elektrosoul	2022-07-25	1	1	0	1	0.5942000000000001
REAL RAGE	2022-07-15	1	1	0	1	0.5942000000000001
开路先锋S:Open Road First Front S	2022-07-05	1	1	0	1	0.5942000000000001
Rainbow Runner	2022-08-12	2	1	0	2	0.5942000000000001
Pixel	2022-07-07	2	1	0	2	0.5942000000000001
The Mangotronics Employment Collection	2022-08-13	1	1	0	1	0.5942000000000001
Battle Rift	2022-08-18	1	1	0	1	0.5942000000000001
A Path to Light	2022-12-01	2	1	0	2	0.5942000000000001
Blockhead 2D	2022-07-06	2	1	0	2	0.5942000000000001
XanChuchamel	2022-10-31	1	1	0	1	0.5942000000000001
Don't Touch Lava	2022-09-01	2	1	0	2	0.5942000000000001
Metro Mover	2022-07-21	2	1	0	2	0.5942000000000001
Nitro Racers	2022-10-07	1	1	0	1	0.5942000000000001
Blobble Wars 2	2022-08-01	3	1	0	3	0.5942000000000001
Space Bunny Explorers	2022-10-31	1	1	0	1	0.5942000000000001
Rampage Ball 2048	2022-12-09	3	1	0	3	0.5942000000000001
2 Late 2 Evade	2022-10-11	1	1	0	1	0.5942000000000001
Through the night	2022-07-25	1	1	0	1	0.5942000000000001
Opalescence	2022-08-05	1	1	0	1	0.5942000000000001
Imaginari	2022-09-06	1	1	0	1	0.5942000000000001
HERO YOUSEIJYO	2022-07-19	3	1	0	3	0.5942000000000001
Cosmic Wartoad	2022-07-28	1	1	0	1	0.5942000000000001
Virus Protocol	2022-07-27	1	1	0	1	0.5942000000000001
PlayWith	2022-08-01	3	1	0	3	0.5942000000000001
INCARNAGE	2022-12-12	1	1	0	1	0.5942000000000001
memory®	2022-12-14	2	1	0	2	0.5942000000000001
钢铁洪流	2022-07-18	1	1	0	1	0.5942000000000001
Binary: A Puzzling Platformer	2022-07-25	1	1	0	1	0.5942000000000001
Star Boss	2022-07-29	1	1	0	1	0.5942000000000001
Angkor: Beginnings	2022-07-25	4	1	0	4	0.5942000000000001
RC SIM 2022	2022-07-25	1	1	0	1	0.5942000000000001
Kentor and also Bloby in: Part 1 - The Krookening	2022-07-25	1	1	0	1	0.5942000000000001
Stellar Propeller	2022-09-16	2	1	0	2	0.5942000000000001
Anomalia Parte1	2022-07-31	1	1	0	1	0.5942000000000001
Afterslave	2022-08-03	1	1	0	1	0.5942000000000001
Cavelon	2022-08-01	1	1	0	1	0.5942000000000001
Cosmic Cruiser	2022-08-04	1	1	0	1	0.5942000000000001
Vault Circuit	2022-08-15	2	1	0	2	0.5942000000000001
Jumping!	2022-07-27	2	1	0	2	0.5942000000000001
PegSoli+	2022-08-31	1	1	0	1	0.5942000000000001
Magefall	2022-08-01	1	1	0	1	0.5942000000000001
Violet's Party Mania	2022-10-05	2	1	0	2	0.5942000000000001
Wilderness Game Stalker VR: North America	2022-08-05	1	1	0	1	0.5942000000000001
9up3kingdom	2022-08-10	2	1	0	2	0.5942000000000001
Fill and Cross Pirate Riddles 3	2022-08-08	3	1	0	3	0.5942000000000001
Holiday Jigsaw Christmas 3	2022-09-12	3	1	0	3	0.5942000000000001
Pud Pud in Weird World	2022-08-10	1	1	0	1	0.5942000000000001
Hellfire	2022-08-12	1	1	0	1	0.5942000000000001
狠斗篮球	2022-09-07	1	1	0	1	0.5942000000000001
Veggies War	2022-12-08	2	1	0	2	0.5942000000000001
Attack of the Trafalas	2022-10-20	2	1	0	2	0.5942000000000001
Summer Games	2022-08-19	2	1	0	2	0.5942000000000001
SHOOT THE BUUUUUUUGS	2022-08-27	1	1	0	1	0.5942000000000001
Chai	2022-12-19	5	1	0	5	0.5942000000000001
Expense	2022-10-10	2	1	0	2	0.5942000000000001
Isostasy	2022-08-13	1	1	0	1	0.5942000000000001
Jigsaw Puzzle: Belgium Through The Lens	2022-09-22	2	1	0	2	0.5942000000000001
AntiShatter	2022-11-11	2	1	0	2	0.5942000000000001
LO FI - A YEAR TO FULFILL MY DREAM.mp3	2022-09-01	1	1	0	1	0.5942000000000001
Rikki Kuu	2022-09-30	2	1	0	2	0.5942000000000001
Kati The Astronaut	2022-08-17	1	1	0	1	0.5942000000000001
Tuning Champions	2022-09-30	2	1	0	2	0.5942000000000001
Neutrino	2022-10-20	1	1	0	1	0.5942000000000001
Spacetime Dimension	2022-08-31	1	1	0	1	0.5942000000000001
Speed the Card Game	2022-08-29	3	1	0	3	0.5942000000000001
Screaming Noppy	2022-09-01	2	1	0	2	0.5942000000000001
Magic Market	2022-09-12	1	1	0	1	0.5942000000000001
Projekt Everblood	2022-08-25	1	1	0	1	0.5942000000000001
Hypogean	2022-10-10	1	1	0	1	0.5942000000000001
Jade's Adventure	2022-09-08	1	1	0	1	0.5942000000000001
REDDOOR	2022-08-30	2	1	0	2	0.5942000000000001
Heist Master	2022-08-31	2	1	0	2	0.5942000000000001
Fantasy Climber. Fun Adventure	2022-08-27	1	1	0	1	0.5942000000000001
Unstable Rock	2022-08-27	1	1	0	1	0.5942000000000001
Epileptic Seizure Battle Ball Challenge	2022-09-07	1	1	0	1	0.5942000000000001
The Fish	2022-08-31	1	1	0	1	0.5942000000000001
Fragment of Humanity	2022-10-27	1	1	0	1	0.5942000000000001
Chroma Key	2022-09-05	2	1	0	2	0.5942000000000001
Slime Runner	2022-08-31	1	1	0	1	0.5942000000000001
Necropolis of the Angels	2022-08-28	1	1	0	1	0.5942000000000001
Monsterstone: Prelude	2022-09-12	2	1	0	2	0.5942000000000001
Asteria: Daniel Bélanger	2022-09-17	1	1	0	1	0.5942000000000001
MushRun	2022-09-07	1	1	0	1	0.5942000000000001
Bridge to Another World: Cursed Clouds Collector's Edition	2022-10-21	6	1	0	6	0.5942000000000001
Marble on Rails	2022-09-01	2	1	0	2	0.5942000000000001
Zombie Mansion	2022-09-29	1	1	0	1	0.5942000000000001
Doomsday Contact	2022-09-29	2	1	0	2	0.5942000000000001
Monster Slayer Extermination	2022-09-02	1	1	0	1	0.5942000000000001
LocoMotion	2022-09-19	2	1	0	2	0.5942000000000001
Ninja Hagakure	2022-09-06	2	1	0	2	0.5942000000000001
Manifest	2022-09-20	1	1	0	1	0.5942000000000001
Elya Richi vs Blackstone : Nuclear War	2022-09-15	1	1	0	1	0.5942000000000001
Off to Sleep	2022-11-03	2	1	0	2	0.5942000000000001
Two Move Chess	2022-09-09	3	1	0	3	0.5942000000000001
Love Photo Studio/真爱照相馆	2022-09-27	2	1	0	2	0.5942000000000001
Mining Odyssey	2022-09-13	2	1	0	2	0.5942000000000001
Legend of Egypt - Pharaohs Garden 2 - The sacred crocodile	2022-09-05	6	1	0	6	0.5942000000000001
恋ひ焦がるるカミカクシ	2022-09-12	1	1	0	1	0.5942000000000001
ZOOGARNIAN	2022-09-14	1	1	0	1	0.5942000000000001
when we lost	2022-09-15	1	1	0	1	0.5942000000000001
Leviathan: An Interactive Comic Book	2022-11-14	1	1	0	1	0.5942000000000001
World_of_Naples	2022-12-15	2	1	0	2	0.5942000000000001
To Eternity	2022-10-26	1	1	0	1	0.5942000000000001
Nightmare Hunter	2022-10-31	2	1	0	2	0.5942000000000001
Little Horror Raiser	2022-09-12	1	1	0	1	0.5942000000000001
城市工人模拟器	2022-09-24	2	1	0	2	0.5942000000000001
Jungle Survivor	2022-09-22	2	1	0	2	0.5942000000000001
RC Dash	2022-09-27	1	1	0	1	0.5942000000000001
Poly Memory: Predators	2022-09-10	1	1	0	1	0.5942000000000001
Mimetic Love	2022-09-19	2	1	0	2	0.5942000000000001
Precision Break	2022-09-15	1	1	0	1	0.5942000000000001
The Slaughterday	2022-09-29	1	1	0	1	0.5942000000000001
Shin Galaxy - Alpha War	2022-11-03	1	1	0	1	0.5942000000000001
Mark of the Void	2022-09-27	2	1	0	2	0.5942000000000001
Light Eater	2022-09-19	1	1	0	1	0.5942000000000001
Bandit Realms	2022-11-15	1	1	0	1	0.5942000000000001
RKR - Rush Kill Repeat	2022-09-30	2	1	0	2	0.5942000000000001
StarTron	2022-12-01	3	1	0	3	0.5942000000000001
Prince Akazaka x Princess	2022-10-04	1	1	0	1	0.5942000000000001
Halloween Trouble 4	2022-10-12	4	1	0	4	0.5942000000000001
千灵大陆-Qianling Mainland	2022-09-22	3	1	0	3	0.5942000000000001
Charlie's Delivery	2022-10-06	1	1	0	1	0.5942000000000001
水城守护战	2022-10-09	1	1	0	1	0.5942000000000001
The Cat Maze	2022-09-28	1	1	0	1	0.5942000000000001
The Adventures of Snacky	2022-10-27	1	1	0	1	0.5942000000000001
Blackjack at Carrot	2022-10-26	2	1	0	2	0.5942000000000001
Arata Haunted Asylum	2022-10-14	2	1	0	2	0.5942000000000001
Blueprints	2022-10-04	1	1	0	1	0.5942000000000001
Great Pilots	2022-11-07	1	1	0	1	0.5942000000000001
Worldest D izzy Game	2022-12-13	2	1	0	2	0.5942000000000001
Detriot	2022-09-28	1	1	0	1	0.5942000000000001
Village Defender	2022-10-13	2	1	0	2	0.5942000000000001
Treasure Trap	2022-12-16	1	1	0	1	0.5942000000000001
Actua Tennis	2022-10-12	4	1	0	4	0.5942000000000001
Christmas Wonderland 5	2022-11-10	2	1	0	2	0.5942000000000001
Sokosignal	2022-10-07	1	1	0	1	0.5942000000000001
FOREST DONGMUL	2022-10-06	1	1	0	1	0.5942000000000001
Europe Empire 2027	2022-10-08	5	1	0	5	0.5942000000000001
IceLine	2022-11-17	1	1	0	1	0.5942000000000001
Keep of the Witch	2022-11-22	1	1	0	1	0.5942000000000001
Magic Bubbles	2022-11-16	3	1	0	3	0.5942000000000001
²Pattern	2022-10-17	2	1	0	2	0.5942000000000001
Causal Nexus	2022-12-19	2	1	0	2	0.5942000000000001
Reeve	2022-12-02	1	1	0	1	0.5942000000000001
Middle East Empire 2027	2022-10-13	3	1	0	3	0.5942000000000001
Throw Wizard	2022-11-14	1	1	0	1	0.5942000000000001
Free My Sight	2022-10-17	2	1	0	2	0.5942000000000001
Christmas Wonderland 4	2022-11-03	3	1	0	3	0.5942000000000001
Age of Heroes - The Beginning	2022-10-24	5	1	0	5	0.5942000000000001
Non-Euclidean	2022-11-04	1	1	0	1	0.5942000000000001
Listen Me	2022-12-11	5	1	0	5	0.5942000000000001
Slugmania	2022-10-31	1	1	0	1	0.5942000000000001
Nelu's Adventure	2022-12-01	1	1	0	1	0.5942000000000001
IPO TOWER	2022-12-04	1	1	0	1	0.5942000000000001
Halloween Stories: Mark on the Bone Collector's Edition	2022-10-14	5	1	0	5	0.5942000000000001
盗墓密探	2022-11-05	5	1	0	5	0.5942000000000001
Fastraq	2022-12-14	2	1	0	2	0.5942000000000001
Mystery Solitaire. Dreamcatcher 3	2022-12-05	3	1	0	3	0.5942000000000001
Heimwald	2022-11-06	1	1	0	1	0.5942000000000001
Omega Mouse	2022-11-04	1	1	0	1	0.5942000000000001
Touch the Balls VR	2022-11-24	1	1	0	1	0.5942000000000001
Keeper of the Keys	2022-10-26	1	1	0	1	0.5942000000000001
Echo Divide	2022-10-31	1	1	0	1	0.5942000000000001
The Music Trivia Challenge	2022-11-04	1	1	0	1	0.5942000000000001
The Sports Trivia Challenge	2022-11-11	1	1	0	1	0.5942000000000001
Put Your Stamp On	2022-12-16	1	1	0	1	0.5942000000000001
Checkered Flag	2022-11-03	1	1	0	1	0.5942000000000001
Dear Friend	2022-12-21	1	1	0	1	0.5942000000000001
Hero Z TPS	2022-11-03	2	1	0	2	0.5942000000000001
Electrocop	2022-11-08	1	1	0	1	0.5942000000000001
Fantasy of War	2022-12-02	1	1	0	1	0.5942000000000001
Hell O Corn	2022-11-12	1	1	0	1	0.5942000000000001
Gates of Zendocon	2022-11-17	2	1	0	2	0.5942000000000001
WEAPONEER	2022-11-09	2	1	0	2	0.5942000000000001
IronKnight	2022-11-06	2	1	0	2	0.5942000000000001
The Ninja	2022-11-11	1	1	0	1	0.5942000000000001
Videopac Collection 1	2022-11-24	2	1	0	2	0.5942000000000001
SPEEDRUNNER	2022-11-11	1	1	0	1	0.5942000000000001
Super Kick Off	2022-11-22	2	1	0	2	0.5942000000000001
Laruaville 13	2022-11-16	8	1	0	8	0.5942000000000001
My Heart Your Soul	2022-12-06	2	1	0	2	0.5942000000000001
VR Pekin Royal Palace	2022-12-16	1	1	0	1	0.5942000000000001
Freddy Frog 2	2022-11-11	1	1	0	1	0.5942000000000001
Futanari Sex - Locker Room Affair	2022-11-05	3	1	0	3	0.5942000000000001
GrandStrategy	2022-12-31	1	1	0	1	0.5942000000000001
七星探偵倶楽部-黄金虫たちの帰巣-	2022-11-18	1	1	0	1	0.5942000000000001
5 Days	2022-11-23	1	1	0	1	0.5942000000000001
Show Ball: Tiger Life	2022-11-18	1	1	0	1	0.5942000000000001
Keepers of the Forest	2022-12-01	2	1	0	2	0.5942000000000001
Rabbit Maze	2022-11-24	1	1	0	1	0.5942000000000001
Space Time	2022-11-22	2	1	0	2	0.5942000000000001
Geometric Hell	2022-12-09	1	1	0	1	0.5942000000000001
See Ya Later!	2022-11-21	1	1	0	1	0.5942000000000001
Lost in Memory	2022-12-01	2	1	0	2	0.5942000000000001
Cambrian Dawn	2022-11-22	3	1	0	3	0.5942000000000001
SURRENDER	2022-12-03	1	1	0	1	0.5942000000000001
DAB 12	2022-12-17	1	1	0	1	0.5942000000000001
Robocoder - Dwarf Mountain (Early Access)	2022-11-27	1	1	0	1	0.5942000000000001
Recoil VS The World	2022-12-23	1	1	0	1	0.5942000000000001
Rune It Out	2022-12-13	2	1	0	2	0.5942000000000001
Native Problems	2022-11-28	1	1	0	1	0.5942000000000001
Look for connecting stars	2022-12-10	1	1	0	1	0.5942000000000001
A Slime In Time	2022-11-27	1	1	0	1	0.5942000000000001
Twin Mind: Nobody's Here Collector's Edition	2022-11-29	8	1	0	8	0.5942000000000001
Winter	2022-12-01	1	1	0	1	0.5942000000000001
Dark Desire 6	2022-11-25	2	1	0	2	0.5942000000000001
Onefold Taxi Simulator	2022-11-30	1	1	0	1	0.5942000000000001
GrandTraveler	2022-11-30	1	1	0	1	0.5942000000000001
Derision	2022-11-30	1	1	0	1	0.5942000000000001
A Christmas Yarn	2022-12-13	4	1	0	4	0.5942000000000001
Color Invader VR	2022-12-13	1	1	0	1	0.5942000000000001
Testimonies	2022-12-27	1	1	0	1	0.5942000000000001
The eagle keita	2022-12-06	1	1	0	1	0.5942000000000001
Crab Digger	2022-12-07	2	1	0	2	0.5942000000000001
Dig Down	2022-12-06	2	1	0	2	0.5942000000000001
Unsolved Case: Fatal Clue Collector's Edition	2022-12-07	4	1	0	4	0.5942000000000001
Kotori	2022-12-12	2	1	0	2	0.5942000000000001
pata	2022-12-13	2	1	0	2	0.5942000000000001
2 Many Pixels	2022-12-12	2	1	0	2	0.5942000000000001
Match Day	2022-12-27	1	1	0	1	0.5942000000000001
Spirit Slider	2022-12-19	2	1	0	2	0.5942000000000001
Squared	2022-12-21	4	1	0	4	0.5942000000000001
Exalted Seracthon	2022-12-11	1	1	0	1	0.5942000000000001
Lewd Anime Racing	2022-12-22	1	1	0	1	0.5942000000000001
《乱步馆》-断崖 <Shop of Edgar Allan Poe>-Precipice	2022-12-21	2	1	0	2	0.5942000000000001
Poly Memory: Animals	2022-12-20	2	1	0	2	0.5942000000000001
Attack Zone	2022-12-31	1	1	0	1	0.5942000000000001
Gunslinger	2022-12-29	1	1	0	1	0.5942000000000001
Medieval Tales Solitaire	2022-12-23	4	1	0	4	0.5942000000000001
Remy Raccoon and the Lost Temple - Festive Frolics (Volume 2)	2022-12-23	1	1	0	1	0.5942000000000001
Cursed Fables: Twisted Tower Collector's Edition	2022-12-16	4	1	0	4	0.5942000000000001
Sex Adventures - Swingers Resort	2022-12-16	3	1	0	3	0.5942000000000001
Mystery Trackers: Fall of Iron Rock Collector's Edition	2022-12-23	5	1	0	5	0.5942000000000001
Offroad Horizons: Rock Crawling Simulator	2022-07-29	6	20	11	17	0.594
Shatter Remastered Deluxe	2022-11-01	16	20	11	27	0.594
The Seekers: Survival	2022-12-02	23	20	11	34	0.594
Steamcore	2022-11-01	73	33	19	92	0.5939
FALL GIRLS	2022-03-26	35	79	48	83	0.5937
PIPELINE RTX	2022-02-24	4	15	8	12	0.5937
Building destruction	2022-04-21	5	15	8	13	0.5937
VOID	2022-11-07	30	15	8	38	0.5937
Badlanders	2022-03-10	998	1037	679	1677	0.5932000000000001
Liber Prologue	2022-12-13	31	63	38	69	0.593
Nodes	2022-06-03	71	28	16	87	0.593
Are you smarter than the crowd?	2022-04-07	27	28	16	43	0.593
MAFIA: Sex Noir	2022-04-02	32	28	16	48	0.593
Monster Mystery	2022-12-08	34	28	16	50	0.593
Instant War	2022-07-08	34	36	21	55	0.5928
Project Wunderwaffe	2022-10-10	345	196	124	469	0.5927
The Zombie Smasher	2022-01-18	6	23	13	19	0.5921000000000001
Smudge Coin Run	2022-03-16	12	23	13	25	0.5921000000000001
Clash of Irons	2022-10-17	30	39	23	53	0.5920000000000001
Blood Job	2022-05-27	21	18	10	31	0.5910000000000001
Ball Torture	2022-06-30	4	18	10	14	0.5910000000000001
Outbreak Island: Pendulum	2022-08-22	404	380	247	651	0.5908
幻想三国志4	2022-01-09	38	34	20	58	0.5908
Alisha's Sexual Fear	2022-07-20	8	34	20	28	0.5908
Dinosaur Park – Primeval Zoo	2022-04-20	22	45	27	49	0.5906
Inheritance: Ladeina's Path	2022-11-25	11	45	27	38	0.5906
The Elder Scrolls Adventures: Redguard	2022-04-26	8	48	29	37	0.5901
Flying Neko Delivery	2022-10-20	10	13	7	17	0.59
Prison Wars	2022-03-30	24	13	7	31	0.59
Wrong train	2022-01-05	5	13	7	12	0.59
H.I.V.E.	2022-05-26	8	13	7	15	0.59
Virtual AI - Aki & Mika	2022-12-15	5	13	7	12	0.59
Obedient Women	2022-11-01	11	13	7	18	0.59
TIMORE REMAKE	2022-10-03	4	13	7	11	0.59
Awaken	2022-12-01	3	13	7	10	0.59
The Last Taxi	2022-06-07	6	8	4	10	0.5897
Double Damnation	2022-08-26	24	8	4	28	0.5897
Flippin Kaktus	2022-05-12	4	8	4	8	0.5897
Arosia	2022-08-08	16	8	4	20	0.5897
DreamWorks Dragons: Legends of The Nine Realms	2022-09-23	10	8	4	14	0.5897
Spelldrifter	2022-02-15	8	8	4	12	0.5897
Brimstone Manor	2022-02-10	28	8	4	32	0.5897
GirlHub - adult puzzle game	2022-01-03	22	8	4	26	0.5897
BEN'S WORLD	2022-02-02	2	8	4	6	0.5897
Eagle Simulator	2022-01-11	2	8	4	6	0.5897
Sunny Love	2022-01-25	2	8	4	6	0.5897
Haunted Stories	2022-02-04	3	8	4	7	0.5897
Sex Adventures - The Job Interview	2022-01-29	3	8	4	7	0.5897
The Way of the Badass	2022-06-08	2	8	4	6	0.5897
Lost Dream: Memories	2022-07-08	2	8	4	6	0.5897
Yummy Girls	2022-06-13	1	8	4	5	0.5897
Raccoon Run	2022-08-11	4	8	4	8	0.5897
Idle Vikings Clicker	2022-09-12	8	8	4	12	0.5897
Chick Rage	2022-12-06	2	8	4	6	0.5897
Escape From Zombies	2022-11-08	4	8	4	8	0.5897
Police Shootout	2022-06-01	201	149	95	296	0.5895
Slashers	2022-05-10	24	54	33	57	0.5893
Navy War	2022-07-07	41	54	33	74	0.5893
Maritime Calling	2022-04-13	8	21	12	20	0.5892000000000001
Void -Dementia-	2022-07-13	15	21	12	27	0.5892000000000001
Mars Base	2022-10-17	30	21	12	42	0.5892000000000001
Fantôme	2022-08-11	16	21	12	28	0.5892000000000001
Hex Picross	2022-08-24	7	21	12	19	0.5892000000000001
Isles of Etherion	2022-09-29	13	32	19	32	0.5887
Hell of Sins: soul	2022-07-22	53	46	28	81	0.5885
Glover	2022-04-20	78	110	70	148	0.5879
Infindustry	2022-05-04	65	24	14	79	0.5879
V1RUZ	2022-01-05	9	38	23	32	0.5875
Friki	2022-02-22	16	38	23	39	0.5875
Dark Past	2022-10-25	8	38	23	31	0.5875
Destiny's Sword	2022-10-17	8	16	9	17	0.5875
The story of Bill Bear	2022-01-11	4	16	9	13	0.5875
Zombies ate my dog	2022-02-25	4	16	9	13	0.5875
Something Weird in Space - A Hidden Object Adventure	2022-05-13	2	16	9	11	0.5875
Old Roots	2022-09-02	5	16	9	14	0.5875
Brutal Japan | 猟奇の日本	2022-06-24	14	16	9	23	0.5875
Flagi	2022-12-31	10	16	9	19	0.5875
CHRONO CROSS: THE RADICAL DREAMERS EDITION	2022-04-07	2637	943	635	3272	0.5870000000000001
Power & Revolution 2022 Edition	2022-04-07	274	377	250	524	0.5867
SIMULACRA 3	2022-10-25	107	115	74	181	0.5861
Mirror Shoot	2022-03-05	7	19	11	18	0.5859000000000001
Wild Terra 2: New Lands	2022-11-10	1530	834	564	2094	0.5857
JR EAST Train Simulator	2022-11-15	498	369	246	744	0.5855
Dead District	2022-08-11	50	146	95	145	0.5855
In The Space - Escape Room	2022-06-28	6	11	6	12	0.5855
Coins Collector Simulator	2022-02-04	3	11	6	9	0.5855
Hentai Sea Battle	2022-02-10	4	11	6	10	0.5855
Travelers in Space Crack	2022-03-13	4	11	6	10	0.5855
Sex Diary - Futanari Jail	2022-03-25	4	11	6	10	0.5855
Gordianaut	2022-05-19	4	11	6	10	0.5855
DouDas Danger	2022-06-25	2	11	6	8	0.5855
CAR DESTROYER	2022-06-25	3	11	6	9	0.5855
My Bloody Weekend	2022-10-12	2	11	6	8	0.5855
Tiny Onion Knight	2022-11-19	3	11	6	9	0.5855
The Backrooms: Mass Extinction	2022-06-23	6	36	22	28	0.5853
天师	2022-01-04	69	230	152	221	0.5851
Mad Experiments 2: Escape Room	2022-10-14	14	39	24	38	0.585
LONGEYED PROJ	2022-12-15	8	22	13	21	0.5849000000000001
Twins Edge	2022-01-24	146	114	74	220	0.5844
ElvenEscape	2022-09-22	7	25	15	22	0.5841
Lys and Ruka's Magical Bag	2022-08-05	163	25	15	178	0.5841
100 Worlds - Escape the Room	2022-04-16	10	14	8	18	0.5833
Combat Troops VR	2022-11-30	6	14	8	14	0.5833
helicopter 2.0	2022-01-03	3	14	8	11	0.5833
Welcome to Albion!	2022-06-17	12	14	8	20	0.5833
Stunts Contest Police Car	2022-07-15	2	14	8	10	0.5833
Rawbots	2022-11-22	18	14	8	26	0.5833
Offside	2022-01-26	5	6	3	8	0.5833
溪风谷之战	2022-06-11	13	6	3	16	0.5833
STALKED	2022-09-22	4	6	3	7	0.5833
Endustry	2022-03-16	2	6	3	5	0.5833
GrubDash Driver: Food Delivery Driver Simulator	2022-03-23	4	6	3	7	0.5833
Maya Star	2022-04-05	5	6	3	8	0.5833
I'm a cowboy: Western Shooter	2022-01-12	2	6	3	5	0.5833
古代从军	2022-03-11	5	6	3	8	0.5833
Exploria	2022-01-27	2	6	3	5	0.5833
Johnny Boy: Red Moon's Kiss - Episode 1	2022-01-31	3	6	3	6	0.5833
Wordish	2022-01-25	24	6	3	27	0.5833
Dungeon Crawler	2022-02-25	3	6	3	6	0.5833
升级打怪换装备	2022-02-13	19	6	3	22	0.5833
Azrael	2022-03-07	3	6	3	6	0.5833
A Slit of Joy	2022-04-04	3	6	3	6	0.5833
Box and Whiskers Pharmacy	2022-05-12	3	6	3	6	0.5833
Tracing Decay	2022-08-26	3	6	3	6	0.5833
Ralph's party RPG	2022-05-17	6	6	3	9	0.5833
THE ILLUSION: NIGHTMARE	2022-05-25	5	6	3	8	0.5833
Apocalive	2022-07-06	2	6	3	5	0.5833
Picking Wheat	2022-08-01	3	6	3	6	0.5833
BRAiN VOMiTS GARDEN	2022-06-16	5	6	3	8	0.5833
Zuria	2022-06-23	5	6	3	8	0.5833
Glyph-Bound: Kotodama	2022-08-11	9	6	3	12	0.5833
Sex Adventures - The Office Slut	2022-07-19	5	6	3	8	0.5833
只爱三国	2022-10-17	5	6	3	8	0.5833
"ENDER OCEAN - Your mission: ""Clean the Ocean"""	2022-09-09	4	6	3	7	0.5833
孤胆惊魂3:起源 Fear3:Origins	2022-09-05	2	6	3	5	0.5833
云城异闻录	2022-10-28	2	6	3	5	0.5833
Heavy Burden: Prologue	2022-11-30	4	6	3	7	0.5833
Dolmen	2022-05-20	206	159	105	311	0.5832
Kogarashi	2022-07-02	19	34	21	40	0.583
一坨便便 YTBB	2022-01-31	582	968	666	1248	0.5824
Survival Quiz CITY	2022-03-04	509	123	81	590	0.5822
Temple Trashers	2022-11-25	5	17	10	15	0.5821000000000001
Re:Legend	2022-09-05	2589	1103	763	3352	0.5817
Code 3	2022-06-16	14	20	12	26	0.5814
Hypno Mama	2022-11-04	19	20	12	31	0.5814
Klotzen! Panzer Battles	2022-04-27	18	23	14	32	0.5809000000000001
Cursed House	2022-01-03	6	23	14	20	0.5809000000000001
Idol Hunter	2022-07-26	4	26	16	20	0.5807
Pirate Souls	2022-07-01	110	47	30	140	0.5806
Arkheim - Realms at War	2022-04-05	78	32	20	98	0.5805
Solitude Underwater	2022-08-28	19	32	20	39	0.5805
Army of One : War Worlds	2022-07-03	34	29	18	52	0.5805
Outerverse	2022-08-29	38	63	41	79	0.5797
FRAIM	2022-11-01	108	101	67	175	0.5796
Jetpack Stadium	2022-02-04	9	9	5	14	0.5796
Level Up Simulator	2022-09-20	6	9	5	11	0.5796
桃花境	2022-01-22	7	9	5	12	0.5796
Pick The Lock	2022-02-15	3	9	5	8	0.5796
I NEED A NAME	2022-02-24	2	9	5	7	0.5796
Escape the Ayuwoki DEMAKE	2022-05-31	5	9	5	10	0.5796
Jesus Sacred Heart	2022-06-24	2	9	5	7	0.5796
Syndeo-Complex	2022-11-30	4	9	5	9	0.5796
SHPR	2022-08-27	3	9	5	8	0.5796
Anomalous Zone ███	2022-08-19	3	9	5	8	0.5796
Fossil Finder	2022-08-02	2	9	5	7	0.5796
Arena Chaos	2022-11-26	2	9	5	7	0.5796
GroundFall	2022-09-24	7	12	7	14	0.5782
The Red Exile	2022-06-19	3	12	7	10	0.5782
Dungeon Runner	2022-02-21	8	12	7	15	0.5782
Fishy Business	2022-02-21	2	12	7	9	0.5782
Heroes Rally	2022-09-30	11	12	7	18	0.5782
Nightmare	2022-11-10	6	12	7	13	0.5782
Closed Island	2022-09-06	2	12	7	9	0.5782
The Fridge is Red	2022-09-27	56	93	62	118	0.5781000000000001
Fracked	2022-05-05	24	33	21	45	0.5779
the DEEP LOST	2022-03-19	6	15	9	15	0.5776
REBEL	2022-03-04	8	15	9	17	0.5776
Atari Mania	2022-10-13	10	15	9	19	0.5776
Dune Strider	2022-06-21	10	27	17	27	0.5775
Hunter Survivors	2022-07-21	26	27	17	43	0.5775
Magical Girl Survivors: Prologue	2022-10-01	30	27	17	47	0.5775
Commanding Nations	2022-09-30	21	24	15	36	0.5774
SOUL JANITOR	2022-05-24	6	21	13	19	0.5773
SMUTA: Inception	2022-06-25	5	21	13	18	0.5773
My Little Miniatures	2022-11-22	9	21	13	22	0.5773
Fiend Heart	2022-12-12	11	21	13	24	0.5773
Deadly Dozen Reloaded	2022-04-29	8	18	11	19	0.5773
Forest Tower Defense	2022-09-12	3	18	11	14	0.5773
Lost Light	2022-09-01	4775	5589	4008	8783	0.5772
Ghostwire: Tokyo - Prelude	2022-03-08	95	219	151	246	0.5764
Paragon: The Overprime	2022-12-06	32524	5187	3733	36257	0.5761999999999999
Wordle 5	2022-10-10	6	40	26	32	0.5761000000000001
In The Backrooms	2022-12-09	58	40	26	84	0.5761000000000001
Cargo Company	2022-05-02	67	37	24	91	0.5758
Kingdom Gun	2022-07-28	61	47	31	92	0.5750000000000001
Ampguard	2022-02-03	28	31	20	48	0.5750000000000001
Sunset World Online	2022-03-01	42	31	20	62	0.5750000000000001
Hardrock Sex 3D	2022-09-24	52	44	29	81	0.5746
Sonia and the Hypnotic City	2022-01-15	125	41	27	152	0.5742
PaintBall War 2	2022-01-08	25	41	27	52	0.5742
FleurBirdShoot	2022-03-20	18	25	16	34	0.5740999999999999
Dysterra	2022-11-23	569	275	193	762	0.5739
SeaWolf VR	2022-04-11	2	4	2	4	0.5739
Digitizer	2022-04-08	1	4	2	3	0.5739
Overdose WW2	2022-08-03	3	4	2	5	0.5739
Fighties 2	2022-01-26	6	4	2	8	0.5739
魔女低语时	2022-08-15	2	4	2	4	0.5739
Amidst The Darkness	2022-03-24	2	4	2	4	0.5739
I've Seen Everything	2022-01-28	4	4	2	6	0.5739
Abyss Protection	2022-11-18	5	4	2	7	0.5739
Hentai Elf	2022-02-13	3	4	2	5	0.5739
Trance	2022-01-19	2	4	2	4	0.5739
Neko Waifu	2022-02-17	2	4	2	4	0.5739
Alien Prop Hunt	2022-02-03	9	4	2	11	0.5739
To Carry a Sword	2022-02-14	6	4	2	8	0.5739
NECROTOPIA	2022-02-23	7	4	2	9	0.5739
Turpedo	2022-09-04	4	4	2	6	0.5739
Minigolf Adventure	2022-05-13	4	4	2	6	0.5739
Paradox Factor	2022-05-05	4	4	2	6	0.5739
EEP 17 Eisenbahn.exe Professional - Aufbau- und Steuerungssimulation	2022-03-01	9	4	2	11	0.5739
Vaccine Delivery Adventure	2022-01-17	2	4	2	4	0.5739
Damsels of Vice	2022-02-11	9	4	2	11	0.5739
Alien Defense	2022-01-24	4	4	2	6	0.5739
Woodcutter Deluxe Edition	2022-02-02	3	4	2	5	0.5739
Escape The Living Nebula	2022-02-11	2	4	2	4	0.5739
Headpunk: The Comic-Style Battle Chaos	2022-08-29	3	4	2	5	0.5739
1001 Black Raven Jigsaw	2022-04-18	3	4	2	5	0.5739
Playtime with Hoogie	2022-11-11	4	4	2	6	0.5739
HARDDRIVE	2022-10-20	2	4	2	4	0.5739
XXX Talent	2022-03-25	6	4	2	8	0.5739
Car Quest	2022-07-22	4	4	2	6	0.5739
推推炸Push Push Boom	2022-11-30	2	4	2	4	0.5739
School Simulator RPG	2022-03-31	4	4	2	6	0.5739
Him & Her Collection	2022-06-23	1	4	2	3	0.5739
Forty Thieves Solitaire Collection	2022-04-14	5	4	2	7	0.5739
Hexfactory	2022-05-13	4	4	2	6	0.5739
Mein Reiterhof 3	2022-12-07	7	4	2	9	0.5739
Fruit farmer	2022-06-15	4	4	2	6	0.5739
VR Health & Safety Trainings For Industry (Base Pack)	2022-05-17	4	4	2	6	0.5739
Girls' civilization 3	2022-07-13	13	4	2	15	0.5739
WordWar	2022-09-01	6	4	2	8	0.5739
纷争之世	2022-06-25	4	4	2	6	0.5739
Realms	2022-06-10	4	4	2	6	0.5739
FLAM THE PURGE OF THE CENTURY	2022-05-27	3	4	2	5	0.5739
Canterz Paranormies	2022-07-08	2	4	2	4	0.5739
Plane Attack	2022-08-08	2	4	2	4	0.5739
Exhale XR | VR Wellness	2022-10-15	3	4	2	5	0.5739
Paperback Vol. 2	2022-07-14	4	4	2	6	0.5739
The Creature: Escape Room	2022-07-11	3	4	2	5	0.5739
Cyber Blades	2022-06-29	2	4	2	4	0.5739
THROWDOWN BOXING 2	2022-07-04	2	4	2	4	0.5739
Tempusia	2022-06-30	4	4	2	6	0.5739
Jet Dancer	2022-11-18	2	4	2	4	0.5739
Vanilla Brain Exam	2022-10-16	3	4	2	5	0.5739
Power Ball 2022	2022-08-01	2	4	2	4	0.5739
Project Possession	2022-08-17	8	4	2	10	0.5739
Endometric Void	2022-08-26	3	4	2	5	0.5739
TurboMania Fog Racers	2022-08-26	2	4	2	4	0.5739
Delivering Letters	2022-11-30	2	4	2	4	0.5739
good game	2022-10-10	2	4	2	4	0.5739
RunOut	2022-10-04	4	4	2	6	0.5739
Wandering Duelist	2022-11-02	2	4	2	4	0.5739
Windsurfing MMX	2022-08-29	3	4	2	5	0.5739
Rise Of A Hero	2022-09-16	1	4	2	3	0.5739
HorrorBox	2022-10-26	5	4	2	7	0.5739
The Qin Empire	2022-11-26	6	4	2	8	0.5739
Tkium Underground	2022-10-29	2	4	2	4	0.5739
Multiverse Mercenaries	2022-10-14	2	4	2	4	0.5739
Portal war	2022-10-21	4	4	2	6	0.5739
都市夜战少女	2022-11-08	5	4	2	7	0.5739
Speed Up	2022-11-11	2	4	2	4	0.5739
G-MODEアーカイブス+ 女神転生外伝 新約ラストバイブル	2022-12-13	10	4	2	12	0.5739
Hentai Beauty	2022-11-22	2	4	2	4	0.5739
攻城夺将Combat For General	2022-12-08	10	4	2	12	0.5739
Warlord	2022-12-25	7	4	2	9	0.5739
SuperJumpWorld Rage	2022-12-16	5	4	2	7	0.5739
Szybowcowa '87	2022-12-29	3	4	2	5	0.5739
Epic Assassin	2022-12-30	2	4	2	4	0.5739
Carnivores: Dinosaur Hunt	2022-08-22	26	61	41	67	0.5737
Linked Mask	2022-09-08	13	22	14	27	0.5736
Disaster	2022-01-12	7	22	14	21	0.5736
King of Kinks	2022-05-11	621	433	307	928	0.5735
Evening Vibes	2022-09-19	6	19	12	18	0.5731
The Serpent Rogue	2022-04-26	159	106	73	232	0.5729
Battleships: Command of the Sea	2022-04-20	9	16	10	19	0.5726
Mall of Mayhem	2022-08-01	9	16	10	19	0.5726
United Assault - Battle of the Bulge	2022-08-18	14	16	10	24	0.5726
Spooky Shooter 3D	2022-01-14	7	16	10	17	0.5726
Brain Exam with Benefits	2022-05-17	8	16	10	18	0.5726
PARADISE CLEANING -Me and my Doctor's life in the hospital-	2022-07-01	4	16	10	14	0.5726
ネジ込みシミュレーターVol4 -強気クールお姉さんの極太野人ちんぽぐちょぐちょ挿れ放題！！-	2022-04-14	17	32	21	38	0.5725
Floodland	2022-11-15	1042	316	224	1266	0.5724
Capsa	2022-02-03	40	135	94	134	0.5721
Pyrmd	2022-12-12	8	13	8	16	0.5721
Zombie VS Police	2022-03-07	2	13	8	10	0.5721
Waves Running Simulator	2022-04-07	2	13	8	10	0.5721
Psyolence	2022-06-25	4	13	8	12	0.5721
Startup Panic	2022-01-20	257	97	67	324	0.5718
Talking Kiteboards	2022-07-16	19	7	4	23	0.5718
Island of the Ancients	2022-04-05	4	7	4	8	0.5718
Roady Life	2022-05-27	7	7	4	11	0.5718
COTTOn Boomerang - Saturn Tribute	2022-02-09	3	7	4	7	0.5718
Shiba Army	2022-01-06	2	7	4	6	0.5718
Poly Puzzle: Dogs	2022-01-10	4	7	4	8	0.5718
Boss Of The Mafia	2022-02-03	2	7	4	6	0.5718
The Mystery Fountain in Space	2022-02-15	3	7	4	7	0.5718
Monster Island	2022-02-28	3	7	4	7	0.5718
KONGFU VR	2022-03-04	2	7	4	6	0.5718
Sim World	2022-10-18	2	7	4	6	0.5718
Crazy shark	2022-06-05	5	7	4	9	0.5718
Hide & Crab	2022-10-18	3	7	4	7	0.5718
Procemon	2022-09-28	4	7	4	8	0.5718
Better Off Dead - Life as a Prison Guard	2022-09-09	3	7	4	7	0.5718
Horny Witch: Hunt	2022-10-11	4	7	4	8	0.5718
Dreamer's Road	2022-09-21	3	7	4	7	0.5718
Total Factory	2022-09-28	4	7	4	8	0.5718
500 Second Challenge	2022-09-29	2	7	4	6	0.5718
Military Division	2022-12-06	3	7	4	7	0.5718
PAL	2022-10-30	2	7	4	6	0.5718
La Villa de la Muerte	2022-04-27	13	39	26	39	0.5717
GAMECINE VR	2022-07-18	2	10	6	8	0.5717
Return To Kurgansk	2022-02-22	4	10	6	10	0.5717
Army To Army	2022-01-04	4	10	6	10	0.5717
OS:Memories	2022-02-09	2	10	6	8	0.5717
Zadel Princess	2022-03-02	3	10	6	9	0.5717
A Crown of Sorcery and Steel	2022-10-27	47	10	6	53	0.5717
Funny Village	2022-03-20	2	10	6	8	0.5717
Muse:Valkiri&Dungeon	2022-11-11	12	10	6	18	0.5717
Revenge Master	2022-05-20	4	10	6	10	0.5717
Porcupine's Fate	2022-04-20	5	10	6	11	0.5717
白娘子	2022-05-30	3	10	6	9	0.5717
Roost	2022-10-31	4	10	6	10	0.5717
Lost Hammer	2022-11-17	5	10	6	11	0.5717
Arkanoid - Eternal Battle	2022-10-27	141	70	48	189	0.5711
Ballads of Hongye	2022-11-15	681	400	287	968	0.5707
东方王朝之丝绸之路	2022-12-16	153	88	61	214	0.5706
OnlyFap Simulator 💦	2022-02-12	874	265	189	1063	0.5704
School Bus Driver Simulator	2022-05-21	3	23	15	18	0.5703
Shackles of Ellswyn	2022-06-15	10	23	15	25	0.5703
Forbidden Fruit	2022-01-21	109	33	22	131	0.5702
Greedy Rabbit	2022-02-18	45	33	22	67	0.5702
Mythic	2022-09-29	74	30	20	94	0.5694
Emilia's PLAYROOM	2022-10-29	41	37	25	66	0.569
Idle Campaign	2022-08-18	212	58	40	252	0.5688000000000001
OUTLIER	2022-03-17	30	44	30	60	0.5688000000000001
代号:X	2022-08-25	46	17	11	57	0.5683
Wyoming Winter	2022-12-10	48	41	28	76	0.568
SAMURAI MAIDEN	2022-12-08	1159	303	220	1379	0.5673
Hentai Survivors	2022-10-01	431	103	73	504	0.5673
梦回大航海	2022-02-15	173	81	57	230	0.5673
UAL: Universal AIM League	2022-01-21	76	24	16	92	0.5673
Reverie Knights Tactics	2022-01-25	61	45	31	92	0.5672
Magna Graecia	2022-05-23	8	14	9	17	0.5669
Sprout Lands	2022-03-18	4	14	9	13	0.5669
Hajis	2022-10-25	10	14	9	19	0.5669
Worm Runner	2022-07-13	3	14	9	12	0.5669
Climb Challenge - Castle	2022-08-17	2	14	9	11	0.5669
DRAGON BALL: THE BREAKERS	2022-10-13	4057	2143	1599	5656	0.5666
Arma Reforger	2022-05-17	12342	4392	3299	15641	0.5663
HELLSEED	2022-11-30	30	53	37	67	0.5660000000000001
Circle Empires Tactics	2022-04-07	66	21	14	80	0.5660000000000001
Arruyo	2022-06-11	55	72	51	106	0.5654
Kamigawa: A Visual Novel	2022-02-18	10	11	7	17	0.5653
Sweet Agents	2022-07-13	5	11	7	12	0.5653
Paranormal Preparatory School	2022-08-11	44	11	7	51	0.5653
Rain Ruin	2022-07-15	30	11	7	37	0.5653
Aevumblade Chronicles	2022-11-01	4	11	7	11	0.5653
Commandos 3 - HD Remaster	2022-08-30	107	106	76	183	0.5652
The Circus	2022-05-19	86	50	35	121	0.5652
SCP: Abhorrent	2022-03-13	18	50	35	53	0.5652
Clouzy!	2022-02-24	20	32	22	42	0.5649000000000001
Pachillinko	2022-02-01	113	25	17	130	0.5645
光辉耀浙里Brilliance shines in Zhejiang	2022-05-26	2	18	12	14	0.5644
The Blight	2022-07-08	8	18	12	20	0.5644
The Last Front	2022-03-05	18	40	28	46	0.5636
SHINORUBI	2022-01-20	5	8	5	10	0.5632
Sex Adventures - The Secret Club	2022-01-22	4	8	5	9	0.5632
TETRIS: Flower Garden	2022-04-15	3	8	5	8	0.5632
Chloe Puzzle Game	2022-06-03	2	8	5	7	0.5632
Medal of Guardians	2022-11-19	46	8	5	51	0.5632
Dotgeon	2022-12-21	2	8	5	7	0.5632
R2Beat: 音速觉醒	2022-04-08	3049	1123	847	3896	0.5629
Broken : Paranormal investigation	2022-09-29	27	22	15	42	0.5629
Lightout 2	2022-05-27	9	22	15	24	0.5629
Dragon Extinction VR	2022-04-28	10	15	10	20	0.5625
重返现场	2022-11-24	11	15	10	21	0.5625
The LastOnesLeft!!	2022-01-15	3	15	10	13	0.5625
Survival Girls	2022-03-31	7	15	10	17	0.5625
CHICKWEED	2022-06-25	2	15	10	12	0.5625
Sefirot Shards	2022-12-11	27	26	18	45	0.562
Legend of the Phoenix	2022-01-27	22	26	18	40	0.562
Galactic Ruler	2022-08-03	38	49	35	73	0.5615
幻塔	2022-10-22	938	186	138	1076	0.5611
Periphery	2022-08-19	12	19	13	25	0.561
Harem King: Peasant to Princess Gotta Breed 'Em All!	2022-09-09	28	19	13	41	0.561
我有一座冒险屋 I have an adventure house	2022-03-12	54	34	24	78	0.5609000000000001
Redemption Cemetery: Dead Park Collector's Edition	2022-01-27	5	5	3	8	0.5605
Super Punch Patrol	2022-09-20	2	5	3	5	0.5605
Velocity Legends - Crazy Car Action Racing Game	2022-03-16	2	5	3	5	0.5605
The Lustful Champion	2022-03-07	4	5	3	7	0.5605
PLAYBOOK	2022-09-07	2	5	3	5	0.5605
Hundreds of Mysteries: Wendy's Home2	2022-02-02	6	5	3	9	0.5605
CURSES	2022-08-29	2	5	3	5	0.5605
Niki in the Ship	2022-09-07	3	5	3	6	0.5605
Ducky	2022-02-01	2	5	3	5	0.5605
Abeyance	2022-10-07	10	5	3	13	0.5605
Ragdolls Playground: The Sandbox	2022-08-10	4	5	3	7	0.5605
一花一世界	2022-02-25	5	5	3	8	0.5605
シオリノコトハ ～ Dark Reflections ～	2022-01-19	4	5	3	7	0.5605
烈火冲锋The charge is the fire	2022-01-11	2	5	3	5	0.5605
Breathless	2022-05-13	2	5	3	5	0.5605
Era Dream	2022-03-31	4	5	3	7	0.5605
死守危城	2022-05-23	12	5	3	15	0.5605
Sodom-R	2022-03-04	5	5	3	8	0.5605
Jigsaw Novel - Double Trouble	2022-03-04	2	5	3	5	0.5605
Epic Pirate	2022-03-25	2	5	3	5	0.5605
驯龙物语	2022-06-15	7	5	3	10	0.5605
Tilebreaker	2022-04-26	2	5	3	5	0.5605
Joyride	2022-06-06	4	5	3	7	0.5605
Jigsaw Puzzle - Futanari Massage	2022-04-26	2	5	3	5	0.5605
Jigsaw Puzzle - Swingers Party	2022-05-13	3	5	3	6	0.5605
Hot Milf 6	2022-06-16	2	5	3	5	0.5605
Hot Milf 7	2022-07-15	2	5	3	5	0.5605
Starship	2022-07-26	3	5	3	6	0.5605
Dalo	2022-07-14	3	5	3	6	0.5605
拳击女神	2022-07-22	3	5	3	6	0.5605
Futanari Sex - Mile High Fun	2022-07-07	3	5	3	6	0.5605
Sneaky IT Support	2022-10-28	7	5	3	10	0.5605
我是大官人	2022-09-01	3	5	3	6	0.5605
The Hideaway	2022-11-01	3	5	3	6	0.5605
Wild West	2022-09-09	2	5	3	5	0.5605
Dragon Must Die	2022-09-08	3	5	3	6	0.5605
Seeking Asylum: Revelations	2022-09-22	4	5	3	7	0.5605
Operation Satoshi	2022-11-08	3	5	3	6	0.5605
Scare Girl	2022-11-04	3	5	3	6	0.5605
Draft Day Sports: Pro Football 2023	2022-10-19	19	5	3	22	0.5605
Zabawa Karaoke	2022-11-18	3	5	3	6	0.5605
Turbo Shot	2022-01-13	56	23	16	72	0.5602
Soldier Warfare	2022-01-06	4	23	16	20	0.5602
TETRIS RTX	2022-02-16	4	12	8	12	0.56
Light Of The Past	2022-05-06	2	12	8	10	0.56
BoomCrash	2022-05-24	9	12	8	17	0.56
Winter Things	2022-06-22	2	12	8	10	0.56
Crypto Clicker	2022-11-28	20	12	8	28	0.56
Nash Racing: Pursuit	2022-11-30	3	12	8	11	0.56
Horror Night	2022-02-04	68	112	83	151	0.5592
World Titans War	2022-03-17	22	43	31	53	0.559
Hidden Tavern Top-Down 3D	2022-02-11	3	16	11	14	0.5586
City Bus Driver Simulator	2022-09-15	3	16	11	14	0.5586
Serena: Dark confessions	2022-03-03	54	20	14	68	0.5579999999999999
Sex Search	2022-03-10	5	20	14	19	0.5579999999999999
Frostbitten	2022-05-10	8	20	14	22	0.5579999999999999
Fiefdom	2022-05-30	8	20	14	22	0.5579999999999999
Common'hood	2022-11-10	301	133	100	401	0.5571
Glizzy Gobbler	2022-05-24	3	2	1	4	0.5569
TOGUM	2022-10-24	2	2	1	3	0.5569
Tribble Troubles	2022-07-16	2	2	1	3	0.5569
Chariots of War	2022-10-13	8	2	1	9	0.5569
Roll Ball Adventures	2022-02-02	1	2	1	2	0.5569
模特姐妹	2022-03-01	1	2	1	2	0.5569
A Midnight Village Story	2022-12-13	1	2	1	2	0.5569
GoVenture Entrepreneur	2022-06-21	5	2	1	6	0.5569
Starfighter Renegade	2022-11-25	2	2	1	3	0.5569
Ultra Imposer	2022-05-20	2	2	1	3	0.5569
Amazing Chicken Adventures	2022-09-16	2	2	1	3	0.5569
Soccer VR Football	2022-07-26	2	2	1	3	0.5569
Slayer Cat	2022-09-22	2	2	1	3	0.5569
Azy - Old School FPS	2022-01-29	1	2	1	2	0.5569
Give the People What They Want	2022-05-06	2	2	1	3	0.5569
Astroroxx	2022-01-10	2	2	1	3	0.5569
Aquarium Travels	2022-12-14	1	2	1	2	0.5569
Legends of Mathmatica²: Under the Shadow of Certainty	2022-03-14	2	2	1	3	0.5569
Mutant	2022-01-24	2	2	1	3	0.5569
Domum	2022-07-29	1	2	1	2	0.5569
Hate Free Heroes: Agents of Aggro City	2022-03-07	2	2	1	3	0.5569
ONCE IN MY HEAD	2022-03-15	1	2	1	2	0.5569
Airborne Ranger	2022-12-19	2	2	1	3	0.5569
Scelestum	2022-10-30	4	2	1	5	0.5569
Bookstore Simulator	2022-07-08	1	2	1	2	0.5569
Master of the Wizards	2022-03-12	5	2	1	6	0.5569
Ragnar	2022-01-14	1	2	1	2	0.5569
Spooky Horror Game	2022-01-02	2	2	1	3	0.5569
Escape Halloween Forest	2022-11-18	2	2	1	3	0.5569
DogFight Time	2022-04-05	2	2	1	3	0.5569
MotoX	2022-11-07	1	2	1	2	0.5569
Alchera	2022-07-16	1	2	1	2	0.5569
Monsters Loot Swag	2022-08-18	3	2	1	4	0.5569
The hardest game in the universe 2	2022-11-08	1	2	1	2	0.5569
Normal SHMUP	2022-02-07	1	2	1	2	0.5569
Pranksterz: Off Your Boss	2022-01-21	1	2	1	2	0.5569
Warmonger: Sins of the Naga	2022-05-15	2	2	1	3	0.5569
Treefender	2022-07-14	5	2	1	6	0.5569
Mr.Egg:Adventure	2022-08-11	5	2	1	6	0.5569
Find The Cat	2022-05-06	1	2	1	2	0.5569
Downfall of Krynto	2022-01-26	1	2	1	2	0.5569
Zephyrus Prelude	2022-12-20	6	2	1	7	0.5569
NeuroWorm	2022-04-28	3	2	1	4	0.5569
Escape	2022-02-07	1	2	1	2	0.5569
Broken	2022-01-31	2	2	1	3	0.5569
Reef Rivals	2022-04-14	4	2	1	5	0.5569
Where's My Horse? An Escape the Room Adventure	2022-01-14	3	2	1	4	0.5569
Rising of the Moon	2022-01-07	2	2	1	3	0.5569
Wardudes	2022-12-23	6	2	1	7	0.5569
Bridge to Another World: Christmas Flight Collector's Edition	2022-01-05	6	2	1	7	0.5569
Jigsaw Puzzle Beach Season	2022-03-01	3	2	1	4	0.5569
LightingClimbing	2022-03-31	2	2	1	3	0.5569
Reveal Your Monster	2022-03-10	2	2	1	3	0.5569
Thumb-Thump	2022-01-26	1	2	1	2	0.5569
BombSweeperVR	2022-01-26	2	2	1	3	0.5569
Aldebaran Legend	2022-11-10	2	2	1	3	0.5569
Crossroads: On a Just Path Collector's Edition	2022-01-18	4	2	1	5	0.5569
Poly Memory: Dogs	2022-01-26	2	2	1	3	0.5569
Gyelfars	2022-08-24	1	2	1	2	0.5569
NEXT DOOR 悠遠の世界	2022-02-02	2	2	1	3	0.5569
TNTODION	2022-05-12	1	2	1	2	0.5569
鳥獣妖怪戯画	2022-05-30	2	2	1	3	0.5569
The Darkest Road	2022-06-09	4	2	1	5	0.5569
Find a way out: Abode of darkness.	2022-02-28	1	2	1	2	0.5569
Midnight Stories 5	2022-02-08	2	2	1	3	0.5569
Chess vs Chat	2022-08-09	2	2	1	3	0.5569
Really Another True	2022-02-24	2	2	1	3	0.5569
Maze Of Realities: Flower Of Discord Collector's Edition	2022-03-08	6	2	1	7	0.5569
costrutto	2022-09-18	2	2	1	3	0.5569
Innocence Island	2022-09-15	1	2	1	2	0.5569
The Quest For Excalibur - Puy Du Fou	2022-07-19	7	2	1	8	0.5569
了不起的棋盘	2022-04-12	1	2	1	2	0.5569
FireSquad	2022-07-01	2	2	1	3	0.5569
Nea Edem	2022-03-11	1	2	1	2	0.5569
VHS PLATFORM: 2D	2022-03-02	1	2	1	2	0.5569
Lollipop Knight	2022-04-08	2	2	1	3	0.5569
Work At Height VR Training	2022-03-20	2	2	1	3	0.5569
Voxel Digger	2022-03-22	3	2	1	4	0.5569
Orkhon Inscriptions Mongolia	2022-03-09	1	2	1	2	0.5569
Unlucky Sniper	2022-03-30	1	2	1	2	0.5569
Pet Vet 3D Animal hospital Down Under	2022-04-21	3	2	1	4	0.5569
VR Air Hockey	2022-04-06	4	2	1	5	0.5569
Frontier Fortress - Tower Defense	2022-04-06	2	2	1	3	0.5569
The Legend of Gandar	2022-04-26	3	2	1	4	0.5569
The Endless Summer Surfing Challenge	2022-05-20	2	2	1	3	0.5569
Infinite Links	2022-05-12	8	2	1	9	0.5569
Pokaban	2022-11-01	2	2	1	3	0.5569
Comixxx Swap	2022-04-16	2	2	1	3	0.5569
Jigsaw Novel - Summer Threesome	2022-03-19	2	2	1	3	0.5569
Nature's Habit	2022-04-07	1	2	1	2	0.5569
Golden Mine Pickaxe 2: Mummy Tombs	2022-04-05	2	2	1	3	0.5569
Moonphase Pass	2022-07-08	3	2	1	4	0.5569
Bad Bad	2022-04-14	2	2	1	3	0.5569
čeke ceké	2022-06-30	2	2	1	3	0.5569
Zion survivors	2022-05-06	3	2	1	4	0.5569
Crazy Cook	2022-06-23	2	2	1	3	0.5569
Class Five Memorial GAME	2022-07-01	1	2	1	2	0.5569
M87	2022-08-20	1	2	1	2	0.5569
出发吧冒险家	2022-06-01	4	2	1	5	0.5569
Without End	2022-09-02	3	2	1	4	0.5569
Gone	2022-05-16	1	2	1	2	0.5569
Nano Organism	2022-05-21	1	2	1	2	0.5569
Ahack Adventure 2: Quest For The Ciggy	2022-07-18	2	2	1	3	0.5569
From Within	2022-07-29	5	2	1	6	0.5569
Nine Lives or Less	2022-06-17	2	2	1	3	0.5569
The Invisible Man's Stealth NTR: Convincing and Inseminating the New Announcer with an Invisible Boner	2022-06-24	10	2	1	11	0.5569
The Chronicle	2022-06-28	2	2	1	3	0.5569
Collapse Relapse	2022-06-22	2	2	1	3	0.5569
Boltcraft	2022-07-29	3	2	1	4	0.5569
VR CHINESE KUNG FU	2022-07-08	2	2	1	3	0.5569
DarkSelf: Other Mind	2022-06-08	2	2	1	3	0.5569
Who Stole My Sheep?	2022-06-29	3	2	1	4	0.5569
The Fighters Online	2022-08-08	2	2	1	3	0.5569
Paranoya	2022-12-01	1	2	1	2	0.5569
Office Harasser	2022-07-11	9	2	1	10	0.5569
GALXAGAR	2022-08-19	1	2	1	2	0.5569
Hacker life simulator	2022-07-08	2	2	1	3	0.5569
海岛守卫	2022-07-05	3	2	1	4	0.5569
UPGRADE 2021-22 - Bionic Traveler	2022-08-18	2	2	1	3	0.5569
PARTHIAN STRIKE	2022-08-02	2	2	1	3	0.5569
Charging Out Dead Zone	2022-08-05	2	2	1	3	0.5569
May's Mysteries: The Secret of Dragonville Remastered	2022-08-30	2	2	1	3	0.5569
The Legend of Azarias	2022-07-06	1	2	1	2	0.5569
Jigsaw Puzzle - Futanari Roomate	2022-07-10	2	2	1	3	0.5569
Islet Hell	2022-07-24	2	2	1	3	0.5569
Rush Hour Deluxe	2022-12-20	3	2	1	4	0.5569
69 Ember Hot	2022-10-21	2	2	1	3	0.5569
Tale Of Tale - Hansel And Gretel	2022-11-04	2	2	1	3	0.5569
Holiday Jigsaw Christmas 2	2022-09-05	2	2	1	3	0.5569
War of Bellrook	2022-08-02	2	2	1	3	0.5569
呜咽岛	2022-10-25	2	2	1	3	0.5569
天天萌泡泡	2022-08-17	2	2	1	3	0.5569
Anolock	2022-08-11	3	2	1	4	0.5569
Celadon	2022-09-13	2	2	1	3	0.5569
슬픈 가족사 - 산장으로부터의 탈출	2022-08-26	3	2	1	4	0.5569
Anvil Life	2022-08-17	3	2	1	4	0.5569
The Packages	2022-08-22	2	2	1	3	0.5569
Charley's Day	2022-09-30	2	2	1	3	0.5569
Sins From Magdala	2022-11-18	3	2	1	4	0.5569
Sex Adventures - Swingers Gym	2022-08-13	2	2	1	3	0.5569
Pedal to the Metal	2022-09-06	4	2	1	5	0.5569
The Levels of Backrooms	2022-10-29	3	2	1	4	0.5569
Lovely Trap	2022-09-06	2	2	1	3	0.5569
Cracked	2022-10-12	4	2	1	5	0.5569
エクストリームバイクX	2022-10-17	1	2	1	2	0.5569
Moto Trophy VR	2022-11-19	1	2	1	2	0.5569
Tivick'ing! Chronicles	2022-11-25	1	2	1	2	0.5569
Cat and Watermouse	2022-09-21	2	2	1	3	0.5569
Bad Writer	2022-09-30	2	2	1	3	0.5569
Pot Breaker	2022-10-31	1	2	1	2	0.5569
Cute Fight	2022-09-29	1	2	1	2	0.5569
Slayer Of Sin	2022-10-28	1	2	1	2	0.5569
Big Adventure: Trip to Europe 2 - Collector's Edition	2022-10-05	4	2	1	5	0.5569
Little Witchelsa: Pumpkin Peril	2022-10-14	4	2	1	5	0.5569
Tomb of the Dead	2022-10-09	2	2	1	3	0.5569
Robbie	2022-12-05	2	2	1	3	0.5569
To the earth	2022-12-02	2	2	1	3	0.5569
Im Late	2022-10-26	1	2	1	2	0.5569
RCPG	2022-10-13	3	2	1	4	0.5569
ハーレム過ぎる異世界は俺が救う - Isekai Harem Saver -	2022-11-17	2	2	1	3	0.5569
My Universe - My Baby Dragon	2022-12-01	3	2	1	4	0.5569
Pressure Within	2022-10-25	2	2	1	3	0.5569
Patty Pepperton in The Pumpkin Patch	2022-11-01	2	2	1	3	0.5569
Rocket Inc	2022-10-28	2	2	1	3	0.5569
UNRUSH	2022-12-15	2	2	1	3	0.5569
Sex Simulator - Love Room	2022-11-14	6	2	1	7	0.5569
Ghost Village	2022-11-03	2	2	1	3	0.5569
Dark City: International Intrigue Collector's Edition	2022-10-28	5	2	1	6	0.5569
Lustful Assistant	2022-11-10	3	2	1	4	0.5569
NONOGRAM - KAWAII CUTIES 2nd	2022-11-17	3	2	1	4	0.5569
WORDKOUR	2022-11-02	2	2	1	3	0.5569
Candy Maid	2022-11-11	1	2	1	2	0.5569
Welme	2022-11-29	3	2	1	4	0.5569
Utopia	2022-11-24	1	2	1	2	0.5569
Crossroads: Escaping the Dark Collector's Edition	2022-11-11	4	2	1	5	0.5569
Athena Code	2022-12-13	1	2	1	2	0.5569
Hentai! Waifu Puzzles	2022-12-06	2	2	1	3	0.5569
Furry Dream	2022-12-15	2	2	1	3	0.5569
Detective Rosie Morgan: Death at a Dinner Party	2022-12-20	3	2	1	4	0.5569
Christmas Stories: Taxi of Miracles Collector's Edition	2022-12-09	9	2	1	10	0.5569
Aeolus Fighter	2022-12-16	3	2	1	4	0.5569
Jump Jump	2022-12-19	3	2	1	4	0.5569
BumpUpGhostBuster	2022-12-28	2	2	1	3	0.5569
A dream that never wakes up	2022-12-22	2	2	1	3	0.5569
Sex Simulator - The Cabin	2022-12-18	4	2	1	5	0.5569
Claustrophobia	2022-02-10	3	9	6	9	0.5566
Magic Sexyland	2022-02-10	7	9	6	13	0.5566
Legend of Ixtona	2022-03-04	15	9	6	21	0.5566
Captain of Leningrad: Underwater Soviet Postapocalypse	2022-01-31	2	9	6	8	0.5566
Windsor - Strategy	2022-07-16	7	9	6	13	0.5566
Annum	2022-11-23	3	9	6	9	0.5566
Grot Slasher	2022-06-16	7	9	6	13	0.5566
Sakura Gym Girls: Prologue	2022-12-05	39	9	6	45	0.5566
这里有妖	2022-07-29	16	9	6	22	0.5566
Boat Rage	2022-12-03	3	9	6	9	0.5566
Size It	2022-01-24	2	13	9	11	0.5555
Hidden Industries Top-Down 3D	2022-06-18	2	13	9	11	0.5555
VDoll	2022-11-15	10	13	9	19	0.5555
Hardcore Cruising: A Sci-Fi Gay Sex Cruise!	2022-06-29	27	17	12	39	0.5552
Who is the hero of this Game	2022-07-24	7	17	12	19	0.5552
SnowBrawl	2022-07-17	12	17	12	24	0.5552
LandBox	2022-10-14	21	17	12	33	0.5552
Joint War	2022-08-26	39	121	92	131	0.5545
Sphere: Flying Cities	2022-10-13	96	99	75	171	0.5544
Soccer Story	2022-11-29	101	51	38	139	0.5542
Hot Pussy College 🍓🔞	2022-10-15	504	131	100	604	0.5540999999999999
Yeomna : The Legend of Dongbaek	2022-07-31	23	34	25	48	0.554
Blackwind	2022-01-20	35	34	25	60	0.554
Escort Simulator	2022-02-14	23	114	87	110	0.5536
江湖百异图	2022-12-16	22	30	22	44	0.5536
Knight Story	2022-05-18	4	22	16	20	0.5527000000000001
Lost Ember VR Edition	2022-07-12	8	35	26	34	0.5525
Blade Runner: Enhanced Edition	2022-06-23	82	126	97	179	0.5523
回忆画册~MemoriesAlbum~	2022-09-09	15	44	33	48	0.5522
Superstar Streetz	2022-01-04	22	18	13	35	0.5522
STARTMOVE	2022-01-03	9	18	13	22	0.5522
Virago	2022-03-15	7	18	13	20	0.5522
Mysterious Island - A Hidden Object Adventure	2022-06-03	3	18	13	16	0.5522
Hell Grocery	2022-10-21	29	18	13	42	0.5522
Monstrum 2	2022-09-06	406	309	242	648	0.5517000000000001
No Captain Allowed!	2022-05-02	17	14	10	27	0.5517000000000001
纵横	2022-10-10	17	14	10	27	0.5517000000000001
风暴行动	2022-11-15	5	14	10	15	0.5517000000000001
因缘	2022-06-13	7	6	4	11	0.5514
Minable & Create	2022-03-23	4	6	4	8	0.5514
Donutis Simulator	2022-11-28	2	6	4	6	0.5514
Metavusking	2022-04-28	8	6	4	12	0.5514
My Universe - Green Adventure - Farmer Friends	2022-06-30	9	6	4	13	0.5514
December 24th	2022-08-03	7	6	4	11	0.5514
Project Noah	2022-10-27	4	6	4	8	0.5514
Ingredients for the Chaos	2022-08-01	5	6	4	9	0.5514
艾诺之地 Land Of Eno	2022-01-06	3	6	4	7	0.5514
Cloud Girl	2022-01-06	2	6	4	6	0.5514
Sketch	2022-05-20	5	6	4	9	0.5514
slaves	2022-10-02	8	6	4	12	0.5514
Kuggs	2022-04-22	2	6	4	6	0.5514
Dare to Stay	2022-07-01	2	6	4	6	0.5514
Zankinzoken	2022-11-26	2	6	4	6	0.5514
This Girl Does Not Exist	2022-09-08	2	6	4	6	0.5514
PIP 2	2022-08-26	3	6	4	7	0.5514
Final Recurrence	2022-10-16	6	6	4	10	0.5514
The Tower	2022-11-09	3	6	4	7	0.5514
Draco	2022-10-11	3	6	4	7	0.5514
Bitter Belief	2022-11-04	3	6	4	7	0.5514
Sticky Honey	2022-10-20	4	6	4	8	0.5514
Mountain Parkour	2022-12-19	1	6	4	5	0.5514
Tasty Defense	2022-12-21	2	6	4	6	0.5514
Jedi Survive	2022-12-22	4	6	4	8	0.5514
Usagi Health Club	2022-09-19	7	10	7	14	0.5513
Who Is Zombie	2022-02-24	25	10	7	32	0.5513
Sex Adventures - Futanari BDSM	2022-04-08	4	10	7	11	0.5513
THE MADMAN	2022-07-02	4	10	7	11	0.5513
Arcade Waifu	2022-08-12	3	10	7	10	0.5513
Jurassic Clans	2022-10-21	10	10	7	17	0.5513
Hidden Dungeon Top-Down 3D	2022-10-27	3	10	7	10	0.5513
Jessica's Life The Beginning	2022-12-13	7	10	7	14	0.5513
SUPER PEOPLE 2	2022-10-09	47392	8591	6931	54323	0.5505
PBA Pro Bowling 2023	2022-09-07	20	23	17	37	0.5505
FROM FEAR	2022-09-16	34	23	17	51	0.5505
Bicycle Rider Simulator	2022-08-05	9	23	17	26	0.5505
Nighthunt	2022-07-25	203	126	98	301	0.5503
Maroon Berets: 2030	2022-05-19	10	19	14	24	0.5496
3D PUZZLE - Modern House	2022-02-09	4	19	14	18	0.5496
Cute Invaders	2022-05-10	7	15	11	18	0.5484
Hidden Post-Apocalyptic 3 Top-Down 3D	2022-12-17	3	15	11	14	0.5484
Only Furry 18+	2022-04-30	278	107	84	362	0.5478000000000001
🕌魔塔与6️⃣勇者 (Six Braves)	2022-09-13	418	245	195	613	0.5477000000000001
梦江湖	2022-07-13	2421	738	595	3016	0.5475
Cold House	2022-05-03	28	63	49	77	0.5474
FEEBLE	2022-02-08	6	20	15	21	0.5471
Dungeon Swappers	2022-07-22	6	11	8	14	0.5468999999999999
Sacred Valley	2022-04-29	2	11	8	10	0.5468999999999999
The Claws of Blood	2022-09-16	6	11	8	14	0.5468999999999999
Ukrainien Agent	2022-07-03	3	11	8	11	0.5468999999999999
Sitri ~Shadow Walk~	2022-10-29	14	11	8	22	0.5468999999999999
Tint 'n Ink	2022-11-04	43	84	66	109	0.5468000000000001
INTERASTRA	2022-02-09	17	25	19	36	0.5465
SEX HELL 👹	2022-11-19	508	60	47	555	0.5459
Zcrew	2022-09-12	306	175	140	446	0.5457
Manny Boxing VR	2022-05-27	8	16	12	20	0.5455
3D PUZZLE - Farm House	2022-04-22	3	16	12	15	0.5455
GoRogue	2022-05-16	10	16	12	22	0.5455
World War 3	2022-12-10	11792	27660	22900	34692	0.5453
Nova Empire	2022-05-26	183	92	73	256	0.5452
Warhammer 40,000: Darktide	2022-11-30	108395	36733	30454	138849	0.5451
Karagon: Prologue	2022-02-08	25	46	36	61	0.5449
Fire Commander: First Response	2022-06-14	40	41	32	72	0.5448
Chat with yu	2022-09-22	5	7	5	10	0.5448
Turbeton	2022-05-26	7	7	5	12	0.5448
Enjoy	2022-08-15	4	7	5	9	0.5448
Cat and fish	2022-01-27	2	7	5	7	0.5448
恥力女戰士	2022-03-05	11	7	5	16	0.5448
Corleone Online	2022-06-24	7	7	5	12	0.5448
EMPYRE: Dukes of the Far Frontier	2022-06-03	5	7	5	10	0.5448
Absolute Tennis Manager	2022-05-09	4	7	5	9	0.5448
Sex Diary - Swingers Yacht	2022-04-28	3	7	5	8	0.5448
Omni Magic!	2022-10-21	7	7	5	12	0.5448
Futanari Sex - The New Boss	2022-05-21	6	7	5	11	0.5448
King Pig	2022-06-13	3	7	5	8	0.5448
御剑三国	2022-08-01	5	7	5	10	0.5448
AdvLite	2022-11-26	2	7	5	7	0.5448
Water Chaos	2022-12-03	14	7	5	19	0.5448
Cycle of The Moon	2022-09-30	3	7	5	8	0.5448
War of Kings	2022-12-06	1	7	5	6	0.5448
Ultra Rhythm	2022-12-02	4	7	5	9	0.5448
Knocking Up my Nympho Neighbors	2022-12-09	8	7	5	13	0.5448
Bibots	2022-10-05	52	31	24	76	0.5447
The Dark Pictures Anthology: The Devil in Me	2022-11-18	3599	1429	1173	4772	0.5446
Out There: Oceans of Time	2022-05-26	336	105	84	420	0.5441
GWENT: Rogue Mage (Single-Player Expansion)	2022-07-07	1170	463	378	1548	0.5439
MultiVerse	2022-03-19	6	12	9	15	0.5433
The Hike	2022-05-05	6	12	9	15	0.5433
DarkSpar	2022-03-07	49	12	9	58	0.5433
Alcyone	2022-05-04	3	12	9	12	0.5433
Drive 21	2022-12-21	25	196	159	184	0.5432
SBK™22	2022-09-15	168	82	66	234	0.5421
The Beat: A Glam Noir Game	2022-08-24	2	3	2	4	0.5417000000000001
Infinite Home	2022-01-12	4	3	2	6	0.5417000000000001
Dash Hale	2022-04-22	1	3	2	3	0.5417000000000001
This rain will never end	2022-08-17	4	3	2	6	0.5417000000000001
Operation Sexy Sudoku	2022-02-05	4	3	2	6	0.5417000000000001
Eternal War	2022-12-10	3	3	2	5	0.5417000000000001
EverWorld	2022-02-02	1	3	2	3	0.5417000000000001
A Cure for Jessica	2022-01-08	3	3	2	5	0.5417000000000001
Stand Of Arms	2022-01-16	2	3	2	4	0.5417000000000001
Merchant's Game	2022-09-01	2	3	2	4	0.5417000000000001
Theory of Poltaran	2022-01-04	2	3	2	4	0.5417000000000001
Dungeon Raider	2022-06-09	1	3	2	3	0.5417000000000001
Stop the Bus!	2022-02-04	3	3	2	5	0.5417000000000001
Hexagourds	2022-01-06	3	3	2	5	0.5417000000000001
The Flow Experience	2022-04-01	2	3	2	4	0.5417000000000001
Shaped Beats	2022-03-11	1	3	2	3	0.5417000000000001
Grey Block	2022-10-26	1	3	2	3	0.5417000000000001
Rejoinder	2022-03-23	2	3	2	4	0.5417000000000001
That Castle	2022-12-22	1	3	2	3	0.5417000000000001
Vektor Z	2022-01-15	4	3	2	6	0.5417000000000001
The Last Rite of Death	2022-05-06	2	3	2	4	0.5417000000000001
Knights Riot	2022-02-08	2	3	2	4	0.5417000000000001
Emiko's Pledge	2022-02-25	1	3	2	3	0.5417000000000001
SynthWaves	2022-07-15	2	3	2	4	0.5417000000000001
O.D.T.: Escape... Or Die Trying	2022-04-05	2	3	2	4	0.5417000000000001
Tegridy Puzzles	2022-03-15	2	3	2	4	0.5417000000000001
A List Of People Who Went Missing In The Scheleirland National Forest	2022-03-14	3	3	2	5	0.5417000000000001
The Sinking Structure, Clione, and Lost Child -Log5	2022-04-06	2	3	2	4	0.5417000000000001
Between Two Stars	2022-04-20	3	3	2	5	0.5417000000000001
FreeCell Solitaire Collection	2022-05-14	8	3	2	10	0.5417000000000001
Another Side	2022-06-07	2	3	2	4	0.5417000000000001
Financial freedom for the few	2022-08-19	5	3	2	7	0.5417000000000001
Capture Creatures	2022-04-15	3	3	2	5	0.5417000000000001
1001 Jigsaw. Legends of Mystery 5	2022-05-30	2	3	2	4	0.5417000000000001
Wind Angel Challenge	2022-04-22	3	3	2	5	0.5417000000000001
The Sinking Structure, Clione, and Lost Child -Log6	2022-04-20	2	3	2	4	0.5417000000000001
CubeLoop	2022-08-30	3	3	2	5	0.5417000000000001
The Den of Chaos2 - 混沌の魔窟殿２～アッサマラームの遺跡編～	2022-05-16	6	3	2	8	0.5417000000000001
Skystrike: Wings of Justice	2022-11-10	21	3	2	23	0.5417000000000001
Rhythm Knights: Double Treble	2022-08-04	3	3	2	5	0.5417000000000001
Amanda's Magic Book 4: True Love	2022-05-18	4	3	2	6	0.5417000000000001
Fertile Heroine Seaworthy	2022-08-02	5	3	2	7	0.5417000000000001
Akapulka - The Rainbow	2022-05-26	1	3	2	3	0.5417000000000001
E-ON	2022-09-07	2	3	2	4	0.5417000000000001
FarmingCat	2022-09-06	1	3	2	3	0.5417000000000001
The Alchemist	2022-06-26	4	3	2	6	0.5417000000000001
피랍 일지 - 그 남자로부터의 탈출	2022-07-28	5	3	2	7	0.5417000000000001
Futanari Sex - Naughty Massage	2022-06-20	2	3	2	4	0.5417000000000001
dead train	2022-07-22	2	3	2	4	0.5417000000000001
The Marson Home	2022-07-18	2	3	2	4	0.5417000000000001
Tesla Legacy	2022-07-22	2	3	2	4	0.5417000000000001
Agent1218	2022-07-29	1	3	2	3	0.5417000000000001
Haunted:Live	2022-10-20	5	3	2	7	0.5417000000000001
The Voices Games 3d Collection	2022-09-16	2	3	2	4	0.5417000000000001
Sapper Robot	2022-08-02	2	3	2	4	0.5417000000000001
Connect the Dots 3D	2022-07-28	2	3	2	4	0.5417000000000001
Dragon Prana	2022-10-07	22	3	2	24	0.5417000000000001
Scorphius	2022-08-29	5	3	2	7	0.5417000000000001
Oil Manager	2022-10-14	6	3	2	8	0.5417000000000001
カルマの回収屋	2022-09-16	2	3	2	4	0.5417000000000001
Link Bomb☆Party/链接炸弹☆派对	2022-10-14	4	3	2	6	0.5417000000000001
Project: Dream	2022-10-12	2	3	2	4	0.5417000000000001
Reality	2022-10-21	5	3	2	7	0.5417000000000001
War Of Gold 2 Mission 99	2022-10-31	2	3	2	4	0.5417000000000001
Save the Queen	2022-11-04	3	3	2	5	0.5417000000000001
One Shot Challenge	2022-12-15	2	3	2	4	0.5417000000000001
Barren Depths	2022-11-09	2	3	2	4	0.5417000000000001
Gray	2022-11-19	3	3	2	5	0.5417000000000001
Sword of Wonder: It's Good to be a King	2022-11-17	14	3	2	16	0.5417000000000001
Sex Adventures - Cuckold Gym	2022-11-26	4	3	2	6	0.5417000000000001
Metal Detecting Simulator	2022-12-28	2	3	2	4	0.5417000000000001
Call of the Wild: The Angler™	2022-08-31	9995	2458	2053	12048	0.5413
Hentai Most Wanted	2022-05-27	2	13	10	12	0.5402
DonutCrabs	2022-07-03	5	13	10	15	0.5402
4th Generation Warfare	2022-07-28	32	75	61	93	0.5398
A Little Time	2022-05-08	3	8	6	9	0.5398
Wailing Guignol	2022-04-15	8	8	6	14	0.5398
RIFT	2022-07-10	5	8	6	11	0.5398
RC Death Race: Multiplayer	2022-03-20	6	8	6	12	0.5398
Wife Massage	2022-05-27	8	8	6	14	0.5398
木偶公馆	2022-05-11	6	8	6	12	0.5398
S.I.N. Unit	2022-05-26	9	24	19	28	0.5395000000000001
TCM RACING 2	2022-11-17	8	19	15	23	0.5387
Kritika Global	2022-07-22	84	84	69	153	0.5383
College Bound: Arctic Adventure	2022-03-18	133	48	39	172	0.5383
Demons Rise Up!	2022-02-21	16	25	20	36	0.538
The Tennis Master	2022-04-22	27	25	20	47	0.538
TINY ISLANDS	2022-03-15	2	14	11	13	0.5375
Hidden Office Top-Down 3D	2022-09-29	3	14	11	14	0.5375
最后的仙门	2022-05-09	1673	272	228	1901	0.5372
Never Breakup	2022-07-15	73	20	16	89	0.5368
Swordia	2022-10-06	9	20	16	25	0.5368
Kredolis	2022-09-27	54	26	21	75	0.5366
DANGO!	2022-07-15	166	187	157	323	0.5361
SEX Apocalypse 3D	2022-10-08	137	83	69	206	0.5359
Night and Day	2022-11-13	18	9	7	25	0.5359
Stranded B	2022-10-27	6	9	7	13	0.5359
Search	2022-08-28	2	9	7	9	0.5359
燃爆英雄(Bomb Hero)	2022-02-22	8	9	7	15	0.5359
House Flipper Pets VR	2022-12-15	12	9	7	19	0.5359
守望之影 - Shadow Watcher	2022-01-07	4	9	7	11	0.5359
Puck Bash	2022-01-19	5	9	7	12	0.5359
Aria	2022-03-11	8	9	7	15	0.5359
MEDIEVAL KNIGHTMARE	2022-02-14	15	9	7	22	0.5359
Cubic Neon Nightclub	2022-02-24	7	9	7	14	0.5359
RogueClick	2022-03-02	13	9	7	20	0.5359
Humans vs Tigers	2022-03-31	2	9	7	9	0.5359
Third Wild	2022-09-28	42	9	7	49	0.5359
Millie's Adventure	2022-07-19	14	9	7	21	0.5359
VR Archeology: Secrets of Kulikovo Field	2022-11-30	3	9	7	10	0.5359
City of Scary Zombies	2022-12-21	2	9	7	9	0.5359
Minion Raid Epic Monsters	2022-08-08	233	58	48	281	0.5356000000000001
Dark Haunting	2022-03-17	6	15	12	18	0.5352
Ravage Road	2022-12-20	70	15	12	82	0.5352
Super Meat Boy Forever	2022-01-10	237	528	450	687	0.5349
Boxing Club Manager	2022-10-07	27	41	34	61	0.534
Auto Chess	2022-12-07	338	83	70	408	0.5332
Tavern Tales: Tabletop Adventures	2022-09-30	10	4	3	13	0.5332
Unnatural Investigations	2022-08-01	5	4	3	8	0.5332
Ryan's Rescue Squad	2022-03-04	4	4	3	7	0.5332
Final Foe	2022-05-18	7	4	3	10	0.5332
Magic Thief	2022-02-28	2	4	3	5	0.5332
Hardworking Hero	2022-01-21	8	4	3	11	0.5332
Mercs Fully Loaded	2022-01-07	2	4	3	5	0.5332
Brick Breaker	2022-01-25	4	4	3	7	0.5332
DEBT - CHASING TREASURE	2022-02-25	5	4	3	8	0.5332
Ignis Corruption	2022-04-15	3	4	3	6	0.5332
PanzerG	2022-06-05	4	4	3	7	0.5332
Island Berry	2022-10-14	3	4	3	6	0.5332
Solitarius	2022-09-25	2	4	3	5	0.5332
Jigsaw Novel - Sexy Job Interview	2022-01-07	2	4	3	5	0.5332
Dnaxcat vr	2022-03-17	17	4	3	20	0.5332
Jigsaw Novel - Kinky Bondage	2022-01-15	3	4	3	6	0.5332
The Celestra	2022-02-16	6	4	3	9	0.5332
The Unfamiliar Story of Grandfather's Heritage	2022-05-10	2	4	3	5	0.5332
Ancient Medieval Empire	2022-03-08	3	4	3	6	0.5332
Neon Racer	2022-03-12	2	4	3	5	0.5332
Catharsis	2022-04-07	4	4	3	7	0.5332
Car War Legends	2022-10-16	4	4	3	7	0.5332
Splinters of Regret	2022-04-27	3	4	3	6	0.5332
You Deserve a Seat at the Table	2022-05-12	1	4	3	4	0.5332
乱入英雄	2022-03-29	5	4	3	8	0.5332
PIMP Island	2022-11-25	6	4	3	9	0.5332
MILK ME DARLING	2022-05-13	3	4	3	6	0.5332
MiniTrans	2022-05-27	2	4	3	5	0.5332
Rogue Warlords	2022-07-19	4	4	3	7	0.5332
Grimhunt	2022-05-25	2	4	3	5	0.5332
Memory Puzzle - Futanari Threesome	2022-04-24	3	4	3	6	0.5332
Traffic Safety	2022-05-13	1	4	3	4	0.5332
DreamIsland	2022-07-20	2	4	3	5	0.5332
Hentai Packer	2022-05-31	3	4	3	6	0.5332
Realm Of Cubes	2022-05-25	2	4	3	5	0.5332
Saving Sheep	2022-05-31	3	4	3	6	0.5332
異能マスカレイド	2022-08-01	6	4	3	9	0.5332
Futanari Sex - Pool Party	2022-06-03	3	4	3	6	0.5332
Futanari Sex - The Gym	2022-06-09	4	4	3	7	0.5332
Jigsaw Puzzle - BDSM Room	2022-06-07	2	4	3	5	0.5332
Bolu	2022-06-25	3	4	3	6	0.5332
Embodiment	2022-08-09	3	4	3	6	0.5332
What The Fortress!?	2022-09-06	3	4	3	6	0.5332
Escape Yourself	2022-08-01	3	4	3	6	0.5332
Otaku‘s Daily	2022-11-29	3	4	3	6	0.5332
Ninja Creator	2022-08-10	2	4	3	5	0.5332
Crossroads of life	2022-08-27	4	4	3	7	0.5332
LEGENO SLAYER	2022-08-12	3	4	3	6	0.5332
Simple Builder	2022-09-21	3	4	3	6	0.5332
Sex Adventures - Modeling Audition	2022-09-15	2	4	3	5	0.5332
Hypnotizing Beautiful Sisters Who Piss Me Off	2022-11-04	4	4	3	7	0.5332
Keep Me Posted	2022-11-04	2	4	3	5	0.5332
Escape From Ithara	2022-11-11	2	4	3	5	0.5332
Corruption Ranch	2022-11-11	10	4	3	13	0.5332
Black Sheep	2022-12-16	1471	359	308	1779	0.5328
Fuzoku Frame [18+]	2022-01-01	12	10	8	20	0.5327000000000001
Box logistics	2022-01-06	3	10	8	11	0.5327000000000001
Zombie Shotgun Rampage	2022-02-06	4	10	8	12	0.5327000000000001
Hidden Battle Top-Down 3D	2022-06-21	2	10	8	10	0.5327000000000001
Inexperienced Driver	2022-07-05	2	10	8	10	0.5327000000000001
Sky Resort - Delphi & Jessy	2022-05-12	35	36	30	65	0.5326
3D PUZZLE - Old House	2022-01-26	7	23	19	26	0.5323
Achromatic	2022-06-14	7	23	19	26	0.5323
山村老屋	2022-09-21	16	23	19	35	0.5323
Polycalypse: Last bit of Hope	2022-04-15	16	17	14	30	0.5313
Deltazone	2022-12-13	19	17	14	33	0.5313
Rappelz	2022-07-01	23	31	26	49	0.5309
Otherworld Legends	2022-04-28	564	366	318	882	0.5302
Ragnarok: The Lost Memories	2022-04-13	431	177	153	584	0.53
SugarWinds: Prologue	2022-01-27	5	11	9	14	0.53
RPGScenery	2022-01-27	6	11	9	15	0.53
World of Motors	2022-02-16	6	11	9	15	0.53
道不可道	2022-10-25	5	11	9	14	0.53
Fortress Building Puzzle	2022-04-18	2	11	9	11	0.53
Furry Futanari: 3 in 1 ⚧🏳️‍🌈	2022-03-03	3	25	21	24	0.5297999999999999
足臭的女孩	2022-02-25	6	18	15	21	0.5297
Lost Fleet	2022-09-27	37	18	15	52	0.5297
3D PUZZLE - Japan	2022-06-12	7	18	15	22	0.5297
Feartress	2022-06-29	101	26	22	123	0.5288
From Warrior to Hero (Idle 3D RPG)	2022-06-15	97	19	16	113	0.5283
Road Maintenance Simulator	2022-04-07	118	66	57	175	0.528
Virtual Virtual Reality 2	2022-10-25	12	12	10	22	0.5278
Drag Deal	2022-08-24	12	12	10	22	0.5278
Mira's Brush	2022-01-21	3	5	4	7	0.5278
EQDRIVE.IO	2022-07-07	4	5	4	8	0.5278
SaberStyle	2022-02-12	2	5	4	6	0.5278
2B青年的救赎	2022-05-31	2	5	4	6	0.5278
YEOLLEB Warrior	2022-01-13	3	5	4	7	0.5278
Circuit City	2022-02-01	6	5	4	10	0.5278
Pinballer	2022-05-20	2	5	4	6	0.5278
Pet Vet 3D Animal Hospital	2022-04-07	4	5	4	8	0.5278
Abduction	2022-01-06	3	5	4	7	0.5278
猫咪小镇	2022-01-17	3	5	4	7	0.5278
Santa Jump	2022-02-07	6	5	4	10	0.5278
BLOCKY.GO!	2022-03-22	3	5	4	7	0.5278
Samurai Challenge	2022-03-30	4	5	4	8	0.5278
Ink Bunny	2022-12-17	2	5	4	6	0.5278
TV Thief	2022-02-17	3	5	4	7	0.5278
TIME TO HUNT	2022-05-07	16	5	4	20	0.5278
The World is Binary: Why Love is the Answer	2022-03-08	1	5	4	5	0.5278
SafeGuard	2022-03-16	4	5	4	8	0.5278
Sex Diary - Futanari Massage	2022-04-09	4	5	4	8	0.5278
Stonegeon	2022-10-27	5	5	4	9	0.5278
Dub Club	2022-05-20	3	5	4	7	0.5278
Mini Treasure Girl	2022-05-20	2	5	4	6	0.5278
FAMILY BATTLE	2022-08-05	73	5	4	77	0.5278
Futanari Sex - The Fertility Doctor	2022-05-12	3	5	4	7	0.5278
Where's Oswald	2022-06-30	3	5	4	7	0.5278
SailSim	2022-06-08	2	5	4	6	0.5278
Bravery	2022-07-31	3	5	4	7	0.5278
Yakuza Undisputed	2022-07-17	3	5	4	7	0.5278
The Grizzled: Armistice Digital	2022-10-07	6	5	4	10	0.5278
Draft Day Sports: College Football 2023	2022-08-31	21	5	4	25	0.5278
CrazyCaps	2022-10-19	6	5	4	10	0.5278
Crazy Edition of Stunts	2022-10-04	2	5	4	6	0.5278
Strong Protection	2022-12-06	2	5	4	6	0.5278
Kingdom Of Secrets	2022-10-21	13	5	4	17	0.5278
SURVIVAL IN THE BACKROOMS	2022-11-04	4	5	4	8	0.5278
TRAHA Global	2022-11-02	8038	651	576	8614	0.527
CrossingFrontier	2022-07-14	386	129	113	499	0.5267000000000001
BattleSteam	2022-08-01	18	13	11	29	0.5259
Card Girl Army	2022-04-07	4	13	11	15	0.5259
UnnamedGame RPG	2022-02-08	37	21	18	55	0.5258
Angel Perversion	2022-04-28	20	21	18	38	0.5258
Cosmic Purge	2022-05-21	6	21	18	24	0.5258
POLE	2022-05-02	185	193	171	356	0.5251
Alien Shooter 2 - New Era	2022-06-15	85	95	84	169	0.5243
Dual Universe	2022-09-27	792	258	230	1022	0.5242
THE WORST GAME	2022-12-27	9	14	12	21	0.5242
Heart of Dungeon	2022-05-17	2	6	5	7	0.5239
Double Shot Gals	2022-04-11	4	6	5	9	0.5239
爆战联盟	2022-01-21	5	6	5	10	0.5239
Snow Scout	2022-08-16	3	6	5	8	0.5239
Milf Puzzle	2022-01-06	2	6	5	7	0.5239
Sugarcane Empire	2022-01-13	5	6	5	10	0.5239
The Blunderbuss	2022-10-13	6	6	5	11	0.5239
Choice of the Viking	2022-12-15	38	6	5	43	0.5239
Hyperland	2022-08-10	6	6	5	11	0.5239
Versus.	2022-09-23	7	6	5	12	0.5239
Solar Nations	2022-08-05	5	6	5	10	0.5239
BOOOOOOOOOOBS	2022-08-03	6	6	5	11	0.5239
Witch's Mystery	2022-09-09	2	6	5	7	0.5239
Romancing The Kingdom	2022-10-28	10	6	5	15	0.5239
Logic and Candy	2022-12-21	2	6	5	7	0.5239
Prisonfall	2022-12-24	2	6	5	7	0.5239
Echo	2022-12-02	20	15	13	33	0.5228
DMM Connect Chat	2022-03-15	102	15	13	115	0.5228
Cursed Blood	2022-04-29	5	15	13	18	0.5228
Dungeon Defenders: Going Rogue	2022-03-29	172	128	115	287	0.5216
GUNDAM EVOLUTION	2022-09-20	56911	9861	9012	65923	0.5213
VOIDCRISIS	2022-10-27	351	67	60	411	0.5212
NearEscape	2022-03-20	5	7	6	11	0.5211
Goblin Hunter Wizard Emona	2022-12-08	5	7	6	11	0.5211
Goblin Town	2022-02-15	6	7	6	12	0.5211
Imperium BCE	2022-06-09	3	7	6	9	0.5211
真 麻雀天下布武	2022-01-24	6	7	6	12	0.5211
Dinosaurs A Prehistoric Adventure 2	2022-03-18	4	7	6	10	0.5211
100 Days without delays	2022-02-02	3	7	6	9	0.5211
CRASH TEST IDIOT	2022-03-11	4	7	6	10	0.5211
Offenders	2022-05-30	4	7	6	10	0.5211
PUSSY 5	2022-06-09	2	7	6	8	0.5211
Chewing Gum Tests	2022-12-06	3	7	6	9	0.5211
Peek a Boo	2022-11-01	7	7	6	13	0.5211
Demonic Labyrinth	2022-12-24	3	7	6	9	0.5211
Medieval Defence	2022-12-29	3	7	6	9	0.5211
Medieval towers	2022-12-24	2	7	6	8	0.5211
Anonymous ME	2022-07-07	58	155	140	198	0.5208
HOBGOB ～Please Save Me～	2022-09-20	113	79	71	184	0.5208
Karagon: Prelude	2022-07-27	42	58	52	94	0.5207
Taxi Simulator	2022-03-31	9	17	15	24	0.5203
Russian Hunter	2022-06-15	3	17	15	18	0.5203
Elementite	2022-01-19	3	8	7	10	0.5189
Parapsychology	2022-04-07	8	8	7	15	0.5189
三国群英传	2022-05-31	22	8	7	29	0.5189
Adventures Nearby	2022-01-21	2	8	7	9	0.5189
Draft Day Sports: College Football 2022	2022-02-15	20	8	7	27	0.5189
COG Back To The 80s	2022-04-02	3	8	7	10	0.5189
Momo's Conflict	2022-07-29	9	8	7	16	0.5189
细菌边缘	2022-03-17	1	8	7	8	0.5189
Master of The Earth: Chapter 1	2022-09-10	40	8	7	47	0.5189
Inner Abyss	2022-12-08	3	8	7	10	0.5189
Knights of Messiah	2022-05-28	343	68	62	405	0.5178
Blacksmith Legends	2022-01-18	216	68	62	278	0.5178
THE_ABYSS_HAS_WALLS	2022-03-28	5	20	18	23	0.5176
Dragon Forge	2022-07-08	162	57	52	214	0.5174000000000001
The Deep Diving of Flood Dragon	2022-08-07	3	9	8	11	0.5171
Объемная история	2022-06-20	4	9	8	12	0.5171
Resistance: The 8th Wave	2022-01-06	5	9	8	13	0.5171
Fritz Chess 18 Steam Edition	2022-03-14	12	9	8	20	0.5171
VR Sweet Heart	2022-02-20	4	9	8	12	0.5171
蓝星舰策略	2022-07-29	11	9	8	19	0.5171
Hentai Girls - Neko Pastry	2022-04-20	3	9	8	11	0.5171
Dissent	2022-06-02	4	9	8	12	0.5171
Goetia 2	2022-05-19	9	9	8	17	0.5171
Drain Runner	2022-08-05	2	9	8	10	0.5171
XEL	2022-07-12	101	89	82	183	0.5161
DEATHVERSE: LET IT DIE	2022-10-05	1380	380	353	1733	0.5159
Brave Dungeon -The Meaning of Justice-	2022-02-19	19	10	9	28	0.5156000000000001
GIGABUSTER	2022-10-03	13	10	9	22	0.5156000000000001
SIMULATTE - Coffee Shop Simulator	2022-01-16	4	10	9	13	0.5156000000000001
Portal with RTX	2022-12-08	7169	5453	5114	12283	0.5151
트리 오브 세이비어	2022-12-26	568	110	102	670	0.5151
AI Dungeon	2022-07-28	363	238	222	585	0.5146000000000001
Hidden Floating City Top-Down 3D	2022-02-22	4	11	10	14	0.5144
Hexagonal Tower	2022-04-04	57	27	25	82	0.5134000000000001
AnatomyOfFear	2022-01-26	6	12	11	17	0.5134000000000001
Parabellum	2022-05-20	48	12	11	59	0.5134000000000001
Hidden Farm 2 Top-Down 3D	2022-07-18	4	12	11	15	0.5134000000000001
Summer Pleasure	2022-08-05	11	12	11	22	0.5134000000000001
My Days In Belair	2022-05-24	66	28	26	92	0.513
Sexy Space Airlines	2022-03-23	77	80	75	152	0.5126
Above the Fold	2022-05-29	6	13	12	18	0.5125
Village RPG	2022-01-31	5	13	12	17	0.5125
Hidden Build Top-Down 3D	2022-03-08	6	13	12	18	0.5125
MUSHROOMAN	2022-12-17	4	14	13	17	0.5117
Cult	2022-10-25	7	15	14	21	0.511
THE WAYLANDERS	2022-02-02	321	225	214	535	0.5105
侠之信条	2022-01-26	200	77	73	273	0.5104
Zombie Survivors	2022-03-25	23	16	15	38	0.5104
Marine Survivors	2022-08-26	20	16	15	35	0.5104
Kingshunt	2022-11-03	573	125	119	692	0.5099
寂静破碎	2022-05-04	9	17	16	25	0.5099
EA SPORTS™ FIFA 23	2022-09-30	110878	49344	47508	158386	0.5092
Gangsta: The Return	2022-02-26	4	19	18	22	0.509
Cult Of Babel	2022-10-17	69	19	18	87	0.509
Wild Wolf	2022-03-04	8	72	69	77	0.5082
Metal Force: Tank Games Online	2022-08-04	18	21	20	38	0.5082
Cobra Kai 2: Dojos Rising	2022-11-08	24	21	20	44	0.5082
Castan	2022-05-28	7	21	20	27	0.5082
Exos Heroes	2022-08-11	214	136	131	345	0.5075999999999999
Mirror War: Reincarnation of Holiness SA	2022-09-08	24	23	22	46	0.5075999999999999
Craterbound	2022-06-15	17	34	33	50	0.5054
OnlyFuck 2: Scarlett	2022-02-10	62	41	40	102	0.5045000000000001
Ghost of Dragon	2022-10-27	2317	347	344	2661	0.5019
Richman 11	2022-10-20	3258	618	616	3874	0.5007
Steel Ocean: Wolves of Deep Sea	2022-04-20	247	100	100	347	0.5
伏妖绘卷	2022-03-18	138	36	36	174	0.5
塔塔帝国	2022-02-21	122	29	29	151	0.5
Unoccupied	2022-05-28	8	23	23	31	0.5
七雄纷争	2022-01-25	71	23	23	94	0.5
BURST WITCH	2022-07-21	30	23	23	53	0.5
三国：万人敌	2022-04-18	40	21	21	61	0.5
Drug Business	2022-01-07	20	19	19	39	0.5
ENDGAME: Survival	2022-08-25	16	17	17	33	0.5
Snipe Hunt	2022-10-24	10	16	16	26	0.5
Mythos	2022-09-08	15	15	15	30	0.5
ALLON3	2022-11-15	4	14	14	18	0.5
MiniRacer	2022-01-07	7	13	13	20	0.5
Farmer Adventure	2022-01-10	5	13	13	18	0.5
Anime Gas Station	2022-02-15	3	13	13	16	0.5
Prodigy Trainer	2022-04-02	37	13	13	50	0.5
Hidden Post-Apocalyptic Top-Down 3D	2022-03-09	7	13	13	20	0.5
3D PUZZLE - Castle	2022-05-19	4	13	13	17	0.5
Old Retro Shooter	2022-07-23	4	13	13	17	0.5
Wicked Paradise	2022-03-03	41	12	12	53	0.5
Hidden Ghost Town 2	2022-02-07	5	12	12	17	0.5
The Cold Forest	2022-08-08	2	12	12	14	0.5
Race! Beauty! Bugs!	2022-01-18	4	11	11	15	0.5
Futa Spell	2022-02-09	6	11	11	17	0.5
Daybreaker VR	2022-07-21	7	11	11	18	0.5
Handyman	2022-09-15	4	11	11	15	0.5
Onsen Master	2022-09-04	4	10	10	14	0.5
Freedom's eye	2022-06-22	2	10	10	12	0.5
AFTERLIFE: KILLING DEATH	2022-02-03	3	10	10	13	0.5
OverNight	2022-07-29	10	10	10	20	0.5
Lucky Tlhalerwa - Zombie Rampage	2022-04-04	3	10	10	13	0.5
Bicycle Challenge - Wastelands	2022-07-26	7	10	10	17	0.5
Unsettled	2022-12-18	4	9	9	13	0.5
Sex Dating Trip	2022-01-21	19	9	9	28	0.5
Auto Kingdom Crunch	2022-04-14	8	9	9	17	0.5
Galaxy Splitter	2022-06-14	8	9	9	17	0.5
Rift Sweepers	2022-09-08	10	8	8	18	0.5
Fanite	2022-04-05	6	8	8	14	0.5
The Last Escape	2022-12-06	2	8	8	10	0.5
Mini Mini-Golf	2022-01-28	5	7	7	12	0.5
Sex Diary - A Slutty Anniversary	2022-03-09	3	7	7	10	0.5
Dark ill	2022-09-27	4	7	7	11	0.5
ConquestAreas	2022-06-03	7	7	7	14	0.5
暗影天使 - Shadow Angel	2022-10-01	4	7	7	11	0.5
Chess VR: Multiverse Journey	2022-07-18	4	7	7	11	0.5
Mikos Wish	2022-10-21	7	7	7	14	0.5
Keep Sheep	2022-11-22	57	7	7	64	0.5
Talevania	2022-12-24	2	7	7	9	0.5
Sacrifice of The Spirit	2022-01-13	4	6	6	10	0.5
Scare: Project of Fear	2022-03-02	2	6	6	8	0.5
The Winter	2022-07-28	2	6	6	8	0.5
Famished zombies: Decisive extermination	2022-07-01	5	6	6	11	0.5
The Unsettled	2022-08-19	4	6	6	10	0.5
Cyphers Game VR	2022-05-28	4	6	6	10	0.5
Astro Bandits	2022-05-17	5	6	6	11	0.5
Nedia Hotel	2022-05-25	4	6	6	10	0.5
Cool Game	2022-06-10	3	6	6	9	0.5
Asian Maiden Creator	2022-08-04	3	6	6	9	0.5
Reach the Hilltop	2022-12-06	2	6	6	8	0.5
WarKind	2022-10-11	6	6	6	12	0.5
人鱼世界	2022-10-21	3	6	6	9	0.5
AMBER	2022-12-06	8	6	6	14	0.5
Magic Corgi	2022-12-21	2	6	6	8	0.5
Forest towers	2022-12-24	1	6	6	7	0.5
Idle Game x100	2022-12-26	12	6	6	18	0.5
Project Reborn	2022-02-14	7	5	5	12	0.5
Heir Obscure	2022-07-20	1	5	5	6	0.5
If you win...you lose !	2022-01-21	137	5	5	142	0.5
Grim Tales: Graywitch Collector's Edition	2022-01-25	10	5	5	15	0.5
Leave No One Behind: la Drang VR	2022-07-19	4	5	5	9	0.5
BLOODSTAGE Possessed By A Tsundere Demon	2022-07-16	2	5	5	7	0.5
L30-P4RD	2022-11-30	2	5	5	7	0.5
Teahouse of the Gods	2022-11-23	17	5	5	22	0.5
House of Ghosts	2022-12-12	2	5	5	7	0.5
巨頭ォ	2022-12-29	8	5	5	13	0.5
Ice Battle	2022-12-29	2	5	5	7	0.5
足球梦之队	2022-09-29	8	4	4	12	0.5
Rhythm Stars Climbing	2022-05-31	2	4	4	6	0.5
Merchant of Phenistoria	2022-02-18	3	4	4	7	0.5
My Universe - Puppies & Kittens	2022-03-03	4	4	4	8	0.5
Unity Testing Grounds	2022-10-11	3	4	4	7	0.5
Golden Mine Pickaxe	2022-01-16	2	4	4	6	0.5
Lunar Odyssey	2022-02-22	10	4	4	14	0.5
动物园怪谈	2022-04-15	9	4	4	13	0.5
The Ghost Ship	2022-06-30	3	4	4	7	0.5
武动苍穹	2022-09-15	5	4	4	9	0.5
DopeMine Arena	2022-06-22	7	4	4	11	0.5
Magic crystals 2	2022-03-13	2	4	4	6	0.5
Jigsaw Novel - Futanari Nurse	2022-03-30	2	4	4	6	0.5
不可能犯罪事件簿-Impossible Crime Book	2022-05-17	6	4	4	10	0.5
하트리스(Heartless)	2022-05-31	3	4	4	7	0.5
Dark Desire 2	2022-05-23	5	4	4	9	0.5
MIRADOR	2022-05-25	2	4	4	6	0.5
Delusional	2022-08-24	3	4	4	7	0.5
Moontrain	2022-07-02	4	4	4	8	0.5
OVERTOP	2022-11-10	3	4	4	7	0.5
The One Penny Adventure	2022-08-09	4	4	4	8	0.5
Life Matters	2022-08-18	7	4	4	11	0.5
Flying Umbrella	2022-08-23	3	4	4	7	0.5
Skeleton Runner	2022-12-03	1	4	4	5	0.5
One Last Crane	2022-07-04	6	3	3	9	0.5
World of Towers	2022-02-01	2	3	3	5	0.5
Space Defense Grid	2022-05-24	6	3	3	9	0.5
RULES OF GRAVITY	2022-12-23	3	3	3	6	0.5
CYBER TENNIS	2022-02-05	2	3	3	5	0.5
我的变色龙女友My chameleon girlfriend	2022-12-24	1	3	3	4	0.5
BlitzPunch	2022-01-26	3	3	3	6	0.5
Scripture	2022-01-17	1	3	3	4	0.5
Anthropocene Epoch	2022-01-13	3	3	3	6	0.5
CycloHex	2022-08-15	4	3	3	7	0.5
The Creature Zone VR	2022-07-18	2	3	3	5	0.5
Mighty Castles	2022-02-22	2	3	3	5	0.5
Jigsaw Novel - Naughty Stewardesses	2022-02-12	2	3	3	5	0.5
Hinter	2022-07-26	3	3	3	6	0.5
Poly Puzzle: Birds	2022-03-01	4	3	3	7	0.5
One By One	2022-03-17	3	3	3	6	0.5
Poly Memory: Birds	2022-03-17	2	3	3	5	0.5
Agent 01	2022-05-07	2	3	3	5	0.5
拯救校花行动	2022-04-13	3	3	3	6	0.5
LENDARIOS STORY BRIGHTNESS PART 1	2022-05-04	2	3	3	5	0.5
Survivor Legends	2022-06-11	3	3	3	6	0.5
Solo War Medieval	2022-08-05	1	3	3	4	0.5
StarMaker VR	2022-09-30	5	3	3	8	0.5
Asteroid	2022-08-26	3	3	3	6	0.5
Witness of the Night	2022-07-27	2	3	3	5	0.5
Book Quest	2022-08-10	2	3	3	5	0.5
House of Witches	2022-08-05	2	3	3	5	0.5
Samurai Creator	2022-08-16	2	3	3	5	0.5
EpicSurvivors	2022-10-21	2	3	3	5	0.5
Cyber Attack VR board game	2022-09-06	43	3	3	46	0.5
Shift of War	2022-09-30	3	3	3	6	0.5
Plan B - Goddess's cards	2022-09-16	2	3	3	5	0.5
Mirror Broken/镜·碎	2022-09-20	3	3	3	6	0.5
Divine Adventure RPG	2022-12-21	16	3	3	19	0.5
Daemonum	2022-10-24	1	3	3	4	0.5
The Umbridge Estate	2022-10-23	8	3	3	11	0.5
Little Devil	2022-11-08	5	3	3	8	0.5
KABENAGURI	2022-12-05	4	3	3	7	0.5
Furry UwU	2022-12-19	2	3	3	5	0.5
MazeCraft	2022-12-22	3	3	3	6	0.5
Space Turret Gunner	2022-01-07	1	2	2	3	0.5
Night of the loving dead	2022-06-23	2	2	2	4	0.5
 Here to There	2022-11-03	1	2	2	3	0.5
WREN	2022-01-14	2	2	2	4	0.5
The Outbreak Guardian	2022-01-08	2	2	2	4	0.5
Pets VR	2022-02-21	5	2	2	7	0.5
Dark Dragonkin	2022-03-01	1	2	2	3	0.5
Earth Elements	2022-04-24	2	2	2	4	0.5
Shy Eye Labyrinth: The Incredible Mystery	2022-04-12	2	2	2	4	0.5
Greats of the Gridiron	2022-05-06	6	2	2	8	0.5
Rotate To Find The Difference	2022-04-29	2	2	2	4	0.5
Throb of Lovegirl: A Ero Waifu TD	2022-10-04	2	2	2	4	0.5
Offroad Truck Racing	2022-03-08	2	2	2	4	0.5
Ultimate Waifu Battle Online	2022-11-09	4	2	2	6	0.5
Dominus rage	2022-08-15	1	2	2	3	0.5
Beku	2022-02-25	2	2	2	4	0.5
Combatant	2022-03-12	2	2	2	4	0.5
Last Minute	2022-01-13	2	2	2	4	0.5
Roommate	2022-08-22	8	2	2	10	0.5
Burning Faith	2022-04-29	3	2	2	5	0.5
Red Colony 3 Uncensored	2022-03-17	3	2	2	5	0.5
BEST VRCADE 9000	2022-07-23	2	2	2	4	0.5
我就是要红	2022-01-24	3	2	2	5	0.5
Pornocrates: VHS	2022-04-26	4	2	2	6	0.5
Truco	2022-03-12	2	2	2	4	0.5
Gears of Phantasm: Destiny Tailored(Act I)	2022-08-15	2	2	2	4	0.5
Fruit Girls 2: Hentai Jigsaw Photo Studio	2022-02-28	3	2	2	5	0.5
Krypt	2022-06-21	3	2	2	5	0.5
Legacy: the last pure heart	2022-03-07	1	2	2	3	0.5
Child vs Clowns	2022-01-15	2	2	2	4	0.5
Maverta Island	2022-01-18	2	2	2	4	0.5
Mental Math Tutor	2022-01-18	2	2	2	4	0.5
Word Crack	2022-01-21	3	2	2	5	0.5
Pixel Art School - 今から始めるドット絵入門 -	2022-03-22	5	2	2	7	0.5
Dungeon & Burglar	2022-04-12	8	2	2	10	0.5
Fatal Blade	2022-11-17	2	2	2	4	0.5
Midnight snack	2022-02-28	3	2	2	5	0.5
Horrors of the North	2022-10-24	1	2	2	3	0.5
1001 Jigsaw Legend of Mystery 3	2022-02-25	4	2	2	6	0.5
Exorzine	2022-03-21	2	2	2	4	0.5
World of Retailing	2022-03-22	3	2	2	5	0.5
WTC : Recruitment Day	2022-03-07	2	2	2	4	0.5
WHY I was Born	2022-08-18	3	2	2	5	0.5
Hidden Objects: Tranquil Valley	2022-03-15	2	2	2	4	0.5
Stay away from zombies	2022-03-16	1	2	2	3	0.5
The One Chapter 1	2022-08-01	3	2	2	5	0.5
GENIUS VS ANTICHRIST 1	2022-10-29	1	2	2	3	0.5
DUST - A Post Apocalyptic Role Playing Game	2022-05-01	5	2	2	7	0.5
Cyber Pool	2022-04-08	4	2	2	6	0.5
Paige Turner	2022-05-27	4	2	2	6	0.5
Goddess Of War Essa	2022-04-15	2	2	2	4	0.5
Déjà-vu	2022-04-13	1	2	2	3	0.5
Gem Tower Defense 2	2022-04-21	5	2	2	7	0.5
Undead Under Night Rain	2022-10-28	3	2	2	5	0.5
Spyer	2022-06-11	2	2	2	4	0.5
守护神域	2022-05-13	4	2	2	6	0.5
Super Asqr	2022-12-12	3	2	2	5	0.5
Star Lodge	2022-06-02	3	2	2	5	0.5
Survival Island	2022-05-27	2	2	2	4	0.5
HoverRider	2022-05-28	1	2	2	3	0.5
Scripted Souls	2022-05-20	4	2	2	6	0.5
Gale of Windoria	2022-08-04	7	2	2	9	0.5
Ultimate Starfighter	2022-07-01	2	2	2	4	0.5
SuperDuck!	2022-06-04	2	2	2	4	0.5
Fantasy Fighters	2022-05-25	1	2	2	3	0.5
Legendary Heroes	2022-11-24	2	2	2	4	0.5
Spintales	2022-11-04	4	2	2	6	0.5
Cards of Binokee	2022-07-31	3	2	2	5	0.5
Omnichess	2022-07-12	2	2	2	4	0.5
Al Andalus 711: Epic history battle game	2022-08-10	3	2	2	5	0.5
Perfect Jump	2022-06-23	2	2	2	4	0.5
Once upon a time in morocco	2022-08-04	1	2	2	3	0.5
Pandemic 1993	2022-07-01	4	2	2	6	0.5
WordBed	2022-08-03	2	2	2	4	0.5
Fastest Fantasy Life Simulator	2022-07-26	3	2	2	5	0.5
PTRL Stockcar Edition	2022-08-02	1	2	2	3	0.5
你与月光同罪-As Guilty As the Moon	2022-07-27	3	2	2	5	0.5
Bright Garden	2022-08-11	1	2	2	3	0.5
Sylvarcon 2049: A Cybersecurity Aventure	2022-11-21	2	2	2	4	0.5
Lost Beyond	2022-12-08	3	2	2	5	0.5
丛林守护者_Guardian of the jungle	2022-11-09	4	2	2	6	0.5
Zombies TD	2022-08-23	2	2	2	4	0.5
Mars: The New Eden	2022-09-02	4	2	2	6	0.5
Memory Puzzle - Futanari Massage	2022-08-27	2	2	2	4	0.5
Memory Puzzle - Mile High Fun	2022-09-29	2	2	2	4	0.5
Salvation of the soul	2022-12-01	4	2	2	6	0.5
Soul After	2022-11-02	2	2	2	4	0.5
Jeeps Offroad Simulator	2022-12-05	3	2	2	5	0.5
Stellar Fight	2022-10-01	1	2	2	3	0.5
Save Santa	2022-11-30	1	2	2	3	0.5
Bargain Platfomer	2022-11-07	1	2	2	3	0.5
Sex Adventures - BDSM Dungeon	2022-10-02	3	2	2	5	0.5
Gallery : Moa's Room	2022-10-26	2	2	2	4	0.5
骑士与工匠	2022-12-12	2	2	2	4	0.5
Wojak This Game	2022-10-17	2	2	2	4	0.5
Slender: Exploration	2022-10-26	2	2	2	4	0.5
Gloomy Tales: Horrific Show Collector's Edition	2022-10-25	7	2	2	9	0.5
Dead on Arrival: Remastered	2022-11-18	4	2	2	6	0.5
Dots in line	2022-10-31	4	2	2	6	0.5
The last lover	2022-11-27	2	2	2	4	0.5
PIP 6	2022-11-03	3	2	2	5	0.5
G-MODEアーカイブス+ 女神転生外伝 新約ラストバイブルII 始まりの福音	2022-12-13	5	2	2	7	0.5
Book Travelers: A Victorian Story Collector's Edition	2022-11-04	7	2	2	9	0.5
胡辣三国	2022-12-19	3	2	2	5	0.5
是男人就上一百层	2022-12-01	1	2	2	3	0.5
PIP L	2022-11-19	3	2	2	5	0.5
Furry Glory	2022-12-05	3	2	2	5	0.5
Speluncaphobia	2022-12-01	2	2	2	4	0.5
Anubis Clicker	2022-12-15	2	2	2	4	0.5
Snow Moon Flower	2022-12-27	4	2	2	6	0.5
Ninja VS Zombies	2022-12-14	2	2	2	4	0.5
Not A Thief Simulator	2022-12-16	2	2	2	4	0.5
RADical ROACH: Infinity	2022-02-11	2	1	1	3	0.5
MineCart Adventures	2022-12-01	3	1	1	4	0.5
Marisa's Inconceivable Journey	2022-06-04	2	1	1	3	0.5
The Final Stand: Breakout	2022-01-14	2	1	1	3	0.5
Wreck it! VR	2022-12-23	1	1	1	2	0.5
Alien:Chip	2022-07-08	1	1	1	2	0.5
Total Rendition	2022-09-13	1	1	1	2	0.5
Caterva	2022-03-31	2	1	1	3	0.5
Musical Balls	2022-07-15	1	1	1	2	0.5
The Cruel Dreamer Marchosias	2022-06-25	1	1	1	2	0.5
Redneck Rift	2022-07-05	1	1	1	2	0.5
Covid: Survive The PlanDemic	2022-08-13	2	1	1	3	0.5
Man of the World	2022-07-13	2	1	1	3	0.5
Gnomes Solitaire	2022-03-21	3	1	1	4	0.5
FukTopia 2	2022-02-05	3	1	1	4	0.5
Welcome to Dreamville	2022-02-18	2	1	1	3	0.5
瀚辰书院	2022-01-19	2	1	1	3	0.5
Time Keeper	2022-08-23	1	1	1	2	0.5
Sudoku Minimalist Infinite	2022-05-03	3	1	1	4	0.5
Astralojia: Season 1	2022-07-22	2	1	1	3	0.5
Love Hentai and Puzzles: Cattle and Horses	2022-11-18	1	1	1	2	0.5
Saturn Menace	2022-06-14	2	1	1	3	0.5
Asterism	2022-03-05	1	1	1	2	0.5
Furries & Scalies & Scarecrows OH MY!	2022-01-28	1	1	1	2	0.5
Nailed It	2022-08-25	1	1	1	2	0.5
Animal Crusaders	2022-04-22	3	1	1	4	0.5
Cosmos Conquer	2022-03-04	1	1	1	2	0.5
Shooter's Island	2022-01-29	2	1	1	3	0.5
Milliopoly - Language Quiz and Learning	2022-08-09	2	1	1	3	0.5
斗士	2022-02-12	1	1	1	2	0.5
カラクリエイト	2022-09-29	5	1	1	6	0.5
Drawize - Draw and Guess	2022-02-15	21	1	1	22	0.5
Lupa	2022-03-28	2	1	1	3	0.5
Yum Yum Cookstar	2022-11-11	3	1	1	4	0.5
Animal Sanctuary	2022-06-17	4	1	1	5	0.5
COMA: Lost in the Maze	2022-01-11	1	1	1	2	0.5
Pirate's Gold	2022-03-01	3	1	1	4	0.5
Secret Mission: The Forgotten Island	2022-01-12	4	1	1	5	0.5
jingor mine	2022-01-15	1	1	1	2	0.5
Pirates of the Maverta	2022-01-29	2	1	1	3	0.5
Remembrance	2022-01-16	2	1	1	3	0.5
WHMIS 2015 VR	2022-01-26	1	1	1	2	0.5
EM	2022-01-14	1	1	1	2	0.5
幻梦之城(C T O D)	2022-02-10	2	1	1	3	0.5
Royal Jigsaw	2022-03-07	1	1	1	2	0.5
Holiday Jigsaw Christmas	2022-03-17	2	1	1	3	0.5
Provisional Detective	2022-02-24	1	1	1	2	0.5
Rabbit Canyon	2022-02-20	1	1	1	2	0.5
Bo's Adventure: Merging Islands	2022-01-21	2	1	1	3	0.5
Nerraia	2022-03-04	1	1	1	2	0.5
Run Girls Run	2022-02-18	2	1	1	3	0.5
One day after the snow and wind	2022-02-21	1	1	1	2	0.5
Land of Zympaia The New Light	2022-08-24	2	1	1	3	0.5
Invaders from another dimension	2022-06-22	1	1	1	2	0.5
Math it Right 3D Adventure	2022-02-11	2	1	1	3	0.5
Oogy: Can You Help	2022-03-03	2	1	1	3	0.5
Space Maxwell: Arcade	2022-06-16	1	1	1	2	0.5
Dungeon Castle	2022-02-10	1	1	1	2	0.5
BOX RUSH	2022-02-10	2	1	1	3	0.5
Dragon Battle	2022-02-16	1	1	1	2	0.5
Legends And Lore	2022-07-31	5	1	1	6	0.5
PROJECT : KNIGHT™ 2 Dusk of Souls	2022-08-19	1	1	1	2	0.5
I am not legend	2022-02-28	1	1	1	2	0.5
VillageBlade	2022-02-16	2	1	1	3	0.5
Razed Earth	2022-03-02	1	1	1	2	0.5
1001 Jigsaw Detective 2	2022-06-13	2	1	1	3	0.5
Apocalyptic	2022-06-30	1	1	1	2	0.5
Dungeon Blocks	2022-03-09	1	1	1	2	0.5
Paint To Pixel	2022-03-01	1	1	1	2	0.5
Gamma Space	2022-02-28	1	1	1	2	0.5
Monsters and Warriors - Onet Match Connect	2022-03-04	3	1	1	4	0.5
Cruise Ship Horse Racing	2022-03-08	2	1	1	3	0.5
Hot Work VR Training	2022-03-17	2	1	1	3	0.5
Blink God	2022-06-01	1	1	1	2	0.5
Elteria Hunter	2022-03-10	4	1	1	5	0.5
The Castle Of Time	2022-06-12	1	1	1	2	0.5
Conflict 3048	2022-03-11	2	1	1	3	0.5
Saber Ship	2022-08-26	1	1	1	2	0.5
Neon Outlast	2022-03-17	1	1	1	2	0.5
不朽人生-孔子传	2022-06-11	2	1	1	3	0.5
Pinzzo	2022-03-21	2	1	1	3	0.5
Caverns of Evil	2022-04-02	2	1	1	3	0.5
Crusader: Dungeon Series	2022-05-02	2	1	1	3	0.5
Mahjong Business Style	2022-03-14	3	1	1	4	0.5
Pirate Solitaire 2	2022-04-04	3	1	1	4	0.5
1001 Jigsaw: Earth Chronicles 7	2022-04-04	3	1	1	4	0.5
1001 Jigsaw: Earth Chronicles 8	2022-04-25	3	1	1	4	0.5
Jim's Adventure	2022-05-04	2	1	1	3	0.5
Royal Mahjong King's Journey	2022-03-29	3	1	1	4	0.5
Jungle Resistance	2022-09-06	2	1	1	3	0.5
Futuristic Museum	2022-05-14	1	1	1	2	0.5
Defensive Measures	2022-05-06	1	1	1	2	0.5
星之传说	2022-05-13	2	1	1	3	0.5
1001 Jigsaw. Legends of Mystery 4	2022-05-09	2	1	1	3	0.5
1001 Jigsaw. Home Sweet Home 2	2022-05-23	2	1	1	3	0.5
1001 Jigsaw. Castles And Palaces 3	2022-05-02	2	1	1	3	0.5
Hungry Animals	2022-04-19	1	1	1	2	0.5
Sailor’s Stories Solitaire	2022-05-19	3	1	1	4	0.5
Creature Discomfort	2022-05-13	2	1	1	3	0.5
L'Avancée du désert	2022-06-17	1	1	1	2	0.5
The Missing Thing	2022-05-01	1	1	1	2	0.5
Balance Knight	2022-04-26	2	1	1	3	0.5
The Ball Flow - Nature and Lights	2022-08-05	1	1	1	2	0.5
Ai-(Onic)	2022-04-27	5	1	1	6	0.5
Taiga	2022-06-20	4	1	1	5	0.5
贪吃纸片猫	2022-05-16	3	1	1	4	0.5
Eyes of Darkness	2022-05-31	2	1	1	3	0.5
Murdo's Quest	2022-06-01	1	1	1	2	0.5
HUMDLE	2022-07-01	1	1	1	2	0.5
Finding America: The Heartland	2022-08-29	5	1	1	6	0.5
Dreadful Hours	2022-08-01	2	1	1	3	0.5
遗忘之地	2022-08-19	2	1	1	3	0.5
Penetrator	2022-05-17	2	1	1	3	0.5
Mystery Solitaire Cthulhu Mythos	2022-05-30	4	1	1	5	0.5
Victim	2022-05-19	2	1	1	3	0.5
Detect Dan The Dog!	2022-05-26	1	1	1	2	0.5
1651	2022-07-14	2	1	1	3	0.5
CAVE VR	2022-06-03	2	1	1	3	0.5
Knights of Fate	2022-07-08	3	1	1	4	0.5
Ned Kelly: Armored Outlaw	2022-06-29	2	1	1	3	0.5
SSS222: HyperSpace	2022-08-31	2	1	1	3	0.5
Mystical Riddles: Behind Doll’s Eyes Collector's Edition	2022-09-13	4	1	1	5	0.5
Alien Task Force	2022-07-19	4	1	1	5	0.5
Spiritus	2022-06-09	1	1	1	2	0.5
边缘世界 Edge Worlds	2022-06-21	2	1	1	3	0.5
VAR乐园终身VIP	2022-10-01	1	1	1	2	0.5
Para-Lax	2022-07-30	2	1	1	3	0.5
Big Flying Asteroid	2022-07-01	1	1	1	2	0.5
Life After Death	2022-09-16	2	1	1	3	0.5
Scranny	2022-07-05	2	1	1	3	0.5
Checkers VR: Multiverse Journey	2022-07-08	1	1	1	2	0.5
Just Jump	2022-08-26	4	1	1	5	0.5
HauntedPlaces	2022-07-16	2	1	1	3	0.5
Mottia - The gem hunters	2022-09-08	1	1	1	2	0.5
Cable Clutter	2022-09-21	2	1	1	3	0.5
War Dots	2022-08-11	2	1	1	3	0.5
Anime Prison - Gisele's Escape	2022-10-03	1	1	1	2	0.5
FaceWorld Pro	2022-12-11	2	1	1	3	0.5
Small Shop	2022-07-14	1	1	1	2	0.5
ドライブドリフトX	2022-10-05	2	1	1	3	0.5
Acassia	2022-07-25	1	1	1	2	0.5
幻想世界中的平民被忽悠著走上拯救公主的道路	2022-07-23	1	1	1	2	0.5
Coin Blitz	2022-10-18	4	1	1	5	0.5
The Voices Games 2d Collection	2022-09-15	1	1	1	2	0.5
Mud Way	2022-08-20	1	1	1	2	0.5
Whispering Abyss	2022-10-28	2	1	1	3	0.5
Knocking up my brother's wife: My sister-in-law can't resist my seed	2022-12-16	4	1	1	5	0.5
Wash Card	2022-11-03	2	1	1	3	0.5
VIRUSUM	2022-08-04	1	1	1	2	0.5
Dama_Hame_Tosatsu_Nikki	2022-09-01	1	1	1	2	0.5
Burger Butt	2022-09-21	2	1	1	3	0.5
Fly to hope	2022-08-25	1	1	1	2	0.5
Smash The Synth	2022-09-13	1	1	1	2	0.5
Tales of Tarium: Awakening from the Ashes	2022-08-19	1	1	1	2	0.5
Action: Vengeance	2022-08-14	2	1	1	3	0.5
Termalloc	2022-08-17	1	1	1	2	0.5
Speedrunner's Paradise: Sky is the limit	2022-09-03	1	1	1	2	0.5
Adventure Trip: New York Collector's Edition	2022-08-20	6	1	1	7	0.5
Square Rounds	2022-10-11	1	1	1	2	0.5
Find Me In The Maze	2022-10-26	1	1	1	2	0.5
Elite Forces	2022-11-13	2	1	1	3	0.5
原初之岛	2022-09-30	3	1	1	4	0.5
Gumnaam	2022-09-20	2	1	1	3	0.5
Poly Puzzle: Predators	2022-08-25	2	1	1	3	0.5
FastRogue	2022-12-15	2	1	1	3	0.5
Glass Bridge	2022-09-09	1	1	1	2	0.5
RichBroker	2022-11-03	2	1	1	3	0.5
Jump Journey	2022-09-09	1	1	1	2	0.5
Lustcraft	2022-10-19	2	1	1	3	0.5
Eat Me Alive	2022-10-01	1	1	1	2	0.5
The Hard Game	2022-09-06	2	1	1	3	0.5
一号(One)	2022-10-01	1	1	1	2	0.5
Magnetism	2022-09-17	2	1	1	3	0.5
Save The Princess	2022-09-27	2	1	1	3	0.5
Equilibrium	2022-09-28	8	1	1	9	0.5
Live Cycling Manager 2022	2022-09-20	3	1	1	4	0.5
幻灵界：幻想小森林(FantasyKingdom：Fantasy Tiny Forest)	2022-10-04	1	1	1	2	0.5
Math Adventures	2022-10-07	3	1	1	4	0.5
Tapering Tower	2022-09-17	1	1	1	2	0.5
RetroRange	2022-10-19	1	1	1	2	0.5
Jump Ball	2022-10-26	2	1	1	3	0.5
Strong Moon	2022-10-11	1	1	1	2	0.5
Run and Gun	2022-09-24	2	1	1	3	0.5
Chamber's Reunion	2022-10-03	2	1	1	3	0.5
Midnight Calling: Wise Dragon Collector's Edition	2022-10-07	4	1	1	5	0.5
Evil Nightmares	2022-10-10	2	1	1	3	0.5
Sky Puzzle	2022-10-19	1	1	1	2	0.5
街机捕鱼	2022-09-29	2	1	1	3	0.5
Open Course	2022-10-20	1	1	1	2	0.5
Actua Ice Hockey	2022-10-28	3	1	1	4	0.5
Elkabir	2022-10-08	1	1	1	2	0.5
Zad Maldan My Bloody Sacrifice	2022-10-07	2	1	1	3	0.5
Tahoe Dragon	2022-10-21	1	1	1	2	0.5
BATTLE GEAR	2022-11-04	1	1	1	2	0.5
Under The Shack	2022-11-01	1	1	1	2	0.5
SPY SWATTER 2	2022-10-06	2	1	1	3	0.5
Fast Food Chef	2022-12-26	2	1	1	3	0.5
SPyGirl-01	2022-11-08	3	1	1	4	0.5
一本橋ワタル	2022-10-13	1	1	1	2	0.5
Innocent's purgatory	2022-10-13	1	1	1	2	0.5
Final Beacon	2022-10-27	1	1	1	2	0.5
Enemy at the Gates: Commander	2022-11-22	2	1	1	3	0.5
Unified	2022-10-14	1	1	1	2	0.5
Sex Adventures - GangBang Surprise	2022-10-12	3	1	1	4	0.5
Kanji RPG	2022-10-24	1	1	1	2	0.5
The Experiment	2022-11-01	3	1	1	4	0.5
Massi	2022-12-03	2	1	1	3	0.5
ARCADE VS PLAYER	2022-11-04	1	1	1	2	0.5
The shelter of patient	2022-11-21	1	1	1	2	0.5
Sex Adventures - Office Affairs	2022-10-21	2	1	1	3	0.5
Castle Defense Battles	2022-11-13	3	1	1	4	0.5
Cherry Lady	2022-11-11	1	1	1	2	0.5
N₂O	2022-12-06	2	1	1	3	0.5
Green Garden	2022-11-17	1	1	1	2	0.5
BlueTricks	2022-12-28	1	1	1	2	0.5
Bewells	2022-11-20	1	1	1	2	0.5
Save Kill them all	2022-11-18	2	1	1	3	0.5
One Sex Night	2022-12-26	2	1	1	3	0.5
Zako Slayer	2022-12-02	2	1	1	3	0.5
Slime Evolution	2022-12-10	2	1	1	3	0.5
Furry Immersion	2022-12-05	2	1	1	3	0.5
Pichi Girl	2022-11-29	1	1	1	2	0.5
Mysterious Lab	2022-12-21	1	1	1	2	0.5
First Sexy Night 2: Second Date	2022-12-16	3	1	1	4	0.5
idle Party Leader	2022-12-22	5	1	1	6	0.5
Crowd Medieval City War	2022-12-19	2	1	1	3	0.5
Leave No One Behind: Ia Drang	2022-03-02	55	95	97	152	0.49590000000000006
Resident Evil Village Gold Edition Gameplay Demo	2022-10-20	347	112	115	462	0.4947
Miraculous: Rise of the Sphinx	2022-10-25	44	29	30	74	0.494
Neon Blight	2022-07-11	50	28	29	79	0.4938
Outside The Box	2022-03-28	67	56	58	125	0.4933
SEXXXNATOR: Adult Sandbox RPG	2022-11-18	5	24	25	30	0.4929
The Backrooms Multiplayer	2022-12-04	19	24	25	44	0.4929
Dog Clicker	2022-03-14	10	23	24	34	0.4927
灭顶之灾	2022-02-10	16	20	21	37	0.4918
Alternative Punishment	2022-03-11	18	17	18	36	0.49060000000000004
Battle Dawn 2: Terra Reborn	2022-10-17	68	16	17	85	0.4901
Abedot Family Estate: Search For Hidden Objects	2022-06-14	3	15	16	19	0.48960000000000004
Beasties	2022-07-27	27	14	15	42	0.489
Project: Name	2022-06-24	1028	192	203	1231	0.48840000000000006
FurstDate	2022-11-19	11	13	14	25	0.4883
母乳少女～夏の甘い思い出	2022-10-12	56	13	14	70	0.4883
Afterlife Work	2022-03-11	5	13	14	19	0.4883
StarFlint the BlackHole Prophecy	2022-07-07	33	29	31	64	0.4882
Breath of Ghosts	2022-06-09	4	12	13	17	0.4875
决战紫禁怀旧服	2022-11-22	82	12	13	95	0.4875
坦克大战	2022-12-08	12	11	12	24	0.4866
Party Bunch	2022-08-12	12	11	12	24	0.4866
Minimal Dungeon RPG	2022-03-08	64	24	26	90	0.48610000000000003
Gold Hunter	2022-05-13	488	203	217	705	0.48600000000000004
风色幻想2:Alive	2022-08-09	19	23	25	44	0.48560000000000003
The Galactic Junkers	2022-06-30	8	10	11	19	0.48560000000000003
Your Waifu JUICE	2022-09-22	10	21	23	33	0.48450000000000004
Foster: Child Ghost | 养小鬼	2022-08-04	112	33	36	148	0.4843
Music Racer 2	2022-07-15	6	20	22	28	0.4839
TechnoMagic	2022-02-02	21	20	22	43	0.4839
Football Club Management 2023	2022-12-07	61	20	22	83	0.4839
Undecember	2022-10-12	46103	7477	8028	54131	0.4832
Prehistoric Marine Monsters	2022-10-01	11	19	21	32	0.4832
Robber Sam	2022-06-07	3	19	21	24	0.4832
Femdom Waifu VR	2022-03-09	6	8	9	15	0.4829
Futanari Sex - BDSM Room	2022-05-10	4	8	9	13	0.4829
Overdrive	2022-07-02	5	8	9	14	0.4829
Hell Madness	2022-07-22	3	8	9	12	0.4829
The DioField Chronicle	2022-09-22	1272	316	343	1615	0.48240000000000005
The Dark Journey	2022-02-28	9	18	20	29	0.48240000000000005
Clearcutting	2022-03-31	6	7	8	14	0.4811
Blackout!!	2022-05-02	4	7	8	12	0.4811
Thunderbolt Poker	2022-12-08	13	7	8	21	0.4811
Casting Couch Simulator	2022-10-15	10	16	18	28	0.4807
Madden NFL 23	2022-08-19	6169	2233	2431	8600	0.4804
仙劍客棧 2	2022-07-08	7532	977	1068	8600	0.48
18层	2022-03-17	14	15	17	31	0.4797
英灵殿：女武神觉醒	2022-09-30	174	122	135	309	0.47950000000000004
AREA MAN LIVES	2022-05-12	5	6	7	12	0.4789
Yacht Dice M : Global League	2022-01-18	8	6	7	15	0.4789
Dangerous Hobby	2022-01-25	2	6	7	9	0.4789
罪人之籠	2022-05-09	9	6	7	16	0.4789
Fix Me Up - Hospital Edition	2022-05-06	1	6	7	8	0.4789
Space	2022-08-22	3	6	7	10	0.4789
Magic Staves	2022-12-06	2	6	7	9	0.4789
UfoScare	2022-12-24	2	6	7	9	0.4789
Escort Simulator 2	2022-02-14	18	22	25	43	0.478
Paranormal Motel	2022-03-11	4	13	15	19	0.4772
TVG (The Vox Games). Journey	2022-04-28	5	13	15	20	0.4772
Red Haven	2022-10-07	15	13	15	30	0.4772
空気読み。オンライン	2022-06-20	450	143	160	610	0.47700000000000004
GHARP	2022-03-12	6	37	42	48	0.4768
Wolfteam: Reboot	2022-12-07	79	69	78	157	0.47619999999999996
The Witch's Garden	2022-06-12	33	44	50	83	0.47619999999999996
VR Dungeon	2022-07-08	3	5	6	9	0.4761
New Joe & Mac - Caveman Ninja	2022-12-02	5	5	6	11	0.4761
Taxi Driver - The Simulation	2022-02-16	4	5	6	10	0.4761
Ultramarine	2022-02-09	8	5	6	14	0.4761
Gunslinger Valley	2022-01-21	9	5	6	15	0.4761
Bad Girl Confidential - The Pleasure Den	2022-02-02	3	5	6	9	0.4761
Ludo XXL	2022-07-07	10	5	6	16	0.4761
转生成为史莱姆的我变成了美少女的宠物	2022-04-21	3	5	6	9	0.4761
白领厨娘	2022-05-20	4	5	6	10	0.4761
CANDY EATERS TOURNAMENT	2022-05-31	2	5	6	8	0.4761
Prostitute Simulator	2022-07-21	5	5	6	11	0.4761
黄金矿工大冒险	2022-08-17	4	5	6	10	0.4761
Farma Force	2022-12-06	3	5	6	9	0.4761
Zombies Killer Machine	2022-01-06	3	12	14	17	0.4758
Breath of Ghosts 2	2022-07-25	5	12	14	19	0.4758
Bug Butcher	2022-06-25	3	12	14	17	0.4758
二十一	2022-09-28	139	27	31	170	0.4756
Got reincarnated into a world of RPG full of NPCs…	2022-03-04	9	19	22	31	0.4753
Horror In Valkeala	2022-03-03	4	19	22	26	0.4753
Watch Your Back	2022-06-30	13	26	30	43	0.47490000000000004
It follows you	2022-01-14	4	18	21	25	0.4742
Omitted	2022-07-30	10	18	21	31	0.4742
Bud Farm Idle Tycoon	2022-11-15	67	25	29	96	0.474
A.V.A Global	2022-08-24	16199	3002	3361	19560	0.47380000000000005
FLASHOUT 3	2022-09-22	44	61	70	114	0.47350000000000003
EndlessBattlefield	2022-01-04	63	23	27	90	0.4722
一代掌门	2022-06-08	39	10	12	51	0.4722
İfrit	2022-09-03	7	10	12	19	0.4722
Battle Ready	2022-02-17	2	4	5	7	0.4722
Auto World Tycoon	2022-03-15	8	4	5	13	0.4722
Carrier Commander	2022-08-10	4	4	5	9	0.4722
Valley of the Dead: MalnaZidos	2022-03-11	2	4	5	7	0.4722
POG 7	2022-02-12	3	4	5	8	0.4722
幸运宝石	2022-04-13	4	4	5	9	0.4722
Vacant Planet	2022-05-25	2	4	5	7	0.4722
Insurrection: Awakening of the cyborgs	2022-07-27	4	4	5	9	0.4722
Revived Forest	2022-06-04	3	4	5	8	0.4722
Tank Commander: Battlefield	2022-07-04	3	4	5	8	0.4722
Worlds of Nyx	2022-11-25	2	4	5	7	0.4722
Cowgirl Adventures	2022-07-29	4	4	5	9	0.4722
Mono Playground	2022-07-27	4	4	5	9	0.4722
World Mahjong (Original)	2022-09-30	5	4	5	10	0.4722
2tinycowboys	2022-09-13	3	4	5	8	0.4722
Unrushed Defence	2022-12-19	2	4	5	7	0.4722
SusRitual	2022-11-01	8	4	5	13	0.4722
Beat The Devil	2022-10-11	3	4	5	8	0.4722
Boot Camp	2022-11-03	3	4	5	8	0.4722
Last Girl in Futa Sexpocalypse	2022-11-30	6	4	5	11	0.4722
Little white man	2022-12-24	2	4	5	7	0.4722
BATTLE STEED : GUNMA	2022-08-11	25	29	34	59	0.4717
还我河山HeroRagingFire	2022-03-20	22	79	92	114	0.47009999999999996
エマの武器屋さん	2022-09-10	226	32	38	264	0.469
New Tales from the Borderlands	2022-10-21	435	256	297	732	0.4685
GOAL! The Club Manager	2022-11-02	711	130	152	863	0.4681
Diner Runners	2022-02-28	12	25	30	42	0.4681
They are coming	2022-05-20	12	19	23	35	0.46770000000000006
Hollow 2	2022-07-08	3	8	10	13	0.4673
Orbital Combat	2022-05-14	12	8	10	22	0.4673
Casino Tycoon Simulator	2022-04-17	4	8	10	14	0.4673
Fantasy Adventure	2022-07-08	6	8	10	16	0.4673
天若有情	2022-07-15	20	8	10	30	0.4673
Enf Novels: Cold Night	2022-06-27	6	8	10	16	0.4673
13 Candles	2022-12-13	4	8	10	14	0.4673
Nine to Five	2022-05-16	897	1566	1810	2707	0.467
Dead Man´s Diary	2022-03-30	22	35	42	64	0.4668
Skyward	2022-04-02	3	3	4	7	0.4668
BearHammer	2022-09-23	3	3	4	7	0.4668
Paramount Hero	2022-10-07	7	3	4	11	0.4668
Human Diaspora	2022-05-22	2	3	4	6	0.4668
Pepo	2022-01-31	4	3	4	8	0.4668
Crazy Wheels	2022-07-11	20	3	4	24	0.4668
BOSS BEEK- Beekeeping Simulator	2022-02-04	2	3	4	6	0.4668
Jigsaw Novel - Public Toilet Sex	2022-01-21	2	3	4	6	0.4668
Dark Desire 1	2022-02-23	2	3	4	6	0.4668
Helga the Viking Warrior	2022-03-19	5	3	4	9	0.4668
Puzzle Mix	2022-02-21	2	3	4	6	0.4668
BeatNClean	2022-05-10	27	3	4	31	0.4668
Descentium	2022-08-23	4	3	4	8	0.4668
Memory Novel - Girls Night Out	2022-03-22	2	3	4	6	0.4668
Fun with Friends and Trampolines	2022-09-01	2	3	4	6	0.4668
Primal Roar - Jurassic Dinosaur Era	2022-12-01	2	3	4	6	0.4668
Unbearable	2022-06-12	4	3	4	8	0.4668
刀光剑影	2022-05-26	1	3	4	5	0.4668
ZOSU VR Explosive Bow Hunting	2022-12-15	2	3	4	6	0.4668
ホーンテッド･ガールズ	2022-09-25	6	3	4	10	0.4668
Fracture: City of Destruction	2022-09-09	3	3	4	7	0.4668
Sex in the Office	2022-10-28	6	3	4	10	0.4668
Angels of Amsterdam	2022-12-06	2	3	4	6	0.4668
Who is Here?	2022-10-21	3	3	4	7	0.4668
Daring Detectives - A new life!	2022-12-15	7	3	4	11	0.4668
The Visitor	2022-12-23	3	3	4	7	0.4668
MythBusters: The Game - Crazy Experiments Simulator	2022-09-01	117	58	69	186	0.4667
Fangs	2022-11-30	2702	529	619	3321	0.46549999999999997
Animal Simulator	2022-08-25	9	12	15	24	0.4648
Tales of Terror	2022-09-29	23	12	15	38	0.4648
ULTRARUSH	2022-08-11	10	12	15	25	0.4648
黑帮英豪	2022-04-17	6	12	15	21	0.4648
Exorcist	2022-05-12	5	12	15	20	0.4648
Me Alone Reissue	2022-06-25	3	12	15	18	0.4648
Body of Evidence	2022-10-31	9	7	9	18	0.46409999999999996
mstm	2022-02-13	7	7	9	16	0.46409999999999996
Wicked Dolls	2022-07-30	10	7	9	19	0.46409999999999996
CAEDES	2022-08-18	5	16	20	25	0.4632
Survive Me Miolhr	2022-06-18	188	11	14	202	0.4625
Miho Adventures	2022-08-05	7	11	14	21	0.4625
Cronous Online	2022-09-01	120	55	67	187	0.46240000000000003
HopeLine	2022-03-16	61	81	99	160	0.46049999999999996
Life in Willowdale: Farm Adventures	2022-10-25	11	6	8	19	0.46020000000000005
Dymension:Scary Horror Survival Shooter	2022-03-03	5	6	8	13	0.46020000000000005
战甲online	2022-02-25	12	6	8	20	0.46020000000000005
洛神见月	2022-07-11	1	6	8	9	0.46020000000000005
Mystery Case Files: The Last Resort Collector's Edition	2022-12-08	11	6	8	19	0.46020000000000005
The Anacrusis	2022-01-13	1478	674	807	2285	0.4601
The Amulet of AmunRun	2022-04-27	7	10	13	20	0.4598
Gladia	2022-03-12	3	10	13	16	0.4598
清平书社	2022-07-01	3	10	13	16	0.4598
Road Trip	2022-05-26	5	14	18	23	0.4593
kill or dead	2022-11-07	67	22	28	95	0.45840000000000003
Gallows	2022-03-05	1	2	3	4	0.4583
Ninja Blast	2022-05-21	1	2	3	4	0.4583
Sugar Story	2022-02-10	3	2	3	6	0.4583
Imprisoned Hyperion	2022-11-11	3	2	3	6	0.4583
Never End, Neverland!	2022-03-21	3	2	3	6	0.4583
Galactic Ravager	2022-01-15	2	2	3	5	0.4583
The Home Of Closed Doors	2022-01-01	3	2	3	6	0.4583
Deliver or Die!	2022-02-25	2	2	3	5	0.4583
Animaddicts	2022-02-28	3	2	3	6	0.4583
Insipid	2022-02-02	2	2	3	5	0.4583
Music Thief	2022-03-01	2	2	3	5	0.4583
Zombie City	2022-03-02	3	2	3	6	0.4583
Night Of Disturbance	2022-10-24	2	2	3	5	0.4583
Music & Fireworks Show	2022-02-22	2	2	3	5	0.4583
Astro Mission: Moon	2022-02-25	1	2	3	4	0.4583
次元乱斗	2022-04-12	3	2	3	6	0.4583
Mirror Spirits	2022-04-09	4	2	3	7	0.4583
The Butcher	2022-06-16	2	2	3	5	0.4583
Shirazu Yama	2022-04-20	5	2	3	8	0.4583
B.I.N.D.	2022-08-19	2	2	3	5	0.4583
Animaddicts 4	2022-06-01	1	2	3	4	0.4583
Beer Break	2022-04-30	4	2	3	7	0.4583
Fearless Rider	2022-05-11	1	2	3	4	0.4583
Aurelia: Stellar Arising	2022-05-16	2	2	3	5	0.4583
Arth Island	2022-11-04	1	2	3	4	0.4583
MY Neko Waifu!	2022-08-27	3	2	3	6	0.4583
War Tanks	2022-08-22	1	2	3	4	0.4583
Guardian	2022-08-17	2	2	3	5	0.4583
Minimal Bubble Pop	2022-08-01	3	2	3	6	0.4583
 Nightmares	2022-09-05	1	2	3	4	0.4583
Girls vs Zombies	2022-10-29	2	2	3	5	0.4583
Dark Desire 3	2022-08-05	3	2	3	6	0.4583
Idle Zombies Clicker	2022-08-22	9	2	3	12	0.4583
Single Player: Horror	2022-11-11	2	2	3	5	0.4583
Merchant's Rush	2022-10-10	3	2	3	6	0.4583
Jigsaw Puzzle - Futanari Threesome	2022-08-20	2	2	3	5	0.4583
BONERDALE - 2022 Edition	2022-10-21	5	2	3	8	0.4583
Code: 29	2022-09-20	1	2	3	4	0.4583
甜心魔术师	2022-09-23	3	2	3	6	0.4583
ソラナと陽の工房	2022-10-20	15	2	3	18	0.4583
Cairn: Stone Balancing	2022-09-19	7	2	3	10	0.4583
Fly Missions	2022-10-08	2	2	3	5	0.4583
Stunts Contest Monster Car	2022-11-11	2	2	3	5	0.4583
Sunny Memories	2022-11-17	3	2	3	6	0.4583
绝色舞姬	2022-12-23	5	2	3	8	0.4583
Grapple	2022-03-21	110	405	492	602	0.45780000000000004
Empire Takeover	2022-02-10	72	56	70	142	0.45740000000000003
Hidden World Top-Down 3D	2022-03-07	5	9	12	17	0.45670000000000005
Capitals	2022-08-08	6	9	12	18	0.45670000000000005
CargoRun	2022-11-22	2	9	12	14	0.45670000000000005
Card Storm Idle	2022-01-13	91	29	37	128	0.4565
50	2022-03-11	26	29	37	63	0.4565
BLACK ACE	2022-02-03	19	33	42	61	0.45630000000000004
幻想三国志3	2022-01-09	57	49	62	119	0.4556
Luminary	2022-03-16	146	24	31	177	0.45530000000000004
Kingdom of Assetia: The Clicker Game	2022-01-25	6	5	7	13	0.45520000000000005
Pixel Robot Return	2022-01-04	2	5	7	9	0.45520000000000005
BridgeTeam: Ship Simulator	2022-01-02	3	5	7	10	0.45520000000000005
TITS OKAY TITS FINE	2022-02-07	5	5	7	12	0.45520000000000005
Infinite Construction	2022-03-04	3	5	7	10	0.45520000000000005
In The End	2022-03-14	4	5	7	11	0.45520000000000005
Project Alex	2022-09-23	3	5	7	10	0.45520000000000005
Pirates Gold	2022-12-06	2	5	7	9	0.45520000000000005
The Lost Village	2022-10-12	3	5	7	10	0.45520000000000005
Warlords: Age of Shadow Magic	2022-04-11	28	12	16	44	0.4545
十三月のふたり姫	2022-12-02	9	8	11	20	0.45310000000000006
Eo	2022-08-04	7	22	29	36	0.4523
UNDER the WATER	2022-05-24	4	18	24	28	0.4516
Space Crafting	2022-05-19	3	18	24	27	0.4516
Voidwalkers: The Gates Of Hell	2022-06-03	11	11	15	26	0.4516
Xio: Survival	2022-07-01	11	11	15	26	0.4516
梦三国2	2022-09-01	195	59	76	271	0.4514
Romans: Age of Caesar	2022-04-27	264	131	167	431	0.45049999999999996
Stalker in black	2022-05-24	92	28	37	129	0.4504
SICK	2022-04-30	3	14	19	22	0.4504
梦塔防	2022-09-01	163	20	27	190	0.44880000000000003
Agent X	2022-08-20	3	7	10	13	0.4487
The Last Shape	2022-05-11	4	7	10	14	0.4487
Scary Wife HD	2022-04-06	3	7	10	13	0.4487
Idle Galaxy	2022-06-04	22	7	10	32	0.4487
At The Party	2022-06-02	5	4	6	11	0.4486
Hentai Achievement Puzzle	2022-06-27	2	4	6	8	0.4486
Forest Mystery	2022-07-25	2	4	6	8	0.4486
Putridness	2022-02-20	3	4	6	9	0.4486
DungeonSlime	2022-08-22	2	4	6	8	0.4486
VR Archery	2022-03-31	10	4	6	16	0.4486
Mozart Requiem	2022-09-07	4	4	6	10	0.4486
Project PULSE	2022-01-03	5	10	14	19	0.4483
Tetris Girls	2022-09-05	11	16	22	33	0.4473
Touchdown Girls	2022-12-08	41	19	26	67	0.44680000000000003
Autobahn Police Simulator 3	2022-06-23	151	108	142	293	0.4449
Draken	2022-03-22	9	12	17	26	0.4448
Inn Mage	2022-08-05	9	9	13	22	0.44450000000000006
Nonogram Kindom	2022-04-13	17	9	13	30	0.44450000000000006
人妻痴汉电车	2022-01-06	8	6	9	17	0.4434
Mebula	2022-06-10	6	6	9	15	0.4434
Drunk Games	2022-06-03	3	6	9	12	0.4434
Backroom Beyond	2022-07-08	5	6	9	14	0.4434
7 Angels	2022-02-28	35	42	57	92	0.44320000000000004
Loco Bonobo	2022-02-17	3	1	2	5	0.44310000000000005
The Thing at the Window	2022-10-24	2	1	2	4	0.44310000000000005
Psihanul	2022-12-21	2	1	2	4	0.44310000000000005
SANCTION	2022-06-10	2	1	2	4	0.44310000000000005
 Lost Gray	2022-08-05	2	1	2	4	0.44310000000000005
Zombie Groove	2022-06-30	5	1	2	7	0.44310000000000005
Human Defense [RTS]	2022-09-27	1	1	2	3	0.44310000000000005
Escape Abstraction	2022-06-03	2	1	2	4	0.44310000000000005
The Patagonians	2022-08-03	1	1	2	3	0.44310000000000005
Baptism of Fire	2022-02-25	5	1	2	7	0.44310000000000005
Xtreme Aces Racing	2022-01-13	2	1	2	4	0.44310000000000005
BINGIMAN: Trap Ochido	2022-05-20	1	1	2	3	0.44310000000000005
UNSTABLE	2022-02-19	2	1	2	4	0.44310000000000005
Scholar	2022-05-13	1	1	2	3	0.44310000000000005
Trialtime Reborn	2022-02-28	2	1	2	4	0.44310000000000005
Royal Legends: Marshes Curse Collector's Edition	2022-01-04	9	1	2	11	0.44310000000000005
Skeletons	2022-09-09	1	1	2	3	0.44310000000000005
Project Valkiriya	2022-03-03	1	1	2	3	0.44310000000000005
LEADING the DEAD	2022-01-11	2	1	2	4	0.44310000000000005
Color Patterns	2022-01-21	2	1	2	4	0.44310000000000005
执剑九霄	2022-03-24	3	1	2	5	0.44310000000000005
Wild West Old Sam	2022-07-08	2	1	2	4	0.44310000000000005
Lighthouse Stories - Book one: Part one	2022-01-25	1	1	2	3	0.44310000000000005
Sharon and the Last Garden	2022-01-31	2	1	2	4	0.44310000000000005
Way Down	2022-02-28	2	1	2	4	0.44310000000000005
Каролина	2022-05-02	1	1	2	3	0.44310000000000005
Infinadeck Medieval Maze	2022-02-24	2	1	2	4	0.44310000000000005
Crowd Sign: Emission	2022-05-01	2	1	2	4	0.44310000000000005
Tabbellarius	2022-03-09	3	1	2	5	0.44310000000000005
Sokonashi No Me	2022-02-19	2	1	2	4	0.44310000000000005
王子斗恶龙	2022-03-07	1	1	2	3	0.44310000000000005
The Eternal Battlefields	2022-04-23	2	1	2	4	0.44310000000000005
The Giant of Torridge Island	2022-04-11	2	1	2	4	0.44310000000000005
Clocknockers 2	2022-02-25	3	1	2	5	0.44310000000000005
Fire Safety VR Training	2022-03-20	9	1	2	11	0.44310000000000005
Swift Attack	2022-09-02	2	1	2	4	0.44310000000000005
1001 Jigsaw Castles And Palaces 2	2022-02-21	3	1	2	5	0.44310000000000005
Lockout Tagout (LOTO) VR Training	2022-03-20	2	1	2	4	0.44310000000000005
Medusa Frontier	2022-04-11	2	1	2	4	0.44310000000000005
Terror Shooter Apocalypse	2022-04-04	2	1	2	4	0.44310000000000005
一念成仙	2022-06-14	6	1	2	8	0.44310000000000005
The Coven of Calahree	2022-06-24	9	1	2	11	0.44310000000000005
Smash Therapy	2022-10-08	2	1	2	4	0.44310000000000005
Wet Dreams	2022-04-28	2	1	2	4	0.44310000000000005
Nectar	2022-05-26	1	1	2	3	0.44310000000000005
TheFlame	2022-05-25	2	1	2	4	0.44310000000000005
She is mad	2022-05-28	3	1	2	5	0.44310000000000005
像素绘图方块	2022-09-14	3	1	2	5	0.44310000000000005
Via Mortis	2022-05-19	1	1	2	3	0.44310000000000005
Guacamojo	2022-07-02	2	1	2	4	0.44310000000000005
格斗少女	2022-06-18	1	1	2	3	0.44310000000000005
Memory Puzzle - Neko Girls	2022-05-07	4	1	2	6	0.44310000000000005
Goddess Of Card War 2	2022-07-09	2	1	2	4	0.44310000000000005
ROD Multiplayer Car Driving	2022-11-25	3	1	2	5	0.44310000000000005
Let Me Out	2022-09-30	2	1	2	4	0.44310000000000005
Boss Hunter	2022-07-08	2	1	2	4	0.44310000000000005
Descension	2022-07-21	3	1	2	5	0.44310000000000005
CLASHBOWL	2022-08-20	2	1	2	4	0.44310000000000005
ボクらの消しゴム落とし新学期	2022-10-19	6	1	2	8	0.44310000000000005
Valete vos viatores	2022-08-17	4	1	2	6	0.44310000000000005
Endless Chaos: Hordes of the Afterlife	2022-07-23	2	1	2	4	0.44310000000000005
Dorm Days	2022-12-01	4	1	2	6	0.44310000000000005
The Last Metal Shooter	2022-07-25	3	1	2	5	0.44310000000000005
Oblige Of CHAOS	2022-08-31	3	1	2	5	0.44310000000000005
Box Runner!	2022-07-28	2	1	2	4	0.44310000000000005
BattlefieldPriest	2022-08-15	2	1	2	4	0.44310000000000005
Warrior Maiden	2022-08-04	1	1	2	3	0.44310000000000005
Hold or Die	2022-11-11	5	1	2	7	0.44310000000000005
Crossroad of Worlds: 100 Doors Collector's Edition	2022-10-07	4	1	2	6	0.44310000000000005
The Edge Of The World Z (Will Shock You)	2022-08-22	2	1	2	4	0.44310000000000005
Sir Questionnaire	2022-12-08	2	1	2	4	0.44310000000000005
fig.	2022-10-24	2	1	2	4	0.44310000000000005
I'm a sardine Keita	2022-09-16	1	1	2	3	0.44310000000000005
Girls slap	2022-10-24	2	1	2	4	0.44310000000000005
PermaNight	2022-09-30	2	1	2	4	0.44310000000000005
Street Paint Playground	2022-09-27	1	1	2	3	0.44310000000000005
Living With Dragons	2022-10-28	5	1	2	7	0.44310000000000005
PIP 4	2022-09-30	3	1	2	5	0.44310000000000005
The Heart Defenders	2022-11-08	2	1	2	4	0.44310000000000005
DrugRunner	2022-11-08	1	1	2	3	0.44310000000000005
Null G	2022-11-18	2	1	2	4	0.44310000000000005
Grapple Whip	2022-11-22	2	1	2	4	0.44310000000000005
逆光追竹	2022-12-06	3	1	2	5	0.44310000000000005
Lustful Vampire	2022-12-15	1	1	2	3	0.44310000000000005
Hentai Slide Puzzle	2022-12-22	2	1	2	4	0.44310000000000005
BattleReign	2022-12-22	2	1	2	4	0.44310000000000005
Sex Adventures - Hot Sauna	2022-12-11	2	1	2	4	0.44310000000000005
World of Fate	2022-12-24	15	23	32	47	0.4425
SpellMaster: The Saga	2022-02-16	372	161	213	585	0.4422
Romance of the Three Kingdoms Hadou [JP]	2022-02-17	813	14	20	833	0.44200000000000006
Wars and Roses	2022-01-21	4170	1092	1417	5587	0.4414
僕と彼の危険な同居生活	2022-06-29	35	11	16	51	0.4414
The Drained Goddess	2022-04-06	7	11	16	23	0.4414
Wizard Girl Anzu	2022-02-04	6	11	16	22	0.4414
VELONE	2022-04-21	20	11	16	36	0.4414
玫瑰行动	2022-04-22	11	11	16	27	0.4414
Hidden Farm Top-Down 3D	2022-04-08	7	19	27	34	0.4403
Flippin Misfits	2022-09-27	201	60	82	283	0.4399
The Monster Mole	2022-07-21	19	3	5	24	0.43950000000000006
Tower of Ascension	2022-07-19	2	3	5	7	0.43950000000000006
Roma VR - Domus	2022-02-04	5	3	5	10	0.43950000000000006
Grederys	2022-05-19	2	3	5	7	0.43950000000000006
卧龙觉醒	2022-05-20	12	3	5	17	0.43950000000000006
Snack Stall	2022-08-05	2	3	5	7	0.43950000000000006
Advent Calendar	2022-11-10	5	3	5	10	0.43950000000000006
AsteroIdle	2022-08-11	29	3	5	34	0.43950000000000006
Nightmare Slash	2022-06-15	3	3	5	8	0.43950000000000006
Search 4 Bigfoot	2022-10-20	3	3	5	8	0.43950000000000006
Blade of Darkness	2022-07-19	3	3	5	8	0.43950000000000006
Kenomaze	2022-07-08	2	3	5	7	0.43950000000000006
Wings of The Universe	2022-12-17	5	3	5	10	0.43950000000000006
Waifu Packer	2022-09-14	2	3	5	7	0.43950000000000006
Nebula Realms	2022-06-22	22	27	38	60	0.4394
Warcos	2022-01-27	11	13	19	30	0.439
Hot wife Tara	2022-04-21	21	13	19	40	0.439
Age of Pyramids	2022-11-15	11	21	30	41	0.4386
Tanks Boom Boom	2022-08-04	2	10	15	17	0.4375
LandPort	2022-05-20	4	5	8	12	0.4368
Eger	2022-05-14	3	5	8	11	0.4368
Lost in Hell	2022-07-08	3	5	8	11	0.4368
CROWZ	2022-06-28	2559	2155	2854	5413	0.43560000000000004
Disembowel	2022-11-24	31	27	39	70	0.4347
Idle Hero	2022-08-11	24	7	11	35	0.4347
Late photographer 2 free	2022-02-23	18	14	21	39	0.434
Motorcycle Travel Simulator	2022-06-18	63	61	86	149	0.4339
Zombie Shooter: Ares Virus	2022-01-25	186	51	73	259	0.43200000000000005
Masterchef Chinese Food Edition	2022-04-01	4	11	17	21	0.43170000000000003
Time Idle RPG	2022-03-29	112	35	51	163	0.43119999999999997
Dying Night SEX with ZOMBI	2022-05-27	18	20	30	48	0.43060000000000004
Idol Queens Production	2022-04-30	21	13	20	41	0.43060000000000004
Retro three kingdoms : Special edition	2022-04-12	10	6	10	20	0.4283
Chrysalis Inc.	2022-04-27	3	6	10	13	0.4283
Short Horror Story	2022-12-10	4	6	10	14	0.4283
Sun Warriors	2022-07-14	82	4	7	89	0.4282
DEBUG	2022-02-13	3	4	7	10	0.4282
Just Power: The Papal States	2022-11-12	9	4	7	16	0.4282
A100	2022-05-12	2	4	7	9	0.4282
风流霸业	2022-06-22	15	4	7	22	0.4282
Mirror Beauty	2022-08-24	5	4	7	12	0.4282
Armor Clash 2022	2022-06-06	4	8	13	17	0.4279
ALEON's Nightmare	2022-08-09	7	8	13	20	0.4279
The Shore VR	2022-02-14	11	21	32	43	0.4275
The Apocalypse	2022-11-30	5	10	16	21	0.4274
Hentai Teachers	2022-09-24	11	10	16	27	0.4274
MythBusters: The First Experiment	2022-05-05	24	23	35	59	0.4269
Aya's Journey	2022-10-29	3	12	19	22	0.4269
Puzzle Quest 3	2022-03-01	221	157	224	445	0.4268
Vampire: The Masquerade — Sins of the Sires	2022-03-24	120	46	68	188	0.4266
Strike Force 2	2022-03-17	3	2	4	7	0.4261
Ancient Gladiators	2022-01-18	4	2	4	8	0.4261
WeeRPG	2022-05-06	6	2	4	10	0.4261
Project:Special Forces	2022-09-11	2	2	4	6	0.4261
Deadly Nightmare	2022-02-10	2	2	4	6	0.4261
Age of Dynasty	2022-09-09	2	2	4	6	0.4261
Zom Tom	2022-05-07	1	2	4	5	0.4261
人生！重新开始吧！泰诺特的冒险	2022-07-29	2	2	4	6	0.4261
Victory7	2022-07-21	3	2	4	7	0.4261
Битва Героев 3	2022-04-23	8	2	4	12	0.4261
Charlotte: Dragon Slayer	2022-05-29	3	2	4	7	0.4261
Doorman	2022-05-28	2	2	4	6	0.4261
Sushi Rush	2022-09-28	1	2	4	5	0.4261
Fruit Juice	2022-10-09	2	2	4	6	0.4261
Futanari Sex - The Birthday Massage	2022-06-21	3	2	4	7	0.4261
Lunatic	2022-08-27	3	2	4	7	0.4261
Underworld Re: Card	2022-08-17	2	2	4	6	0.4261
Office Racer	2022-08-22	2	2	4	6	0.4261
City Metro Simulator	2022-12-23	2	2	4	6	0.4261
Chased	2022-12-16	5	2	4	9	0.4261
Naomi's Exhibition	2022-12-28	3	2	4	7	0.4261
Equinox	2022-11-12	2	2	4	6	0.4261
Mining Copper	2022-11-11	14	2	4	18	0.4261
Math Ball	2022-11-28	4	2	4	8	0.4261
Fractured Online	2022-09-15	1515	183	265	1780	0.423
The Future You've Been Dreaming Of	2022-07-14	36	15	24	60	0.4226
FREAKOUT	2022-12-02	20	19	30	50	0.42229999999999995
Among Walls	2022-05-24	8	7	12	20	0.4218
Runaway Princess	2022-03-18	9	7	12	21	0.4218
MadMan	2022-04-07	4	7	12	16	0.4218
Lovecraft's Untold Stories 2	2022-09-13	84	42	64	148	0.4216
Venatio	2022-01-23	7	5	9	16	0.4204
Under Siege	2022-06-08	3	5	9	12	0.4204
The Lost Castle: Escape Room	2022-11-15	5	5	9	14	0.4204
Little Imps	2022-02-07	31	20	32	63	0.41950000000000004
눈 떠보니 임진왜란이었다 - Back To the Joseon	2022-09-07	4	10	17	21	0.4179
VARIOUS DAYLIFE	2022-09-13	91	33	52	143	0.4175
Survive 4 Pleasure	2022-03-11	6	8	14	20	0.4167
Hentai Men	2022-03-22	2	3	6	8	0.4167
Astral Shipwright	2022-11-11	6	3	6	12	0.4167
多宝修仙	2022-01-28	5	3	6	11	0.4167
Flight 737 - MAXIMUM	2022-03-22	5	3	6	11	0.4167
War in Europe: 1940	2022-06-15	2	3	6	8	0.4167
Mysterious Things	2022-06-02	2	3	6	8	0.4167
Galactic Liberation	2022-05-24	2	3	6	8	0.4167
Fruit Girl Kiss	2022-08-11	3	3	6	9	0.4167
The Googol Clicker	2022-12-09	22	3	6	28	0.4167
City Eye	2022-08-12	40	28	45	85	0.4154
Clown Theft Auto: Woke City	2022-10-22	6	13	22	28	0.41509999999999997
King and Kingdoms	2022-05-05	19	24	39	58	0.41500000000000004
Kandra The Moonwalker	2022-05-17	5	6	11	16	0.41450000000000004
Green Wounds	2022-09-27	3	6	11	14	0.41450000000000004
Candy Girlfriend	2022-07-08	9	6	11	20	0.41450000000000004
Paradise Puzzle!	2022-09-10	7	20	33	40	0.4143
Star Alliance	2022-03-25	27	23	38	65	0.41250000000000003
BABYLON'S FALL	2022-03-03	1188	193	295	1483	0.4117
PC Virtual LAB	2022-07-18	30	31	51	81	0.4103
Serendipity Hotel	2022-04-24	3	4	8	11	0.4103
Stakeholder Game	2022-02-10	14	4	8	22	0.4103
Ghost	2022-01-31	3	4	8	11	0.4103
Valkyrie Nemesis	2022-03-25	3	4	8	11	0.4103
FAST FOOD SHOP 	2022-08-30	9	4	8	17	0.4103
Hunted: Kalevala	2022-12-31	2	4	8	10	0.4103
Babba Yagga: Woodboy	2022-02-27	4	7	13	17	0.41000000000000003
密室监禁	2022-01-21	8	7	13	21	0.41000000000000003
College Seduction	2022-01-24	45	15	26	71	0.4094
Destroy All Humans! – Clone Carnage	2022-06-01	307	76	121	428	0.409
WW2: World War Strategy Simulator	2022-01-11	31	23	39	70	0.408
Project XMAS	2022-03-04	7	16	28	35	0.40700000000000003
Signals of Chaos	2022-04-21	2	0	1	3	0.4058
Undarkened: Revival	2022-06-04	3	0	1	4	0.4058
The Tale of Treasonous Tom: Part 1	2022-10-15	1	0	1	2	0.4058
HammerBorn: Tears of Mani	2022-05-02	1	0	1	2	0.4058
Codename Nemesis	2022-08-12	2	0	1	3	0.4058
Markerboard Jungle: Frogs	2022-03-05	2	0	1	3	0.4058
FitnessVR	2022-09-22	2	0	1	3	0.4058
Kingdomfall	2022-07-15	2	0	1	3	0.4058
Neko Match	2022-11-04	1	0	1	2	0.4058
Battle Siege Royale	2022-05-09	3	0	1	4	0.4058
Bus Parking 3D	2022-10-21	1	0	1	2	0.4058
pilapa BOOM	2022-01-11	1	0	1	2	0.4058
Eternal Starshine	2022-01-27	1	0	1	2	0.4058
Battlecaster	2022-05-02	3	0	1	4	0.4058
Mechone	2022-01-10	1	0	1	2	0.4058
Liberation Special Forces	2022-10-20	3	0	1	4	0.4058
Spike Match	2022-11-30	2	0	1	3	0.4058
Mobile Soldiers: Plastic Army	2022-08-14	2	0	1	3	0.4058
Cubiti pARti	2022-12-20	4	0	1	5	0.4058
BreakoutForce	2022-12-19	1	0	1	2	0.4058
Huckleberry Fields Forever	2022-02-22	2	0	1	3	0.4058
Lottery Center Simulator	2022-01-15	2	0	1	3	0.4058
Heart of a Warrior	2022-02-02	2	0	1	3	0.4058
Multigravity	2022-02-02	1	0	1	2	0.4058
Air Racing VR	2022-03-06	3	0	1	4	0.4058
Hisui no Kikai	2022-01-10	1	0	1	2	0.4058
Pillars Of Protection	2022-10-22	2	0	1	3	0.4058
AFTER	2022-10-03	1	0	1	2	0.4058
The Dragon Apprentice	2022-05-04	2	0	1	3	0.4058
Reset	2022-01-15	1	0	1	2	0.4058
Powerjackers - VR Superhero Battle Royale	2022-09-12	1	0	1	2	0.4058
Amaze Adventure	2022-07-24	1	0	1	2	0.4058
Hate Free Heroes Tactics - Strategy Building MMORPG	2022-03-22	3	0	1	4	0.4058
Happy VR Plantation Farm	2022-01-14	1	0	1	2	0.4058
Outer Space: War Gears	2022-11-24	2	0	1	3	0.4058
Old Salt	2022-01-20	1	0	1	2	0.4058
Anxiety Treatment with Relaxation	2022-01-18	1	0	1	2	0.4058
Hero or Foe	2022-01-30	11	0	1	12	0.4058
Despectum Drakone	2022-06-03	2	0	1	3	0.4058
Cursed Town	2022-06-03	3	0	1	4	0.4058
R.E.A.C.T	2022-03-21	3	0	1	4	0.4058
FPS Arena	2022-03-28	1	0	1	2	0.4058
Corridors	2022-02-01	2	0	1	3	0.4058
ASTRID	2022-09-11	1	0	1	2	0.4058
Unnamed Arcade Engine	2022-02-28	1	0	1	2	0.4058
Christmas Wonderland 3	2022-01-06	3	0	1	4	0.4058
Circo:Dark Story	2022-01-14	1	0	1	2	0.4058
Tavolga-12	2022-03-30	2	0	1	3	0.4058
BattlefieldCars	2022-02-06	1	0	1	2	0.4058
 A Space Odyssey	2022-02-03	1	0	1	2	0.4058
Furry Shakespeare: Two Incredibly Ripped, Absolutely Shredded Noble Kinsmen	2022-04-07	1	0	1	2	0.4058
末世天醒	2022-04-02	1	0	1	2	0.4058
NoiseBox.噪音盒子	2022-10-14	1	0	1	2	0.4058
Lost Contact	2022-04-12	1	0	1	2	0.4058
Ghost Puncher	2022-11-08	2	0	1	3	0.4058
Adult Aura	2022-01-14	2	0	1	3	0.4058
Insect War	2022-01-16	1	0	1	2	0.4058
Blinky	2022-02-21	1	0	1	2	0.4058
DEITY SOULS Plus	2022-02-14	2	0	1	3	0.4058
The Final Answer	2022-08-09	1	0	1	2	0.4058
Undercraft	2022-10-17	3	0	1	4	0.4058
Monster Of Nyum	2022-03-30	1	0	1	2	0.4058
Zhazari VR	2022-03-16	1	0	1	2	0.4058
Retrievable	2022-01-14	1	0	1	2	0.4058
疯狂厨房	2022-01-13	1	0	1	2	0.4058
Comixxx Desires	2022-01-13	1	0	1	2	0.4058
Prototype: Paradise Lost	2022-06-06	1	0	1	2	0.4058
Nervous Granny	2022-02-07	3	0	1	4	0.4058
Game City	2022-02-02	1	0	1	2	0.4058
Stapel	2022-02-21	2	0	1	3	0.4058
休闲拼一拼	2022-02-09	1	0	1	2	0.4058
Return Ace	2022-03-25	2	0	1	3	0.4058
Knightlife	2022-07-14	3	0	1	4	0.4058
Dark Hood	2022-06-20	1	0	1	2	0.4058
Ejaculation Time - Mommy Play with a Super-Sexy Fox Girl -	2022-04-02	4	0	1	5	0.4058
A Hero's wish	2022-09-09	2	0	1	3	0.4058
Maze Workout - Western Lost Solo Car Racer	2022-05-02	2	0	1	3	0.4058
Sweet Surge	2022-03-30	1	0	1	2	0.4058
Detective Agency 2	2022-02-17	1	0	1	2	0.4058
Herbheim's Mine	2022-02-10	1	0	1	2	0.4058
The Oathkeeper	2022-04-14	2	0	1	3	0.4058
Break It	2022-05-10	1	0	1	2	0.4058
Get Off My Space!	2022-03-09	1	0	1	2	0.4058
Mini Battle Ground	2022-02-10	2	0	1	3	0.4058
Kapital13	2022-05-27	2	0	1	3	0.4058
SKY JUMP	2022-03-15	1	0	1	2	0.4058
Planet Collectors: Episode Earth	2022-03-19	1	0	1	2	0.4058
Initium Legenda	2022-02-25	2	0	1	3	0.4058
3D将棋	2022-07-14	3	0	1	4	0.4058
"""Space"""	2022-06-30	1	0	1	2	0.4058
Scorpion Overdrive	2022-04-01	1	0	1	2	0.4058
Jessica Mysterious Journey	2022-03-09	2	0	1	3	0.4058
Animaddicts 2	2022-03-03	2	0	1	3	0.4058
Surface: Strings of Fate Collector's Edition	2022-02-15	7	0	1	8	0.4058
星の子ヴェルタと空への道	2022-10-27	1	0	1	2	0.4058
Dallaham	2022-09-19	1	0	1	2	0.4058
Underground Lords	2022-06-22	1	0	1	2	0.4058
牝喰いダンジョン - MeguiDungeon -	2022-03-22	2	0	1	3	0.4058
No Lights 2	2022-03-23	3	0	1	4	0.4058
Emoji Merge - Puzzle Matching	2022-03-16	1	0	1	2	0.4058
Comixxx Temptations	2022-03-31	2	0	1	3	0.4058
Find The Cats - Memory	2022-03-21	2	0	1	3	0.4058
SACROSANCT	2022-04-04	1	0	1	2	0.4058
Wild West Gringos	2022-04-07	2	0	1	3	0.4058
Solitaire Beach Season 2	2022-03-28	4	0	1	5	0.4058
Solitaire Beach Season 3	2022-05-09	3	0	1	4	0.4058
1001 Jigsaw American Puzzles	2022-03-23	3	0	1	4	0.4058
Tetris(俄罗斯方块收纳版)	2022-04-07	1	0	1	2	0.4058
Samurai( the rise of warrior)- 武士の台頭	2022-03-31	1	0	1	2	0.4058
Jeu de Tarot	2022-05-03	3	0	1	4	0.4058
Tales from the Crossing: The Captain's Chair	2022-04-27	2	0	1	3	0.4058
Graffiti Battle	2022-08-13	2	0	1	3	0.4058
PVNP	2022-06-13	1	0	1	2	0.4058
Alchemist	2022-05-06	1	0	1	2	0.4058
Prison of the mind	2022-05-01	1	0	1	2	0.4058
Holiday Jigsaw Easter 3	2022-04-11	2	0	1	3	0.4058
Object Ward. ~April Fools' Collection~	2022-04-20	1	0	1	2	0.4058
赛博病毒	2022-06-01	1	0	1	2	0.4058
Researchity Open World Survival Game	2022-06-10	3	0	1	4	0.4058
BATTLE OF BILLIONAIRES	2022-08-04	3	0	1	4	0.4058
Sarissa and the Legendary Sword	2022-07-20	2	0	1	3	0.4058
Minarchy: Active Shooter	2022-04-20	1	0	1	2	0.4058
The Detail's In The Devils	2022-05-06	1	0	1	2	0.4058
鬥犬 Dog Fighting	2022-04-24	1	0	1	2	0.4058
Aznak	2022-08-03	3	0	1	4	0.4058
Arobynn: The First Adventure	2022-05-02	1	0	1	2	0.4058
Hotel Manager Simulator	2022-05-06	2	0	1	3	0.4058
Trouble Town	2022-08-19	4	0	1	5	0.4058
Ikusaotome	2022-05-13	1	0	1	2	0.4058
Decisive Strike	2022-05-16	2	0	1	3	0.4058
Master of War: Rule of Power	2022-10-10	1	0	1	2	0.4058
Project: Maidenless	2022-05-27	2	0	1	3	0.4058
Before The Kingdom Falls	2022-05-17	1	0	1	2	0.4058
Drift Type C	2022-05-13	3	0	1	4	0.4058
Stress Test	2022-05-14	1	0	1	2	0.4058
Among the Skies	2022-06-03	1	0	1	2	0.4058
Knight Solitaire 3	2022-08-08	4	0	1	5	0.4058
Pirate fishing	2022-05-16	1	0	1	2	0.4058
校园拾光 - The Golden Time in high school	2022-05-30	2	0	1	3	0.4058
Bogdan's HeartQuest - The Invader Slayer	2022-10-17	1	0	1	2	0.4058
Spiritus	2022-05-13	2	0	1	3	0.4058
Duel Jousting VR	2022-05-18	1	0	1	2	0.4058
Adventure Trip: London Collector's Edition	2022-05-17	4	0	1	5	0.4058
Tomb Defender	2022-07-14	2	0	1	3	0.4058
Reborn Souls	2022-07-15	3	0	1	4	0.4058
Blitz Roads	2022-09-17	1	0	1	2	0.4058
Round Table	2022-06-03	1	0	1	2	0.4058
Zombie Spree: The Dawn	2022-10-11	1	0	1	2	0.4058
Merge Beasts - Defense Game	2022-06-01	2	0	1	3	0.4058
Maniacs	2022-06-13	1	0	1	2	0.4058
垃圾游戏	2022-07-20	1	0	1	2	0.4058
The Roots	2022-07-11	1	0	1	2	0.4058
Uncharted Space - project 3062	2022-06-16	2	0	1	3	0.4058
MAZE RUNNER	2022-06-18	1	0	1	2	0.4058
Birds Are Real	2022-09-28	1	0	1	2	0.4058
STREAM WAR	2022-07-04	2	0	1	3	0.4058
Two Hot Chicks: an Erotica Porn Space Orgy!	2022-06-17	1	0	1	2	0.4058
Redaxium 2	2022-08-08	1	0	1	2	0.4058
3D Joys	2022-06-25	1	0	1	2	0.4058
Boulder Island	2022-06-28	1	0	1	2	0.4058
RUUUUUUN	2022-08-03	1	0	1	2	0.4058
Mission: Driver	2022-08-03	3	0	1	4	0.4058
SENGOKU Princess ～ 天下統一は姫武将と共に ～	2022-07-14	2	0	1	3	0.4058
ワタシのココロは綺麗ですか？ - Am I Kind Hearted ? -	2022-07-21	2	0	1	3	0.4058
AI WAR	2022-07-12	1	0	1	2	0.4058
Space Assistance	2022-09-27	1	0	1	2	0.4058
MastEr	2022-07-19	1	0	1	2	0.4058
Jelly's Adventure	2022-07-13	1	0	1	2	0.4058
Brain Syndrome VR	2022-10-28	1	0	1	2	0.4058
Kingdom Quest	2022-12-20	4	0	1	5	0.4058
TheBeanstalk	2022-07-20	1	0	1	2	0.4058
Icarus Challenge	2022-08-04	1	0	1	2	0.4058
Truck Rally Hyper Hardcore	2022-09-05	1	0	1	2	0.4058
I Was Wrong	2022-08-26	2	0	1	3	0.4058
Devils 'n Dragons Arcade	2022-12-23	2	0	1	3	0.4058
The Great	2022-07-30	1	0	1	2	0.4058
Dark Lady	2022-07-27	1	0	1	2	0.4058
Farmhand Go!	2022-11-08	2	0	1	3	0.4058
幻恋逢星之时	2022-07-26	1	0	1	2	0.4058
Galactic Story	2022-11-17	1	0	1	2	0.4058
Moon Whalers	2022-09-03	1	0	1	2	0.4058
Hue Hills	2022-08-01	1	0	1	2	0.4058
Tiki Tiki Hop	2022-07-28	2	0	1	3	0.4058
心の力の生徒達	2022-08-16	1	0	1	2	0.4058
Motorcycle Racing VR	2022-12-02	2	0	1	3	0.4058
Water Search	2022-12-08	1	0	1	2	0.4058
Ideal Nightmare	2022-11-23	1	0	1	2	0.4058
GHOSTKEEPER	2022-08-04	1	0	1	2	0.4058
INCOMER	2022-12-16	1	0	1	2	0.4058
Hard Life	2022-10-11	1	0	1	2	0.4058
Girl And Demon 1	2022-08-15	2	0	1	3	0.4058
Clientele: Sexy Deckbuilder	2022-09-06	2	0	1	3	0.4058
3D Pacman	2022-08-17	2	0	1	3	0.4058
Run Sheldon	2022-08-17	2	0	1	3	0.4058
Flappy Bird	2022-08-17	2	0	1	3	0.4058
Pocket Tank	2022-08-25	2	0	1	3	0.4058
Headz Go Racing	2022-11-19	3	0	1	4	0.4058
MEDIEVAL WARRIOR SIMULATOR	2022-09-06	1	0	1	2	0.4058
The City Cards Challenge	2022-09-14	1	0	1	2	0.4058
Blue Print	2022-09-18	1	0	1	2	0.4058
Warna	2022-09-01	1	0	1	2	0.4058
War Obelisks	2022-09-29	1	0	1	2	0.4058
Top Fun 10 VR	2022-09-10	1	0	1	2	0.4058
Winter's Ankh	2022-09-05	1	0	1	2	0.4058
Call of Dusk	2022-09-02	1	0	1	2	0.4058
TK-cosgan	2022-09-28	1	0	1	2	0.4058
Fast or Dead VR	2022-11-04	1	0	1	2	0.4058
Road Frog	2022-09-15	1	0	1	2	0.4058
RX Racing 2022 Pro	2022-11-01	1	0	1	2	0.4058
Fight Until Death	2022-10-23	3	0	1	4	0.4058
The Myriad	2022-10-07	2	0	1	3	0.4058
world of motors 2	2022-11-03	3	0	1	4	0.4058
Deathwish	2022-10-13	1	0	1	2	0.4058
純情ギャルと幸せのカタチ ～Shape of Happiness～	2022-10-20	2	0	1	3	0.4058
Bite Me	2022-10-07	2	0	1	3	0.4058
The Lonely People	2022-10-05	1	0	1	2	0.4058
NONOGRAM - GIRL's SWEETS	2022-09-28	3	0	1	4	0.4058
Court Sort VR	2022-10-11	1	0	1	2	0.4058
Chiky Poky	2022-10-18	2	0	1	3	0.4058
Ravyne	2022-11-21	1	0	1	2	0.4058
Grave-Queen	2022-12-01	1	0	1	2	0.4058
Seven Days	2022-10-17	2	0	1	3	0.4058
Epic Naval Battle Simulator	2022-09-28	1	0	1	2	0.4058
Extermination Cars Stadium	2022-11-14	1	0	1	2	0.4058
Finger Soccer	2022-09-29	2	0	1	3	0.4058
KFZ	2022-10-05	1	0	1	2	0.4058
Asia Empire 2027	2022-10-08	2	0	1	3	0.4058
Bike Arena	2022-12-28	1	0	1	2	0.4058
X-RACER	2022-11-15	2	0	1	3	0.4058
Africa Empire 2027	2022-10-12	2	0	1	3	0.4058
LazerHawk	2022-10-25	3	0	1	4	0.4058
Supermarket Duck Dash	2022-10-17	3	0	1	4	0.4058
Slicing Slicing	2022-10-12	2	0	1	3	0.4058
Bizarr Adventure	2022-11-08	1	0	1	2	0.4058
Poly Puzzle: Dinosaurs	2022-10-17	2	0	1	3	0.4058
PIP 5	2022-10-17	3	0	1	4	0.4058
Together With Me	2022-10-18	1	0	1	2	0.4058
THE LAST SCAPE	2022-11-11	1	0	1	2	0.4058
Solid Flight	2022-10-31	2	0	1	3	0.4058
Robox	2022-11-30	1	0	1	2	0.4058
ValleyLords	2022-11-07	1	0	1	2	0.4058
Hallowed Pumpkins	2022-11-16	2	0	1	3	0.4058
Labyrinth Hearts II	2022-11-14	2	0	1	3	0.4058
Aswang Detective: The Case of New York	2022-11-09	1	0	1	2	0.4058
Draft Day Sports: Pro Basketball 2023	2022-11-23	13	0	1	14	0.4058
Hunting Life VR: Dove Season	2022-11-22	2	0	1	3	0.4058
ZigZagging Ski	2022-12-14	1	0	1	2	0.4058
Nightmare Inside	2022-11-28	1	0	1	2	0.4058
Dark Desire 5	2022-11-24	1	0	1	2	0.4058
WordSpiral	2022-12-05	1	0	1	2	0.4058
Survive and Revenge	2022-12-06	2	0	1	3	0.4058
Dwarven Mercenaries	2022-11-28	2	0	1	3	0.4058
Tsubaki Hata	2022-11-29	1	0	1	2	0.4058
The Epic FishHead Adventure	2022-12-29	1	0	1	2	0.4058
Chaos Saw	2022-12-01	1	0	1	2	0.4058
Contract Bridge Solo	2022-12-23	1	0	1	2	0.4058
DFL2	2022-12-07	2	0	1	3	0.4058
lianliankan	2022-12-12	3	0	1	4	0.4058
Labyrinth of Chaos	2022-12-19	1	0	1	2	0.4058
BeatPlane	2022-12-18	1	0	1	2	0.4058
TUMBLE	2022-12-16	1	0	1	2	0.4058
Spring Puzzle	2022-12-19	2	0	1	3	0.4058
Marble Ball Racing 2022	2022-12-21	2	0	1	3	0.4058
Fast Coffee Simulator	2022-12-23	2	0	1	3	0.4058
Mummy Rumble VR	2022-12-22	1	0	1	2	0.4058
One Tap Golf VR	2022-12-22	1	0	1	2	0.4058
Moley Christmas	2022-12-22	2	0	1	3	0.4058
Mindbytes Japanese	2022-12-27	1	0	1	2	0.4058
Christmas Wonderland 13: Collector's Edition	2022-12-30	2	0	1	3	0.4058
Girlfight 2024	2022-02-25	3	5	10	13	0.4057
戦国の狩人	2022-01-15	5	5	10	15	0.4057
Re: Collector	2022-05-31	7	5	10	17	0.4057
Scary School Simulator	2022-09-14	4	5	10	14	0.4057
Game of Dragons	2022-12-09	3	1	3	6	0.40399999999999997
Forsaken Barn	2022-05-20	2	1	3	5	0.40399999999999997
Bone Mayhem	2022-09-23	2	1	3	5	0.40399999999999997
Paralellia	2022-04-29	2	1	3	5	0.40399999999999997
Explosiver	2022-03-05	2	1	3	5	0.40399999999999997
The Last Defense	2022-03-30	2	1	3	5	0.40399999999999997
Into The Abyss	2022-10-27	1	1	3	4	0.40399999999999997
人中怪物多人版	2022-02-15	16	1	3	19	0.40399999999999997
HERADÔNIA	2022-01-05	2	1	3	5	0.40399999999999997
Unreal Element World	2022-01-23	3	1	3	6	0.40399999999999997
Fighting Mad Lads	2022-01-19	5	1	3	8	0.40399999999999997
Electric	2022-01-14	2	1	3	5	0.40399999999999997
Department 42: The Mystery of the Nine	2022-01-12	4	1	3	7	0.40399999999999997
The First Odyssey	2022-06-14	2	1	3	5	0.40399999999999997
Saviour of Humanity	2022-01-07	3	1	3	6	0.40399999999999997
Down the Hill	2022-01-09	2	1	3	5	0.40399999999999997
Lesbian Voyeur Simulator 2	2022-05-14	2	1	3	5	0.40399999999999997
Insect Simulator	2022-06-23	2	1	3	5	0.40399999999999997
Otome No Himitsu	2022-01-28	2	1	3	5	0.40399999999999997
Memory Novel - The Sex Sauna	2022-01-31	2	1	3	5	0.40399999999999997
ZOMBODRIVE	2022-05-26	2	1	3	5	0.40399999999999997
Memory Novel - The Threesome	2022-02-11	2	1	3	5	0.40399999999999997
The Mostly Empty Theatre	2022-03-18	2	1	3	5	0.40399999999999997
VR Mini World Roller Coaster	2022-03-26	2	1	3	5	0.40399999999999997
The Reflection	2022-03-17	1	1	3	4	0.40399999999999997
Davey	2022-11-06	1	1	3	4	0.40399999999999997
The President	2022-05-27	1	1	3	4	0.40399999999999997
Jigsaw Novel - The Job Promotion	2022-03-14	2	1	3	5	0.40399999999999997
魂之独颂歌 Song of Souls	2022-04-16	2	1	3	5	0.40399999999999997
Outrace	2022-09-20	2	1	3	5	0.40399999999999997
- Doki Doki Family - 特異体質者のドキドキ家族生活	2022-05-26	3	1	3	6	0.40399999999999997
修仙世界	2022-07-25	3	1	3	6	0.40399999999999997
Shooting girl	2022-05-30	2	1	3	5	0.40399999999999997
Little Town Shooter VR	2022-06-03	3	1	3	6	0.40399999999999997
血染め鬼女	2022-08-26	1	1	3	4	0.40399999999999997
The Mystery of William Moore	2022-11-24	3	1	3	6	0.40399999999999997
Haunted Mansion	2022-06-17	2	1	3	5	0.40399999999999997
River Raid 3D	2022-08-15	3	1	3	6	0.40399999999999997
Soul Maze	2022-10-01	5	1	3	8	0.40399999999999997
Can Gym Break This?	2022-12-19	1	1	3	4	0.40399999999999997
Invisible Man VR In Eleanor's room	2022-08-14	4	1	3	7	0.40399999999999997
Pipes Puzzles	2022-08-23	2	1	3	5	0.40399999999999997
Home Deco Puzzles	2022-08-18	2	1	3	5	0.40399999999999997
Splash Ship	2022-08-28	2	1	3	5	0.40399999999999997
a survivor girl	2022-09-06	7	1	3	10	0.40399999999999997
WWII Tanks: Forgotten Battles	2022-11-15	2	1	3	5	0.40399999999999997
Touch Love	2022-10-26	2	1	3	5	0.40399999999999997
Love Formula	2022-10-11	3	1	3	6	0.40399999999999997
THE TRADER -Goods Dealer Simulator-	2022-10-19	2	1	3	5	0.40399999999999997
Dark Desire 4	2022-10-13	2	1	3	5	0.40399999999999997
Wrestling Manager 2023	2022-12-22	3	1	3	6	0.40399999999999997
Sexy Sliders	2022-12-09	2	1	3	5	0.40399999999999997
The last door	2022-12-06	3	1	3	6	0.40399999999999997
mummification	2022-12-15	1	1	3	4	0.40399999999999997
Miss LU	2022-12-29	3	1	3	6	0.40399999999999997
Steel Shell	2022-02-26	5	10	19	24	0.4006
Endure Island	2022-08-29	6	10	19	25	0.4006
Mage Guard	2022-12-05	2	2	5	7	0.40030000000000004
Anxiety Treatment with Relaxation Demo	2022-01-18	1	2	5	6	0.40030000000000004
Memory Novel - Mile High Club	2022-03-13	2	2	5	7	0.40030000000000004
Disharmonia	2022-05-03	2	2	5	7	0.40030000000000004
Pickup One	2022-06-03	2	2	5	7	0.40030000000000004
Aviation Manager	2022-09-03	5	2	5	10	0.40030000000000004
鬼魂街	2022-06-23	2	2	5	7	0.40030000000000004
Hot Sauna	2022-07-25	2	2	5	7	0.40030000000000004
Super Owlboy	2022-08-02	3	2	5	8	0.40030000000000004
Computer Club	2022-08-10	2	2	5	7	0.40030000000000004
DragonHill VR	2022-12-23	2	2	5	7	0.40030000000000004
Aqorel	2022-05-19	4	7	14	18	0.39909999999999995
Blood Camp	2022-02-24	3	14	26	29	0.399
Camp Wars	2022-03-26	281	36	63	344	0.39770000000000005
City Block Builder	2022-08-17	7	3	7	14	0.3972
Distortion VR	2022-09-10	2	3	7	9	0.3972
Kilroy Was Here	2022-01-31	3	3	7	10	0.3972
Tuwas gegen MUDA	2022-03-29	7	3	7	14	0.3972
幻想三国	2022-04-08	17	3	7	24	0.3972
Grey Eyes of Death	2022-04-21	15	3	7	22	0.3972
Hentai Tentacle Survivors	2022-12-10	4	3	7	11	0.3972
Best Friend	2022-09-15	5	3	7	12	0.3972
Foxventures	2022-12-21	2	3	7	9	0.3972
Code: XGamer Meta	2022-10-10	5	8	16	21	0.39659999999999995
Mythic Dungeons	2022-04-23	32	12	23	55	0.39630000000000004
FIshing Adventure VR	2022-01-07	4	4	9	13	0.3946
Long Road	2022-02-18	3	4	9	12	0.3946
Mass Harvest	2022-09-30	7	4	9	16	0.3946
Math Game	2022-01-28	2	4	9	11	0.3946
Sex Diary - Double Trouble Teacher	2022-02-22	4	4	9	13	0.3946
内卷三年竟穿越：皇帝模拟器	2022-04-19	5	4	9	14	0.3946
绝色女警	2022-08-26	6	4	9	15	0.3946
3D PUZZLE - Wood House	2022-03-04	6	13	25	31	0.3945
MVR	2022-02-13	6	9	18	24	0.3945
War and Empires	2022-01-25	39	10	20	59	0.3926
Monster master	2022-04-08	8	5	11	19	0.3924
Exotic	2022-01-10	4	5	11	15	0.3924
The Monster PIMP	2022-02-11	4	5	11	15	0.3924
Bloody Forest	2022-04-28	5	5	11	16	0.3924
OPPAI RENDER	2022-03-24	3	5	11	14	0.3924
Idle Sand Castle	2022-01-24	27	22	41	68	0.3923
HideTime	2022-12-21	16	23	43	59	0.3912
Become a Gladiator VR	2022-08-22	12	7	15	27	0.3889
Idle magic herb	2022-09-01	11	7	15	26	0.3889
HORDE	2022-09-27	11	8	17	28	0.3875
Real Feel	2022-05-05	18	14	28	46	0.3871
SUMMER VACATION	2022-03-24	95	35	66	161	0.3847
My Escort Company	2022-12-06	8	4	10	18	0.3805
Succubi's Trap Dungeon of Seduction	2022-05-13	11	4	10	21	0.3805
Chinese Train Trip	2022-03-31	4	4	10	14	0.3805
修仙者黎明	2022-08-31	13	4	10	23	0.3805
Cutie Tutti Frutti	2022-07-10	4	4	10	14	0.3805
Until Lights Out	2022-09-16	6	4	10	16	0.3805
Police Car Simulator	2022-12-29	5	4	10	15	0.3805
Protecting Santa	2022-05-13	1	3	8	9	0.3803
Tokyo Cop	2022-03-18	5	3	8	13	0.3803
Hero Ring	2022-03-23	3	3	8	11	0.3803
Ambitious	2022-07-15	7	3	8	15	0.3803
mrFOX	2022-07-02	2	3	8	10	0.3803
江湖群雄传	2022-08-04	10	3	8	18	0.3803
太荒初境	2022-04-15	36315	4979	8375	44690	0.3801
Missing Plane: Survival	2022-02-07	14	7	16	30	0.37950000000000006
Warfield	2022-08-06	2	2	6	8	0.379
Board Game Engine	2022-01-22	3	2	6	9	0.379
My Little Colony	2022-04-01	1	2	6	7	0.379
Inyoku Shoujo	2022-03-10	2	2	6	8	0.379
Air Museum VR	2022-03-22	2	2	6	8	0.379
Idle Business Tycoon - Build Simulator	2022-04-29	8	2	6	14	0.379
Broken System	2022-12-11	3	2	6	9	0.379
Rayna Survivors	2022-11-25	7	2	6	13	0.379
Asian caprice	2022-11-13	3	2	6	9	0.379
巨龙猎手	2022-12-17	175	9	20	195	0.3785
iblissorcery2	2022-11-28	9	12	26	35	0.3769
退休模拟器	2022-04-20	3404	1481	2569	5973	0.37670000000000003
Resident Evil Re:Verse	2022-10-21	2115	1333	2324	4439	0.376
NHRA Championship Drag Racing: Speed For All	2022-08-26	98	44	86	184	0.37570000000000003
Ironsmith Medieval Simulator	2022-03-09	221	73	139	360	0.3753
Quiet Town	2022-10-06	3	1	4	7	0.3749
Virtual Vacations	2022-01-24	2	1	4	6	0.3749
Knight Princess Eris	2022-07-16	5	1	4	9	0.3749
遊んで将棋が強くなる！銀星将棋DX2	2022-03-11	6	1	4	10	0.3749
Kill To Live	2022-01-21	2	1	4	6	0.3749
姚记捕鱼	2022-03-27	12	1	4	16	0.3749
The Final Hour	2022-03-18	2	1	4	6	0.3749
Quad Dice Defence	2022-04-13	3	1	4	7	0.3749
Amazing Girl	2022-02-24	2	1	4	6	0.3749
Memory Novel - The SPA	2022-03-05	2	1	4	6	0.3749
S E V E R A N C E	2022-04-16	2	1	4	6	0.3749
My Pet Vet	2022-12-15	3	1	4	7	0.3749
Anna bunny	2022-05-20	2	1	4	6	0.3749
Full of work	2022-05-10	4	1	4	8	0.3749
Royal Legends: Raised in Exile Collector's Edition	2022-05-19	7	1	4	11	0.3749
Military Attack	2022-09-10	2	1	4	6	0.3749
Take no Prisoners	2022-07-02	2	1	4	6	0.3749
Silver Nornir	2022-11-03	6	1	4	10	0.3749
Ultimate Soldier	2022-07-20	2	1	4	6	0.3749
机械兽：进化	2022-11-10	2	1	4	6	0.3749
PIP 3	2022-09-11	2	1	4	6	0.3749
Dear Diary	2022-11-04	2	1	4	6	0.3749
Sex Teacher	2022-11-18	3	1	4	7	0.3749
Curse of Black Bone	2022-09-01	56	19	40	96	0.3739
PAWN SHOP SIMULATOR	2022-07-23	11	10	23	34	0.3712
Many Buttons to Press	2022-01-06	6	8	19	25	0.371
地下城冒险记	2022-08-16	25	14	31	56	0.37079999999999996
Micetopia	2022-12-16	9	4	11	20	0.3679
County Hospital 2	2022-10-03	3	4	11	14	0.3679
守护者盟约	2022-01-21	16	4	11	27	0.3679
Zeppelin: Escape Room	2022-02-12	18	4	11	29	0.3679
BadTrip	2022-03-13	4	4	11	15	0.3679
Lustful Professor	2022-07-11	3	4	11	14	0.3679
PUPPETEERS	2022-11-02	26	13	30	56	0.36560000000000004
Revolution Diabolique	2022-02-24	21	3	9	30	0.3655
Little League World Series Baseball 2022	2022-08-17	9	3	9	18	0.3655
Spy Network	2022-05-20	4	3	9	13	0.3655
Momo's Eternal Adventure	2022-04-27	10	3	9	19	0.3655
NTR Dream	2022-04-20	8	3	9	17	0.3655
We are definitely the baddies	2022-05-19	4	3	9	13	0.3655
Resonance	2022-09-28	5	3	9	14	0.3655
Mega Fast Food: A Fast Food Simulator Game	2022-09-08	4	3	9	13	0.3655
Hidden Western	2022-02-23	3	10	24	27	0.36469999999999997
Doko Roko	2022-09-09	20	8	20	40	0.36350000000000005
YUME : Special Edition	2022-03-25	20	25	55	75	0.3624
Zombie Fooker: Starring Doug Fooker	2022-01-05	3	2	7	10	0.3611
Chico's Family-Friendly Circus	2022-03-26	2	2	7	9	0.3611
TerraNova: Escape Room	2022-04-20	4	2	7	11	0.3611
Star Trust - 3D Shooter Game	2022-09-04	1	2	7	8	0.3611
Heartbreak Hotel	2022-11-25	6	2	7	13	0.3611
Slave Of Lust	2022-10-04	2	2	7	9	0.3611
Final Boss	2022-10-24	2	2	7	9	0.3611
Spirit of Adventure	2022-02-07	2	0	2	4	0.3592
Toasted!	2022-03-18	4	0	2	6	0.3592
Quarry Simulator	2022-12-17	1	0	2	3	0.3592
Hillmain Hotel	2022-04-19	2	0	2	4	0.3592
Brushlings	2022-01-06	1	0	2	3	0.3592
Train Ride Simulator	2022-06-17	2	0	2	4	0.3592
Pop Bowling VR	2022-07-11	2	0	2	4	0.3592
Guillotine The Necromorph	2022-05-04	30	0	2	32	0.3592
Operation: VICUS	2022-01-17	2	0	2	4	0.3592
Galactic Dreams	2022-01-04	1	0	2	3	0.3592
BULLETHEAT	2022-02-20	2	0	2	4	0.3592
Harbor Tycoon	2022-03-05	3	0	2	5	0.3592
Go Run a Dungeon	2022-03-10	3	0	2	5	0.3592
The Forest Prison	2022-06-04	1	0	2	3	0.3592
KAIJU MONSTER VR	2022-10-25	2	0	2	4	0.3592
Quake Survivor	2022-03-25	3	0	2	5	0.3592
Seventh Angel	2022-09-20	2	0	2	4	0.3592
Cradle of Souls	2022-02-18	6	0	2	8	0.3592
Jagged Farm: Birth of a Hero	2022-01-25	1	0	2	3	0.3592
Wizard time!	2022-11-12	1	0	2	3	0.3592
25°N 71°W	2022-06-20	1	0	2	3	0.3592
Intimate Relationship	2022-02-22	2	0	2	4	0.3592
Ambushed	2022-02-06	2	0	2	4	0.3592
Solitaire Jack Frost Winter Adventures 3	2022-04-11	4	0	2	6	0.3592
C.O.D.E.R.E.D	2022-02-11	27	0	2	29	0.3592
西游战棋	2022-02-08	3	0	2	5	0.3592
A Siren's Call VR: Death Comes At Night	2022-04-20	2	0	2	4	0.3592
GO	2022-02-17	2	0	2	4	0.3592
TheDark	2022-06-30	4	0	2	6	0.3592
Survive	2022-02-17	23	0	2	25	0.3592
Garden Madness	2022-03-01	1	0	2	3	0.3592
Behind Border Zone	2022-02-23	2	0	2	4	0.3592
Z-Rush Survival	2022-03-08	1	0	2	3	0.3592
Battle 19XX	2022-03-16	2	0	2	4	0.3592
Wizard of Hunting Life	2022-06-11	2	0	2	4	0.3592
Voice from Beyond	2022-05-30	1	0	2	3	0.3592
I.D.F.K.	2022-11-09	3	0	2	5	0.3592
Outer Darkness	2022-10-26	3	0	2	5	0.3592
Midway:Sink the Japanese Aircraft Carriers	2022-04-20	1	0	2	3	0.3592
RogueStone	2022-05-11	2	0	2	4	0.3592
Rail Walkers	2022-05-18	3	0	2	5	0.3592
MAXIM	2022-10-18	1	0	2	3	0.3592
Change District	2022-05-27	8	0	2	10	0.3592
Mawthorne	2022-05-25	1	0	2	3	0.3592
King	2022-05-30	1	0	2	3	0.3592
Phone Seller Simulator	2022-07-04	1	0	2	3	0.3592
Game Of The Dead	2022-12-21	2	0	2	4	0.3592
Party Words	2022-12-07	15	0	2	17	0.3592
Category 1	2022-10-14	2	0	2	4	0.3592
العدم	2022-06-09	1	0	2	3	0.3592
Goddess Of War Essa Ⅱ	2022-08-25	3	0	2	5	0.3592
Ashzel & The Power Dagger	2022-06-10	1	0	2	3	0.3592
地城争霸	2022-10-12	4	0	2	6	0.3592
Blood Scheme	2022-09-23	1	0	2	3	0.3592
COLORIDER	2022-08-27	1	0	2	3	0.3592
Xeno Last Stand	2022-07-24	2	0	2	4	0.3592
POP TANK	2022-10-31	1	0	2	3	0.3592
Ferrule Instincts	2022-08-12	1	0	2	3	0.3592
The Ballad of Radolf	2022-07-08	1	0	2	3	0.3592
Cyber Sex	2022-07-01	2	0	2	4	0.3592
Invadead	2022-07-21	1	0	2	3	0.3592
PornBitch Hardcore: Hot Explicit Sex	2022-10-07	7	0	2	9	0.3592
混沌之地	2022-08-17	3	0	2	5	0.3592
Bloodwatch	2022-08-02	1	0	2	3	0.3592
Roghill Incident	2022-09-16	2	0	2	4	0.3592
Loot Box Waifus	2022-12-05	5	0	2	7	0.3592
FootPool	2022-09-26	2	0	2	4	0.3592
外道催眠術師と囚われのマリオネット - The Savage Hypnotist's Puppets -	2022-08-25	3	0	2	5	0.3592
Everett Isle	2022-09-01	3	0	2	5	0.3592
Maze Of Realities: Reflection Of Light Collector's Edition	2022-09-22	5	0	2	7	0.3592
Reptile Rehab	2022-09-09	2	0	2	4	0.3592
The Reaper Survivors	2022-11-15	2	0	2	4	0.3592
Planked: Survive & Thrive	2022-10-01	3	0	2	5	0.3592
The Wild: Survival Game	2022-09-01	2	0	2	4	0.3592
Goetita: Turn-based City	2022-08-31	1	0	2	3	0.3592
AQRA_Tenses[Learn English]	2022-09-27	12	0	2	14	0.3592
Crazy Click Thursday	2022-10-11	3	0	2	5	0.3592
VR Dragon Flight	2022-10-27	1	0	2	3	0.3592
Tech Invaders TD	2022-10-07	2	0	2	4	0.3592
Survive_The_Forest	2022-12-11	1	0	2	3	0.3592
Hero Jumper	2022-10-03	2	0	2	4	0.3592
Sacred Ember	2022-11-26	1	0	2	3	0.3592
DIVINITY	2022-11-18	1	0	2	3	0.3592
Island Defender Jets	2022-11-07	1	0	2	3	0.3592
Eureka	2022-10-21	2	0	2	4	0.3592
Santa's Gifts	2022-12-21	4	0	2	6	0.3592
Escape From This Planet	2022-11-11	3	0	2	5	0.3592
Creative Continents	2022-11-17	2	0	2	4	0.3592
Bad Santa	2022-12-13	1	0	2	3	0.3592
星辰封神	2022-12-01	4	0	2	6	0.3592
Sex Adventures - Kinky Bondage	2022-11-20	4	0	2	6	0.3592
Furry Tale	2022-12-15	2	0	2	4	0.3592
Roll Ball	2022-12-16	2	0	2	4	0.3592
Sky Goddess Remaking	2022-12-19	2	0	2	4	0.3592
推箱子	2022-12-28	2	0	2	4	0.3592
Girls Eliminate	2022-12-26	2	0	2	4	0.3592
Ferus- The dark abyss	2022-12-22	1	0	2	3	0.3592
Call of Senpai: Waifu Warfare 2	2022-05-24	5	9	23	28	0.3576
Asterix & Obelix XXXL : The Ram From Hibernia	2022-10-27	9	4	12	21	0.3565
AChat Next	2022-09-06	11	13	32	43	0.3556
SCP: Keter	2022-12-17	20	10	26	46	0.3527
剣と魔法と学園クエスト。	2022-09-07	89	10	26	115	0.3527
UFOBIA	2022-12-01	5	6	17	22	0.3527
Forest	2022-01-21	3	3	10	13	0.35240000000000005
Penguin Hunting	2022-05-13	2	3	10	12	0.35240000000000005
Animals	2022-06-13	3	3	10	13	0.35240000000000005
Witches Brew	2022-10-17	9	1	5	14	0.3522
Perseverance: Part 3	2022-08-11	3	1	5	8	0.3522
Enemy Engaged 2: Desert Operations	2022-04-18	2	1	5	7	0.3522
Warspace	2022-01-18	1	1	5	6	0.3522
万千网友共修仙	2022-10-29	5	1	5	10	0.3522
Hologram	2022-11-28	1	1	5	6	0.3522
Candy Match 3	2022-02-09	3	1	5	8	0.3522
Soulstrive	2022-03-10	1	1	5	6	0.3522
Romance In Space	2022-05-28	2	1	5	7	0.3522
Space Theory	2022-06-07	2	1	5	7	0.3522
Ghost Bus Simulator	2022-12-09	2	1	5	7	0.3522
Dear Nostalgia	2022-10-24	3	1	5	8	0.3522
Cowboys & Zombies VR	2022-11-22	1	1	5	6	0.3522
3D PUZZLE - Alchemist House	2022-04-15	2	14	35	37	0.3517
Castle Reborn	2022-06-01	2	5	15	17	0.35000000000000003
Idle Cyber Dungeon	2022-10-13	13	5	15	28	0.35000000000000003
Escape : Lia	2022-04-13	72	8	22	94	0.3497
幻想曹操传 Fantasy of Caocao	2022-01-14	262	47	107	369	0.3479
TRANSIT	2022-06-03	3	2	8	11	0.3458
Perceptio	2022-04-09	4	2	8	12	0.3458
Sporty Peppers	2022-04-16	8	2	8	16	0.3458
vision\memory\maze	2022-03-03	2	2	8	10	0.3458
DID YOU SCARED	2022-04-14	4	2	8	12	0.3458
Truck Simulator in City	2022-07-29	3	2	8	11	0.3458
Backrooms Mainframe	2022-12-23	8	2	8	16	0.3458
Merge Hero	2022-04-04	55	6	18	73	0.34490000000000004
Dead Survival	2022-02-19	6	5	16	22	0.34140000000000004
Pornocrates: Osiris's Seed	2022-03-26	7	3	11	18	0.3407
Click Lovers	2022-06-02	6	3	11	17	0.3407
Castle	2022-07-20	4	3	11	15	0.3407
Battle Life Online	2022-05-21	5	4	14	19	0.3367
混沌小队（CHAOS SQUAD）	2022-10-03	13	4	14	27	0.3367
Lucky Tlhalerwa - IMS Death Squad	2022-09-20	4	4	14	18	0.3367
Silence In The Cabin	2022-12-19	42	11	32	74	0.334
Rival Fury	2022-02-02	2	1	6	8	0.33380000000000004
The Thief	2022-04-02	1	1	6	7	0.33380000000000004
Beastmaster	2022-05-19	2	1	6	8	0.33380000000000004
Hacker Man	2022-06-04	2	1	6	8	0.33380000000000004
Memory Puzzle - Bad Girl	2022-04-09	2	1	6	8	0.33380000000000004
Courage	2022-07-08	2	1	6	8	0.33380000000000004
Zombie Land - Survival	2022-11-30	4	1	6	10	0.33380000000000004
Missing Persons	2022-08-18	2	2	9	11	0.33240000000000003
Airport Service Simulator	2022-06-21	4	2	9	13	0.33240000000000003
Summer Weekend	2022-07-15	2	2	9	11	0.33240000000000003
Life and Sex in Men's Сollege - Season 1 💕🔞	2022-12-22	14	12	35	49	0.33159999999999995
DEAD ZONE	2022-07-13	4	3	12	16	0.33020000000000005
Dark Blue Warriorr	2022-08-15	4	3	12	16	0.33020000000000005
Picture Builder	2022-08-24	2	0	3	5	0.32939999999999997
VR Black Hole Travel Hypothesis	2022-09-26	2	0	3	5	0.32939999999999997
For another day	2022-08-05	1	0	3	4	0.32939999999999997
The Dead Rooms	2022-06-07	1	0	3	4	0.32939999999999997
Hardcore Trivia	2022-06-14	2	0	3	5	0.32939999999999997
Battle Brigade	2022-02-23	2	0	3	5	0.32939999999999997
My Universe - Doctors and Nurses	2022-05-10	3	0	3	6	0.32939999999999997
RGBY	2022-05-04	4	0	3	7	0.32939999999999997
Forsaken	2022-04-29	1	0	3	4	0.32939999999999997
Eason	2022-03-28	2	0	3	5	0.32939999999999997
Mad Geometry	2022-11-23	1	0	3	4	0.32939999999999997
Last Sinner	2022-01-14	4	0	3	7	0.32939999999999997
Man of Sterling Quality	2022-03-08	1	0	3	4	0.32939999999999997
AURUM	2022-04-15	1	0	3	4	0.32939999999999997
Unwind	2022-02-23	2	0	3	5	0.32939999999999997
Construction Machines SIM: Bridges, buildings and constructor trucks simulator	2022-05-05	4	0	3	7	0.32939999999999997
Detectives United: Deadly Debt Collector's Edition	2022-02-11	6	0	3	9	0.32939999999999997
The Elevator Game	2022-04-06	2	0	3	5	0.32939999999999997
Hate's Offering	2022-04-06	2	0	3	5	0.32939999999999997
Emiko's Pledge 2	2022-04-29	1	0	3	4	0.32939999999999997
- Mischief Dungeon Life - 異世界転生した俺のイタズラダンジョンライフ	2022-05-26	2	0	3	5	0.32939999999999997
Space City - Build Your Empire	2022-05-04	2	0	3	5	0.32939999999999997
Last Day Zombie Survival VR	2022-05-05	1	0	3	4	0.32939999999999997
Cyberpoly	2022-11-04	2	0	3	5	0.32939999999999997
Infinity War Land	2022-10-13	2	0	3	5	0.32939999999999997
骸亡禁决	2022-08-11	2	0	3	5	0.32939999999999997
舞Hime:节奏连消	2022-10-26	1	0	3	4	0.32939999999999997
Battle of Tanks	2022-08-29	1	0	3	4	0.32939999999999997
Tommy Gun Carnage	2022-08-14	2	0	3	5	0.32939999999999997
Quick Pleasure	2022-07-25	2	0	3	5	0.32939999999999997
Zombie Hunter	2022-09-29	4	0	3	7	0.32939999999999997
双线交锋：收获日	2022-08-16	3	0	3	6	0.32939999999999997
中国式富豪	2022-09-09	1	0	3	4	0.32939999999999997
TITS OKAY TITS FINE: NEED MORE TITS CREAMPIE	2022-10-14	2	0	3	5	0.32939999999999997
Cruise Control Mode On!	2022-11-28	1	0	3	4	0.32939999999999997
Bowling	2022-10-06	2	0	3	5	0.32939999999999997
『俺』が『私』になるまで…　- Becoming a She -	2022-12-01	3	0	3	6	0.32939999999999997
Secret Battle	2022-11-11	2	0	3	5	0.32939999999999997
Aircraft Pushback Simulator	2022-12-30	1	0	3	4	0.32939999999999997
Haramase!semen transport project	2022-12-15	8	0	3	11	0.32939999999999997
Boat Builder: Andy's Story	2022-11-03	2	0	3	5	0.32939999999999997
Monsterlabshooter	2022-12-07	1	0	3	4	0.32939999999999997
Ariel’s Daily Grind	2022-12-17	151	12	36	187	0.3275
Firing Vibes	2022-01-05	44	5	18	62	0.326
Forest Spring	2022-10-03	51	5	18	69	0.326
兜仙	2022-12-14	319	74	185	504	0.3259
Slime Factory	2022-03-23	4	2	10	14	0.3207
NEVERLAND	2022-09-15	4	2	10	14	0.3207
女子监狱	2022-11-25	6	2	10	16	0.3207
Succubus Dating	2022-06-15	5	4	16	21	0.32
Island Assault	2022-03-24	2	1	7	9	0.3185
Breaker's World	2022-10-05	3	1	7	10	0.3185
Grimland	2022-05-27	14	1	7	21	0.3185
The Peak Climb VR	2022-09-23	4	1	7	11	0.3185
Find The Key	2022-11-11	3	1	7	10	0.3185
Last Tour 終末旅行	2022-10-26	9	5	20	29	0.3125
Click and Slay	2022-03-18	10	7	26	36	0.31170000000000003
Zombies Midnight	2022-07-02	3	2	11	14	0.3103
Naked Maya Tattoo Girls From Outer Space	2022-01-10	2	0	4	6	0.308
Requiem	2022-02-09	1	0	4	5	0.308
Hell Dungeons - The Lost Souls	2022-12-09	1	0	4	5	0.308
Fleshgait	2022-02-03	3	0	4	7	0.308
Autos	2022-09-06	2	0	4	6	0.308
Hentai Jigsaw Puzzle Collection: Autumn	2022-01-21	1	0	4	5	0.308
Drag Battle Top Fuel	2022-02-17	2	0	4	6	0.308
Trapped in the Forest	2022-02-11	3	0	4	7	0.308
Red Hero Adventure	2022-02-16	1	0	4	5	0.308
Obsessive Revenge	2022-04-09	2	0	4	6	0.308
Dungeon Dueler	2022-05-18	2	0	4	6	0.308
Fantasylandia World	2022-03-11	2	0	4	6	0.308
Hard landing	2022-08-30	3	0	4	7	0.308
Shake Ground	2022-06-01	4	0	4	8	0.308
Edge Of The End	2022-08-27	1	0	4	5	0.308
Bubble Shooter	2022-08-17	2	0	4	6	0.308
Survival Shot VR	2022-12-23	2	0	4	6	0.308
Turret Girl	2022-12-22	1	0	4	5	0.308
武儒绘卷 - 天地奇缘	2022-09-07	5	1	8	13	0.3056
Dungeons and Myths	2022-11-15	6	1	8	14	0.3056
Armed Zone	2022-06-15	209	63	184	393	0.30160000000000003
SUPER RUNNER VR	2022-02-15	3	1	9	12	0.2943
Jigoku Unko: Toripuru	2022-08-06	2	1	9	11	0.2943
The Office	2022-06-09	5	2	13	18	0.2925
Expresso Espresso	2022-04-29	2	0	5	7	0.2916
Wandering Meatbags	2022-02-25	3	0	5	8	0.2916
Jumping Horses Champions	2022-05-12	3	0	5	8	0.2916
地下城割草	2022-05-18	2	0	5	7	0.2916
Vikindor	2022-09-24	2	0	5	7	0.2916
Our Home	2022-07-02	3	0	5	8	0.2916
Finding Felicia	2022-07-21	3	0	5	8	0.2916
Cyber Tetris	2022-09-01	5	0	5	10	0.2916
black idea	2022-12-05	2	0	5	7	0.2916
Cyber Bodies	2022-12-01	98	17	64	162	0.28690000000000004
Abermore	2022-03-29	26	8	35	61	0.2865
Morbid	2022-10-07	4	1	10	14	0.2845
Beauty from Wisdom	2022-12-14	7	1	10	17	0.2845
Yacht Mechanic Simulator	2022-07-28	175	30	109	284	0.28
ROUGH LOVE	2022-08-14	2	0	6	8	0.2783
GUILT	2022-09-06	2	0	6	8	0.2783
Mars Rover Simulator	2022-02-22	5	1	11	16	0.2758
Mirror 2: Project X	2022-01-21	45657	30296	86798	132455	0.2659
The Rumble Fish 2	2022-12-07	61	4	26	87	0.2637
Prison	2022-09-05	3	1	13	16	0.2611
Mirror Chains	2022-07-28	5	2	18	23	0.26
Godless grove	2022-05-26	2	0	8	10	0.2581
A Match with a Succubus Witch	2022-06-23	2	0	8	10	0.2581
Day on Mars	2022-01-11	9	1	14	23	0.2547
东方红雾缘起Begin Of Scarlet Family	2022-11-18	5	4	29	34	0.2522
校长模拟器-高中篇	2022-07-10	149	11	60	209	0.2502
hopeless.	2022-12-02	8	0	9	17	0.25
Malice	2022-11-03	1533	178	692	2225	0.24309999999999998
Hot Mom	2022-09-20	8	1	17	25	0.23870000000000002
Magic Сity Detective: Secret Desire Collector's Edition	2022-08-09	3	0	11	14	0.2366
Arachnophobia	2022-04-26	4	0	16	20	0.21309999999999998
SuperPower 3	2022-10-07	1343	112	980	2323	0.1509
Totally Accurate Battle Simulator	2021-04-01	13674	102071	2191	15865	0.9642000000000001
Dyson Sphere Program	2021-01-21	59815	68221	1546	61361	0.9612
Firework	2021-02-04	3746	31090	621	4367	0.9592
Rhythm Doctor	2021-02-26	2892	16901	267	3159	0.9587000000000001
The Room 4: Old Sins	2021-02-11	1199	11628	144	1343	0.9587000000000001
The Chronicles Of Myrtana: Archolos	2021-12-10	9328	11773	168	9496	0.9571
Inscryption	2021-10-19	17072	85630	2576	19648	0.9555
Tiny Bunny	2021-04-16	1820	10537	183	2003	0.9534
Cookie Clicker	2021-09-01	67867	41564	1185	69052	0.9531999999999999
Project Kat - Paper Lily Prologue	2021-10-15	238	3612	26	264	0.9511000000000001
文字遊戲：第零章	2021-01-14	412	4357	46	458	0.9504000000000001
TOEM	2021-09-17	402	3414	25	427	0.9503
100 hidden frogs	2021-11-15	58	4551	57	115	0.9492
Webbed	2021-09-09	1151	9575	214	1365	0.9481
海沙风云 Far Away	2021-08-17	1053	4805	69	1122	0.9481
Before Your Eyes	2021-04-08	510	9772	224	734	0.9477
Clone Drone in the Danger Zone	2021-07-27	1944	21237	653	2597	0.9470000000000001
SuchArt: Creative Space	2021-01-21	879	6061	123	1002	0.9454000000000001
Aventura Copilului Albastru și Urât	2021-02-08	187	2286	17	204	0.9447
东方夜雀食堂 - Touhou Mystia's Izakaya	2021-10-01	1898	13536	402	2300	0.9445
MADNESS: Project Nexus	2021-09-29	4919	11292	317	5236	0.9444
Milk outside a bag of milk outside a bag of milk	2021-12-16	291	10227	279	570	0.9443000000000001
第七号列车 - Train No. 7	2021-08-14	263	5400	109	372	0.9443000000000001
Psychonauts 2	2021-08-24	7262	8659	223	7485	0.9440999999999999
Doki Doki Literature Club Plus!	2021-06-30	8662	18628	623	9285	0.9436
Resident Evil Village	2021-05-07	106631	87131	3863	110494	0.9428000000000001
Purrgatory	2021-08-23	108	2538	29	137	0.9427
星空列车与白的旅行	2021-05-14	300	2081	17	317	0.9427
It Takes Two	2021-03-26	32685	117519	5429	38114	0.9425
Portal Reloaded	2021-04-19	5194	16313	555	5749	0.9422
The Last Campfire	2021-10-07	402	5060	114	516	0.9415000000000001
Cruelty Squad	2021-06-16	360	9895	306	666	0.9408
Valheim	2021-02-02	502387	379510	20253	522640	0.9401
Snake Force	2021-11-19	291	4309	96	387	0.9400000000000001
Alpaca Stacka	2021-07-29	111	4711	111	222	0.9399
Mon Bazou	2021-12-16	1979	7375	216	2195	0.9395
Find Love or Die Trying	2021-09-16	545	8347	258	803	0.9393000000000001
Townscaper	2021-08-26	1165	17645	685	1850	0.9385
OPUS: Echo of Starsong - Full Bloom Edition	2021-09-01	567	6442	191	758	0.9379000000000001
The Planet Crafter: Prologue	2021-12-19	1352	8492	287	1639	0.9369
BAD END THEATER	2021-10-26	159	4746	129	288	0.9368000000000001
Milo and the Magpies	2021-09-07	82	2092	32	114	0.9366
东方冰之勇者记：序章	2021-12-17	983	2729	55	1038	0.9361
Mini Motorways	2021-07-20	9914	15143	612	10526	0.9359999999999999
UNBEATABLE [white label]	2021-05-07	528	6905	228	756	0.9357
Walkabout Mini Golf	2021-07-15	274	2138	36	310	0.9356
The Rewinder	2021-09-10	1304	5141	154	1458	0.9353
死寂（DeathlyStillness）	2021-09-04	1182	16299	684	1866	0.9352
枝江往事	2021-06-11	1142	4839	146	1288	0.9344
Car Mechanic Simulator 2021	2021-08-11	22561	18002	791	23352	0.9342
Paint the Town Red	2021-07-29	1423	21060	961	2384	0.9339000000000001
Scarlet Hollow	2021-06-11	520	1173	10	530	0.9331
The Forgotten City	2021-07-28	603	7034	256	859	0.9329000000000001
pureya	2021-03-26	409	1954	37	446	0.9325
Impostor Factory	2021-09-30	1754	8528	335	2089	0.9322
Muck	2021-06-05	16715	134497	7915	24630	0.9319
Chicory: A Colorful Tale	2021-06-10	353	2231	49	402	0.9318000000000001
Sword and Fairy	2021-04-15	1729	2773	71	1800	0.9317000000000001
HROT	2021-01-29	258	2669	69	327	0.9309999999999999
OpenTTD	2021-04-01	3254	8850	366	3620	0.9308
LoveChoice 拣爱	2021-11-15	10241	19135	935	11176	0.9304000000000001
Dagon	2021-09-24	755	8791	367	1122	0.9304000000000001
葬花·暗黑桃花源	2021-10-21	897	4264	142	1039	0.9304000000000001
ROUNDS	2021-04-01	2269	16314	782	3051	0.9301
Bang-On Balls: Chronicles	2021-03-03	277	2295	60	337	0.9287000000000001
SUPER CHICKEN JUMPER	2021-09-24	171	2778	82	253	0.9284
Everhood	2021-03-04	819	9645	442	1261	0.9277
東方虹龍洞 ～ Unconnected Marketeers.	2021-05-03	3416	1607	34	3450	0.9277
Voidigo	2021-02-25	110	1820	43	153	0.9275
Marvel's Guardians of the Galaxy	2021-10-26	10989	24510	1331	12320	0.9274
Swallow the Sea	2021-09-03	156	1720	39	195	0.9274
Samorost 1	2021-05-20	186	3202	106	292	0.9272
I MAED A GAM3 W1TH Z0MB1ES 1NIT!!!1	2021-11-11	41	1268	22	63	0.927
Incredibox	2021-04-30	129	2137	58	187	0.9269
ENDER LILIES	2021-06-21	6332	22580	1230	7562	0.9268000000000001
WorldBox - God Simulator	2021-12-02	11034	21465	1170	12204	0.9264
Little Nightmares II	2021-02-10	7103	25065	1406	8509	0.9259999999999999
Gunfire Reborn	2021-11-18	35263	79671	5115	40378	0.9252
Wildermyth	2021-06-15	8106	14002	736	8842	0.925
Mitoza	2021-03-05	126	2486	80	206	0.9247
Jerma's Big Adventure	2021-08-27	42	998	16	58	0.924
My Singing Monsters	2021-03-24	3939	26498	1584	5523	0.9233
Bunny eShop	2021-11-12	1935	8954	460	2395	0.9224
Sizeable	2021-03-19	97	813	11	108	0.9222
Griftlands	2021-06-01	7693	11947	657	8350	0.9218000000000001
Geometry Arena	2021-06-01	673	2111	70	743	0.9217000000000001
Knights College	2021-01-15	599	1634	47	646	0.9216
Behind the Frame: The Finest Scenery	2021-08-25	180	3960	170	350	0.9214
Super Animal Royale	2021-08-26	7648	33341	2129	9777	0.9212
英雄黄昏	2021-09-29	772	1678	50	822	0.9211
Timberborn	2021-09-15	12354	16524	976	13330	0.9208
Tetris® Effect: Connected	2021-08-18	1259	4842	227	1486	0.9203
OnlyCans: Thirst Date	2021-02-12	156	2531	97	253	0.9198000000000001
Dogs Organized Neatly	2021-11-01	119	750	11	130	0.9197
Duck Simulator 2	2021-11-22	180	1873	63	243	0.9196
Perfect Gold	2021-04-19	56	821	14	70	0.9195000000000001
Kinkoi	2021-06-11	506	1254	33	539	0.9194
Cyber Manhunt	2021-02-03	2807	11350	658	3465	0.9189
美少女万华镜 -理与迷宫的少女-	2021-06-20	810	2384	95	905	0.9178000000000001
Mosaique Neko Waifus 4	2021-02-12	715	4224	204	919	0.9177
SNKRX	2021-05-17	1766	3775	177	1943	0.9176000000000001
Letters From a Rainy Day -Oceans and Lace-	2021-06-30	165	670	10	175	0.9172
坏小孩	2021-07-15	162	1239	36	198	0.917
Tree Simulator 2022	2021-04-16	150	1135	31	181	0.9169
Toree 2	2021-09-30	45	665	10	55	0.9169
Turnip Boy Commits Tax Evasion	2021-04-22	341	7961	453	794	0.9168000000000001
Bitburner	2021-12-10	5935	4627	235	6170	0.9166
亿万恋人 Billionaire Lovers	2021-07-03	1352	2977	134	1486	0.9163
Death Trash	2021-08-05	1008	2827	126	1134	0.9161
The Legend of Tianding	2021-11-02	600	2307	97	697	0.9155
Labyrinth City: Pierre the Maze Detective	2021-06-22	566	1705	63	629	0.9155
Zeepkist	2021-01-28	241	909	22	263	0.9155
THE IDOLM@STER STARLIT SEASON 	2021-10-13	6138	3696	182	6320	0.9154000000000001
Heavenly Bodies	2021-12-07	391	1963	78	469	0.9152
Quickie: A Love Hotel Story	2021-12-17	252	1167	35	287	0.9152
Loop Hero	2021-03-04	51156	28739	2019	53175	0.915
9-nine-:Episode 4	2021-03-19	111	671	12	123	0.9148000000000001
The Great Ace Attorney Chronicles	2021-07-27	2523	4589	243	2766	0.9147
Northern Journey	2021-08-18	55	1094	32	87	0.9147
Library Of Ruina	2021-08-10	8015	17808	1215	9230	0.9137000000000001
DRAMAtical Murder	2021-04-07	343	1792	72	415	0.9136
Cleo - a pirate's tale	2021-12-12	59	479	5	64	0.9136
Karryn's Prison	2021-12-15	1052	2245	99	1151	0.9135
Death's Door	2021-07-20	3740	12287	802	4542	0.9134000000000001
NOeSIS-羽化	2021-11-08	82	396	2	84	0.9134000000000001
The Darkside Detective: A Fumble in the Dark	2021-04-15	216	1115	35	251	0.9133
Skul: The Hero Slayer	2021-01-20	18970	39007	2906	21876	0.9131999999999999
The Chrono Jotter	2021-08-26	124	1335	48	172	0.9126000000000001
Days Gone	2021-05-18	27450	53975	4187	31637	0.9123000000000001
ElecHead	2021-10-14	79	622	12	91	0.9120999999999999
Crab Game	2021-10-29	56106	134362	11167	67273	0.9115000000000001
Brutal Orchestra	2021-12-17	176	736	18	194	0.9114
Escape Simulator	2021-10-19	6616	10154	675	7291	0.9109999999999999
Toree 3D	2021-04-09	17	1067	36	53	0.9107
The Advisor - Episode 1: Royal Pain	2021-05-31	10	507	8	18	0.9106000000000001
Motor Town: Behind The Wheel	2021-12-17	610	2484	125	735	0.9098
If On A Winter's Night, Four Travelers	2021-09-21	129	1445	59	188	0.9098
I'm on Observation Duty 4	2021-12-22	134	519	9	143	0.9098
Parquet	2021-08-27	924	1702	75	999	0.9097
FINAL FANTASY	2021-07-28	3079	4379	258	3337	0.9094
Rain on Your Parade	2021-04-15	99	594	13	112	0.9091
Redmatch 2	2021-06-25	807	7902	525	1332	0.9089
Cloud Gardens	2021-09-01	286	1793	83	369	0.9086
The Adventure of NAYU	2021-01-19	69	1214	48	117	0.9081
Dead Estate	2021-10-19	519	2986	165	684	0.908
Saiko no sutoka	2021-03-19	140	2315	119	259	0.908
Bright Memory: Infinite	2021-11-12	22076	31629	2528	24604	0.9076000000000001
Ragnarock	2021-07-15	123	2384	126	249	0.9072
In Sound Mind	2021-09-28	228	2341	124	352	0.9069
I Expect You To Die 2	2021-08-24	396	914	32	428	0.9069
Moncage	2021-11-16	1965	4045	248	2213	0.9066
Cats in Time	2021-08-26	108	724	22	130	0.9063
Huntdown	2021-05-12	337	2341	126	463	0.9062000000000001
Touhou Endless Dream	2021-11-01	145	1654	80	225	0.9058
秘密舞会	2021-03-01	115	526	12	127	0.9058
Severed Steel	2021-09-17	330	2531	142	472	0.9053
Critters for Sale	2021-06-03	58	744	24	82	0.9053
Blood Spear	2021-08-13	143	1561	75	218	0.9052
Flowers Blooming at the End of Summer	2021-02-26	111	1267	57	168	0.9045000000000001
Kaze and the Wild Masks	2021-03-26	135	961	38	173	0.9042
Sprocket	2021-08-26	1936	6265	439	2375	0.9039
Bubble People	2021-10-13	275	4241	277	552	0.9039
Mass Effect™ Legendary Edition	2021-05-14	59817	32285	2744	62561	0.9036
A YEAR OF SPRINGS	2021-09-29	14	419	8	22	0.9036
Ready or Not	2021-12-17	19621	93231	8524	28145	0.9033
Mondealy: Day One	2021-09-13	41	604	18	59	0.9032
Football Manager 2022	2021-11-09	88767	18825	1536	90303	0.9031
Landlord of the Woods	2021-03-17	19	392	7	26	0.903
Record of Lodoss War-Deedlit in Wonder Labyrinth-	2021-03-27	848	5097	351	1199	0.9029
Purrfect Apawcalypse: Love at Furst Bite	2021-02-16	22	369	6	28	0.9028
Slender Threads: Prologue	2021-09-15	56	368	6	62	0.9027
DEVOUR	2021-01-28	7969	55002	4922	12891	0.9026000000000001
Luna's Fishing Garden	2021-06-16	172	1415	70	242	0.9026000000000001
Sunshine Heavy Industries	2021-08-17	24	276	2	26	0.9023000000000001
Unpacking	2021-11-02	2512	17999	1482	3994	0.9022
Ann	2021-08-26	182	1877	104	286	0.902
Armoured Commander II	2021-09-04	35	382	7	42	0.902
巴哈姆特2-龍之新娘(Bahamut2-dragon's bride)	2021-09-30	232	382	7	239	0.902
Priest Simulator: Heavy Duty	2021-10-18	104	669	23	127	0.9016
TaleSpire	2021-04-15	1416	3122	200	1616	0.9015000000000001
OMFG: One Million Fatal Guns	2021-03-11	231	1929	109	340	0.9015000000000001
Teacup	2021-09-23	20	435	10	30	0.9014
Buddy Simulator 1984	2021-02-18	368	3070	197	565	0.9012000000000001
Turing Complete	2021-10-02	303	1324	67	370	0.9007
Enderal: Forgotten Stories (Special Edition)	2021-04-02	2428	4719	336	2764	0.9003
东方华彩乱战2 ~ Touhou Blooming Chaos 2	2021-06-24	530	2182	131	661	0.9003
风信楼	2021-10-14	2212	3033	198	2410	0.9002
Save Me, Sakuya-san!	2021-06-02	63	531	16	79	0.9002
Black Book	2021-08-10	1817	4261	299	2116	0.9
Mad Games Tycoon 2	2021-01-21	2182	3876	268	2450	0.8998999999999999
Yakuza 6: The Song of Life	2021-03-25	1635	3979	280	1915	0.8992
Annalynn	2021-01-29	37	335	6	43	0.8991
做个好梦	2021-05-24	72	2788	183	255	0.8989
Peace, Death! 2	2021-10-07	327	629	23	350	0.8987
Subnautica: Below Zero	2021-05-14	42115	69274	6663	48778	0.8983
Rec Room	2021-09-02	7154	45836	4308	11462	0.8982
Jerma & Otto: The Curse of the Late Streamer	2021-10-08	39	402	10	49	0.8981
Soul Fantasy	2021-12-31	347	402	10	357	0.8981
Wrestling Empire	2021-07-02	261	1285	69	330	0.8978
Grey Instinct - Part 1	2021-07-21	62	615	23	85	0.8976000000000001
Tormented Souls	2021-08-27	744	3792	273	1017	0.8974
NERTS! Online	2021-01-05	369	1249	67	436	0.8974
Ys IX: Monstrum Nox	2021-07-06	1365	1248	67	1432	0.8974
IRMÃO Grande & Brasileiro 2	2021-10-15	128	448	13	141	0.8974
Furry Shades of Gay 2: A Shade Gayer	2021-12-09	105	689	28	133	0.8973000000000001
Momotype	2021-12-03	30	497	16	46	0.8972
MECHANICA: A Ballad of the Rabbit and Mercury	2021-09-17	138	609	23	161	0.8971
Boomerang X	2021-07-08	191	760	33	224	0.897
Ancient Dungeon VR	2021-11-03	108	746	32	140	0.897
GUILTY GEAR -STRIVE-	2021-06-11	31156	34227	3210	34366	0.8969
Wytchwood	2021-12-09	345	1886	117	462	0.8968
Re: LieF ~ Shin'ainaru Anata e~	2021-02-26	167	601	23	190	0.8964
The Legend of Heroes: Trails of Cold Steel IV	2021-04-09	2758	1655	100	2858	0.8963
Blade of Darkness	2021-10-07	590	1522	90	680	0.8961
Melvor Idle	2021-11-18	11867	7891	652	12519	0.8959
Pronty	2021-11-19	124	595	23	147	0.8959
ScooterFlow	2021-11-29	365	1240	69	434	0.8956999999999999
Perfect Heist 2	2021-12-10	847	1663	102	949	0.8956000000000001
Super Mombo Quest	2021-11-04	29	324	7	36	0.8954000000000001
Sixtar Gate: STARTRAIL	2021-11-06	257	933	47	304	0.8952
Obama Boss Fight	2021-11-24	26	474	16	42	0.895
Nuclear Blaze	2021-10-18	74	489	17	91	0.8948999999999999
Shadow Tactics: Blades of the Shogun - Aiko's Choice	2021-12-06	1676	3158	230	1906	0.8947
FINAL FANTASY III	2021-07-28	1806	1398	83	1889	0.8947
Siralim Ultimate	2021-12-03	761	1391	83	844	0.8944
 Marfusha	2021-08-26	1076	1785	115	1191	0.8942
CUCKOLD SIMULATOR: Life as a Beta Male Cuck	2021-05-01	70	1498	92	162	0.8941
Love Sucks: Night One	2021-04-09	144	720	33	177	0.8941
GolfTopia	2021-03-30	77	417	13	90	0.8941
PICO PARK	2021-05-07	16802	17417	1610	18412	0.8940000000000001
Coloring Game 4	2021-07-30	624	1506	93	717	0.8939
Bear's Restaurant	2021-10-06	24	364	10	34	0.8937999999999999
Shadow Man Remastered	2021-04-15	402	947	50	452	0.8936000000000001
NKO DICE	2021-05-29	1132	396	12	1144	0.8936000000000001
Tavern Master	2021-11-16	2713	5176	419	3132	0.8935
Fights in Tight Spaces	2021-12-02	1469	2064	140	1609	0.8935
Haven Park	2021-08-05	98	566	23	121	0.8934000000000001
Fossil Corner	2021-06-12	40	212	2	42	0.8932
Steven Universe: Unleash the Light	2021-02-19	117	502	19	136	0.8931
Emily is Away <3	2021-04-16	882	4246	336	1218	0.8929
100 hidden cats	2021-04-15	1026	1289	78	1104	0.8926000000000001
Pro Soccer Online	2021-11-15	4703	9669	862	5565	0.8924
Road 96	2021-08-16	2289	11874	1084	3373	0.8923000000000001
Cooking Companions	2021-10-07	82	793	40	122	0.8923000000000001
Airtight City 1.0	2021-07-08	19	367	11	30	0.8921
The Riftbreaker	2021-10-14	21741	12289	1130	22871	0.892
DYSMANTLE	2021-11-16	3614	7661	669	4283	0.892
Antonball Deluxe	2021-03-05	62	299	7	69	0.892
Mundaun	2021-03-16	82	786	40	122	0.8918
Persona 5 Strikers	2021-02-23	8730	10738	983	9713	0.8913
軒轅劍參外傳 天之痕	2021-08-19	1600	1469	95	1695	0.8913
A Random Maze 某个迷宫	2021-03-11	55	361	11	66	0.8913
Hypnagogia: Boundless Dreams	2021-10-29	16	310	8	24	0.8911
子夜之章:历史的终局～MidNights of Desperado～	2021-03-12	23	257	5	28	0.8911
Eronoctosis: Put Yourself Together	2021-10-11	243	1204	74	317	0.8908
UNSIGHTED	2021-09-30	238	1106	66	304	0.8908
UnMetal	2021-09-28	433	1703	116	549	0.8906999999999999
Rogue Glitch	2021-03-10	258	1092	65	323	0.8906999999999999
Frame of Mind	2021-01-18	38	730	37	75	0.8906000000000001
Koi Farm	2021-02-26	62	634	30	92	0.8905
The Tenants - Free Trial	2021-03-09	1729	1961	139	1868	0.8904000000000001
The Journey - Episode 1: Whatever This Is	2021-04-19	11	270	6	17	0.8903
My Child Lebensborn	2021-06-01	239	1241	78	317	0.8902
Sumire	2021-05-26	30	400	14	44	0.8902
Shadows of Forbidden Gods	2021-11-01	423	366	12	435	0.8898999999999999
Ambrosia	2021-01-30	904	1667	115	1019	0.8897
Chill Corner	2021-12-17	866	6789	605	1471	0.8896
Farming Simulator 22	2021-11-22	105636	41047	4278	109914	0.8895000000000001
Lacuna	2021-05-20	218	1404	93	311	0.8894
Evo\Wave	2021-03-12	67	438	17	84	0.8894
Vectorio Classic	2021-03-22	158	1220	78	236	0.8891
Ynglet	2021-06-05	32	280	7	39	0.8891
Medieval Dynasty	2021-09-23	18738	27127	2770	21508	0.8890000000000001
Ark Mobius:Censored Edition	2021-10-14	229	839	47	276	0.8890000000000001
Super Auto Pets	2021-09-24	10760	22924	2318	13078	0.8889
Yakuza 4 Remastered	2021-01-28	913	3044	243	1156	0.8889
My Catgirl Maid Thinks She Runs the Place	2021-04-14	179	747	40	219	0.8889
Drova - Teaser	2021-05-10	19	147	0	19	0.8889
College Kings - The Complete Season	2021-03-05	2116	7827	717	2833	0.8887999999999999
Sucker for Love: Prelude	2021-12-15	29	342	11	40	0.8887
HuniePop 2: Double Date	2021-02-08	15388	7946	731	16119	0.8886000000000001
Bacon May Die	2021-04-15	107	676	35	142	0.8884000000000001
The Ramp	2021-08-03	110	989	60	170	0.8883
Hog Hunter 2021	2021-05-07	31	876	51	82	0.8881
Terminus: Zombie Survivors	2021-03-01	117	411	16	133	0.8879000000000001
qomp	2021-02-04	28	334	11	39	0.8876000000000001
ヤマふだ！　にごうめ	2021-09-24	24	141	0	24	0.8875000000000001
晚上nano好	2021-07-30	72	286	8	80	0.8874
Chasing Tails -A Promise in the Snow-	2021-08-14	120	751	42	162	0.8871
Adios	2021-03-17	42	966	60	102	0.8868
Lost Words: Beyond the Page	2021-04-06	43	473	21	64	0.8868
FIGHT KNIGHT	2021-11-30	300	832	49	349	0.8867
Martial Law	2021-12-23	119	2640	213	332	0.8865999999999999
Samurai Gunn 2	2021-07-20	98	512	24	122	0.8865999999999999
Minecraft Dungeons	2021-09-22	2939	6666	619	3558	0.8865000000000001
Purrfect Apawcalypse: Patches' Infurno	2021-05-13	13	157	1	14	0.8863
Monster Girl's Labyrinth	2021-11-09	7	262	7	14	0.8861
inbento	2021-07-30	58	338	12	70	0.8859
Rail Route	2021-06-23	461	998	64	525	0.8858
Dinner with an Owl	2021-05-18	132	570	29	161	0.8858
Toodee and Topdee	2021-08-04	104	505	24	128	0.8858
圣歌德嘉的晚钟	2021-12-04	260	985	63	323	0.8856999999999999
The Vale	2021-08-19	31	243	6	37	0.8856
Vermillion	2021-07-27	54	475	22	76	0.8855
Cell to Singularity - Evolution Never Ends	2021-11-03	7340	15198	1554	8894	0.8854000000000001
TAISHO x ALICE epilogue	2021-06-24	78	289	9	87	0.8853
The Life and Suffering of Sir Brante	2021-03-04	1819	4680	423	2242	0.8852
Slipways	2021-06-03	1012	1644	123	1135	0.8851000000000001
Catlateral Damage: Remeowstered	2021-09-15	32	152	1	33	0.8851000000000001
The Big Con	2021-08-31	45	388	16	61	0.8849
Corpse Party (2021)	2021-10-20	126	586	31	157	0.8848
Sam & Max: Beyond Time and Space	2021-12-08	162	222	5	167	0.8847
Orakyubu	2021-08-15	36	205	4	40	0.8847
Tainted Grail	2021-05-27	3294	5756	539	3833	0.8845999999999999
Old School RuneScape	2021-02-24	6151	11963	1212	7363	0.8845000000000001
Cloud Climber	2021-01-14	546	3470	303	849	0.8845000000000001
You Can Kana	2021-08-11	22	149	1	23	0.8844
Arcadia Fallen	2021-11-17	57	203	4	61	0.8843000000000001
Wartales	2021-12-01	8834	9419	937	9771	0.8842
Slay the Dragon!	2021-02-05	32	312	11	43	0.8842
Infinitode 2	2021-05-06	2215	2255	184	2399	0.8840000000000001
Open Hexagon	2021-11-02	34	340	13	47	0.8840000000000001
Hellish Quart	2021-02-16	755	4750	438	1193	0.8839
Boss of this gym	2021-03-05	13	590	32	45	0.8839
Evil God Korone	2021-11-08	116	434	20	136	0.8837
WitchSpring3 Re:Fine - The Story of Eirudy -	2021-11-02	256	672	39	295	0.8835
Purrfect Apawcalypse: Purrgatory Furever	2021-04-01	14	145	1	15	0.8834000000000001
DUSK '82	2021-10-22	60	231	6	66	0.8833
天命奇御二 Fate Seeker II	2021-11-22	15417	11140	1146	16563	0.8828
The Artful Escape	2021-09-09	72	1110	78	150	0.8828
Strangeland	2021-05-25	115	602	34	149	0.8826
Astalon: Tears of the Earth	2021-06-03	252	636	37	289	0.8824
Paradise Lust	2021-04-19	120	272	9	129	0.8823000000000001
FALL IN LABYRINTH	2021-04-17	473	668	40	513	0.882
100 hidden rams	2021-08-20	5	176	3	8	0.882
The Wild at Heart	2021-05-20	79	367	16	95	0.8818000000000001
湛藍牢籠Rail of Möbius	2021-08-31	42	367	16	58	0.8818000000000001
Tavern Master - Prologue	2021-06-24	281	1069	76	357	0.8815999999999999
Omno	2021-07-29	261	1431	111	372	0.8811
30XX	2021-02-17	768	1083	78	846	0.8811
Gladio and Glory	2021-03-16	272	2970	268	540	0.8806
铁道少女：梦想轨迹	2021-04-28	25	153	2	27	0.8806
未来战士	2021-12-16	3	115	0	3	0.8805
中医模拟器	2021-07-29	58	202	5	63	0.8804000000000001
Henchman Story	2021-10-14	57	185	4	61	0.8802
Press Any Button	2021-01-07	398	2143	184	582	0.8801000000000001
Super Raft Boat Classic	2021-02-22	84	784	52	136	0.8801000000000001
SPOOKWARE	2021-08-26	52	507	28	80	0.8801000000000001
Bright Lights of Svetlov	2021-09-14	49	837	57	106	0.8799
The Black Heart	2021-10-21	41	230	7	48	0.8799
Yugo Puzzle	2021-10-14	200	184	4	204	0.8799
Miss Neko 2	2021-12-17	818	1886	159	977	0.8797
Tales of Arise	2021-09-09	60274	25898	2951	63225	0.8795999999999999
PULSAR: Lost Colony	2021-06-22	1205	4488	437	1642	0.8795000000000001
Happy's Humble Burger Farm	2021-12-03	308	1026	75	383	0.8795000000000001
Cyberfrags '69	2021-12-11	16	112	0	16	0.8795000000000001
Sakura Hime	2021-10-15	162	1109	83	245	0.8794
Who Needs a Hero?	2021-01-21	137	1057	78	215	0.8794
Cabin Fever	2021-07-12	70	337	15	85	0.8792
FOREWARNED	2021-09-10	2173	3943	379	2552	0.8791
Factory Town	2021-11-17	2648	3497	331	2979	0.8790000000000001
Element TD 2	2021-04-02	1490	2092	182	1672	0.8790000000000001
Cemetery Mary	2021-12-30	27	211	6	33	0.8790000000000001
Jupiter Hell	2021-08-05	666	1348	107	773	0.8789
Mission in Snowdriftland	2021-12-01	55	240	8	63	0.8789
Meridian 157: Chapter 3	2021-07-29	32	195	5	37	0.8788
Ziggurat 2	2021-10-28	436	1046	78	514	0.8787
Chihiro Himukai Always Walks Away	2021-07-28	12	146	2	14	0.8786
Utawarerumono: Prelude to the Fallen	2021-01-22	344	861	61	405	0.8783
Buffet Knight	2021-12-09	11	145	2	13	0.8783
Looking for Aliens	2021-12-08	18	127	1	19	0.8782
Life is Strange: True Colors	2021-09-09	8001	10410	1129	9130	0.8781
Going Medieval	2021-06-01	14676	12742	1416	16092	0.8775000000000001
Come Home	2021-10-15	778	1920	169	947	0.8771
Sacred Fire	2021-10-18	83	337	16	99	0.877
Night Reverie	2021-10-08	27	217	7	34	0.8769
Forza Horizon 4	2021-03-09	40399	156299	19960	60359	0.8765999999999999
Distant Memoraĵo	2021-07-15	31	122	1	32	0.8765999999999999
ALTDEUS: Beyond Chronos	2021-02-19	43	283	12	55	0.8765000000000001
Apopia: Prologue	2021-08-07	35	186	5	40	0.8765000000000001
Tanks: The Crusades	2021-06-24	62	522	32	94	0.8762000000000001
Crimzon Clover World EXplosion	2021-12-07	42	185	5	47	0.8762000000000001
EXS1～EthnologySister：Cultural functionalism	2021-08-19	28	199	6	34	0.8761
Tiny Lands	2021-01-22	132	695	48	180	0.8759
Ruka	2021-10-15	41	240	9	50	0.8758
Sweet Shine	2021-08-26	86	366	19	105	0.8756
Rift Wizard	2021-09-01	339	765	55	394	0.8755
DEEEER Simulator: Your Average Everyday Deer Game	2021-11-23	251	2697	259	510	0.8752
Demeo	2021-05-06	336	1274	106	442	0.8752
Animal Shelter: Prologue	2021-11-03	1038	1580	138	1176	0.8751000000000001
Bunhouse	2021-10-19	137	386	21	158	0.875
Sewer Rave	2021-12-10	6	134	2	8	0.8749
//TODO: today	2021-04-10	45	335	17	62	0.8745
Guilty Parade	2021-01-06	90	207	7	97	0.8745
Clawfish	2021-06-12	33	285	13	46	0.8743000000000001
Dungeon Deathball	2021-10-13	43	178	5	48	0.8743000000000001
Midnight Scenes: The Nanny	2021-10-27	11	132	2	13	0.8743000000000001
Kathy Rain: Director's Cut	2021-10-26	85	436	26	111	0.8738
Castlevania Advance Collection	2021-09-24	701	1143	95	796	0.8737
Bonfire Peaks	2021-09-30	57	190	6	63	0.8737
Cozy Grove	2021-04-08	873	5556	599	1472	0.8736
Boyfriend Dungeon	2021-08-11	1087	1680	152	1239	0.8736
Fears to Fathom - Episode 1	2021-07-02	126	3143	316	442	0.8734999999999999
Crow Story	2021-12-25	31	243	10	41	0.8734999999999999
Rogue Fable III	2021-12-22	173	564	38	211	0.8733
Super Raft Boat VR	2021-08-04	16	129	2	18	0.8733
纸嫁衣	2021-12-03	471	1448	128	599	0.8731
Biphase	2021-03-30	34	215	8	42	0.8731
Mr. Hopp's Playhouse 2	2021-06-14	177	464	29	206	0.873
Xuan-Yuan Sword: Dance of the Maple Leaves	2021-02-08	74	201	7	81	0.873
Exo One	2021-11-18	747	3198	325	1072	0.8729000000000001
Svoboda 1945: Liberation	2021-08-03	29	127	2	31	0.8726
Atelier Ryza 2: Lost Legends & the Secret Fairy	2021-01-26	4005	2515	248	4253	0.8725
Eye of the Temple	2021-10-14	40	312	16	56	0.8724
Blind Drive	2021-03-10	23	199	7	30	0.8724
Skald: Against the Black Priory - the Prologue	2021-06-01	22	157	4	26	0.8724
Zardy's Maze	2021-01-22	101	1142	97	198	0.8723000000000001
A Juggler's Tale	2021-09-29	50	492	32	82	0.8723000000000001
Castle in the Clouds	2021-10-09	473	700	52	525	0.8722
Minit Fun Racer	2021-02-18	36	198	7	43	0.8722
Papetura	2021-05-07	84	799	62	146	0.872
100 hidden cats 2	2021-07-17	2009	532	36	2045	0.8719
西游记2021	2021-10-01	23	343	19	42	0.8715999999999999
World End Diner	2021-06-19	88	296	15	103	0.8715999999999999
Frog Fighters	2021-05-30	19	539	37	56	0.8715
The Little Red Lie	2021-04-06	160	432	27	187	0.8715
100 hidden snails 2	2021-02-26	1984	319	17	2001	0.8715
Pro Wrestling Sim	2021-03-29	67	247	11	78	0.8715
Intravenous	2021-07-26	283	1480	135	418	0.8714000000000001
Dodgeball Academia	2021-08-05	168	341	19	187	0.8713
Koikari	2021-10-22	238	208	8	246	0.8713
The Shadow of Yidhra	2021-04-16	154	1013	85	239	0.8712000000000001
云端之约	2021-01-12	65	441	28	93	0.8712000000000001
UDONGEIN X	2021-12-03	24	233	10	34	0.8711
Summer of '58	2021-07-21	162	2900	298	460	0.871
Vampire: The Masquerade — Parliament of Knives	2021-10-28	215	207	8	223	0.871
Dwarf Journey	2021-03-05	25	269	13	38	0.8709
Maneater	2021-05-25	2861	9588	1125	3986	0.8708
100 hidden birds 2	2021-10-08	8	193	7	15	0.8708
Buissons	2021-02-03	49	106	1	50	0.8708
Slice of Sea	2021-11-11	127	372	22	149	0.8706999999999999
Trap Genesis	2021-09-17	86	256	12	98	0.8706999999999999
Tails of Iron	2021-09-17	1549	5245	583	2132	0.8706
GET OUT!	2021-03-03	45	371	22	67	0.8706
SnowRunner	2021-05-17	7897	18959	2349	10246	0.8704000000000001
Tres-Bashers	2021-10-01	15	121	2	17	0.8704000000000001
Cat Slide Tiles	2021-06-06	18	105	1	19	0.8704000000000001
Suspicious Downpour	2021-06-22	11	380	23	34	0.8702
RoboLife-Days with Aino	2021-06-23	543	1110	97	640	0.8701000000000001
Raptor Boyfriend	2021-07-15	14	87	0	14	0.8701000000000001
Dungeon and Puzzles	2021-01-14	20	104	1	21	0.87
Sugar * Style	2021-04-30	184	190	7	191	0.8699
Ruined King: A League of Legends Story™	2021-11-16	16297	8452	993	17290	0.8698
The Questionably Quirky Quiz Show - Episode 1	2021-10-04	4	119	2	6	0.8695999999999999
Rubber Bandits: Summer Prologue	2021-05-28	2696	2489	255	2951	0.8695
100 hidden dogs	2021-10-14	10	274	14	24	0.8694
Contraband Police: Prologue	2021-02-16	813	4931	553	1366	0.8693000000000001
Inglorious Waifu VS Nazi Zombies	2021-03-10	11	308	17	28	0.8693000000000001
Yakuza 5 Remastered	2021-01-28	852	3133	333	1185	0.8692000000000001
Coffee flavor of love	2021-02-01	16	174	6	22	0.8691
Legends of Idleon MMO	2021-04-02	7846	9554	1144	8990	0.8690000000000001
Ravager	2021-09-03	253	318	18	271	0.8690000000000001
The Savior From Above	2021-12-06	28	284	15	43	0.8690000000000001
FIND ALL	2021-06-03	16	317	18	34	0.8688
Suit for Hire	2021-08-31	26	236	11	37	0.8688
세 장의 카드	2021-03-04	14	294	16	30	0.8687
RetroArch	2021-09-14	793	4034	446	1239	0.8686
Bot Wars	2021-09-10	220	537	39	259	0.8684999999999999
No Straight Roads: Encore Edition	2021-10-21	186	818	68	254	0.8684000000000001
Forza Horizon 5	2021-11-09	81096	99284	13612	94708	0.868
NEKOPARA - Catboys Paradise	2021-07-15	1235	4207	471	1706	0.8679000000000001
Nioh 2 – The Complete Edition	2021-02-05	41325	31567	4134	45459	0.8678
From the darkness	2021-03-30	51	1815	181	232	0.8678
Dragon Fist: VR Kung Fu	2021-12-15	23	267	14	37	0.8678
封神外传	2021-11-03	26	195	8	34	0.8677
Secret Agent HD	2021-06-30	25	114	2	27	0.8676
排球入门指南	2021-09-16	39	98	1	40	0.8674
Warhammer 40,000: Battlesector	2021-07-22	2598	3226	353	2951	0.8672
GuLady 蛊婆	2021-07-21	66	373	24	90	0.867
Kaigrad	2021-05-26	20	263	14	34	0.8669
Berry	2021-12-09	9	80	0	9	0.8668000000000001
Uncrashed : FPV Drone Simulator	2021-09-01	149	937	83	232	0.8666
My waifu guild	2021-10-05	27	215	10	37	0.8665
SOLAS 128	2021-01-25	22	153	5	27	0.8665
戦場のフーガ	2021-07-29	415	666	54	469	0.8664000000000001
Chess Evolved Online	2021-02-22	141	531	40	181	0.8664000000000001
Loading Story	2021-09-11	29	261	14	43	0.8664000000000001
Cards & Tankards	2021-04-20	44	511	38	82	0.8663
Vivid Knight	2021-05-26	1749	1347	130	1879	0.8662000000000001
White Hell	2021-08-12	27	152	5	32	0.8662000000000001
Rolled Out!	2021-03-23	210	368	24	234	0.8661
The Ghost Cage	2021-10-11	49	151	5	54	0.8658
Cinderella Phenomenon: Evermore	2021-01-13	109	150	5	114	0.8654999999999999
MAMIYA	2021-04-30	15	93	1	16	0.8651000000000001
Kraken Academy!!	2021-09-10	106	471	35	141	0.8648
Attack on Toys	2021-09-25	107	422	30	137	0.8648
Kasi	2021-01-07	16	148	5	21	0.8647
Sailwind	2021-10-18	369	869	78	447	0.8645999999999999
Geneforge 1 - Mutagen	2021-02-24	382	308	19	401	0.8645999999999999
SLUDGE LIFE	2021-06-02	2712	1726	179	2891	0.8642000000000001
Happy Game	2021-10-28	363	1618	166	529	0.8642000000000001
Altered	2021-03-12	11	75	0	11	0.8642000000000001
F.I.S.T.: Forged In Shadow Torch	2021-10-03	5133	4687	556	5689	0.8641
Lifeslide	2021-08-06	33	295	18	51	0.8641
方块地牢	2021-11-04	93	295	18	111	0.8641
Lost Ruins	2021-05-13	1146	3410	391	1537	0.8639
Here Comes Niko!	2021-08-03	415	772	68	483	0.8639
Astronarch	2021-01-22	279	681	58	337	0.8638
WTF is wrong with you?	2021-06-14	8	304	19	27	0.8638
Garden Story	2021-08-11	351	698	60	411	0.8637
Clea 2	2021-03-25	33	90	1	34	0.8637
SUPERゆきおんなちゃん	2021-07-06	9	90	1	10	0.8637
九州：商旅（Nine Provinces: Caravan）	2021-02-26	628	953	89	717	0.8634000000000001
The Pathless	2021-11-16	117	811	73	190	0.8633
Lab Rags	2021-05-16	155	342	23	178	0.8631000000000001
Chair Simulator	2021-05-14	273	4198	498	771	0.863
NieR Replicant ver.1.22474487139...	2021-04-24	28684	18081	2419	31103	0.8628
Stolen Realm	2021-10-14	1506	1468	151	1657	0.8628
The Doors of Trithius	2021-08-16	142	130	4	146	0.8628
Fallow	2021-08-25	15	103	2	17	0.8628
Bloodwash	2021-09-16	103	823	75	178	0.8627
OPPAI Academy Big, Bouncy, Booby Babes!	2021-05-13	124	438	33	157	0.8626
Hourglass	2021-10-22	84	224	12	96	0.8626
Behind Glass: Aquarium Simulator	2021-08-25	20	167	7	27	0.8626
Curious Expedition 2	2021-01-28	3043	2700	307	3350	0.8622
Hitler Hates Anime	2021-08-19	15	473	37	52	0.8621
Star Drift Evolution	2021-08-27	47	200	10	57	0.8621
Mecha Knights: Nightmare	2021-08-30	433	833	77	510	0.8620000000000001
Hidden Lands	2021-01-28	51	253	15	66	0.8616
TRAIN CREW	2021-09-30	98	127	4	102	0.8615
Solasta: Crown of the Magister	2021-05-27	8291	13850	1848	10139	0.8614
Let's Build a Zoo	2021-11-05	1645	2101	233	1878	0.8614
Stumble Guys	2021-10-07	43705	66866	9643	53348	0.8613
Goose Goose Duck	2021-10-03	702845	39264	5549	708394	0.8612000000000001
Demon Slayer -Kimetsu no Yaiba- The Hinokami Chronicles	2021-10-15	7995	13518	1804	9799	0.8612000000000001
Lost in Random™	2021-09-10	508	2088	232	740	0.8612000000000001
Dreamscaper	2021-08-05	1129	2249	253	1382	0.8611
Survivor Dieland	2021-03-01	9	208	11	20	0.8611
Hoa	2021-08-24	492	1760	191	683	0.861
Gas Station Simulator: Prologue - Early Days	2021-04-28	459	3247	385	844	0.8606
My Garage	2021-08-10	213	989	97	310	0.8606
City Zoomer	2021-11-13	10	125	4	14	0.8606
The Medium	2021-01-28	2765	6360	808	3573	0.8605
NIMBY Rails	2021-01-26	834	1235	127	961	0.8604
Arthurian Legends	2021-10-04	44	338	24	68	0.8602
GashiShachiNoSachi	2021-05-04	26	124	4	30	0.8602
Alisa	2021-10-22	105	641	57	162	0.8601000000000001
When The Night Comes	2021-08-09	69	215	12	81	0.8599
Space Gladiators	2021-03-10	68	287	19	87	0.8598
Sumotori Dreams Classic	2021-05-03	15	135	5	20	0.8595999999999999
hexceed	2021-01-15	779	1731	191	970	0.8595
Thrive	2021-11-26	145	601	53	198	0.8595
Yu Crossing Animals	2021-12-01	80	485	40	120	0.8595
荣耀斗罗	2021-11-19	13	203	11	24	0.8595
Adorable Witch	2021-06-17	238	1349	143	381	0.8593999999999999
Doggone Hungry	2021-08-02	39	255	16	55	0.8593999999999999
Bean and Nothingness	2021-12-01	13	82	1	14	0.8593999999999999
Olija	2021-01-28	71	529	45	116	0.8593000000000001
Dadish	2021-02-22	6	146	6	12	0.8592000000000001
Room to Grow	2021-02-25	25	134	5	30	0.8592000000000001
Prison Simulator: Prologue	2021-05-20	1016	2519	295	1311	0.8590000000000001
Last Days	2021-10-03	11	157	7	18	0.8590000000000001
KeyWe	2021-08-31	336	870	85	421	0.8589
Glyph	2021-08-09	17	121	4	21	0.8589
Through The Fragmentation	2021-05-13	5	121	4	9	0.8589
Cross Maid	2021-08-21	17	179	9	26	0.8588
Sayonara Golden Days	2021-05-20	8	81	1	9	0.8588
The Mystery of Caketropolis	2021-06-18	9	81	1	10	0.8588
Urtuk: The Desolation	2021-02-27	949	1810	203	1152	0.8587
Hmmsim Metro	2021-06-25	169	949	95	264	0.8586
Slow living with Princess	2021-10-07	199	424	34	233	0.8584999999999999
Silicon Dreams	2021-04-20	21	178	9	30	0.8584999999999999
RagingBlasters	2021-01-22	15	94	2	17	0.8583
Romeow: in the cracked world	2021-03-04	4	94	2	6	0.8583
月球巫妖/Lunar Lich	2021-09-28	67	94	2	69	0.8583
Vomitoreum	2021-07-30	78	661	61	139	0.8582
The Jewel of Monostructure	2021-11-17	6	80	1	7	0.8582
Super Robot Wars 30	2021-10-27	17005	4310	543	17548	0.858
Feign	2021-10-23	2700	2237	262	2962	0.8577
Snowdrop Escape	2021-01-20	142	1652	185	327	0.8577
Bard Harder!	2021-02-28	4	79	1	5	0.8576
Dad's Monster House	2021-09-23	35	130	5	40	0.8575
Island Farmer	2021-04-30	40	306	22	62	0.8573000000000001
Roll	2021-05-13	223	296	21	244	0.8572
Logic World	2021-10-22	144	237	15	159	0.8572
Operation Tango	2021-06-01	972	4658	597	1569	0.8571
Dwerve: Prologue	2021-09-03	165	557	50	215	0.8570000000000001
Endgame: Road To Salvation	2021-04-16	72	78	1	73	0.8570000000000001
Deepest Sword	2021-06-09	345	6958	927	1272	0.8568000000000001
Machinika Museum	2021-03-23	58	572	52	110	0.8567
F.I.S.H.	2021-03-25	57	194	11	68	0.8566
Filcher	2021-09-14	14	116	4	18	0.8565
Chessplosion	2021-09-21	29	116	4	33	0.8565
TAISHO x ALICE episode 3	2021-03-04	48	214	13	61	0.8564
Lemon Cake	2021-02-18	218	1203	130	348	0.8563
Les aventures de Fierot	2021-10-04	5	139	6	11	0.8563
Zool Redimensioned	2021-08-18	20	103	3	23	0.8562000000000001
Unlock The Cat	2021-03-02	6	90	2	8	0.8561
Slobbish Dragon Princess 2	2021-12-17	28	90	2	30	0.8561
GP Bikes	2021-12-18	60	213	13	73	0.856
Hadean Tactics	2021-02-25	121	463	40	161	0.8559000000000001
Mail Mole	2021-03-03	23	160	8	31	0.8558
Matchsticks - Coffee Break Club	2021-07-30	9	76	1	10	0.8558
Forest Star	2021-12-09	12	76	1	13	0.8558
ECHOLOCAUTION	2021-03-24	11	61	0	11	0.8556999999999999
7 Years From Now	2021-06-17	7	61	0	7	0.8556999999999999
Fishards	2021-11-03	24	102	3	27	0.8556
Fireboy & Watergirl: Fairy Tales	2021-11-01	38	102	3	41	0.8556
Welcome to Free Will	2021-09-22	389	1020	108	497	0.8555
Kubinashi Recollection	2021-12-08	46	114	4	50	0.8555
Dark Water : Slime Invader	2021-03-18	29	148	7	36	0.8554
HighFleet	2021-07-27	1709	4423	575	2284	0.8553000000000001
白花 the white flower	2021-12-23	12	190	11	23	0.8552
湖心亭奇談集	2021-12-31	18	147	7	25	0.855
秘封フラグメント	2021-07-16	39	113	4	43	0.855
Bunny's Flowers	2021-03-15	12	60	0	12	0.8549
King Boo	2021-10-18	11	60	0	11	0.8549
Drift Phonk 666	2021-04-16	47	238	16	63	0.8545999999999999
Creatures Docking Station	2021-12-07	30	112	4	34	0.8545
SaGa Frontier Remastered	2021-04-15	2590	446	39	2629	0.8544
Inspector Waffles	2021-03-23	30	198	12	42	0.8544
Maskmaker	2021-04-20	24	198	12	36	0.8544
Cat Gets Medieval	2021-03-02	12	87	2	14	0.8543000000000001
Sex and the Furry Titty	2021-06-03	68	744	75	143	0.8542000000000001
Doll Explorer Prologue	2021-01-23	41	207	13	54	0.8541
Rainbow Billy: The Curse of the Leviathan	2021-10-05	33	134	6	39	0.8541
Space Slurpies	2021-04-08	8	73	1	9	0.8539
The Last Stand Legacy Collection	2021-07-15	214	1254	141	355	0.8538
Tadpole Tales	2021-03-12	184	708	71	255	0.8538
Vengeful Rites	2021-07-29	13	235	16	29	0.8537
Railway Islands - Puzzle	2021-11-18	50	144	7	57	0.8537
幻想乡妖怪塔防 ~ Touhou Monster TD	2021-10-01	435	658	65	500	0.8536
100 hidden mice	2021-01-27	5	224	15	20	0.8533
Ark Mobius	2021-10-14	62	224	15	77	0.8533
Archvale	2021-12-02	654	1508	176	830	0.8532
Not Another Weekend	2021-05-20	9	72	1	10	0.8532
Dodge It!	2021-08-28	175	782	81	256	0.8531000000000001
Button City	2021-08-10	29	109	4	33	0.8529000000000001
START AGAIN: a prologue	2021-08-18	7	109	4	11	0.8529000000000001
Rule No. 1	2021-07-08	12	232	16	28	0.8528
FINAL FANTASY IV	2021-09-08	3432	1425	166	3598	0.8527
The Jackbox Party Pack 8	2021-10-14	4723	996	109	4832	0.8527
Duck Creator	2021-11-03	7	183	11	18	0.8527
Escape FishStop 3D	2021-03-06	10	57	0	10	0.8527
Crazy Flasher Series 2021	2021-02-25	916	2185	271	1187	0.8525
Cosmodread	2021-03-25	45	323	26	71	0.8525
Atelier Sophie: The Alchemist of the Mysterious Book DX	2021-04-22	530	519	49	579	0.8523999999999999
魂之归宿	2021-01-06	280	460	42	322	0.8523000000000001
Amelie	2021-12-15	8	182	11	19	0.8523000000000001
GunBlocks: Prologue	2021-01-02	20	96	3	23	0.8523000000000001
Fetish Locator Week Two	2021-10-25	1020	1374	160	1180	0.8522
Journey To The Savage Planet	2021-01-28	2162	4121	551	2713	0.8520000000000001
Overboard!	2021-06-02	93	347	29	122	0.8520000000000001
Devil Inside Us: Roots of Evil	2021-10-28	6	56	0	6	0.8520000000000001
Below The Ocean	2021-12-11	4	56	0	4	0.8520000000000001
SCP: Containment Breach Multiplayer	2021-10-25	3275	14327	2105	5380	0.8519
大家的幻想乡·S	2021-12-31	200	181	11	211	0.8519
Mirror Layers	2021-10-30	19	83	2	21	0.8518000000000001
Nina Aquila: Legal Eagle, Season One	2021-07-09	10	70	1	11	0.8518000000000001
军团战棋 Legion War	2021-07-14	226	699	72	298	0.8517
Tennis Elbow 4	2021-06-04	96	265	20	116	0.8515
What The Dub?!	2021-04-08	76	228	16	92	0.8515
Sheep Love	2021-01-30	20	336	28	48	0.8514
东方栖霞园 ~ Blue devil in the Belvedere.	2021-05-21	335	309	25	360	0.8513
Yogurt Commercial 3	2021-05-03	9	55	0	9	0.8512000000000001
Flewfie's Adventure	2021-09-23	11	55	0	11	0.8512000000000001
Cosmo's Quickstop	2021-08-18	28	69	1	29	0.8511
The Bart Bonte collection	2021-05-03	37	69	1	38	0.8511
Idol Manager	2021-07-27	2930	2836	369	3299	0.851
Cute Cats	2021-08-09	53	226	16	69	0.8509000000000001
Age of Empires IV: Anniversary Edition	2021-10-28	73928	42589	6650	80578	0.8508
Ultimate Racing 2D 2	2021-10-12	48	148	8	56	0.8508
The Dark Pictures Anthology: House of Ashes	2021-10-21	4578	5272	731	5309	0.8506999999999999
Rewrite+	2021-12-17	107	225	16	123	0.8505
Epic Fantasy Battle Simulator	2021-08-30	67	279	22	89	0.8504
100 hidden mushrooms	2021-03-23	5	261	20	25	0.8504
Sigma Impact	2021-08-11	12	68	1	13	0.8504
Anopek	2021-07-30	4	54	0	4	0.8504
Space Warlord Organ Trading Simulator	2021-12-07	151	424	39	190	0.8503000000000001
Rocket Assault	2021-02-19	92	196	13	105	0.8503000000000001
月球坠落时 Moon Fall	2021-01-16	101	664	69	170	0.8502
The Captain	2021-12-03	126	224	16	142	0.8502
Wolfstride	2021-12-07	149	521	51	200	0.8501000000000001
Larry The Unlucky Part 1	2021-08-09	32	136	7	39	0.85
Crystal Call	2021-01-06	17	146	8	25	0.8499
Gravity Snake	2021-04-26	9	92	3	12	0.8499
吉原彼岸花	2021-05-07	97	250	19	116	0.8498000000000001
Succubus Cafe	2021-05-13	352	1877	236	588	0.8495999999999999
OneShot: Fading Memory	2021-08-25	70	213	15	85	0.8495999999999999
Dap: Prologue	2021-07-16	14	103	4	18	0.8495999999999999
Primitier	2021-12-02	17	103	4	21	0.8495999999999999
Hair of the Dog	2021-03-24	8	67	1	9	0.8495999999999999
No Plan B	2021-12-01	110	258	20	130	0.8495
Curse That Magic Cat!	2021-01-06	52	249	19	71	0.8495
Farlanders: Prologue	2021-05-18	191	240	18	209	0.8495
Runo	2021-07-05	138	336	29	167	0.8494
Pandemic Love	2021-04-27	24	203	14	38	0.8494
The Dream Libra had	2021-05-26	21	145	8	29	0.8494
MOTHERED - A ROLE-PLAYING HORROR GAME	2021-12-24	10	145	8	18	0.8494
Dread X Collection: The Hunt	2021-04-13	164	310	26	190	0.8493
Garlic	2021-06-16	45	284	23	68	0.8493
Alekon	2021-06-12	14	91	3	17	0.8492000000000001
Eggcelerate!	2021-03-30	18	91	3	21	0.8492000000000001
Space Otter Charlie	2021-03-18	21	66	1	22	0.8489
Fate of Kai	2021-03-19	12	173	11	23	0.8488
Sunblaze	2021-06-03	72	273	22	94	0.8487
Super Grappling Gecko	2021-12-16	4	52	0	4	0.8487
Dogworld	2021-03-18	17	90	3	20	0.8486
Lady in Mystery	2021-05-15	35	112	5	40	0.8484999999999999
The Zodiac Trial	2021-01-21	14	101	4	18	0.8484
Rune Factory 4 Special	2021-12-07	1274	1174	140	1414	0.8482
Summoner's Mess	2021-10-29	14	77	2	16	0.8478
Gas Station Simulator	2021-09-15	12229	15303	2347	14576	0.8477
That Flipping Mountain	2021-11-17	72	121	6	78	0.8477
Dominion	2021-10-07	466	766	85	551	0.8476
Legend Bowl	2021-09-02	100	653	70	170	0.8476
Heart Fragment	2021-07-30	28	160	10	38	0.8473
The Penguin IQ Test	2021-01-05	4	64	1	5	0.8473
归路：见证	2021-05-30	8	64	1	9	0.8473
Vedelem: The Golden Horde	2021-06-22	195	627	67	262	0.8472
Pawnbarian	2021-09-24	139	566	59	198	0.8472
Exodus Borealis	2021-11-18	64	206	15	79	0.8472
Transiruby	2021-12-09	69	169	11	80	0.8471
Everybody Wham Wham	2021-01-29	8	130	7	15	0.8470000000000001
satryn deluxe	2021-10-14	6	76	2	8	0.8470000000000001
Secret Pie	2021-11-19	262	1594	202	464	0.8469
Lost: Find	2021-12-03	1853	1702	218	2071	0.8468000000000001
Steel Salvo	2021-04-07	13	109	5	18	0.8468000000000001
Viscerafest	2021-05-20	146	422	41	187	0.8466
The GoD Unit	2021-02-12	7	63	1	8	0.8465
pear potion🍐	2021-02-26	5	63	1	6	0.8465
Sentimental Trickster: Yaoi BL Gay Visual Novel	2021-03-23	31	63	1	32	0.8465
Good Knight	2021-09-17	19	86	3	22	0.846
Klang 2	2021-10-20	16	49	0	16	0.846
Growing Up	2021-10-14	1587	1938	255	1842	0.8459000000000001
MILFs of Sunville	2021-11-04	737	947	112	849	0.8458
Knight Squad 2	2021-04-14	125	166	11	136	0.8458
Castle on the Coast	2021-12-02	5	62	1	6	0.8456999999999999
City Game Studio	2021-08-24	258	902	106	364	0.8456
Frincess&Cnight	2021-09-11	17	107	5	22	0.8456
Fi da Puti Samurai	2021-03-29	20	107	5	25	0.8456
World of Tanks	2021-04-29	6128	53272	8784	14912	0.8455
Marsupilami: Hoobadventure	2021-11-16	27	127	7	34	0.8455
Hell Let Loose	2021-07-27	18280	81416	13622	31902	0.8453
BUSTAFELLOWS	2021-07-30	115	368	35	150	0.8453
A long Time	2021-04-30	12	253	21	33	0.8453
Star Apprentice: Magical Murder Mystery	2021-07-09	16	146	9	25	0.8453
1f y0u're a gh0st ca11 me here!	2021-11-01	9	85	3	12	0.8453
Rubber Bandits	2021-12-02	3599	3085	431	4030	0.8451000000000001
The Gardener and the Wild Vines	2021-09-09	10	48	0	10	0.8451000000000001
Hop Step Sing! VR Live 《Hop★Summer Tour 2020》	2021-04-02	10	48	0	10	0.8451000000000001
CHR$(143)	2021-08-04	8	48	0	8	0.8451000000000001
攻城天下	2021-11-17	211	209	16	227	0.845
Detective From The Crypt	2021-06-17	17	106	5	22	0.845
Terra Firma	2021-06-27	28	226	18	46	0.8449
Draft of Darkness	2021-07-30	39	116	6	45	0.8449
BACK OF SPACE	2021-08-25	15	61	1	16	0.8449
Puzzlecar	2021-02-27	6	61	1	7	0.8449
Arrow Sudoku	2021-05-21	61	61	1	62	0.8449
NAIR	2021-09-15	18	73	2	20	0.8448000000000001
Gloomhaven	2021-10-20	6983	10673	1651	8634	0.8445999999999999
MELTY BLOOD: TYPE LUMINA	2021-09-30	13182	6134	914	14096	0.8445999999999999
LOVE 3	2021-12-06	13	84	3	16	0.8445999999999999
恐惧之间 Fear surrounds	2021-10-20	7373	8718	1332	8705	0.8445
Lycanthorn II - Rain of Beasts	2021-02-24	10	190	14	24	0.8445
Dandy Ace	2021-03-25	464	875	104	568	0.8442000000000001
Myst	2021-08-26	481	909	109	590	0.8441
Monster Bash HD	2021-10-29	13	47	0	13	0.8441
The Two of Us	2021-12-18	255	3826	552	807	0.8440000000000001
International Space Banana	2021-03-31	18	72	2	20	0.8440000000000001
The Blind Of The New World	2021-05-28	14	72	2	16	0.8440000000000001
Space Docker VR	2021-12-15	11	72	2	13	0.8440000000000001
Cute Dogs	2021-12-15	5	124	7	12	0.8439
IllusionCircle	2021-12-15	12	104	5	17	0.8438
Tiny Room Stories: Town Mystery	2021-02-26	98	469	49	147	0.8437000000000001
The Cyclist: Tactics	2021-07-29	55	71	2	57	0.8432
PSYCRON	2021-08-20	15	82	3	18	0.8431000000000001
Kimagure Temptation	2021-11-19	16	82	3	19	0.8431000000000001
Island Diary	2021-07-03	13	59	1	14	0.8431000000000001
Roll The Cat	2021-11-17	6	59	1	7	0.8431000000000001
Gigapocalypse	2021-11-12	34	122	7	41	0.8428
Warplanes: WW1 Fighters	2021-03-04	52	341	33	85	0.8426
IRON GUARD VR	2021-09-01	18	81	3	21	0.8423999999999999
Forgotten Hill: First Steps	2021-06-10	35	81	3	38	0.8423999999999999
Super Glitter Rush	2021-07-01	9	70	2	11	0.8423999999999999
The Durka: You will (not) die	2021-09-06	24	371	37	61	0.8423
Terraformers: First steps on Mars	2021-10-23	243	521	57	300	0.8422000000000001
그랑 엠파이어	2021-01-10	21	158	11	32	0.8422000000000001
FWsim - Fireworks Display Simulator	2021-02-16	20	58	1	21	0.8422000000000001
Berzerk Flashback	2021-02-09	30	58	1	31	0.8422000000000001
SJ-19 Learns To Love	2021-04-23	3	45	0	3	0.8421
Fuzz Dungeon	2021-06-08	5	45	0	5	0.8421
Pavlov's House	2021-02-26	21	45	0	21	0.8421
GrandMa Badass	2021-05-05	6	45	0	6	0.8421
Trick & Treat Remake	2021-09-25	6	45	0	6	0.8421
SNK VS. CAPCOM: THE MATCH OF THE MILLENNIUM	2021-09-30	22	91	4	26	0.8420000000000001
Open Brush	2021-06-08	31	91	4	35	0.8420000000000001
Beach Buggy Racing 2	2021-03-10	42	376	38	80	0.8417
Teocida	2021-12-25	13	80	3	16	0.8416
Kittens and Yarn	2021-06-17	8	129	8	16	0.8414
S.U.M. - Slay Uncool Monsters	2021-02-19	16	110	6	22	0.8414
Hentai Aim Trainer	2021-11-16	9	442	47	56	0.8412999999999999
Dadish 2	2021-02-24	5	57	1	6	0.8412999999999999
Atelier Lydie & Suelle: The Alchemists and the Mysterious Paintings DX	2021-04-22	124	190	15	139	0.841
Jigsaw Puzzle Dreams	2021-12-02	76	231	20	96	0.8408
Happy's Humble Burger Barn	2021-12-28	36	223	19	55	0.8408
T-Minus 30	2021-08-26	63	155	11	74	0.8408
Grotto	2021-10-26	12	155	11	23	0.8408
Shopping Empire Tycoon	2021-01-05	11	68	2	13	0.8408
Lingo	2021-12-13	41	68	2	43	0.8408
Shin Megami Tensei III Nocturne HD Remaster	2021-05-25	1906	2430	347	2253	0.8406
Dee's Nuts	2021-10-21	5	89	4	9	0.8406
F1 2021	2021-07-15	25575	29954	5052	30627	0.8404
Say No! More	2021-04-09	85	1131	147	232	0.8403
Projections	2021-07-13	20	56	1	21	0.8403
Rob Riches	2021-11-16	7	56	1	8	0.8403
Curse of the Dead Gods	2021-02-23	3004	5464	842	3846	0.8402
Switchcars	2021-04-30	156	392	41	197	0.8402
Didnapper 2	2021-12-13	126	108	6	132	0.8401000000000001
Apotheorasis Prologue	2021-12-22	17	78	3	20	0.8401000000000001
Hellevator	2021-05-24	47	245	22	69	0.84
Princess Castle Quest	2021-03-24	6	43	0	6	0.84
Couch Monsters	2021-03-24	12	43	0	12	0.84
Conquest of Elysium 5	2021-08-17	1179	608	71	1250	0.8399
Space Cats Tactics: Prologue	2021-01-01	136	98	5	141	0.8399
CATch the Stars: Japan	2021-04-29	6	98	5	11	0.8399
Sheepy	2021-07-24	22	268	25	47	0.8397
The Sekimeiya: Spun Glass	2021-05-06	16	144	10	26	0.8397
Trials of Fire	2021-04-09	1765	2500	362	2127	0.8395
Down in Bermuda	2021-01-14	188	675	81	269	0.8395
ゆうゆう自適のゆうかりん	2021-09-03	45	203	17	62	0.8395
Clan O'Conall	2021-04-28	18	107	6	24	0.8395
LABYRINTH OF TOUHOU - GENSOKYO AND THE HEAVEN-PIERCING TREE	2021-08-24	413	259	24	437	0.8394
The Perfect Tower II	2021-02-26	2725	1744	243	2968	0.8393
The Secret of Retropolis	2021-07-21	8	116	7	15	0.8393
Trash Quest	2021-04-26	6	77	3	9	0.8393
TOTALLY BASEBALL	2021-07-08	13	125	8	21	0.8392000000000001
EXIT 2	2021-12-07	16	125	8	24	0.8392000000000001
变量2	2021-10-01	175	379	40	215	0.8389
第五件遗留物	2021-02-09	100	342	35	135	0.8389
SEIKEN-MANIFESTIA	2021-05-18	499	106	6	505	0.8389
Lunch Lady	2021-04-15	1135	8990	1451	2586	0.8388
Combots	2021-07-08	92	480	54	146	0.8387000000000001
Mutropolis	2021-02-18	31	142	10	41	0.8387000000000001
Breach Wanderers	2021-06-04	50	124	8	58	0.8386
Teamfight Manager	2021-03-01	8092	4108	629	8721	0.8384999999999999
狂神无双	2021-11-11	19	184	15	34	0.8384999999999999
Radioactive dwarfs: evil from the sewers	2021-08-16	6	54	1	7	0.8384
Dininho Adventures: Definitive Edition	2021-03-29	8	54	1	9	0.8384
Black Skylands	2021-07-09	883	1253	169	1052	0.8383
Bravery Network Online	2021-02-16	69	141	10	79	0.8382
Space Choice: Data Analyzer	2021-03-01	22	132	9	31	0.8381000000000001
Len's Island	2021-11-26	1558	2194	318	1876	0.838
Circuit Superstars	2021-10-12	396	1474	204	600	0.838
The Corruption Within	2021-06-09	13	114	7	20	0.838
SiNiSistar	2021-11-30	29	308	31	60	0.8379000000000001
The Greatest Penguin Heist of All Time	2021-07-02	425	1356	186	611	0.8378
Jetborne Racing	2021-05-27	94	389	42	136	0.8378
Dap	2021-09-29	13	95	5	18	0.8378
Causality	2021-04-16	45	174	14	59	0.8377
LaserZone	2021-07-29	7	41	0	7	0.8377
Born Race	2021-04-05	3	41	0	3	0.8377
Beat Blast	2021-08-25	81	337	35	116	0.8376000000000001
The Troop	2021-12-21	70	261	25	95	0.8375
Majikoi! Love Me Seriously!	2021-02-26	35	104	6	41	0.8375
Sword and Fairy 2	2021-04-15	501	816	104	605	0.8373999999999999
Piposh	2021-03-31	141	113	7	148	0.8373999999999999
魔法迷域	2021-06-11	106	113	7	113	0.8373999999999999
Kor	2021-12-23	8	53	1	9	0.8373999999999999
GTFO	2021-12-10	18813	40175	7032	25845	0.8373
FATAL ERROR	2021-09-27	3	64	2	5	0.8372
Monster Rancher 1 & 2 DX	2021-12-09	1411	740	93	1504	0.8371
No Plan B: Prologue	2021-04-23	52	197	17	69	0.8371
Christmas Massacre	2021-12-17	43	478	55	98	0.8369
Tandem: a tale of shadows	2021-10-20	24	164	13	37	0.8369
Scoober Splat	2021-12-11	103	84	4	107	0.8369
Dead Seater	2021-04-02	12	259	25	37	0.8368000000000001
Kinduo	2021-07-29	12	74	3	15	0.8368000000000001
Tanto Cuore	2021-05-11	62	155	12	74	0.8366
Adventure Bit	2021-01-11	6	40	0	6	0.8365
Lighton: Duo	2021-03-31	7	40	0	7	0.8365
ATOM RPG Trudograd	2021-09-13	1155	2804	424	1579	0.8362999999999999
3D Aim Trainer	2021-07-08	366	1561	222	588	0.8361000000000001
6 Seasons And A Game	2021-01-09	128	557	67	195	0.8361000000000001
Adorable Girls	2021-02-27	11	83	4	15	0.8361000000000001
Darius Cozmic Collection Arcade	2021-11-17	56	83	4	60	0.8361000000000001
Press Ctrl	2021-03-16	34	345	37	71	0.8359000000000001
Horny Girls	2021-03-19	16	388	43	59	0.8358
Enter The Backrooms	2021-02-12	52	809	105	157	0.8357
Cat Simulator : Animals on Farm	2021-09-08	16	92	5	21	0.8357
惊险极速	2021-11-29	3	92	5	8	0.8357
Fujiwara Bittersweet	2021-01-16	54	300	31	85	0.8356
Crash Dive 2	2021-04-01	29	153	12	41	0.8356
Jester / King	2021-09-08	14	62	2	16	0.8353
SudoKats	2021-08-14	8	62	2	10	0.8353
魔法少女は自由に変身できない。	2021-04-01	11	51	1	12	0.8353
INVERT	2021-10-16	9	51	1	10	0.8353
Cranked Up	2021-07-13	37	39	0	37	0.8353
Magic Twins	2021-03-18	11	39	0	11	0.8353
東方文花帖 ～ Shoot the Bullet.	2021-06-19	7	39	0	7	0.8353
Puzzle Light: One Move	2021-05-27	7	39	0	7	0.8353
Romeow: To The Cracked Mars	2021-08-11	3	39	0	3	0.8353
Tied by your Red	2021-11-28	5	39	0	5	0.8353
BLUE WISH DESIRE	2021-11-17	7	39	0	7	0.8353
GRIME	2021-08-02	2012	3170	490	2502	0.8351999999999999
SlapBR	2021-12-08	21	127	9	30	0.8351999999999999
Jurassic World Evolution 2	2021-11-09	20784	15793	2716	23500	0.8349
Bitardia	2021-12-28	84	724	93	177	0.8349
Himno - The Silent Melody	2021-10-20	58	223	21	79	0.8349
EXCALIBURIAN!!	2021-12-31	55	135	10	65	0.8349
Four color jumps	2021-10-08	16	312	33	49	0.8348000000000001
Ninki Seiyuu: How to Make a Pop Voice Actress	2021-10-15	18	100	6	24	0.8348000000000001
Gomoku Let’s Go	2021-07-28	345	548	67	412	0.8345
Sable	2021-09-23	763	3032	470	1233	0.8344
The Last Friend	2021-09-30	29	81	4	33	0.8344
The Mikado Birdgirl in Taichung	2021-01-21	10	61	2	12	0.8344
Memories with my Kitten	2021-08-12	5	61	2	7	0.8344
Prison Simulator	2021-11-04	1633	1450	208	1841	0.8343
Doctor Who: The Lonely Assassins	2021-03-19	147	540	66	213	0.8343
Beasts of Maravilla Island	2021-06-12	28	266	27	55	0.8342
Juro Janosik	2021-10-25	21	71	3	24	0.8342
Volt Patrol	2021-02-19	6	38	0	6	0.8340000000000001
Legion TD 2	2021-10-01	5753	8254	1384	7137	0.8339
Mud and Blood	2021-12-01	104	366	41	145	0.8339
Rising Hell	2021-05-19	28	243	24	52	0.8339
PsiloSybil	2021-12-07	19	80	4	23	0.8336
CARNAL	2021-04-09	8	157	13	21	0.8334
Pile Up	2021-03-18	27	60	2	29	0.8334
DeadOS	2021-04-29	5	70	3	8	0.8333
Mayhem Brawler	2021-08-19	65	363	41	106	0.8331000000000001
Old Coin Pusher Friends	2021-10-08	839	313	34	873	0.833
moon	2021-12-16	70	140	11	81	0.833
Interstate Drifter 2000	2021-01-21	6	49	1	7	0.833
Dashie's Puh-ranormal Activity	2021-11-04	15	49	1	16	0.833
Bad Dream: Stories	2021-09-30	8	49	1	9	0.833
Five Nights at Freddy's: Security Breach	2021-12-17	11264	38360	6947	18211	0.8329000000000001
Crash Drive 3	2021-07-08	35	291	31	66	0.8328
Viola	2021-02-17	11	79	4	15	0.8328
Lake	2021-09-01	972	2405	371	1343	0.8327
Get Stuffed!	2021-10-29	432	498	61	493	0.8327
Simona's Requiem	2021-04-27	6	37	0	6	0.8327
Kingslayer: The First Assassin	2021-04-08	6	37	0	6	0.8327
Watermelon Blocks	2021-03-02	7	37	0	7	0.8327
Dungeon Slime 2	2021-03-29	6	37	0	6	0.8327
Mastho is Together	2021-03-30	5	37	0	5	0.8327
Potion Party	2021-04-08	35	97	6	41	0.8326000000000001
Hero of the Kingdom: The Lost Tales 2	2021-11-19	195	470	57	252	0.8325
Wild Dive	2021-05-27	167	311	34	201	0.8323999999999999
STRIDE Multiplayer	2021-06-23	42	147	12	54	0.8323999999999999
Rogue Star Rescue	2021-02-04	59	114	8	67	0.8323999999999999
Sockventure	2021-05-11	11	69	3	14	0.8323999999999999
Run Run Run	2021-10-12	103	69	3	106	0.8323999999999999
ZADETTE	2021-03-01	8	59	2	10	0.8323
Motorcycle Mechanic Simulator 2021: Prologue	2021-06-04	643	1742	261	904	0.8322
Slow and Steady	2021-04-27	121	529	66	187	0.8322
Andy's Apple Farm	2021-11-26	34	407	48	82	0.8320000000000001
Monmusu Gladiator	2021-07-14	28	78	4	32	0.8319
Fighting Fiends	2021-11-09	16	48	1	17	0.8319
Yupitergrad: Sneaki Peaki	2021-04-21	7	48	1	8	0.8319
Atopes	2021-07-30	4	87	5	9	0.8318000000000001
Ambition: A Minuet in Power	2021-08-18	96	237	24	120	0.8317
Pathfinder: Wrath of the Righteous - Enhanced Edition	2021-09-02	46724	22016	3949	50673	0.8316
That Time I Got Reincarnated as an Orc	2021-07-23	235	280	30	265	0.8316
琴葉姉妹とライサント島の伝説	2021-06-04	130	104	7	137	0.8314
Mon Amour	2021-10-14	18	58	2	20	0.8312999999999999
Scoot Kaboom and the Tomb of Doom	2021-06-01	12	58	2	14	0.8312999999999999
Melancholy Love	2021-01-29	10	58	2	12	0.8312999999999999
Jubilee	2021-11-18	8	58	2	10	0.8312999999999999
Angel Wings	2021-01-29	187	543	69	256	0.8312
SnOut	2021-05-20	137	168	15	152	0.8311000000000001
Super Woden GP	2021-09-01	49	235	24	73	0.831
Karma City Police	2021-12-16	4	77	4	8	0.831
Eastward	2021-09-16	13882	11263	1975	15857	0.8307
Gary Grigsby's War in the East 2	2021-12-10	110	190	18	128	0.8307
Kiki & Ana - The Child	2021-03-13	6	47	1	7	0.8307
Laser Attraction	2021-03-17	20	47	1	21	0.8307
Wirewalk()↳	2021-09-23	6	47	1	7	0.8307
Shovel Knight Pocket Dungeon	2021-12-13	329	298	33	362	0.8306
Draw & Guess	2021-03-12	41766	24453	4445	46211	0.8305
Blaster Master Zero 3	2021-07-29	194	290	32	226	0.8303
MUSICUS!	2021-04-08	27	57	2	29	0.8301999999999999
Play With Gilbert - A Small Tail	2021-05-05	11	76	4	15	0.8301000000000001
Haiki	2021-10-26	3	35	0	3	0.8300000000000001
Ms.Director	2021-05-18	5	35	0	5	0.8300000000000001
Main Assembly	2021-01-26	295	976	139	434	0.8299
Singing Iris 鸢之歌	2021-01-12	86	391	47	133	0.8298000000000001
Aquarium Designer	2021-10-21	146	682	92	238	0.8297
Polyville Canyon	2021-05-20	19	110	8	27	0.8297
Mrs.Cat In Mars	2021-07-13	6	46	1	7	0.8295
Countryballs: Modern Ballfare	2021-06-11	17	149	13	30	0.8292
No Ghost in Stay Home	2021-06-04	13	75	4	17	0.8292
Fluffy Cubed	2021-06-18	6	75	4	10	0.8292
Kulebra and the Souls of Limbo - Prologue	2021-08-17	6	56	2	8	0.8291
Fantasy General	2021-09-16	21	56	2	23	0.8291
Pumpkin Eater	2021-11-17	30	293	33	63	0.8290000000000001
InfraSpace	2021-10-15	505	819	115	620	0.8288
Sakura Succubus 4	2021-03-01	31	156	14	45	0.8288
How to bathe your cat	2021-09-27	9	92	6	15	0.8287000000000001
Leaf Me Alone	2021-07-29	8	34	0	8	0.8285
Mission in Snowdriftland - Snowlogue	2021-05-06	21	207	21	42	0.8284
MONOBOT	2021-06-18	17	100	7	24	0.8284
Super Dungeon Maker - Fink's Awakening	2021-10-21	33	83	5	38	0.8284
Underland: The Climb	2021-04-23	6	65	3	9	0.8284
The Repairing Mantis	2021-09-17	5	65	3	8	0.8284
SEARCH ALL - FOXES	2021-12-20	4	65	3	7	0.8284
Phoenotopia Awakening	2021-01-21	327	1431	218	545	0.8283
Embr	2021-09-23	670	1163	173	843	0.8281000000000001
Arid	2021-06-29	402	1339	203	605	0.8279000000000001
恋爱关系/Romance	2021-09-24	262	1679	262	524	0.8277
Workplace Rhapsody	2021-09-29	525	1016	149	674	0.8277
Exit From	2021-04-16	21	448	57	78	0.8277
Clownfield 2042	2021-12-31	542	3947	666	1208	0.8276000000000001
Lamentum	2021-08-27	136	395	49	185	0.8275
Lelie Navigation!	2021-12-04	339	219	23	362	0.8275
Demonpact: Clarice	2021-02-11	7	64	3	10	0.8273999999999999
Mambo Wave	2021-01-08	14	73	4	18	0.8273
Knockout City™	2021-05-21	6027	6812	1196	7223	0.8272
Gobby McGobblenutz Presents: The Art of the Dad Joke: Chapter 1	2021-11-15	9	130	11	20	0.8271
Pale Cachexia	2021-04-14	5	33	0	5	0.8270000000000001
BOY BEATS WORLD	2021-05-28	4	33	0	4	0.8270000000000001
Falta	2021-12-31	5	33	0	5	0.8270000000000001
Fantasy Tavern Sextet -Vol.3 Postlude Days-	2021-05-13	77	160	15	92	0.8269
Clockwork Calamity in Mushroom World: What would you do if the time stopped ticking?	2021-06-01	4	44	1	5	0.8269
The Legend of Bear-Truck Trucker	2021-04-30	16	44	1	17	0.8269
Love n War: Warlord by Chance	2021-05-28	861	1067	159	1020	0.8268000000000001
Super Monkey Ball Banana Mania	2021-10-05	782	996	147	929	0.8268000000000001
Occult Crime Police	2021-10-12	24	106	8	32	0.8268000000000001
斩妖行 Eastern Exorcist	2021-07-08	2206	5165	895	3101	0.8267
Search Party	2021-03-04	12	81	5	17	0.8267
Epiphany City: Prologue	2021-08-26	7	81	5	12	0.8267
The Tale of Fighting Nymphs	2021-10-20	75	159	15	90	0.8264
Sniper Ghost Warrior Contracts 2	2021-06-04	7055	6529	1152	8207	0.8262999999999999
NUTS	2021-02-04	67	505	67	134	0.8262999999999999
Roll a Ball With Your Friends	2021-07-30	18	63	3	21	0.8262999999999999
Ranch Simulator	2021-03-04	3412	11397	2076	5488	0.8262
超将棋	2021-11-08	679	298	35	714	0.8262
Furry Love 2	2021-12-24	2452	2392	393	2845	0.8259000000000001
Tastemaker	2021-02-18	814	887	130	944	0.8259000000000001
Increlution	2021-10-13	2132	664	93	2225	0.8259000000000001
Orcs Must Die! 3	2021-07-23	13210	8898	1605	14815	0.8258
Slappyball	2021-05-21	1858	3444	584	2442	0.8258
Soviet Hentai	2021-03-06	6	270	31	37	0.8258
Paint Drying Simulator	2021-07-14	25	158	15	40	0.8258
Boot Camp Fitness	2021-03-19	4	53	2	6	0.8256
Ultreïa	2021-05-31	6	53	2	8	0.8256
GROUND-UNBOUND	2021-10-07	8	53	2	10	0.8256
Bobok	2021-11-11	7	53	2	9	0.8256
凯尔文 - Kelvin And The Chateau	2021-08-06	85	355	44	129	0.8255
times infinity	2021-04-08	9	43	1	10	0.8255
墨之韵	2021-10-25	9	43	1	10	0.8255
Wadality	2021-11-16	7	43	1	8	0.8255
FEWAR-DVD	2021-12-31	5	43	1	6	0.8255
Desecrators	2021-03-26	6	32	0	6	0.8255
Sokocat - Dungeon	2021-09-02	5	32	0	5	0.8255
Phantom Abyss	2021-06-21	1607	1692	270	1877	0.8254000000000001
Re:ZERO -Starting Life in Another World- The Prophecy of the Throne	2021-01-28	253	444	58	311	0.8254000000000001
tERRORbane: an INTRODUCTION, mostly	2021-10-13	35	62	3	38	0.8253
Erannorth Chronicles	2021-09-16	75	234	26	101	0.8251000000000001
Bean	2021-04-25	37	1002	151	188	0.8249
a guard walks into a tavern	2021-04-07	34	134	12	46	0.8248000000000001
REKKR: Sunken Land	2021-10-11	13	79	5	18	0.8248000000000001
Candy Disaster	2021-11-12	122	219	24	146	0.8245
Anime Artist: Tiffy’s notty secret	2021-09-21	25	126	11	36	0.8245
Path of Sacrifice	2021-06-23	18	103	8	26	0.8245
Heliopedia	2021-10-12	48	103	8	56	0.8245
Weaving Tides	2021-05-27	23	95	7	30	0.8245
Fly Corp	2021-05-28	604	1258	196	800	0.8244
花妖物语/Flower girl	2021-09-15	680	2219	368	1048	0.8242
SPOOKWARE: Watch Party	2021-11-16	45	61	3	48	0.8242
Lunar's Chosen	2021-11-02	302	445	59	361	0.8240999999999999
Oneiro	2021-06-18	5	42	1	6	0.8240999999999999
REVISITOR	2021-11-20	28	42	1	29	0.8240999999999999
PuzzlePet - Feed your cat	2021-03-26	3	42	1	4	0.8240999999999999
The Colorful Creature	2021-08-31	6	42	1	7	0.8240999999999999
UNDYING	2021-10-19	324	736	107	431	0.8240000000000001
Creepy Tale 2	2021-07-16	100	765	112	212	0.8239000000000001
Shot in the Dark	2021-01-12	6	31	0	6	0.8239000000000001
Buster's Tower Defense	2021-02-07	6	31	0	6	0.8239000000000001
Of Mice and Moggies	2021-02-23	4	31	0	4	0.8239000000000001
The Mermaid of Zennor	2021-04-08	3	31	0	3	0.8239000000000001
Roar of Revenge	2021-10-04	5	31	0	5	0.8239000000000001
Cat Box Paradox	2021-12-10	11	31	0	11	0.8239000000000001
Project H	2021-07-15	25	349	44	69	0.8238
Paint Chips	2021-05-04	25	125	11	36	0.8238
Psycholonials	2021-02-03	303	566	79	382	0.8237000000000001
Sokpop S10: Pocket Watch	2021-01-09	14	86	6	20	0.8237000000000001
Submorse	2021-03-31	12	117	10	22	0.8235
Mayhem in Single Valley	2021-05-20	39	223	25	64	0.8234
Wrestling Revolution 2D	2021-06-26	12	51	2	14	0.8231
Video Hole Episode I	2021-02-19	4	51	2	6	0.8231
Ayo the Clown	2021-07-28	10	60	3	13	0.823
DunDun VR	2021-09-29	9	60	3	12	0.823
Farm Kitten - Puzzle Pipes	2021-08-26	7	60	3	10	0.823
My Friend Peppa Pig	2021-10-22	71	610	87	158	0.8229000000000001
Negative Nancy	2021-10-13	12	77	5	17	0.8229000000000001
Meat Beating: No More Horny	2021-04-07	17	77	5	22	0.8229000000000001
Evil Tonight	2021-10-14	39	248	29	68	0.8227
Head AS Code	2021-02-09	13	41	1	14	0.8227
STAY	2021-02-26	18	41	1	19	0.8227
Gnome Jigsaw Puzzles	2021-01-29	5	41	1	6	0.8227
Panqueca & Paçoca: A Friendship Jigsaw	2021-06-17	6	41	1	7	0.8227
Chorus	2021-12-03	962	2029	339	1301	0.8224
FutaDomWorld	2021-12-05	38	68	4	42	0.8223
BigChick	2021-03-04	4	30	0	4	0.8222
Tiny Traffic	2021-02-25	4	30	0	4	0.8222
Catty & Batty: The Spirit Guide	2021-02-10	4	30	0	4	0.8222
Golden Rails: Small Town Story	2021-01-15	22	30	0	22	0.8222
Upaon: A Snake's Journey	2021-06-25	4	30	0	4	0.8222
Lost and found - What if I come and find it	2021-10-01	8	30	0	8	0.8222
Angel's Tale : An extraordinary love story	2021-09-05	23	30	0	23	0.8222
The Signal State	2021-09-23	230	330	42	272	0.8220000000000001
The Sin Collector: Repentless	2021-11-09	21	76	5	26	0.8220000000000001
Out of Line	2021-06-23	18	165	17	35	0.8219
Be Hero	2021-03-30	44	84	6	50	0.8219
[TDA03] Muv-Luv Unlimited: THE DAY AFTER - Episode 03 REMASTERED	2021-02-05	15	59	3	18	0.8219
Hobo Cat Adventures	2021-09-30	10	59	3	13	0.8219
Milli & Greg	2021-10-28	5	50	2	7	0.8219
晴天咖啡館Sunny Cafe	2021-12-09	18	50	2	20	0.8219
Sophie's Safecracking Simulator	2021-06-16	21	50	2	23	0.8219
Airport CEO	2021-03-04	2745	5301	961	3706	0.8216
Devil Slayer - Raksasi / 斩妖Raksasi	2021-04-22	1080	2284	389	1469	0.8215000000000001
False Myth	2021-02-20	300	341	44	344	0.8215000000000001
外兽祭·兽人们的冒险酒馆	2021-07-29	40	164	17	57	0.8212999999999999
The Clockworker	2021-12-03	4	40	1	5	0.8212
Primal Dungeon	2021-02-04	8	40	1	9	0.8212
Funbag Fantasy 3if	2021-05-06	35	40	1	36	0.8212
Realms of Antiquity: The Shattered Crown	2021-03-22	11	40	1	12	0.8212
my brother lives in a canyon	2021-07-22	3	40	1	4	0.8212
Zombie Army 4: Dead War	2021-02-18	3352	4780	865	4217	0.821
Snow-Swept Quest	2021-05-01	140	224	26	166	0.821
Black Baby	2021-02-23	4	75	5	9	0.821
Simple Fish Adventure	2021-08-06	80	204	23	103	0.8209000000000001
Tinytopia	2021-08-30	170	177	19	189	0.8209000000000001
Lacuna: Prologue	2021-04-22	38	128	12	50	0.8209000000000001
Spirit of Europe - Origins	2021-09-30	163	106	9	172	0.8209000000000001
Moons of Ardan	2021-10-21	25	58	3	28	0.8207
FINAL FANTASY V	2021-11-10	3953	1049	166	4119	0.8205
Strike Buster Prototype	2021-05-22	190	567	82	272	0.8205
After I met that catgirl, my questlist got too long!	2021-02-18	53	98	8	61	0.8205
Rogue Invader	2021-12-15	9	49	2	11	0.8205
Chess Brain: Dark Troops	2021-02-04	6	49	2	8	0.8205
Gloom and Doom	2021-01-18	3	29	0	3	0.8204000000000001
Dino Galaxy Tennis	2021-03-19	10	29	0	10	0.8204000000000001
Welcome Back	2021-10-01	4	29	0	4	0.8204000000000001
Under The Ghost Mountain	2021-04-29	2	29	0	2	0.8204000000000001
Blokker: Orange	2021-05-05	5	29	0	5	0.8204000000000001
BOX: Space Station	2021-05-12	6	29	0	6	0.8204000000000001
The Patient S Remedy	2021-09-29	17	29	0	17	0.8204000000000001
Chesskoban Bishop	2021-12-17	2	29	0	2	0.8204000000000001
Alpha Hole Prison	2021-05-20	81	90	7	88	0.8201999999999999
BoomBox	2021-06-12	13	134	13	26	0.8201
Treasures of the Aegean	2021-11-11	10	66	4	14	0.8201
Miss Furry	2021-05-07	674	1500	249	923	0.8199
The Darkest Tales — Into the Nightmare	2021-10-14	374	1479	245	619	0.8199
Out of the Park Baseball 22	2021-03-26	2008	1411	233	2241	0.8197
METALLIC CHILD	2021-09-15	1188	974	154	1342	0.8197
Bloodroots	2021-03-12	57	168	18	75	0.8197
Watch Over Christmas	2021-12-21	17	39	1	18	0.8197
Shindig	2021-09-02	3	39	1	4	0.8197
Swords & Bones	2021-03-01	4	39	1	5	0.8197
Balloon Flight	2021-06-01	13	39	1	14	0.8197
Mummy Sandbox	2021-10-08	4	39	1	5	0.8197
誰是犯案者 Who is the Criminal	2021-12-03	6	39	1	7	0.8197
Bumballon	2021-12-15	3	39	1	4	0.8197
Adventure Rush	2021-12-22	7	39	1	8	0.8197
No Parachute	2021-04-05	7	119	11	18	0.8196
Bamerang	2021-04-22	17	57	3	20	0.8195
Clodhoppers	2021-04-28	48	48	2	50	0.8192
Guazu: The Rescue	2021-06-17	7	48	2	9	0.8192
Star Shift Origins	2021-11-08	403	48	2	405	0.8192
Breathedge	2021-02-25	6857	10841	2085	8942	0.8190999999999999
Black Powder Red Earth®	2021-03-29	14	160	17	31	0.8190999999999999
Sands of Salzaar	2021-12-16	21047	17554	3448	24495	0.8190000000000001
Deflector: Specimen Zero	2021-12-09	42	153	16	58	0.8190000000000001
A Tale for Anna	2021-09-28	16	81	6	22	0.8190000000000001
RAYZE	2021-10-22	12	81	6	18	0.8190000000000001
SupercupOnline	2021-08-23	140	375	51	191	0.8189000000000001
Hellblusser	2021-08-10	16	73	5	21	0.8189000000000001
Vtuber模擬器	2021-08-09	313	387	53	366	0.8188
门里	2021-12-17	63	96	8	71	0.8188
LIBLADE	2021-11-06	50	96	8	58	0.8188
Gravitators	2021-11-12	3	28	0	3	0.8186
Hack Grid	2021-02-26	3	28	0	3	0.8186
Space Yandere	2021-10-08	3	28	0	3	0.8186
sCATch: The Painter Cat	2021-11-19	2	28	0	2	0.8186
Pixel Cup Soccer 17	2021-11-01	90	263	33	123	0.8185
Milf City	2021-10-04	13	172	19	32	0.8181999999999999
Diving Disorder-下潜症	2021-01-15	17	117	11	28	0.8181999999999999
Hanaby's Summer Festival	2021-07-16	45	38	1	46	0.8181
Piratopia	2021-11-11	277	804	126	403	0.818
Captain Bones: Prologue	2021-07-23	90	443	63	153	0.8179000000000001
Claire's Quest	2021-08-23	186	255	32	218	0.8179000000000001
Eraser	2021-12-15	195	1932	335	530	0.8178000000000001
BURIED STARS	2021-11-29	1089	1139	187	1276	0.8178000000000001
Meow Lab	2021-01-25	11	64	4	15	0.8178000000000001
LudoNarraCon Supporter Pack featuring Cyrano	2021-04-23	14	47	2	16	0.8178000000000001
Don't Touch this Button!	2021-08-31	17	47	2	19	0.8178000000000001
Slobbish Dragon Princess LOVE + PLUS	2021-06-22	15	47	2	17	0.8178000000000001
Tested on Humans: Escape Room	2021-02-24	92	310	41	133	0.8176000000000001
QV	2021-03-18	29	197	23	52	0.8176000000000001
Motesolo	2021-06-09	367	773	121	488	0.8175
The End of Dyeus	2021-10-15	11	87	7	18	0.8175
An Airport for Aliens Currently Run by Dogs	2021-05-25	58	157	17	75	0.8173
Academia : School Simulator	2021-01-28	471	2027	355	826	0.8172
Vampires Dawn 3	2021-05-19	1145	550	82	1227	0.8170999999999999
ArmaCulture	2021-05-20	10	150	16	26	0.8170999999999999
Midnight Protocol	2021-10-13	83	290	38	121	0.8170000000000001
契灵之约	2021-08-12	47	202	24	71	0.8169
Eternal Starlight VR	2021-06-17	8	55	3	11	0.8169
Into the Waves	2021-12-30	8	55	3	11	0.8169
Fearmonium	2021-05-20	54	271	35	89	0.8168000000000001
A Little Golf Journey	2021-10-14	15	71	5	20	0.8168000000000001
Shine Within	2021-09-09	25	122	12	37	0.8167
Untrusted	2021-05-09	335	811	129	464	0.8166
SpaceNET	2021-02-26	4	27	0	4	0.8166
Magellania	2021-03-19	5	27	0	5	0.8166
CHESS with LASERS	2021-09-14	11	27	0	11	0.8166
Yarne	2021-04-01	10	27	0	10	0.8166
Snake Pit	2021-11-29	3	27	0	3	0.8166
Happy Puzzle	2021-04-24	114	270	35	149	0.8165000000000001
Spectrolite	2021-11-18	6	37	1	7	0.8165000000000001
Super Taco Crew	2021-09-30	4	37	1	5	0.8165000000000001
hallucination - 幻觉	2021-05-28	23	162	18	41	0.8164
FrankenStorm TD: Prologue	2021-11-24	353	306	41	394	0.8163
Street Cleaner: The Video Game	2021-01-07	9	46	2	11	0.8163
Make a Path for the Chicken	2021-08-31	5	46	2	7	0.8163
Great Paintings VR	2021-01-14	7	78	6	13	0.8161
Cupid Nonogram	2021-11-19	15	78	6	21	0.8161
My Beautiful Paper Smile	2021-10-14	32	293	39	71	0.816
Tennis Elbow Manager 2	2021-06-02	90	168	19	109	0.816
Blind Fate: Edo no Yami — Prologue	2021-12-16	132	394	56	188	0.8159000000000001
Instant Farmer	2021-02-05	53	148	16	69	0.8159000000000001
Witch Explorer	2021-12-20	43	107	10	53	0.8159000000000001
Goop Loop	2021-07-21	7	54	3	10	0.8156
百合籠	2021-04-27	8	62	4	12	0.8155
Seance	2021-05-28	6	62	4	10	0.8155
Ship Graveyard Simulator: Prologue	2021-10-07	807	742	118	925	0.8154000000000001
Witchtastic	2021-10-26	29	147	16	45	0.8153
10 Seconds to Win!	2021-12-28	15	92	8	23	0.8153
SCARLET NEXUS	2021-06-24	14516	11258	2236	16752	0.8151999999999999
World War Z	2021-09-21	6714	10949	2178	8892	0.8148000000000001
Mark Out! The Wrestling Card Game	2021-08-26	20	45	2	22	0.8148000000000001
Renryuu: Ascension	2021-11-30	28	45	2	30	0.8148000000000001
My Friend Stalin	2021-06-18	19	331	46	65	0.8147
Strings Theory	2021-12-14	18	36	1	19	0.8147
Existensis	2021-07-19	7	36	1	8	0.8147
Novena Diabolos	2021-11-18	8	36	1	9	0.8147
Endless Boss Fight	2021-08-25	11	36	1	12	0.8147
ECO HOLE	2021-10-08	28	36	1	29	0.8147
The Most Boring Game Ever	2021-03-16	14	159	18	32	0.8146
Captain Toonhead vs. the Punks from Outer Space	2021-11-11	6	26	0	6	0.8146
Yoli	2021-09-28	7	26	0	7	0.8146
A Hermit Crab is Finding a House	2021-02-04	4	26	0	4	0.8146
IncrediMarble	2021-01-25	18	69	5	23	0.8145
Whisperwind	2021-01-17	6	69	5	11	0.8145
Hentai Girl Clicker	2021-07-29	8	69	5	13	0.8145
Plot of the Druid - Nightwatch	2021-02-19	19	105	10	29	0.8143000000000001
ARISEN	2021-09-21	28	61	4	32	0.8142
Turn on all the lights	2021-03-31	6	61	4	10	0.8142
Hextones	2021-04-05	7	61	4	11	0.8142
Hourglass: Prologue	2021-08-11	8	61	4	12	0.8142
Fostering Apocalypse	2021-07-15	4	53	3	7	0.8142
The Voluptuous DEMON QUEEN and our Shoebox Apartment Life	2021-12-24	8	53	3	11	0.8142
Bum Simulator	2021-08-26	1106	1420	247	1353	0.8140999999999999
Sylphy and the Sleepless Island	2021-10-09	307	132	14	321	0.8140999999999999
Witch 2 Hell Adventure	2021-04-29	47	132	14	61	0.8140999999999999
Karting	2021-04-15	1247	473	71	1318	0.8140000000000001
Combat Mission Black Sea	2021-01-21	137	323	45	182	0.8140000000000001
Bad Memories	2021-05-09	147	299	41	188	0.8138
STORY OF SEASONS: Pioneers of Olive Town	2021-09-15	1119	850	140	1259	0.8136
Galactic Mining Corp	2021-05-18	1305	682	109	1414	0.8136
Hentai Day - Ringsel in Troubles	2021-02-24	20	90	8	28	0.8135
Cats War	2021-11-17	9	268	36	45	0.8134
Hoplegs	2021-11-12	15	68	5	20	0.8134
Roguebook	2021-06-17	2548	2365	434	2982	0.8133
Flowering Across 樱下花期	2021-06-05	8	44	2	10	0.8133
Age of Darkness: Final Stand	2021-10-07	3546	4365	838	4384	0.8131999999999999
猴王模拟器之花果山篇	2021-10-12	61	117	12	73	0.813
Rayland	2021-11-06	8	60	4	12	0.813
Dark Lord: Peacemaker	2021-07-26	5	35	1	6	0.813
Castle Formers	2021-07-13	6	35	1	7	0.813
Teodoro	2021-03-08	7	35	1	8	0.813
TWO MONTHS	2021-01-20	4	35	1	5	0.813
Puzzle Light: Rotate	2021-06-18	8	35	1	9	0.813
Arausio	2021-06-22	5	35	1	6	0.813
Drox Operative 2	2021-10-20	111	194	24	135	0.8129000000000001
Real Heroes: Firefighter HD	2021-01-21	16	75	6	22	0.8129000000000001
2D Platformer GAME (Toy Factory)	2021-04-01	5	52	3	8	0.8129000000000001
Blokker	2021-04-12	7	52	3	10	0.8129000000000001
Hyper Dash	2021-02-25	43	181	22	65	0.8126000000000001
Kemono Mahjong	2021-01-11	15	82	7	22	0.8126000000000001
Nursery Slime	2021-10-22	82	96	9	91	0.8125
WizardChess	2021-10-01	6	25	0	6	0.8125
Succubus Research Diary	2021-09-06	19	25	0	19	0.8125
Neon Souls	2021-10-21	3	25	0	3	0.8125
Spare Parts: Episode 2	2021-06-10	5	25	0	5	0.8125
Jewel Match Twilight 3 Collector's Edition	2021-10-26	17	25	0	17	0.8125
Parametric Creature: Lab	2021-12-04	5	25	0	5	0.8125
College Bound	2021-06-03	567	2672	499	1066	0.8124
Cute Dark Elves	2021-04-25	5	67	5	10	0.8122
Cook-Out	2021-04-20	54	186	23	77	0.812
Rebel Inc: Escalation	2021-10-13	1034	4067	786	1820	0.8118000000000001
Natsuki Chronicles	2021-02-18	21	74	6	27	0.8118000000000001
Urge	2021-11-15	31	74	6	37	0.8118000000000001
The Magister	2021-09-02	26	74	6	32	0.8118000000000001
Mango	2021-11-23	5	74	6	11	0.8118000000000001
Chernobylite Enhanced Edition	2021-07-28	3944	8722	1759	5703	0.8117000000000001
X3: Farnham's Legacy	2021-05-04	849	424	64	913	0.8117000000000001
Death Park 2	2021-02-25	31	122	13	44	0.8117000000000001
Rounded	2021-04-26	6	59	4	10	0.8117000000000001
LIP! Lewd Idol Project Vol. 1	2021-06-23	23	59	4	27	0.8117000000000001
Catway Domino	2021-03-02	4	43	2	6	0.8117000000000001
There Will Be No Turkey This Christmas	2021-12-15	5	43	2	7	0.8117000000000001
Floating Farmer	2021-08-28	7	43	2	9	0.8117000000000001
MoonFall / Butterfly Lovers	2021-11-20	12	81	7	19	0.8116
Between Time: Escape Room	2021-09-15	60	191	24	84	0.8114
MIRAY	2021-07-29	12	51	3	15	0.8114
LOVE BAKUDAN	2021-01-25	20	51	3	23	0.8114
Last Days of Lazarus - Prologue	2021-12-24	6	51	3	9	0.8114
SIIMI	2021-03-29	3	34	1	4	0.8111
Battlecruisers	2021-02-04	56	262	36	92	0.8109999999999999
SCP: Doki Doki Anomaly	2021-10-07	10	66	5	15	0.8109999999999999
UpGun	2021-08-13	540	1270	225	765	0.8108
CYBERDAD	2021-09-23	16	94	9	25	0.8107
Divided Reigns	2021-04-02	30	114	12	42	0.8106
Critters for Sale: SNAKE	2021-01-08	6	58	4	10	0.8104000000000001
Descent: Legends of the Dark	2021-08-06	152	133	15	167	0.8103
Strategic Mind: Fight for Freedom	2021-05-21	117	107	11	128	0.8103
The Door in the Basement	2021-04-21	10	107	11	21	0.8103
House of Rules	2021-12-17	15	107	11	26	0.8103
Christmas Celebration With Sakuya Izayoi	2021-12-21	12	107	11	23	0.8103
Duel on Board	2021-03-05	5	24	0	5	0.8103
Escape Hospital-脫出 失憶病棟	2021-10-01	26	24	0	26	0.8103
Blade Flash Death	2021-05-03	4	24	0	4	0.8103
Color Breakers	2021-07-09	8	24	0	8	0.8103
Forest Dash	2021-02-05	3	24	0	3	0.8103
Sea of Roses	2021-06-29	5	24	0	5	0.8103
FILMECHANISM	2021-12-16	11	24	0	11	0.8103
Dark Crypt	2021-10-15	4	24	0	4	0.8103
Minimal Crypt	2021-09-30	4	24	0	4	0.8103
Heartseeker	2021-10-05	3	24	0	3	0.8103
The Trials	2021-10-01	5	24	0	5	0.8103
Angry Dad	2021-12-27	4	24	0	4	0.8103
Metal Unit	2021-01-28	267	1947	361	628	0.8102
MechWarrior 5: Mercenaries	2021-05-27	6476	6788	1369	7845	0.8101
AIDroneSim	2021-05-27	64	164	20	84	0.81
Max's Big Bust 2 - Max's Bigger Bust	2021-11-07	19	50	3	22	0.81
*NEW* SCUFFED EPIC VISUAL NOVEL	2021-07-13	13	42	2	15	0.81
Flex hooks	2021-05-25	3	42	2	5	0.81
仙绣剑缘录	2021-10-29	116	628	103	219	0.8098000000000001
Field of Glory II: Medieval	2021-02-04	318	316	46	364	0.8097
SRX: The Game	2021-05-28	79	132	15	94	0.8095
One Hand Clapping	2021-12-14	115	448	70	185	0.8093000000000001
Chasing Static	2021-10-14	65	298	43	108	0.8093000000000001
VR Skater	2021-04-30	33	181	23	56	0.8093000000000001
Samurai Shampoo	2021-07-02	136	138	16	152	0.8093000000000001
The Last King's Archer	2021-04-28	8	33	1	9	0.8092
Hidden Shapes Black Skull - Jigsaw Puzzle Game	2021-08-11	5	33	1	6	0.8092
Roxy Raccoon	2021-10-15	3	33	1	4	0.8092
The Tram of Wishes	2021-06-08	44	125	14	58	0.8090999999999999
Ruins of Albion	2021-09-15	50	228	31	81	0.809
ゆるキャン△ VIRTUAL CAMP ～麓キャンプ場編～ / Laid-Back Camp - Virtual - Fumoto Campsite	2021-04-08	18	112	12	30	0.809
Faraday Protocol	2021-08-12	14	57	4	18	0.809
Knight Squad 2 Trials	2021-03-24	63	57	4	67	0.809
Steel Crew	2021-10-28	49	353	53	102	0.8089000000000001
S.H.E.L.T.E.R. - An Apocalyptic Tale	2021-11-12	216	527	85	301	0.8088
EQI	2021-01-15	22	168	21	43	0.8087000000000001
Forgotten Hope	2021-05-12	8	78	7	15	0.8084
Big Klondike	2021-09-08	27	71	6	33	0.8084
ShawnCena121	2021-12-30	7	71	6	13	0.8084
Pawn of the Dead	2021-02-19	8	49	3	11	0.8084
Fuzz Force: Spook Squad	2021-06-08	20	49	3	23	0.8084
Ascension	2021-02-05	6	49	3	9	0.8084
Hobo: Tough Life	2021-04-13	2254	5649	1144	3398	0.8083
Carnal Instinct	2021-03-01	430	2202	419	849	0.8083
Dawn of Corruption	2021-05-18	23	41	2	25	0.8083
Axial Disc 1	2021-08-16	9	41	2	11	0.8083
Dungeon Color	2021-10-12	10	41	2	12	0.8083
Mutant Alley: Do The Dinosaur	2021-03-11	5	98	10	15	0.8081999999999999
Object N	2021-01-13	50	681	115	165	0.8079000000000001
Arietta of Spirits	2021-08-20	53	294	43	96	0.8079000000000001
Cobots	2021-04-09	4	23	0	4	0.8079000000000001
DREAM TIME	2021-06-19	4	23	0	4	0.8079000000000001
CheeseCube	2021-07-16	4	23	0	4	0.8079000000000001
Relaxing Kite	2021-02-23	4	23	0	4	0.8079000000000001
Bunny's Ban	2021-04-02	4	23	0	4	0.8079000000000001
Elemental Angel	2021-04-01	3	23	0	3	0.8079000000000001
Converter	2021-04-06	3	23	0	3	0.8079000000000001
Puzzledorf	2021-08-31	2	23	0	2	0.8079000000000001
Tybot Invasion: The Typing Runner	2021-06-09	4	23	0	4	0.8079000000000001
Let's Puzzle	2021-11-24	9	23	0	9	0.8079000000000001
Six Faces | Overpower	2021-12-15	3	23	0	3	0.8079000000000001
Fling to the Finish	2021-08-23	1112	794	137	1249	0.8078000000000001
Spectacular Sparky	2021-10-20	9	91	9	18	0.8078000000000001
Army of Numbers	2021-06-23	66	56	4	70	0.8076000000000001
Mighty Goose	2021-06-05	283	579	96	379	0.8075
Noob, les Sans-Factions	2021-06-29	1496	760	131	1627	0.8073
Retro Machina: Nucleonics	2021-04-14	91	110	12	103	0.8073
Devil Girl	2021-02-19	132	562	93	225	0.8072
Rolling Hamster	2021-03-24	12	32	1	13	0.8072
Lost Caves	2021-01-29	9	32	1	10	0.8072
Legend of Chilli Tree	2021-08-02	200	32	1	201	0.8072
Dash Lamb	2021-07-06	6	32	1	7	0.8072
Namaiki Dark Elf Sisters	2021-09-30	20	32	1	21	0.8072
SEARCH ALL - STEAMPUNK	2021-11-20	3	32	1	4	0.8072
The Teleport	2021-06-29	50	48	3	53	0.8069
Voxel Tycoon	2021-04-15	1728	1190	217	1945	0.8068000000000001
El Shaddai ASCENSION OF THE METATRON HD Remaster	2021-09-02	198	240	34	232	0.8066
Warp Frontier	2021-09-28	9	40	2	11	0.8066
Blockee	2021-02-10	7	40	2	9	0.8066
Unblock Me Car	2021-03-24	22	40	2	24	0.8066
Warp Factory	2021-06-10	15	40	2	17	0.8066
Kursor	2021-08-19	5	40	2	7	0.8066
Becastled	2021-02-08	1507	3416	681	2188	0.8065000000000001
Grow: Song of the Evertree	2021-11-16	958	1461	273	1231	0.8063
Sword and Fairy 3	2021-04-15	753	1116	203	956	0.8063
My Singing Monsters Playground	2021-11-09	29	115	13	42	0.8062
Purgo box	2021-07-14	12	55	4	16	0.8062
Battle Ball	2021-03-13	105	393	62	167	0.8061
TOHU	2021-01-28	60	445	72	132	0.8058
Red Ronin	2021-03-17	17	127	15	32	0.8058
Alice and You in the planet of number.	2021-03-06	7	22	0	7	0.8054000000000001
Total Arcade Racing	2021-05-07	17	22	0	17	0.8054000000000001
If It Please the Court	2021-05-20	17	22	0	17	0.8054000000000001
ENDO	2021-08-30	4	22	0	4	0.8054000000000001
Vectors	2021-02-04	4	22	0	4	0.8054000000000001
Soaring Machinariae	2021-06-10	6	22	0	6	0.8054000000000001
Beautiful Vikings	2021-08-25	3	22	0	3	0.8054000000000001
Electronic Universe	2021-11-11	3	22	0	3	0.8054000000000001
VAR: Exterminate	2021-05-16	13	114	13	26	0.8053
Growbot	2021-10-21	17	95	10	27	0.8053
Crowhille - Detective Case Files VR	2021-09-10	7	95	10	17	0.8053
Shields of Loyalty	2021-03-18	10	47	3	13	0.8053
末代侠客	2021-06-11	24	168	22	46	0.8052
Machizzle	2021-01-07	6	31	1	7	0.8051
Aloof	2021-03-25	5	31	1	6	0.8051
Amazing Fix	2021-04-14	18	31	1	19	0.8051
Kungfu Cowboy	2021-07-30	8	31	1	9	0.8051
Shattered Slime	2021-03-29	12	31	1	13	0.8051
WORDLAND	2021-05-05	4	31	1	5	0.8051
Hop Step Sing! Happy People	2021-08-27	10	31	1	11	0.8051
Stalks Stalks Stalks	2021-12-20	11	31	1	12	0.8051
Mr. Prepper	2021-03-18	6911	3074	616	7527	0.805
Miska's Cave	2021-01-28	33	156	20	53	0.805
Beacon	2021-12-15	44	132	16	60	0.805
Arcana: Heat and Cold. Season 2	2021-10-14	24	75	7	31	0.805
PropHunter	2021-08-06	344	264	39	383	0.8049
Unbound: Worlds Apart	2021-07-28	162	724	127	289	0.8048000000000001
The Legend of Heroes: Sen no Kiseki II KAI -The Erebonian Civil War-	2021-02-24	152	202	28	180	0.8048000000000001
Escape the Underground	2021-03-15	21	88	9	30	0.8048000000000001
Magical Waifus Academy	2021-02-11	25	88	9	34	0.8048000000000001
Idle big Devil	2021-11-03	2137	3161	636	2773	0.8047
Vagrus - The Riven Realms	2021-10-05	694	764	135	829	0.8047
Crawlspace	2021-11-03	14	68	6	20	0.8047
Monster Hunter Stories 2: Wings of Ruin	2021-07-09	34995	11648	2511	37506	0.8045
Bloons TD Battles 2	2021-11-30	17137	19476	4280	21417	0.8044
Mysteries Under Lake Ophelia	2021-12-22	18	119	14	32	0.8044
Robot Daycare	2021-09-03	14	94	10	24	0.8044
Recon Control	2021-11-04	24	81	8	32	0.8043000000000001
Space Scavenger	2021-08-20	96	201	28	124	0.8042
Adorable Witch 2	2021-10-21	123	412	67	190	0.804
Figment 2: Creed Valley - Prologue	2021-01-15	36	106	12	48	0.8038
ALONE	2021-05-31	8	112	13	21	0.8037000000000001
Size Matters	2021-03-12	235	342	54	289	0.8036
The Sin	2021-05-20	17	118	14	31	0.8036
Siege of Avalon: Anthology	2021-04-08	137	171	23	160	0.8034
长安夜明	2021-11-10	23	67	6	29	0.8034
TechBeat Heart	2021-09-13	11	67	6	17	0.8034
Keyword: A Spider's Thread	2021-09-28	46	182	25	71	0.8031999999999999
TV Kid	2021-10-02	31	53	4	35	0.8031999999999999
ChilloutVR	2021-02-08	1409	1857	364	1773	0.8031
Keeper of the Day and Night	2021-04-01	39	30	1	40	0.8029999999999999
Puzzle Light: Slide	2021-08-13	8	30	1	9	0.8029999999999999
Rescue Operation	2021-04-21	8	204	29	37	0.8029000000000001
Light Fairytale Episode 2	2021-08-30	10	38	2	12	0.8029000000000001
Wardogs: Red's Return	2021-04-29	4	38	2	6	0.8029000000000001
Blake: The Visual Novel	2021-09-01	4	38	2	6	0.8029000000000001
Puzzle Light	2021-04-30	6	38	2	8	0.8029000000000001
Alzheimer's: Memories	2021-07-30	6	38	2	8	0.8029000000000001
Dinogotchi	2021-09-30	4	38	2	6	0.8029000000000001
Corridor 7: Alien Invasion	2021-08-06	4	21	0	4	0.8028000000000001
To Be With You	2021-07-09	4	21	0	4	0.8028000000000001
Panic Mode	2021-07-09	4	21	0	4	0.8028000000000001
the Sequence [2]	2021-11-12	8	21	0	8	0.8028000000000001
Dark Romance: Sleepy Hollow Collector's Edition	2021-03-19	10	21	0	10	0.8028000000000001
Kosmo Laika: Guide to Space	2021-05-19	2	21	0	2	0.8028000000000001
The Tower of Wowers	2021-05-31	3	21	0	3	0.8028000000000001
Super Onion Boy 2	2021-08-06	4	21	0	4	0.8028000000000001
SokoMatch: Lizard Saga	2021-06-17	4	21	0	4	0.8028000000000001
Plan B from Outer Space: A Bavarian Odyssey	2021-10-28	4	21	0	4	0.8028000000000001
Tales of Komori: Prologue	2021-08-27	7	21	0	7	0.8028000000000001
Combo Babies	2021-09-09	14	21	0	14	0.8028000000000001
Balcony	2021-10-05	7	21	0	7	0.8028000000000001
Winning Love by Daylight	2021-09-07	24	117	14	38	0.8027
Lemnis Gate	2021-09-28	807	820	149	956	0.8026000000000001
Fire & Steel	2021-12-14	10	181	25	35	0.8026000000000001
Nix Umbra	2021-11-19	6	73	7	13	0.8026000000000001
Scarlet Hood and the Wicked Wood	2021-04-08	38	158	21	59	0.8025
Spellcaster University	2021-06-15	2197	2722	552	2749	0.8024
Stuck In Time	2021-12-09	1552	545	94	1646	0.8024
Paleon	2021-04-22	34	152	20	54	0.8024
Neko Hentai Girl	2021-09-30	11	274	42	53	0.8022
3 Minute Heroes	2021-11-17	71	180	25	96	0.802
Sir Stretchalot	2021-01-08	9	104	12	21	0.802
Degraman: Act I. Vincent	2021-12-10	92	122	15	107	0.8019
Time Commando	2021-10-09	6	45	3	9	0.8019
Pinecone Game	2021-12-30	4	45	3	7	0.8019
Superstorm Melon Date	2021-01-21	7	59	5	12	0.8018000000000001
Malice & Greed	2021-03-22	10	59	5	15	0.8018000000000001
Cuccchi	2021-07-30	4	52	4	8	0.8017000000000001
Almost My Floor	2021-08-06	18	139	18	36	0.8014
Wolf of Stock Street	2021-10-28	434	525	91	525	0.8013
Explorer of Yggdrasil	2021-03-13	338	201	29	367	0.8013
Underland	2021-02-05	7	127	16	23	0.8012
Super Sami Roll	2021-07-21	16	97	11	27	0.8012
Time on Frog Island - Prologue	2021-11-12	44	97	11	55	0.8012
Ethereal Estate	2021-03-12	49	184	26	75	0.8011
Praey for the Gods	2021-12-14	428	2027	407	835	0.8009999999999999
How We Got Here	2021-05-18	58	329	53	111	0.8009999999999999
Pedro's Adventures in Spanish	2021-07-29	12	78	8	20	0.8009000000000001
Blub Emporium	2021-11-17	7	37	2	9	0.8009000000000001
Excidio the Kaiju Simulator	2021-07-16	5	37	2	7	0.8009000000000001
War Mines: WW1	2021-06-17	4	37	2	6	0.8009000000000001
Drunken Dad Simulator	2021-06-09	3	65	6	9	0.8008
Chastity Catastrophe	2021-12-20	37	65	6	43	0.8008
Wizards	2021-01-16	228	323	52	280	0.8007
God of the Arena Dungeon	2021-05-24	33	29	1	34	0.8007
Color Souls	2021-06-18	4	29	1	5	0.8007
Unforgettable You	2021-05-12	4	29	1	5	0.8007
Dumpy & Bumpy	2021-05-27	5	29	1	6	0.8007
Case 02: Paranormal Evil	2021-09-13	3	29	1	4	0.8007
Star Vortex	2021-07-08	4	29	1	5	0.8007
Murder on the Marine Express	2021-07-30	5	29	1	6	0.8007
Língua	2021-10-01	6	29	1	7	0.8007
Bombing!!	2021-05-18	7	84	9	16	0.8005
Moolii's Dreamland	2021-01-23	8	58	5	13	0.8004000000000001
BORIS RUSSIAN BEAR	2021-06-04	7	301	48	55	0.8003
Vojo	2021-04-23	11	120	15	26	0.8003
The Chameleon	2021-07-13	14	96	11	25	0.8002
Nerve	2021-02-16	23	44	3	26	0.8002
Quickly, Quackley!	2021-06-09	7	44	3	10	0.8002
Palladise Island	2021-03-26	20	108	13	33	0.8001
TitTok	2021-09-20	7	102	12	19	0.8001
SCARF	2021-12-23	49	171	24	73	0.8
Digital Janitors	2021-10-15	3	20	0	3	0.8
Hexagon puzzle	2021-01-05	7	20	0	7	0.8
Angel Made	2021-05-07	5	20	0	5	0.8
Dino Cub	2021-11-16	3	20	0	3	0.8
Retired Men's Nude Beach Volleyball League	2021-12-10	4	20	0	4	0.8
Gladiator Guild Manager	2021-10-14	1543	1559	309	1852	0.7998999999999999
Retro Machina	2021-05-12	51	165	23	74	0.7997
GAI Stops Auto: Right Version	2021-06-04	25	257	40	65	0.7996
Monster Hunter Stories 2: Wings of Ruin Trial Version	2021-07-09	1680	1025	196	1876	0.7995000000000001
Eternium	2021-10-11	773	2045	416	1189	0.7994
RetroMania Wrestling	2021-02-26	98	213	32	130	0.799
Reminiscence	2021-07-12	145	1067	206	351	0.7989
UEBERNATURAL: Prologue	2021-10-13	5	57	5	10	0.7989
Colors! Maze	2021-10-18	4	57	5	9	0.7989
Warshmallows	2021-03-10	23	36	2	25	0.7989
Higgs Boson: Minimal Puzzle	2021-05-25	5	36	2	7	0.7989
Fate of Dynasty	2021-04-23	6	36	2	8	0.7989
Sexy Tails	2021-05-07	385	424	73	458	0.7987000000000001
МЕМОЛОГИЯ	2021-05-07	10	322	53	63	0.7985
Love Flute	2021-10-02	99	244	38	137	0.7985
Twin Stones: The Journey of Bukka	2021-07-12	144	112	14	158	0.7984
fishy	2021-08-20	6	50	4	10	0.7984
TitTok Girls	2021-11-15	6	50	4	10	0.7984
BRAVELY DEFAULT II	2021-09-02	2220	1137	222	2442	0.7983
Oppaidius Desert Island!	2021-06-04	17	43	3	20	0.7983
Super High Ball: Pinball Platformer	2021-06-18	5	28	1	6	0.7983
Making it Home	2021-09-03	7	28	1	8	0.7983
Farmageddon: A Cattle Royale	2021-07-24	7	28	1	8	0.7983
Save me Mr Tako: Definitive Edition	2021-05-05	4	28	1	5	0.7983
Retro Classix: Bad Dudes vs DragonNinja	2021-03-02	3	28	1	4	0.7983
Puppy Pipy	2021-02-18	5	28	1	6	0.7983
One Pixel	2021-03-01	5	28	1	6	0.7983
Destroy The Cube	2021-03-01	3	28	1	4	0.7983
Skip Lake	2021-06-18	3	28	1	4	0.7983
Jay's Walkin'	2021-04-16	6	28	1	7	0.7983
Spell Swap	2021-09-09	17	28	1	18	0.7983
Ultreïa: Prologue	2021-04-19	4	28	1	5	0.7983
Absented Age: Squarebound International	2021-11-12	9	28	1	10	0.7983
Book of Travels	2021-10-11	1390	1345	267	1657	0.7981999999999999
Farmer's Life	2021-08-05	417	872	166	583	0.7981
Demon Turf	2021-11-04	106	346	58	164	0.7979
The Slaverian Trucker	2021-12-01	66	227	35	101	0.7979
The Red Lantern	2021-12-08	25	140	19	44	0.7979
Learning Factory	2021-02-18	70	258	41	111	0.7977
Class of '09	2021-06-10	24	134	18	42	0.7976000000000001
Horse Club Adventures	2021-05-27	39	69	7	46	0.7976000000000001
Sport Mode	2021-04-15	33	370	63	96	0.7975
Cyber Shadow	2021-01-26	490	957	185	675	0.7974
Nothing	2021-03-18	13	75	8	21	0.7973
Cute Bite	2021-08-31	31	75	8	39	0.7973
Paint By Numbers	2021-05-20	37	56	5	42	0.7973
Horror Legends	2021-09-24	20	99	12	32	0.7972
Osteoblasts	2021-02-12	14	99	12	26	0.7972
Stonefly	2021-06-01	30	93	11	41	0.7970999999999999
Larry The Unlucky Part 2	2021-08-13	20	93	11	31	0.7970999999999999
Women of Xal	2021-10-30	5	19	0	5	0.7970999999999999
The Revolt: Awakening	2021-02-01	5	19	0	5	0.7970999999999999
The Grim Ending	2021-01-01	2	19	0	2	0.7970999999999999
Bonsai Castles	2021-04-29	9	19	0	9	0.7970999999999999
Guile & Glory: Firstborn	2021-10-07	5	19	0	5	0.7970999999999999
Rezzil Index / Lite	2021-01-19	4	19	0	4	0.7970999999999999
Battle Strike World War	2021-12-22	5	19	0	5	0.7970999999999999
The World's Hardest Game 3D	2021-02-02	9	19	0	9	0.7970999999999999
EQUALINE	2021-02-08	155	19	0	155	0.7970999999999999
Phucker in the Ashes	2021-02-07	3	19	0	3	0.7970999999999999
Deck Adventurers - Origins	2021-05-14	5	19	0	5	0.7970999999999999
Invisible services – Pixel Art Jigsaw Puzzle	2021-03-08	3	19	0	3	0.7970999999999999
Wisly and the Chickens!	2021-08-27	6	19	0	6	0.7970999999999999
Goldenjar Fall	2021-07-08	2	19	0	2	0.7970999999999999
WORDLAND 2	2021-06-03	4	19	0	4	0.7970999999999999
AIKAGI	2021-11-18	6	19	0	6	0.7970999999999999
FLYING PUDDING	2021-07-06	11	19	0	11	0.7970999999999999
All Dream Long A Flower Storm	2021-08-20	6	19	0	6	0.7970999999999999
I Love Finding Cats	2021-09-21	4	19	0	4	0.7970999999999999
Christmas With My Family - Jigsaw Puzzle	2021-12-04	6	19	0	6	0.7970999999999999
Cinemoji: Series	2021-12-17	3	19	0	3	0.7970999999999999
Baldur's Gate: Dark Alliance	2021-12-17	333	589	108	441	0.797
Space Rescue: Code Pink	2021-02-22	177	209	32	209	0.7968999999999999
Puzzle Light: Connect	2021-09-10	11	35	2	13	0.7968000000000001
LEGO® Builder's Journey	2021-06-22	727	2424	510	1237	0.7967000000000001
Darkness Under My Bed	2021-02-19	9	62	6	15	0.7967000000000001
Tall Poppy	2021-11-26	13	110	14	27	0.7966
Alien Death Mob	2021-05-20	3	42	3	6	0.7965000000000001
Math+Sticks - Coffee Break Club	2021-11-15	8	42	3	11	0.7965000000000001
Cellings	2021-12-10	4	42	3	7	0.7965000000000001
Wordle	2021-04-12	4242	542	99	4341	0.7962
Song of Farca	2021-07-22	177	647	121	298	0.7961
Jewel Match Origins - Palais Imperial Collector's Edition	2021-07-29	16	27	1	17	0.7958
忍者明 / Ninja Ming	2021-01-18	16	27	1	17	0.7958
Neon	2021-02-26	5	27	1	6	0.7958
Tezz	2021-02-09	2	27	1	3	0.7958
Dreamer	2021-04-01	4	27	1	5	0.7958
Lost in Blindness	2021-05-17	12	27	1	13	0.7958
Super Sunny Island	2021-06-17	3	27	1	4	0.7958
Mainframe Defenders: Meltdown - Prologue	2021-06-03	183	27	1	184	0.7958
Foul Play	2021-10-22	9	27	1	10	0.7958
BOT.vinnik Chess: Mid-Century USSR Championships	2021-11-17	4	27	1	5	0.7958
SEARCH ALL - SEASHELLS	2021-12-16	3	27	1	4	0.7958
Seed of the Dead: Sweet Home	2021-08-27	1750	1901	396	2146	0.7957
CYBER EMOJI TALE 2099	2021-03-03	4	109	14	18	0.7957
距离男主自杀还剩七天	2021-02-12	288	748	143	431	0.7956000000000001
Pumpkin Days	2021-02-01	478	418	74	552	0.7955
Disc Golf Valley	2021-06-09	45	180	27	72	0.7955
Blood Card 2: Dark Mist	2021-04-16	75	201	31	106	0.7954000000000001
Speed Limit	2021-02-17	14	153	22	36	0.7954000000000001
Song of Farca: Prologue	2021-02-25	21	131	18	39	0.7953
Kate	2021-10-22	8	48	4	12	0.795
Stickit	2021-12-12	14	48	4	18	0.795
Sudoku RPG	2021-02-10	78	147	21	99	0.7948999999999999
风起长安：驭骨人	2021-12-30	50	226	36	86	0.7948000000000001
Colony Ship: A Post-Earth Role Playing Game	2021-04-06	380	654	124	504	0.7947
Noble Fates	2021-12-14	1139	863	169	1308	0.7946
Get Packed	2021-07-28	17	34	2	19	0.7946
Wildfire Swap	2021-03-31	19	34	2	21	0.7946
COPPER ODYSSEY	2021-07-30	5	34	2	7	0.7946
Howloween Hero	2021-10-25	8	34	2	10	0.7946
Cognition Method: Initiation	2021-04-23	143	346	60	203	0.7945000000000001
Cave Quest 2	2021-08-24	20	41	3	23	0.7945000000000001
Raven's Hike	2021-09-06	3	41	3	6	0.7945000000000001
International Basketball Manager 22	2021-12-16	269	173	26	295	0.7944
Cooking Simulator VR	2021-07-29	383	943	187	570	0.7942
Tender: Creature Comforts	2021-05-28	9	54	5	14	0.7942
The Legend of Heroes: Sen no Kiseki III	2021-03-24	309	285	48	357	0.794
Fantasy Tavern Sextet -Vol.2 Adventurer's Days-	2021-02-18	116	151	22	138	0.7939
Escape from Naraka	2021-07-29	13	90	11	24	0.7939
Caravan Chaos	2021-01-31	11	18	0	11	0.7939
Gloam	2021-03-01	14	18	0	14	0.7939
Nightfall Hacker	2021-03-10	5	18	0	5	0.7939
Troupe	2021-06-16	3	18	0	3	0.7939
Quest for Runia	2021-01-02	2	18	0	2	0.7939
Worm Adventure 4: Into the Wormhole	2021-02-04	8	18	0	8	0.7939
Abducted: The Night Hunters	2021-07-01	5	18	0	5	0.7939
My Jigsaw Adventures - Forgotten Destiny	2021-01-22	10	18	0	10	0.7939
La Porte des Fauconniers : Guerre Médiévale	2021-11-12	6	18	0	6	0.7939
Athena - Rabbit Jigsaw Puzzle	2021-02-04	3	18	0	3	0.7939
Oakrot - it's literally a book	2021-03-05	2	18	0	2	0.7939
Techno Tanks	2021-05-07	6	18	0	6	0.7939
Mantle	2021-11-05	4	18	0	4	0.7939
Space Moth: Lunar Edition	2021-11-18	5	18	0	5	0.7939
Host 714	2021-06-22	4	18	0	4	0.7939
窓の中の先にあるもの	2021-06-22	14	18	0	14	0.7939
Loot Slider	2021-06-01	6	18	0	6	0.7939
Raybound	2021-05-28	2	18	0	2	0.7939
The Feeble Files	2021-06-14	6	18	0	6	0.7939
Entangled	2021-09-03	3	18	0	3	0.7939
Shinobi Shift	2021-10-08	7	18	0	7	0.7939
Motivational Hero Vol. 2	2021-10-21	2	18	0	2	0.7939
Kid Hallow	2021-11-02	7	18	0	7	0.7939
Force of Nature 2	2021-05-27	1357	1369	282	1639	0.7938
The Legend of Heroes: Zero no Kiseki Kai	2021-12-22	103	224	36	139	0.7938
Pixel Art Coloring Book	2021-04-12	195	536	100	295	0.7937000000000001
My Military Life	2021-05-15	30	84	10	40	0.7937000000000001
Stories of Mara	2021-08-26	20	60	6	26	0.7937000000000001
ANDOR Ladies	2021-09-27	5	60	6	11	0.7937000000000001
Coloring Book for Kids	2021-03-08	25	72	8	33	0.7935
DeepStates [VR]	2021-06-18	6	66	7	13	0.7935
Loneliness	2021-03-01	7	101	13	20	0.7934000000000001
C-4	2021-08-27	5	47	4	9	0.7931999999999999
Ultimate Summer	2021-01-15	4	26	1	5	0.7931999999999999
Rick Henderson	2021-08-04	4	26	1	5	0.7931999999999999
Shutter Nyang	2021-03-01	9	26	1	10	0.7931999999999999
For Evelyn	2021-07-30	5	26	1	6	0.7931999999999999
Explosive Candy World	2021-09-15	4	26	1	5	0.7931999999999999
The Legion of Maelstrom	2021-05-24	6	26	1	7	0.7931999999999999
Six F and Six 0	2021-03-13	5	26	1	6	0.7931999999999999
揭谛	2021-03-03	4	26	1	5	0.7931999999999999
メンヘラフレシア　フラワリングアビス	2021-06-24	32	26	1	33	0.7931999999999999
FortressCraft : Chapter 1	2021-04-16	8	26	1	9	0.7931999999999999
Perseverance	2021-09-12	4	26	1	5	0.7931999999999999
Was It Worth It?	2021-06-23	5	26	1	6	0.7931999999999999
Sky Tale	2021-11-01	5	26	1	6	0.7931999999999999
Hidden Objects - Sleeping Beauty	2021-11-19	9	26	1	10	0.7931999999999999
Crimson Waves on the Emerald Sea	2021-12-30	5	26	1	6	0.7931999999999999
SEARCH ALL - POTIONS	2021-12-27	3	26	1	4	0.7931999999999999
FIFA 22	2021-10-01	108295	92226	22766	131061	0.793
Alex Kidd in Miracle World DX	2021-06-22	174	424	77	251	0.793
To Hell With It	2021-04-28	29	155	23	52	0.793
Subway Midnight	2021-10-28	175	723	141	316	0.7928000000000001
Last Message	2021-06-25	12	128	18	30	0.7928000000000001
Phantom Project	2021-10-12	218	170	26	244	0.7925
OLEG MONGOL	2021-02-05	218	133	19	237	0.7925
The ER: Patient Typhon	2021-04-21	6	53	5	11	0.7925
Astro Aqua Kitty	2021-06-04	10	53	5	15	0.7925
Casina: A Visual Novel set in Ancient Greece	2021-05-27	3	40	3	6	0.7925
Virtuous Western	2021-06-17	5	40	3	8	0.7925
Happenlance	2021-10-23	19	40	3	22	0.7925
Dual Souls: The Last Bearer	2021-10-19	8	33	2	10	0.7923
ODA	2021-12-21	6	33	2	8	0.7923
Regrowth	2021-04-19	5	33	2	7	0.7923
Gravity Block	2021-02-09	4	33	2	6	0.7923
Dudes on a Map: Virtual Grid Paper	2021-05-06	20	33	2	22	0.7923
无眠夜曲	2021-01-06	9	33	2	11	0.7923
Calturin	2021-08-24	5	33	2	7	0.7923
Demon Slayer Akagi	2021-07-16	6	33	2	8	0.7923
HEXCRAFT: Harlequin Fair	2021-10-22	6	33	2	8	0.7923
Dark Sheep	2021-04-23	3	33	2	5	0.7923
Lovely Planet Remix	2021-11-12	6	33	2	8	0.7923
ChessCraft	2021-12-17	10	33	2	12	0.7923
Pizza Apocalypse	2021-09-21	21	33	2	23	0.7923
Chameneon	2021-12-16	4	33	2	6	0.7923
Hardwork Simulator	2021-11-17	5	33	2	7	0.7923
Time Loader	2021-11-03	54	246	41	95	0.7922
Bird	2021-02-17	12	486	91	103	0.7918000000000001
Krunker	2021-02-01	2265	17538	4200	6465	0.7916
Gorge	2021-10-02	22	46	4	26	0.7914
Lust from Beyond	2021-03-11	1310	2756	609	1919	0.7913
The Plane Effect Prologue	2021-07-23	38	126	18	56	0.7912
Inside Depth 6	2021-03-12	16	168	26	42	0.7911
Femboy Bangers	2021-04-01	7	312	55	62	0.7909999999999999
Tunguska: The Visitation	2021-06-04	100	278	48	148	0.7909999999999999
WAIFU IMPACT	2021-04-23	13	115	16	29	0.7909999999999999
The Smurfs - Mission Vileaf	2021-10-26	37	183	29	66	0.7909
YUKI	2021-07-22	7	52	5	12	0.7908
The Touryst	2021-12-10	11	52	5	16	0.7908
Blasting Courier	2021-12-28	27	52	5	32	0.7908
Sir Lovelot	2021-03-03	7	64	7	14	0.7906000000000001
Infinitrap : Rehamstered Edition	2021-01-18	3	17	0	3	0.7905
Inner Tao	2021-04-12	8	17	0	8	0.7905
Luciform	2021-02-02	8	17	0	8	0.7905
Squingle	2021-07-15	4	17	0	4	0.7905
Cygnus Pizza Race	2021-02-12	6	17	0	6	0.7905
Happy Bones	2021-04-16	2	17	0	2	0.7905
Wizardry Squared	2021-02-26	3	17	0	3	0.7905
Peaceful Gunner	2021-02-10	3	17	0	3	0.7905
GB Rober	2021-10-13	3	17	0	3	0.7905
Hands of Wisp	2021-03-26	3	17	0	3	0.7905
Aventura Pisicului Pierdut	2021-04-19	3	17	0	3	0.7905
Robot.Start - Puzzle Game	2021-04-27	4	17	0	4	0.7905
魔法与高塔	2021-04-23	5	17	0	5	0.7905
Heartless Dark	2021-10-14	4	17	0	4	0.7905
SlikoBan	2021-06-05	3	17	0	3	0.7905
Hanoi Puzzles: Flip Match	2021-10-15	4	17	0	4	0.7905
BridgeFix 2=3-1	2021-07-15	7	17	0	7	0.7905
Cubiverse	2021-10-07	5	17	0	5	0.7905
Argus Panoptes	2021-09-17	4	17	0	4	0.7905
Starlight Explorers	2021-11-02	3	17	0	3	0.7905
Chaos Brigade	2021-11-15	3	17	0	3	0.7905
Big FLAPPY Tower VS Tiny Square	2021-09-02	4	17	0	4	0.7905
Neon Depth	2021-09-08	4	17	0	4	0.7905
Eternal Warfare	2021-09-05	6	17	0	6	0.7905
Motivational Hero	2021-09-14	2	17	0	2	0.7905
燕赤霞	2021-10-22	2	17	0	2	0.7905
Pieces of Beauty	2021-09-28	2	17	0	2	0.7905
Block City: Bus Edition	2021-12-15	2	17	0	2	0.7905
Legendary Tales	2021-09-09	249	1440	306	555	0.7904000000000001
The Wild Case	2021-04-06	15	141	21	36	0.7904000000000001
Sunset Drive 1986	2021-01-20	45	141	21	66	0.7904000000000001
Open Sorcery: Sea++	2021-01-25	14	39	3	17	0.7904000000000001
Lambs on the Road	2021-07-15	9	39	3	12	0.7904000000000001
Wholesome Slaughter	2021-01-26	5	39	3	8	0.7904000000000001
The Sych story	2021-02-01	6	39	3	9	0.7904000000000001
Marble Pop Paradise	2021-08-12	9	39	3	12	0.7904000000000001
Stardander Revenant	2021-10-18	7	39	3	10	0.7904000000000001
Gravity Heroes	2021-02-19	13	25	1	14	0.7904000000000001
Who Stole My Beard?	2021-08-02	24	25	1	25	0.7904000000000001
TRIOS	2021-09-30	6	25	1	7	0.7904000000000001
Don't Get Bit	2021-01-29	3	25	1	4	0.7904000000000001
The Awakening of Mummies	2021-05-13	4	25	1	5	0.7904000000000001
Venaitura	2021-08-02	6	25	1	7	0.7904000000000001
Spring and Girls	2021-10-13	2	25	1	3	0.7904000000000001
银河轨迹：星系制霸	2021-12-02	4	25	1	5	0.7904000000000001
Murder Diaries 2	2021-10-27	5	25	1	6	0.7904000000000001
BOT.vinnik Chess: Early USSR Championships	2021-09-02	6	25	1	7	0.7904000000000001
My Inner Darkness Is A Hot Anime Girl!	2021-10-01	4	25	1	5	0.7904000000000001
Big Cat from Hell	2021-09-29	3	25	1	4	0.7904000000000001
CARROT	2021-12-03	2	25	1	3	0.7904000000000001
One Line	2021-12-15	4	25	1	5	0.7904000000000001
Anarchy: Wolf's law	2021-11-05	123	358	65	188	0.7903
7Days Origins	2021-05-03	28	146	22	50	0.7903
Conway: Disappearance at Dahlia View	2021-11-02	48	197	32	80	0.7902
Concordia: Digital Edition	2021-09-28	92	103	14	106	0.7898999999999999
BRINK Traveler	2021-09-09	12	92	12	24	0.7898999999999999
Cute animal jigsaw puzzle	2021-03-05	4	32	2	6	0.7898999999999999
Battle for Esturia	2021-03-20	5	32	2	7	0.7898999999999999
Castle of Shikigami 2	2021-12-07	31	32	2	33	0.7898999999999999
Aliens: Fireteam Elite	2021-08-24	15568	14337	3454	19022	0.7898000000000001
Foregone	2021-03-01	308	875	179	487	0.7896
Flesh Water	2021-11-03	39	468	89	128	0.7895000000000001
Dr. oil	2021-02-26	5	45	4	9	0.7895000000000001
Universe For Sale - Prologue	2021-06-06	5	45	4	9	0.7895000000000001
Lone McLonegan : A Western Adventure	2021-11-03	11	45	4	15	0.7895000000000001
HoneyHoneyHoney!	2021-08-23	9	45	4	13	0.7895000000000001
Toilet Flushing Simulator	2021-10-22	5	45	4	9	0.7895000000000001
Wizardry: The Five Ordeals	2021-12-17	929	279	49	978	0.7894
Ship Handling Simulator	2021-01-04	8	69	8	16	0.7894
Xuan-Yuan Sword 2	2021-02-08	99	155	24	123	0.7893000000000001
Undercover Agent	2021-07-10	301	681	136	437	0.7892
Hidden Memory - Neko's Life	2021-02-25	5	51	5	10	0.7891
Peppy's Adventure	2021-09-20	9	51	5	14	0.7891
Shikkoku no Sharnoth	2021-12-15	19	51	5	24	0.7891
The Legend of Heroes: Sen no Kiseki IV -THE END OF SAGA-	2021-12-22	285	195	32	317	0.789
大亨传奇	2021-07-26	188	195	32	220	0.789
春と修羅｜Haru to Shura	2021-06-24	14	57	6	20	0.789
ALTF4	2021-11-12	1207	7865	1865	3072	0.7889
大秦帝国	2021-05-18	1942	915	189	2131	0.7889
Okinawa Rush	2021-10-21	18	102	14	32	0.7889
Tiny Stories: Santa Closes	2021-12-21	12	80	10	22	0.7889
Lover	2021-05-21	12	258	45	57	0.7886
Liftoff: Micro Drones	2021-11-30	65	159	25	90	0.7885
BoneTown	2021-06-08	446	464	89	535	0.7884000000000001
Guts 'N Goals	2021-08-31	12	38	3	15	0.7883
SEARCH ALL - CANDY	2021-11-14	3	38	3	6	0.7883
Call to Arms - Gates of Hell: Ostfront	2021-06-11	3550	6796	1609	5159	0.7881999999999999
SAMURAI WARRIORS 5	2021-07-27	1876	954	199	2075	0.7881999999999999
NEKO ARENA	2021-01-25	15	545	107	122	0.7881999999999999
Insurmountable	2021-04-29	220	518	101	321	0.7881999999999999
Dragon Creek	2021-05-03	21	112	16	37	0.7881999999999999
Neko Beach	2021-06-11	11	96	13	24	0.7881999999999999
Super Magbot	2021-06-22	54	208	35	89	0.7879
封灵档案/Soul Dossier	2021-03-29	4593	15058	3682	8275	0.7878000000000001
Ia，Ia，Cofflhu Fhtagnyaa	2021-01-05	105	237	41	146	0.7878000000000001
旅者	2021-12-20	300	101	14	314	0.7878000000000001
Neon Ships: The Type'em Up Shooter	2021-02-11	5	44	4	9	0.7875
Noir Punk	2021-06-01	5	44	4	9	0.7875
Loco - Shortline Operations	2021-12-22	28	44	4	32	0.7875
Big NEON Tower VS Tiny Square	2021-07-26	6	24	1	7	0.7875
Hexteria	2021-08-30	10	24	1	11	0.7875
Wizard Of Walls	2021-10-29	7	24	1	8	0.7875
Dracula Frames	2021-05-06	5	24	1	6	0.7875
Crazy Gravity	2021-04-20	3	24	1	4	0.7875
MENOS: PSI-SHATTER	2021-05-31	6	24	1	7	0.7875
Legendary Tales: Stolen Life	2021-10-07	15	24	1	16	0.7875
Back again	2021-10-12	5	24	1	6	0.7875
Ghosts 'n Goblins Resurrection	2021-06-01	257	569	113	370	0.7874
Arcane Arts Academy	2021-02-25	8	31	2	10	0.7874
Hidden Shapes Old West - Jigsaw Puzzle Game	2021-06-17	5	31	2	7	0.7874
Hidden Object: Detective Holmes - Heirloom	2021-09-03	12	31	2	14	0.7874
Conundrum	2021-10-08	4	31	2	6	0.7874
Matching Cats	2021-10-11	4	31	2	6	0.7874
SimRail - The Railway Simulator: Prologue	2021-12-16	288	742	152	440	0.7873000000000001
Dirge	2021-10-26	14	50	5	19	0.7873000000000001
FGTeeV Goozy	2021-09-07	40	50	5	45	0.7873000000000001
SkateBIRD	2021-09-16	186	504	99	285	0.787
Run For Cover	2021-04-09	2	16	0	2	0.7869
ParaLily	2021-11-09	4	16	0	4	0.7869
Abda Redeemer: Space alien invasion	2021-10-26	3	16	0	3	0.7869
Critical Zone	2021-02-12	5	16	0	5	0.7869
Rotund Takeoff	2021-01-21	10	16	0	10	0.7869
Bloat	2021-04-02	3	16	0	3	0.7869
Kavel	2021-04-15	8	16	0	8	0.7869
Pingers	2021-07-29	5	16	0	5	0.7869
In Search of Fon Vitae	2021-08-30	4	16	0	4	0.7869
Time Storm	2021-03-03	5	16	0	5	0.7869
Fono	2021-01-22	6	16	0	6	0.7869
Operation Thunder	2021-09-30	3	16	0	3	0.7869
Shinobi's Way - a jigsaw chess tale	2021-05-27	3	16	0	3	0.7869
Freebooter of SPLORR!!	2021-07-01	2	16	0	2	0.7869
Angle Soccer	2021-07-21	3	16	0	3	0.7869
Viking Heroes 2	2021-07-29	19	16	0	19	0.7869
Gabriels Worlds The Adventure	2021-07-20	3	16	0	3	0.7869
Pill Puzzle 2	2021-08-20	3	16	0	3	0.7869
Jubilane	2021-08-23	4	16	0	4	0.7869
Tangent Rush	2021-09-13	3	16	0	3	0.7869
Pumpkins	2021-10-21	3	16	0	3	0.7869
One Pixel The War Begins	2021-10-01	2	16	0	2	0.7869
Dog Adventure	2021-12-30	3	16	0	3	0.7869
Flynn: Son of Crimson	2021-09-15	157	315	58	215	0.7866
Farm Frenzy Refreshed	2021-01-28	28	89	12	40	0.7865000000000001
Endless Furry Killer 3D	2021-01-25	5	67	8	13	0.7865000000000001
LOST EGG 2: Be together	2021-04-30	206	171	28	234	0.7864
The Last Stand: Aftermath	2021-11-16	2942	3680	858	3800	0.7863
Pro Strategy Football 2022	2021-09-01	42	78	10	52	0.7863
Your Adventure	2021-07-23	23	78	10	33	0.7863
RAILROADS Online	2021-10-01	2039	2967	684	2723	0.7862
Yakuza 3 Remastered	2021-01-28	2740	4386	1034	3774	0.7859999999999999
Trikaya	2021-01-18	22	243	43	65	0.7859999999999999
Three Fairies' Hoppin' Flappin' Great Journey! | 三妖精のぴょこぴょこ討伐大作戦！	2021-08-27	86	115	17	103	0.7859999999999999
Jogward	2021-08-13	110	37	3	113	0.7859999999999999
Black Smith3	2021-05-29	16	37	3	19	0.7859999999999999
Blue Fire	2021-02-04	298	1784	399	697	0.7859
Arcade Tycoon	2021-10-14	58	336	63	121	0.7858
Eiyu*Senki Gold - A New Conquest	2021-06-25	293	266	48	341	0.7857
Switchball HD	2021-05-17	12	83	11	23	0.7857
Wave Break	2021-06-11	42	72	9	51	0.7857
WillWalker	2021-05-24	29	72	9	38	0.7857
The Catacombs of Solaris Revisited	2021-02-17	6	55	6	12	0.7857
The Frosts: First Ones	2021-08-31	9	55	6	15	0.7857
ColorBlend FX: Desaturation Prologue	2021-08-01	25	55	6	31	0.7857
SURV1V3	2021-06-20	148	1349	296	444	0.7856000000000001
Путешествие паладина	2021-08-27	9	49	5	14	0.7855
Jet Kave Adventure	2021-01-15	12	49	5	17	0.7855
Super Plexis	2021-02-20	99	43	4	103	0.7855
Shut your teeth	2021-07-21	5	43	4	9	0.7855
Coin Pusher World	2021-09-02	27	43	4	31	0.7855
BIOHAZARD VILLAGE Z Version	2021-01-22	4827	194	33	4860	0.7854000000000001
OshiRabu: Waifus Over Husbandos ~Love･or･die~	2021-07-30	113	394	76	189	0.7853
Til Nord	2021-06-29	49	443	87	136	0.7851
Rooten	2021-09-08	12	66	8	20	0.7851
Mi Scusi	2021-10-08	28	66	8	36	0.7851
Fat Prisoner Simulator 3	2021-01-09	5	77	10	15	0.785
The Alien Trials	2021-03-19	6	30	2	8	0.7848
Mr. Hopp's Manor Escape	2021-10-17	23	30	2	25	0.7848
Chesskoban	2021-11-06	5	30	2	7	0.7848
Mason and Strings	2021-12-03	3	30	2	5	0.7848
Next Space Rebels	2021-11-17	121	207	36	157	0.7846
2ECONDS TO STΔRLIVHT: My Heart's Reflection	2021-01-23	5	82	11	16	0.7845000000000001
Grim Earth	2021-10-15	4	23	1	5	0.7844
洞穴探险队 Caver	2021-04-26	10	23	1	11	0.7844
Twilight Memoria	2021-08-20	5	23	1	6	0.7844
Parallel Shift	2021-02-15	3	23	1	4	0.7844
Starlight: Eye of the Storm	2021-10-30	3	23	1	4	0.7844
正宗台灣十六張麻將	2021-02-08	29	23	1	30	0.7844
Anime Holidays	2021-01-21	2	23	1	3	0.7844
The Little Trashmaid Puzzletime	2021-05-14	5	23	1	6	0.7844
Russian Mailman Simulator	2021-05-05	3	23	1	4	0.7844
clown town 1443	2021-05-05	3	23	1	4	0.7844
Nature and Girls	2021-10-19	3	23	1	4	0.7844
Madrid Noir	2021-11-08	2	23	1	3	0.7844
DELUGE	2021-11-30	5	23	1	6	0.7844
Snowpainters	2021-07-14	19	71	9	28	0.7843000000000001
CountryBalls Heroes	2021-11-16	207	286	53	260	0.7842
Cobra Kai: The Karate Kid Saga Continues	2021-01-05	92	377	73	165	0.7841
Uberlaufer	2021-11-19	10	54	6	16	0.784
Twilight Town: A Cyberpunk Day In Life	2021-03-24	6	76	10	16	0.7837000000000001
Sunshine Manor	2021-10-28	8	36	3	11	0.7837000000000001
Hyper Echelon	2021-11-11	8	36	3	11	0.7837000000000001
Hidden Shapes Animals - Jigsaw Puzzle Game	2021-04-14	6	36	3	9	0.7837000000000001
Toru	2021-05-29	6	36	3	9	0.7837000000000001
Cyjin: The Cyborg Ninja	2021-11-10	8	36	3	11	0.7837000000000001
Triclinium	2021-12-15	3	36	3	6	0.7837000000000001
Ocean's Heart	2021-01-21	200	790	168	368	0.7835
Funny Truck	2021-07-30	5	42	4	9	0.7834000000000001
Master Forge	2021-10-28	5	42	4	9	0.7834000000000001
Gamedec - Definitive Edition	2021-09-16	386	1004	219	605	0.7831999999999999
House Builder: First Job	2021-07-15	181	302	57	238	0.7831999999999999
Escalation!	2021-03-03	23	107	16	39	0.7831999999999999
Märchen Forest	2021-01-27	115	228	41	156	0.7831
Blackout	2021-08-19	7	15	0	7	0.783
A Winding Path	2021-08-26	4	15	0	4	0.783
Cascade Cafe	2021-10-16	3	15	0	3	0.783
Country Discoverer	2021-04-16	8	15	0	8	0.783
Cardinal Chains	2021-09-09	4	15	0	4	0.783
Xeno Shooter	2021-04-30	3	15	0	3	0.783
BasCatball Jupiter	2021-01-15	4	15	0	4	0.783
Scrapshoot	2021-10-22	4	15	0	4	0.783
Crucible	2021-03-22	27	15	0	27	0.783
Lucid: Parables of the Ubermensch	2021-03-25	2	15	0	2	0.783
Human Guise	2021-12-27	3	15	0	3	0.783
Cossack and Magic	2021-05-06	3	15	0	3	0.783
Don't cut your hand 2	2021-08-06	12	15	0	12	0.783
The Lost Robot - Jigsaw Puzzle Stories	2021-08-27	6	15	0	6	0.783
TurBot	2021-07-30	4	15	0	4	0.783
RETROLD	2021-07-28	4	15	0	4	0.783
Get Stuffed!	2021-08-13	7	15	0	7	0.783
Panda in the clouds	2021-08-24	2	15	0	2	0.783
Gra & Vity	2021-10-08	2	15	0	2	0.783
Nino Maze LOFI II	2021-10-25	5	15	0	5	0.783
HyperFleet	2021-09-10	3	15	0	3	0.783
The Fox in the Forest	2021-10-18	7	15	0	7	0.783
Snowman Arena	2021-12-20	3	15	0	3	0.783
Spermicide	2021-10-24	3	15	0	3	0.783
Cinemoji: Halloween	2021-11-08	3	15	0	3	0.783
Dreamer: Puzzle	2021-11-01	3	15	0	3	0.783
Solitaire Harmony	2021-12-15	4	15	0	4	0.783
Infinite jump	2021-07-13	80	369	72	152	0.7829
ADVERSE	2021-01-22	6	70	9	15	0.7829
CYBRID	2021-11-19	5	70	9	14	0.7829
Panzer Knights	2021-05-19	248	1071	236	484	0.7826000000000001
Kyvir: Rebirth	2021-02-01	276	332	64	340	0.7825
Slobbish Dragon Princess	2021-01-29	47	170	29	76	0.7824
MetaPhysical	2021-10-28	57	170	29	86	0.7824
my fluffy life	2021-09-30	11	75	10	21	0.7823000000000001
Toy Tinker Simulator: Prologue	2021-01-22	99	121	19	118	0.7822
Westwood Shadows: Prologue	2021-09-23	20	116	18	38	0.7822
The Sundew	2021-10-14	9	53	6	15	0.7822
Limitless Hunger	2021-10-17	8	53	6	14	0.7822
Fish Person Shooter	2021-05-20	9	29	2	11	0.7820999999999999
My Life Changed	2021-08-25	6	29	2	8	0.7820999999999999
The Dawning Clocks Of Time	2021-09-08	3	29	2	5	0.7820999999999999
Hentai World: Animated Puzzle	2021-07-28	27	64	8	35	0.782
Titan Chaser	2021-02-23	15	476	97	112	0.7819
Yerba Mate Tycoon	2021-09-03	24	80	11	35	0.7819
NIGHTSLINK	2021-08-24	8	80	11	19	0.7819
The Timeless Child	2021-12-10	961	1510	344	1305	0.7818
SYNTHETIK 2	2021-11-11	1170	1040	230	1400	0.7818
virtual beepis	2021-07-01	9	47	5	14	0.7816
Gal*Gun Returns	2021-02-12	112	183	32	144	0.7815000000000001
Aeterna Noctis	2021-12-14	130	849	185	315	0.7814
Forgotten Fields	2021-04-14	10	69	9	19	0.7814
Crypto Girls [18+] - SEXCoin	2021-11-06	724	125	20	744	0.7813
Bubbaruka!	2021-06-22	6	41	4	10	0.7813
Crime Reaper	2021-05-12	9	35	3	12	0.7813
Laserboy	2021-11-22	7	35	3	10	0.7813
Lucky's Tale VR	2021-12-09	6	35	3	9	0.7813
Girl Jigsaw 2	2021-07-15	201	324	63	264	0.7812000000000001
Kakele Online - MMORPG	2021-04-15	113	154	26	139	0.7812000000000001
Hexagon Knockout	2021-08-31	51	110	17	68	0.7812000000000001
The 2020 Trail	2021-11-22	6	58	7	13	0.7812000000000001
EroPhone	2021-04-26	1417	1984	463	1880	0.7811
Triversal	2021-07-13	3	22	1	4	0.7811
Dobo's Heroes	2021-05-14	2	22	1	3	0.7811
NEOGEO POCKET COLOR SELECTION Vol.1 Steam Edition	2021-09-30	7	22	1	8	0.7811
Ambush	2021-08-27	7	22	1	8	0.7811
Jgsw	2021-06-11	20	22	1	21	0.7811
Legend Of The Ape	2021-08-20	6	22	1	7	0.7811
AsMagnet	2021-09-25	3	22	1	4	0.7811
Cave Story's Secret Santa	2021-12-10	581	559	117	698	0.7809999999999999
Stellar Warfare	2021-08-04	115	182	32	147	0.7809
ppL: The Animated Adventures	2021-06-21	42	74	10	52	0.7809
Just Die Already	2021-05-20	1122	1653	382	1504	0.7808
球球少女	2021-02-17	639	777	169	808	0.7805
A Pinch of Magic	2021-04-16	29	153	26	55	0.7804000000000001
Vampirem	2021-05-20	19	63	8	27	0.7804000000000001
They Always Run	2021-10-20	67	491	102	169	0.78
After School Murder Club!!	2021-06-03	10	68	9	19	0.7798999999999999
B100X - Auto Dungeon RPG	2021-01-26	1681	630	135	1816	0.7797000000000001
Totally Reliable Delivery Service	2021-04-01	230	809	178	408	0.7796
Parasite Infection	2021-09-02	32	73	10	42	0.7795000000000001
Hextech Mayhem: A League of Legends Story™	2021-11-16	2629	1777	417	3046	0.7794
Babble Royale	2021-12-15	1747	804	177	1924	0.7794
Zombieland VR: Headshot Fever	2021-07-29	18	57	7	25	0.7794
Alexio	2021-05-08	5	28	2	7	0.7792
Saving Grace	2021-01-03	3	28	2	5	0.7792
ShapeNeon Chaos	2021-02-16	4	28	2	6	0.7792
Ghostist	2021-05-24	8	28	2	10	0.7792
a curse from beyond	2021-08-31	3	28	2	5	0.7792
Spheriums	2021-12-13	5	28	2	7	0.7792
Doom Work	2021-09-30	7	28	2	9	0.7792
The Legend of Heroes: Sen no Kiseki I KAI -Thors Military Academy 1204-	2021-02-08	219	354	71	290	0.7791
Can't Drive This	2021-03-18	58	288	56	114	0.7791
仙劍奇俠傳三外傳·問情篇	2021-04-15	160	288	56	216	0.7791
The Search For Fran	2021-07-11	5	108	17	22	0.7791
RONIN: Two Souls CHAPTER 1	2021-05-27	23	225	42	65	0.779
True Game	2021-05-25	14	40	4	18	0.779
Squadron 51 - Prologue	2021-10-01	6	40	4	10	0.779
Golf Club Wasteland	2021-09-03	55	647	140	195	0.7789
GAME.exe	2021-07-02	10	314	62	72	0.7789
Little Lives	2021-02-08	62	165	29	91	0.7787999999999999
魔灵起源	2021-11-08	110	165	29	139	0.7787999999999999
The Company Man	2021-05-28	13	62	8	21	0.7787999999999999
The Shadow You	2021-01-22	6	34	3	9	0.7787999999999999
DataJack	2021-05-24	103	34	3	106	0.7787999999999999
Untitled Marble Game	2021-06-11	6	34	3	9	0.7787999999999999
CryoFall	2021-04-29	3681	4245	1051	4732	0.7787000000000001
WaveCrash!!	2021-05-18	5	14	0	5	0.7787000000000001
ANCRA	2021-10-29	3	14	0	3	0.7787000000000001
Dextram	2021-11-08	4	14	0	4	0.7787000000000001
Finders Reapers	2021-04-14	6	14	0	6	0.7787000000000001
Marble Computing	2021-12-21	4	14	0	4	0.7787000000000001
Ninshi Masuta	2021-10-30	2	14	0	2	0.7787000000000001
Slide	2021-02-17	4	14	0	4	0.7787000000000001
ASSAULT SHELL	2021-03-19	5	14	0	5	0.7787000000000001
BATTLE ARENA	2021-03-15	5	14	0	5	0.7787000000000001
Command Line Pilot	2021-07-22	3	14	0	3	0.7787000000000001
Endocrisis	2021-06-25	3	14	0	3	0.7787000000000001
Dying Flame	2021-03-22	5	14	0	5	0.7787000000000001
Venus: Improbable Dream	2021-03-19	2	14	0	2	0.7787000000000001
Unit Down	2021-10-16	3	14	0	3	0.7787000000000001
First Days of Atlantis	2021-07-15	3	14	0	3	0.7787000000000001
Hell's Gate - Slide Puzzle	2021-03-25	2	14	0	2	0.7787000000000001
Try To Remember	2021-05-07	2	14	0	2	0.7787000000000001
Unlocked	2021-06-18	3	14	0	3	0.7787000000000001
Cinemoji: Oscar	2021-04-23	2	14	0	2	0.7787000000000001
Miko Adventures Puffball	2021-09-15	2	14	0	2	0.7787000000000001
Apollo in Outer Space	2021-05-21	15	14	0	15	0.7787000000000001
Gravity Runner	2021-10-14	2	14	0	2	0.7787000000000001
Fifefer Island	2021-08-16	2	14	0	2	0.7787000000000001
Mimir's Recruit	2021-07-28	3	14	0	3	0.7787000000000001
Hyperball Tachyon	2021-11-19	4	14	0	4	0.7787000000000001
Pow!	2021-09-24	2	14	0	2	0.7787000000000001
Hermes: Tricks of Thanatos	2021-09-01	13	14	0	13	0.7787000000000001
Food Delivery Battle	2021-09-03	18	14	0	18	0.7787000000000001
Clarence Goes to the F&#%ING Store	2021-09-03	3	14	0	3	0.7787000000000001
Lenny Loosejocks Goes Walkabout	2021-09-16	3	14	0	3	0.7787000000000001
Fleshport	2021-10-27	5	14	0	5	0.7787000000000001
Nuclear Assault	2021-10-29	3	14	0	3	0.7787000000000001
東方剛欲異聞　～ 水没した沈愁地獄	2021-10-29	1191	566	121	1312	0.7786
Impulse, From Here!	2021-02-09	18	122	20	38	0.7785
Synthwave Burnout	2021-09-04	200	122	20	220	0.7785
Lovely Warriors	2021-01-06	3	51	6	9	0.7785
OceanCraft	2021-03-07	11	51	6	17	0.7785
Simulation world	2021-05-25	5	51	6	11	0.7785
Kula	2021-07-22	3	51	6	9	0.7785
Living together with Fox Demon	2021-08-13	125	582	125	250	0.7784000000000001
LAST CLOUDIA	2021-08-30	1214	506	107	1321	0.7783
Iragon: Prologue 18+	2021-07-27	1150	390	80	1230	0.7781
Cauldrons of War - Stalingrad	2021-09-10	20	72	10	30	0.7781
Hell Architect: Prologue	2021-06-09	366	684	150	516	0.7779
Fox Girls Never Play Dirty	2021-11-12	224	145	25	249	0.7779
Physics World	2021-11-15	42	77	11	53	0.7779
STRAY KITTEN	2021-02-19	7	82	12	19	0.7778
迅风的米斯特汀 Windy Mystletainn	2021-10-20	4	21	1	5	0.7777
Hundred Chances - The Fortress	2021-01-08	8	21	1	9	0.7777
Squareometry	2021-02-12	3	21	1	4	0.7777
Neon Parkour	2021-07-06	6	21	1	7	0.7777
UnearthU	2021-05-28	4	21	1	5	0.7777
TAL: Arctic 4	2021-02-25	2	21	1	3	0.7777
LIRE	2021-03-24	3	21	1	4	0.7777
The Legend of Nayuta: Boundless Trails	2021-12-10	42	21	1	43	0.7777
Surfing and Girls	2021-08-25	2	21	1	3	0.7777
Untangle	2021-08-16	5	21	1	6	0.7777
Bloody Everybody	2021-10-15	11	21	1	12	0.7777
Voice of Cards: The Isle Dragon Roars	2021-10-28	1259	903	204	1463	0.7775
英雄伝説 創の軌跡	2021-08-25	942	591	128	1070	0.7775
Craft In Abyss	2021-01-31	11	45	5	16	0.7775
Critadel	2021-10-13	76	163	29	105	0.7774
MotoGP™21	2021-04-22	1989	1344	314	2303	0.7773000000000001
Pixel Poops	2021-02-10	15	61	8	23	0.7772
Aery - A Journey Beyond Time	2021-02-25	8	61	8	16	0.7772
FATAL FRAME / PROJECT ZERO: Maiden of Black Water	2021-10-28	3494	3830	955	4449	0.777
Arboria	2021-09-09	300	480	102	402	0.777
Puyo Puyo™ Tetris® 2	2021-03-23	943	1049	241	1184	0.7769
Aspire: Ina's Tale	2021-12-17	14	167	30	44	0.7769
Five Nations	2021-05-04	39	139	24	63	0.7768
Cactus Cowboy 3 - Fully Loaded	2021-06-21	137	66	9	146	0.7768
Legend of Keepers	2021-04-29	3127	3164	783	3910	0.7767000000000001
Cat Colony Crisis	2021-02-09	10	39	4	14	0.7767000000000001
Dear Brother	2021-05-31	5	39	4	9	0.7767000000000001
Sonata Theory	2021-07-12	2	39	4	6	0.7767000000000001
Oatmeal	2021-07-30	10	39	4	14	0.7767000000000001
Sword of the Stars: The Pit 2	2021-10-22	8	39	4	12	0.7767000000000001
Hell Shuffle	2021-02-05	7	33	3	10	0.7762000000000001
Terrene - An Evidence Of Life Game	2021-02-12	6	33	3	9	0.7762000000000001
Chess Valley	2021-02-05	4	33	3	7	0.7762000000000001
Orkana Conflict VR	2021-03-17	4	33	3	7	0.7762000000000001
Bacon Rebellion	2021-01-08	5	27	2	7	0.7762000000000001
Operation Osama Bin Laden	2021-05-24	3	27	2	5	0.7762000000000001
Eruption 爆发	2021-06-10	3	27	2	5	0.7762000000000001
Aquadine	2021-02-12	4	27	2	6	0.7762000000000001
18 Wheels of Steel: Hard Truck	2021-03-19	8	27	2	10	0.7762000000000001
Kitty Tactics	2021-02-24	4	27	2	6	0.7762000000000001
BOK-BOK: A Chicken Dating Sim	2021-03-13	2	27	2	4	0.7762000000000001
Cinemoji	2021-04-09	8	27	2	10	0.7762000000000001
Beautiful Defenders	2021-10-19	2	27	2	4	0.7762000000000001
Sinsations	2021-11-04	14	27	2	16	0.7762000000000001
Typing Land	2021-11-30	17	27	2	19	0.7762000000000001
New Year Girls	2021-12-24	3	27	2	5	0.7762000000000001
Dust to the End	2021-08-11	761	838	190	951	0.7761
Runeverse: The Card Game	2021-04-12	107	481	103	210	0.7761
Love Season	2021-09-24	235	250	49	284	0.7758
FarmD	2021-12-03	51	661	147	198	0.7757
Let It Flow	2021-03-05	134	599	132	266	0.7756000000000001
New York Rat Simulator	2021-11-13	17	95	15	32	0.7755
IdolDays	2021-08-05	45	95	15	60	0.7755
Scrapland Remastered	2021-12-13	26	60	8	34	0.7755
大禹治水 Flood Fighting Hero	2021-04-29	21	60	8	29	0.7755
He Needs His Medicine	2021-04-14	33	958	221	254	0.7754000000000001
Hentai Femdom Sim: Femdom University	2021-08-04	103	284	57	160	0.7754000000000001
A Field of Flowers and Stars	2021-08-20	4	44	5	9	0.7754000000000001
Fish Story	2021-11-11	3	44	5	8	0.7754000000000001
[NINJA GAIDEN: Master Collection] NINJA GAIDEN Σ	2021-06-10	1603	1337	317	1920	0.7752
Run Prop, Run!	2021-06-23	274	581	128	402	0.7752
Undernauts: Labyrinth of Yomi	2021-11-04	113	85	13	126	0.7752
BlackChain	2021-03-17	14	80	12	26	0.7751000000000001
The Shape of Time	2021-08-27	4	70	10	14	0.7751000000000001
The Slormancer	2021-04-06	4614	2983	746	5360	0.7747
Nebuchadnezzar	2021-02-17	1113	1116	262	1375	0.7747
Night in Riverager	2021-02-02	22	173	32	54	0.7747
Barro 22	2021-11-05	55	99	16	71	0.7746
Viking Trickshot	2021-07-01	49	49	6	55	0.7745000000000001
Agent Intercept	2021-06-16	8	49	6	14	0.7745000000000001
Kawaii Neko Girls	2021-11-04	45	549	121	166	0.7744
Crisis Brigade 2 reloaded	2021-11-11	21	221	43	64	0.7743000000000001
ASTRO ACE	2021-09-15	5	38	4	9	0.7743000000000001
44 Minutes in Nightmare	2021-03-15	19	38	4	23	0.7743000000000001
Forgetter	2021-04-17	8	38	4	12	0.7743000000000001
Storm Tale 2	2021-04-15	21	38	4	25	0.7743000000000001
恶灵退散 Go Back to Hell	2021-10-20	4	38	4	8	0.7743000000000001
Diefrosty	2021-12-15	7	38	4	11	0.7743000000000001
League Of Enthusiastic Losers	2021-10-13	14	136	24	38	0.7742
Days Of Purgatory	2021-01-06	5	13	0	5	0.7741
Palladium: Adventure in Greece	2021-06-05	3	13	0	3	0.7741
WizardPunk	2021-09-01	2	13	0	2	0.7741
Diamond Mirage	2021-06-04	4	13	0	4	0.7741
ZEROED	2021-08-09	7	13	0	7	0.7741
The Lost Legends of Redwall: The Scout Act 2	2021-04-30	4	13	0	4	0.7741
Battle Jacked	2021-05-06	4	13	0	4	0.7741
Hover Attack 3671	2021-12-30	6	13	0	6	0.7741
Zodiac DX	2021-07-15	4	13	0	4	0.7741
The Last Act	2021-03-16	3	13	0	3	0.7741
Bricky to Me	2021-11-05	2	13	0	2	0.7741
Hellcraze	2021-02-05	3	13	0	3	0.7741
Don´t Spill	2021-01-11	3	13	0	3	0.7741
27 pages	2021-01-03	2	13	0	2	0.7741
Bird Pro Skater	2021-12-10	2	13	0	2	0.7741
Vidya Poker	2021-07-21	4	13	0	4	0.7741
只是一座楼	2021-03-24	3	13	0	3	0.7741
War Tank combat	2021-03-30	2	13	0	2	0.7741
Cat's Life Jigsaw Puzzles	2021-03-25	5	13	0	5	0.7741
Battle Star Asteroids	2021-05-12	2	13	0	2	0.7741
Life-Winner Cong's Double Dragon Dream	2021-05-05	3	13	0	3	0.7741
Eternia: Pet Whisperer	2021-05-05	4	13	0	4	0.7741
Timo's Adventures	2021-05-27	7	13	0	7	0.7741
Deep Rune	2021-10-14	6	13	0	6	0.7741
Slime's Journey	2021-09-15	4	13	0	4	0.7741
Printersim	2021-10-28	4	13	0	4	0.7741
Evorales	2021-08-06	7	13	0	7	0.7741
4 Alice Magical Autistic Girls	2021-11-06	3	13	0	3	0.7741
末日竟在我身边2 - Zombies Everywhere 2	2021-09-30	3	13	0	3	0.7741
Survival: Zombies aHead	2021-10-21	2	13	0	2	0.7741
诡事影院	2021-10-28	3	13	0	3	0.7741
Nott Longa	2021-11-05	3	13	0	3	0.7741
Metallophobia	2021-12-30	3	13	0	3	0.7741
Fire in the Beastlands	2021-12-02	4	13	0	4	0.7741
Princess Sera adventures	2021-12-07	3	13	0	3	0.7741
Flipped	2021-12-23	2	13	0	2	0.7741
Grass Cut	2021-12-18	2	13	0	2	0.7741
Among Ass 2: Butt Warfare	2021-04-24	9	122	21	30	0.774
Floor Plan 2	2021-04-01	19	54	7	26	0.774
Motor Strike: Racing Rampage	2021-01-28	9	20	1	10	0.774
Things That Bounce and Explode	2021-03-30	2	20	1	3	0.774
Placebo Love	2021-09-07	6	20	1	7	0.774
Kraken Smash: Volleyball	2021-01-26	8	20	1	9	0.774
Stand By Me	2021-07-01	5	20	1	6	0.774
Rings of Hell	2021-08-04	8	20	1	9	0.774
Junkyard Fury	2021-09-30	2	20	1	3	0.774
Need More Troops	2021-10-02	5	20	1	6	0.774
Winning Love by Daylight [Ep 1+2]	2021-11-08	7	20	1	8	0.774
The Alien Cube	2021-10-14	47	242	48	95	0.7739
The Caregiver | 終焉介護	2021-04-03	99	246	49	148	0.7737
Ark of Artemis	2021-05-22	120	176	33	153	0.7737
SilverFrame(纯白星原)	2021-03-31	7	59	8	15	0.7737
Neko Candy Shop	2021-09-17	5	126	22	27	0.7734000000000001
Gravia	2021-03-15	6	32	3	9	0.7734000000000001
Stand 'em Up	2021-06-11	144	32	3	147	0.7734000000000001
French Crime	2021-11-25	60	32	3	63	0.7734000000000001
Welcome To Your Immune System	2021-12-09	5	32	3	8	0.7734000000000001
Mini Words: Polyglot	2021-03-18	7	43	5	12	0.7732
Măgurele Mystery	2021-12-03	8	43	5	13	0.7732
Jad	2021-02-17	4	26	2	6	0.773
Mixx Island: Remix	2021-01-02	7	26	2	9	0.773
Skeleton King	2021-01-26	4	26	2	6	0.773
Cake Invaders	2021-06-04	4	26	2	6	0.773
BOT.vinnik Chess: Late USSR Championships	2021-12-17	3	26	2	5	0.773
PIGGY: Hunt	2021-10-14	342	1040	246	588	0.7729
Abomi Nation	2021-07-29	34	88	14	48	0.7729
Disillusion	2021-08-30	5	88	14	19	0.7729
My University Girlfriend	2021-12-13	6	83	13	19	0.7726000000000001
Devilated	2021-01-30	8	48	6	14	0.7725
Mark & Lara: Partners In Justice	2021-04-16	14	48	6	20	0.7725
Crowalt: Traces of the Lost Colony - Prologue	2021-08-13	136	183	35	171	0.7724
SUCCUBUS	2021-10-05	1792	2992	761	2553	0.7723000000000001
Hot Brass	2021-02-26	156	332	70	226	0.7723000000000001
Voyage	2021-02-19	11	97	16	27	0.7723000000000001
My New Memories	2021-06-11	310	256	52	362	0.7722
Viral Firar	2021-09-07	153	187	36	189	0.7722
Runeverse: Sea Brawls	2021-11-01	358	700	161	519	0.7721
Recursive Hate	2021-08-01	12	53	7	19	0.7721
SAMUDRA	2021-09-29	11	68	10	21	0.772
Save daddy trump 2: The Final Triumph	2021-01-06	6	68	10	16	0.772
Human Apocalypse: Prologue	2021-12-13	17	63	9	26	0.7719
Banners of Ruin	2021-07-29	1136	1931	481	1617	0.7718
Royale Age: Battle of Kings	2021-06-01	14	37	4	18	0.7718
PowerSlave (DOS Classic Edition)	2021-07-27	7	37	4	11	0.7718
Car Detailing Simulator: Prologue	2021-11-15	276	761	177	453	0.7716
Rogue Heroes: Ruins of Tasos	2021-02-23	1649	1780	442	2091	0.7715000000000001
ARKOS	2021-11-03	14	101	17	31	0.7715000000000001
The Longest Road on Earth	2021-05-27	29	279	58	87	0.7711
Lovely Overseer	2021-04-12	49	77	12	61	0.7709
Hero's Spirit	2021-01-01	37	42	5	42	0.7709
Royale Island Showdown	2021-02-11	18	105	18	36	0.7708
SCORCH	2021-05-15	136	72	11	147	0.7706999999999999
Mandinga - A Tale of Banzo	2021-09-17	5	31	3	8	0.7706000000000001
Sliko	2021-03-27	5	31	3	8	0.7706000000000001
Deadly Daycare VR	2021-05-01	6	31	3	9	0.7706000000000001
Apple Bang!	2021-06-05	11	31	3	14	0.7706000000000001
武者斗天师	2021-08-19	6	31	3	9	0.7706000000000001
Give Me More Pills	2021-11-07	6	31	3	9	0.7706000000000001
Plinko Panic!	2021-12-18	11	31	3	14	0.7706000000000001
Fish Story: Gourmet Puzzle	2021-12-22	5	31	3	8	0.7706000000000001
Clown In A House	2021-07-20	16	47	6	22	0.7704000000000001
Albert and Camille's Little Lille Adventure	2021-11-26	8	47	6	14	0.7704000000000001
First Class Trouble	2021-11-01	1271	2609	668	1939	0.7703
Eternal Cave Escape	2021-08-06	30	100	17	47	0.7703
Legend of Homebody	2021-07-09	385	339	73	458	0.7702
Regain Earth: First Strike	2021-04-28	14	62	9	23	0.7702
Puzzle Box Palace	2021-01-18	8	62	9	17	0.7702
Red Embrace: Mezzanine	2021-07-09	13	62	9	22	0.7702
Live Adventure	2021-12-15	7	62	9	16	0.7702
Gem Wizards Tactics	2021-02-16	15	52	7	22	0.7702
Poppy Playtime	2021-10-12	13971	38460	10787	24758	0.7701000000000001
HaremKingdom	2021-10-25	15	57	8	23	0.7701000000000001
Beautiful Girls	2021-04-05	7	57	8	15	0.7701000000000001
Legend of Mana	2021-06-24	1479	733	172	1651	0.77
Bugvasion TD	2021-02-17	4	19	1	5	0.77
Rolling Adventure	2021-08-31	2	19	1	3	0.77
Deadly Cosmic	2021-04-29	3	19	1	4	0.77
Wolf Adventures	2021-07-30	3	19	1	4	0.77
Wide Open	2021-08-04	11	19	1	12	0.77
Diego: Mission Red Tomato	2021-05-22	2	19	1	3	0.77
Plague Breaker	2021-09-14	7	19	1	8	0.77
Sokpop S10: Hamster All-Stars	2021-03-19	4	19	1	5	0.77
Tic Tac Together	2021-05-11	7	19	1	8	0.77
Hextones: Spacetime	2021-08-05	4	19	1	5	0.77
Brave Dungeon + Dark Witch's Story:Combat	2021-08-21	25	19	1	26	0.77
Color Connect	2021-09-09	4	19	1	5	0.77
Leaf Tree	2021-10-07	4	19	1	5	0.77
Gardener's Path	2021-12-22	3	19	1	4	0.77
Alpha Shark	2021-12-10	6	19	1	7	0.77
The Divine Deception	2021-12-03	8	19	1	9	0.77
Night Delivery | 例外配達	2021-06-05	130	701	164	294	0.7698999999999999
Rocket Rumble	2021-08-03	11	25	2	13	0.7697
Binarystar Infinity	2021-02-04	3	25	2	5	0.7697
Life of Fly 2	2021-06-10	9	25	2	11	0.7697
Squeakers II	2021-06-02	6	25	2	8	0.7697
Higgs Boson: Challenging Puzzle	2021-06-18	2	25	2	4	0.7697
Rabby in the Land of Sweets	2021-08-24	5	25	2	7	0.7697
I Told You So!	2021-11-15	3	25	2	5	0.7697
Dark Roll: Free Kick Challenge	2021-08-05	1683	858	205	1888	0.7695000000000001
FPV.SkyDive	2021-05-31	96	609	141	237	0.7695000000000001
Toram Online	2021-12-20	2989	2551	657	3646	0.7692
EARTH DEFENSE FORCE: WORLD BROTHERS	2021-05-27	882	517	118	1000	0.7692
Red Button	2021-10-15	15	126	23	38	0.7692
Eggy	2021-07-21	11	36	4	15	0.7692
Steep Slopes	2021-02-26	6	36	4	10	0.7692
Drawy	2021-08-31	20	36	4	24	0.7692
World for Two	2021-07-16	7	36	4	11	0.7692
Putin VS Zombies	2021-09-30	5	71	11	16	0.7691
Hexahedral Pathfinder	2021-01-04	4	12	0	4	0.7690000000000001
Girls in Glasses	2021-04-09	9	12	0	9	0.7690000000000001
Super Bout: Champion's Tour	2021-09-10	6	12	0	6	0.7690000000000001
Siebenstreich's Nerdventure	2021-05-26	3	12	0	3	0.7690000000000001
The Lost Legends of Redwall: The Scout Act 3	2021-12-24	4	12	0	4	0.7690000000000001
Rumours From Elsewhere	2021-03-31	3	12	0	3	0.7690000000000001
Groov	2021-01-29	3	12	0	3	0.7690000000000001
Sokpop S10: n-body	2021-01-12	4	12	0	4	0.7690000000000001
Jigsaw Pieces - Sweet Times	2021-02-15	3	12	0	3	0.7690000000000001
UNPLUGGED	2021-06-09	2	12	0	2	0.7690000000000001
Sixth Extinction	2021-03-17	2	12	0	2	0.7690000000000001
The Last Friend - Prologue	2021-09-17	5	12	0	5	0.7690000000000001
UPH!	2021-03-26	5	12	0	5	0.7690000000000001
Augury	2021-05-07	9	12	0	9	0.7690000000000001
Hunted: Kobayashi Tower	2021-06-29	6	12	0	6	0.7690000000000001
Lock Lock: Farm	2021-04-06	1	12	0	1	0.7690000000000001
Imaginaria	2021-06-21	2	12	0	2	0.7690000000000001
To the Max	2021-09-04	2	12	0	2	0.7690000000000001
Frame Game	2021-07-14	15	12	0	15	0.7690000000000001
Equin 2: The Warren Peace	2021-11-19	5	12	0	5	0.7690000000000001
Crystal Sequence	2021-06-17	2	12	0	2	0.7690000000000001
The Slaughter: Magdalene	2021-06-03	2	12	0	2	0.7690000000000001
Demon Cycle	2021-06-29	4	12	0	4	0.7690000000000001
Mousey Mick	2021-06-25	5	12	0	5	0.7690000000000001
WORDLAND 3	2021-06-17	2	12	0	2	0.7690000000000001
Shoal	2021-10-24	7	12	0	7	0.7690000000000001
LoBlocks	2021-07-30	3	12	0	3	0.7690000000000001
Infinity Tempest	2021-08-13	1	12	0	1	0.7690000000000001
Hashi: Light	2021-10-14	3	12	0	3	0.7690000000000001
Rookie Bowman	2021-08-17	2	12	0	2	0.7690000000000001
MikeTheCat	2021-08-17	2	12	0	2	0.7690000000000001
Ardarium	2021-09-10	4	12	0	4	0.7690000000000001
Alphabetical Order	2021-09-13	2	12	0	2	0.7690000000000001
――ｯ違う!!!	2021-09-16	7	12	0	7	0.7690000000000001
The Chicken's Fall	2021-09-24	3	12	0	3	0.7690000000000001
Tri-Star	2021-10-19	4	12	0	4	0.7690000000000001
时间之神的猫	2021-11-20	4	12	0	4	0.7690000000000001
GRAVV: Between Two Worlds	2021-11-18	2	12	0	2	0.7690000000000001
Circus Pocus	2021-12-03	3	12	0	3	0.7690000000000001
Road Mayhem	2021-12-29	3	12	0	3	0.7690000000000001
Princess&Blade	2021-07-07	130	692	163	293	0.7687999999999999
The Invisible Hand	2021-05-07	317	315	68	385	0.7687
Imagine Earth	2021-05-25	327	632	148	475	0.7685
Get In The Car, Loser!	2021-09-21	147	290	62	209	0.7685
Wheelie King Online	2021-03-01	29	112	20	49	0.7685
Toroom	2021-07-17	17	112	20	37	0.7685
Bankrupt Heroines 2	2021-12-22	168	80	13	181	0.7685
Vertical Shift	2021-12-24	17	61	9	26	0.7685
Frontline: World War II	2021-01-01	12	41	5	17	0.7685
Fatal Core	2021-11-05	24	41	5	29	0.7685
Witchaven	2021-06-17	5	41	5	10	0.7685
Sherlock Holmes Chapter One	2021-11-16	1329	1769	449	1778	0.7683
Students' horrible stories FIN	2021-05-25	7	56	8	15	0.7683
Futanari Jigsaw Puzzle	2021-12-08	9	46	6	15	0.7682
Smack Studio	2021-09-20	23	89	15	38	0.7681
Skellboy	2021-01-13	32	75	12	44	0.768
Dreams of Desire: Definitive Edition	2021-10-20	732	805	194	926	0.7676000000000001
Beard Blade	2021-07-20	21	84	14	35	0.7676000000000001
Cloud Cutter	2021-05-06	10	84	14	24	0.7676000000000001
Necken	2021-04-13	6	30	3	9	0.7676000000000001
ChessBase 16 Steam Edition	2021-04-20	42	30	3	45	0.7676000000000001
Escape Machine City: Airborne	2021-03-03	4	30	3	7	0.7676000000000001
Guns N' Runs	2021-03-30	7	30	3	10	0.7676000000000001
Mirlo Above the Sun	2021-06-17	149	146	28	177	0.7675000000000001
PalmRide	2021-09-16	10	102	18	28	0.7674
NGU INDUSTRIES	2021-04-05	8369	1193	297	8666	0.7673000000000001
Crush Depth: U-Boat Simulator	2021-02-10	12	65	10	22	0.7671
Siege Survival: Gloria Victis	2021-05-18	1361	999	246	1607	0.767
Cocaine Dealer	2021-12-08	12	79	13	25	0.767
Bro Falls: Ultimate Showdown	2021-12-30	2635	15509	4346	6981	0.7668
Video World	2021-01-21	19	88	15	34	0.7668
Fat Baby	2021-12-25	27	88	15	42	0.7668
Project Morpheus: Prologue	2021-01-15	77	398	90	167	0.7666
入替人-ReplaceR-	2021-07-22	144	74	12	156	0.7665000000000001
FICTION #F3F	2021-01-23	3	35	4	7	0.7665000000000001
WOLF RIOT	2021-11-15	4	35	4	8	0.7665000000000001
Markus Ritter - The Lost Family	2021-08-20	17	110	20	37	0.7664
ReversEstory	2021-06-04	10	55	8	18	0.7664
Toy Tinker Simulator: BETA	2021-05-21	541	273	59	600	0.7662000000000001
Teratopia	2021-01-20	7	24	2	9	0.7662000000000001
The Runaway Feijoão	2021-04-01	3	24	2	5	0.7662000000000001
Straya	2021-05-27	8	24	2	10	0.7662000000000001
BricksVR	2021-06-30	5	24	2	7	0.7662000000000001
GATE	2021-07-30	11	24	2	13	0.7662000000000001
Ultimate Admiral: Age of Sail	2021-04-07	926	1350	342	1268	0.7661
Guns of Succubus	2021-02-28	8	50	7	15	0.7661
Maze	2021-03-28	6	50	7	13	0.7661
Sacrificial Lighthouse	2021-10-28	6	40	5	11	0.7661
Astral Masters	2021-11-01	13	40	5	18	0.7661
In Silence	2021-10-29	2396	8547	2366	4762	0.766
Before We Leave	2021-05-13	2313	1078	269	2582	0.766
Pierhead Arcade 2	2021-08-05	10	114	21	31	0.7659
Midnight: Submersion - Nightmare Horror Story	2021-11-08	6	114	21	27	0.7659
Nanotale - Typing Chronicles	2021-03-31	64	497	116	180	0.7658
Antisnake	2021-09-20	7	18	1	8	0.7658
Shoot The Zombirds VR	2021-10-28	3	18	1	4	0.7658
Speedy Golf	2021-05-06	10	18	1	11	0.7658
King's Cup: The online multiplayer drinking game	2021-01-16	26	18	1	27	0.7658
Cold Heart	2021-02-08	6	18	1	7	0.7658
Antimatter Elevator	2021-01-22	2	18	1	3	0.7658
Textreme 2	2021-03-01	4	18	1	5	0.7658
Endurance Labyrinth	2021-03-23	3	18	1	4	0.7658
Jigsaw Pieces 3 - Fantasy	2021-06-18	5	18	1	6	0.7658
Magical Otoge Iris	2021-05-01	5	18	1	6	0.7658
Merek's Market	2021-09-15	7	18	1	8	0.7658
Flowers for You: a pleasant walk	2021-05-17	3	18	1	4	0.7658
Vulkan: Lost Planet	2021-10-22	4	18	1	5	0.7658
Luffy: Way Back Home	2021-10-21	6	18	1	7	0.7658
Knife To Meet You	2021-07-21	6	18	1	7	0.7658
Meow'n'Dash	2021-09-23	3	18	1	4	0.7658
Nuremberg: VRdict of Nations	2021-09-21	3	18	1	4	0.7658
Droopy Balls Simulator 2021	2021-09-17	4	18	1	5	0.7658
Scarlet and Blank	2021-11-05	3	18	1	4	0.7658
Cat Clicker	2021-11-24	2	18	1	3	0.7658
MARK'S LIFE	2021-12-21	3	18	1	4	0.7658
不充钱还想过关的坦克大战？	2021-12-16	7	18	1	8	0.7658
Dead Event	2021-11-08	22	118	22	44	0.7656000000000001
扫雷冒险谭2 ~露露姆的冒险~	2021-03-20	18	64	10	28	0.7654000000000001
Ransack Raccoon	2021-08-19	9	64	10	19	0.7654000000000001
HORROR TALES: The Wine	2021-07-30	31	295	65	96	0.7652
Kubifaktorium	2021-12-16	284	525	124	408	0.765
Livestream: Escape from Hotel Izanami	2021-06-10	280	428	99	379	0.7648999999999999
Zombie Survival	2021-04-29	21	113	21	42	0.7648999999999999
Starry Knight	2021-12-16	11	91	16	27	0.7648999999999999
Hell Road VR	2021-10-09	8	59	9	17	0.7648999999999999
Over The Phone	2021-02-14	5	59	9	14	0.7648999999999999
Encased	2021-09-07	3743	2984	798	4541	0.7648
Deep Space Battle Simulator	2021-11-05	35	290	64	99	0.7647
Them and Us	2021-09-28	112	653	158	270	0.7646
vrkshop	2021-12-18	20	130	25	45	0.7646
Oona the Druid's Path	2021-02-26	9	29	3	12	0.7645000000000001
The Humbling of a Holy Maiden	2021-12-10	12	29	3	15	0.7645000000000001
COROPATA	2021-03-13	19	29	3	22	0.7645000000000001
Fastest Hands In The WASD	2021-10-18	30	29	3	33	0.7645000000000001
Carnival and Girls	2021-03-30	3	29	3	6	0.7645000000000001
Food and Girls	2021-05-21	3	29	3	6	0.7645000000000001
Cloud Escape	2021-12-13	5	29	3	8	0.7645000000000001
Vesper: Zero Light Edition	2021-07-30	26	68	11	37	0.7643000000000001
Riddle of the Sphinx™	2021-02-01	18	68	11	29	0.7643000000000001
Carrier Command 2	2021-08-10	2696	1827	478	3174	0.7642
Hellcoming	2021-12-06	190	579	139	329	0.7641
Yaga	2021-01-12	273	387	89	362	0.7641
hocus 2	2021-03-04	5	49	7	12	0.7640000000000001
House Builder	2021-11-11	777	1195	305	1082	0.7639
当火车鸣笛三秒	2021-09-20	103	268	59	162	0.7637
HammerHelm	2021-04-29	101	264	58	159	0.7637
Meow Pow	2021-03-12	13	44	6	19	0.7637
Dull Grey	2021-09-08	5	44	6	11	0.7637
B.ARK	2021-07-29	12	34	4	16	0.7637
Habroxia 2	2021-02-03	6	34	4	10	0.7637
Head 2 Head	2021-06-29	9	34	4	13	0.7637
Slap The Rocks	2021-10-21	3	34	4	7	0.7637
Genesis Noir	2021-03-26	85	1076	273	358	0.7636000000000001
Nox Archaist	2021-01-28	10	39	5	15	0.7635
Sinking Inn	2021-05-01	9	39	5	14	0.7635
In Next Life	2021-12-21	12	39	5	17	0.7635
PIXASSO	2021-08-14	5	39	5	10	0.7635
Hot Vacation	2021-09-27	7	39	5	12	0.7635
东方求闻音录	2021-12-06	10	39	5	15	0.7635
Aerial_Knights Never Yield	2021-05-19	12	81	14	26	0.7634000000000001
Table of Tales: The Crooked Crown	2021-09-15	9	72	12	21	0.7634000000000001
Train Your Minibot	2021-06-30	2	11	0	2	0.7634000000000001
OAOA - Off And On Again	2021-05-28	4	11	0	4	0.7634000000000001
Super Space Towers	2021-06-29	3	11	0	3	0.7634000000000001
Hack or Die!	2021-09-24	4	11	0	4	0.7634000000000001
The Wishing Stone	2021-12-09	3	11	0	3	0.7634000000000001
Tank Quest	2021-04-12	5	11	0	5	0.7634000000000001
Gizmos: Interstellar Voyage	2021-01-28	13	11	0	13	0.7634000000000001
Kill Fish	2021-01-04	7	11	0	7	0.7634000000000001
Jetscout: Boot Camp	2021-02-24	3	11	0	3	0.7634000000000001
Clutter IX: Clutter IXtreme	2021-03-02	10	11	0	10	0.7634000000000001
Field Survivor	2021-02-17	2	11	0	2	0.7634000000000001
The Exaggerated Epoch of Edward O'Hare	2021-05-13	7	11	0	7	0.7634000000000001
Fruit Sudoku	2021-03-31	2	11	0	2	0.7634000000000001
Rebound Raver	2021-05-14	2	11	0	2	0.7634000000000001
Combat Labs	2021-04-10	5	11	0	5	0.7634000000000001
There You Are	2021-12-07	2	11	0	2	0.7634000000000001
Sokobear: Winter	2021-10-01	3	11	0	3	0.7634000000000001
Fisticubes	2021-07-21	4	11	0	4	0.7634000000000001
Dire Vengeance	2021-10-14	3	11	0	3	0.7634000000000001
Another Cat in Dungeons	2021-08-12	2	11	0	2	0.7634000000000001
V.R.G.	2021-11-05	3	11	0	3	0.7634000000000001
LinearShooter Remixed	2021-12-14	8	11	0	8	0.7634000000000001
Jack and the Beanstalk Jigsaw Puzzle	2021-11-26	3	11	0	3	0.7634000000000001
Quest of Wizard	2021-12-01	5	11	0	5	0.7634000000000001
Time of the Clones	2021-09-24	5	11	0	5	0.7634000000000001
Jujubos Puzzle	2021-09-16	2	11	0	2	0.7634000000000001
Dear Agony Aunt	2021-10-01	3	11	0	3	0.7634000000000001
Jeebo & Jerbo vs. Life	2021-10-01	3	11	0	3	0.7634000000000001
Echoed Memories	2021-11-05	7	11	0	7	0.7634000000000001
C.A.P.S. - Cyber Animal Planet Survival	2021-10-15	3	11	0	3	0.7634000000000001
Golf For Fun in Ice	2021-09-29	4	11	0	4	0.7634000000000001
TatuBall	2021-10-07	2	11	0	2	0.7634000000000001
Breadbox	2021-11-27	3	11	0	3	0.7634000000000001
UNDEMON	2021-11-20	3	11	0	3	0.7634000000000001
Vegas Tales	2021-12-24	3	11	0	3	0.7634000000000001
Skate City	2021-05-06	46	94	17	63	0.763
Grand Tactician: The Civil War (1861-1865)	2021-09-24	739	1303	337	1076	0.7628
Your Chronicle	2021-04-05	3148	916	231	3379	0.7628
Endzone - A World Apart	2021-03-18	6426	6130	1712	8138	0.7626999999999999
Farm Manager 2021	2021-05-06	3227	1363	354	3581	0.7626000000000001
Eternal Dreamers	2021-07-24	136	67	11	147	0.7626000000000001
The Drift Challenge	2021-01-30	64	444	105	169	0.7625000000000001
Deep Sea Valentine	2021-02-12	3	23	2	5	0.7625000000000001
MOENTO - Modular Environment Toolkit	2021-04-23	9	23	2	11	0.7625000000000001
King Bullseye: The Chess Strike	2021-05-05	3	23	2	5	0.7625000000000001
SISYPHUS	2021-06-04	7	23	2	9	0.7625000000000001
Propulsion	2021-07-15	7	23	2	9	0.7625000000000001
Up All Night	2021-10-20	3	23	2	5	0.7625000000000001
Octofight Escape	2021-11-05	17	23	2	19	0.7625000000000001
Crypto Against All Odds	2021-03-02	15	53	8	23	0.7624
ToruTaru	2021-09-21	7	53	8	15	0.7624
The City Must Grow	2021-12-08	15	53	8	23	0.7624
My Cute Succubus	2021-10-22	17	136	27	44	0.7623000000000001
Narita Boy	2021-03-30	225	905	229	454	0.7622
Waifu Discovered 2	2021-07-29	18	62	10	28	0.7619
Buildodge	2021-04-08	14	48	7	21	0.7618
TrackDayR	2021-03-17	89	272	61	150	0.7617
Banzai Escape 2 Subterranean	2021-10-29	46	322	74	120	0.7614000000000001
Helping the Hotties	2021-04-15	187	318	73	260	0.7614000000000001
Timerunner	2021-12-13	2060	84	15	2075	0.7614000000000001
The Market of Light	2021-09-28	105	310	71	176	0.7613
Octarina	2021-06-24	40	212	46	86	0.7613
Onirike	2021-06-29	10	43	6	16	0.7613
Pathfinders: Memories	2021-02-16	5	43	6	11	0.7613
Colosseum VR	2021-06-18	136	43	6	142	0.7613
Super Grave Snatchers	2021-10-01	6	43	6	12	0.7613
Sven's SudokuPad	2021-11-26	64	43	6	70	0.7613
6souls	2021-12-03	4	17	1	5	0.7613
Aspiring Light	2021-08-06	5	17	1	6	0.7613
Potato Party: Hash It Out	2021-11-25	3	17	1	4	0.7613
Freezer Pops	2021-10-22	9	17	1	10	0.7613
My Last Memories About You	2021-01-11	3	17	1	4	0.7613
SGS Heia Safari	2021-11-25	7	17	1	8	0.7613
MUMBA IV: Egypt Jewels	2021-12-13	3	17	1	4	0.7613
Grey Bones	2021-04-10	2	17	1	3	0.7613
Joe and the Gun	2021-05-13	3	17	1	4	0.7613
TANKBOX	2021-06-24	4	17	1	5	0.7613
Greedy Bubble	2021-06-07	2	17	1	3	0.7613
SPACE STORESHIP	2021-07-20	9	17	1	10	0.7613
Thats Life of Ralph	2021-09-13	4	17	1	5	0.7613
BuriBoard	2021-10-19	3	17	1	4	0.7613
Halloween Stories: Horror Movie Collector's Edition	2021-10-01	14	17	1	15	0.7613
SpaceGaze	2021-11-16	2	17	1	3	0.7613
BLUE REFLECTION: Second Light	2021-11-09	675	638	158	833	0.7612000000000001
MeecheenMe	2021-12-09	16	28	3	19	0.7612000000000001
Power of Two	2021-03-05	10	28	3	13	0.7612000000000001
NANOCELLS - Mission: Back Home	2021-02-06	5	28	3	8	0.7612000000000001
Tyfortress: Tactical Typing	2021-08-05	4	28	3	7	0.7612000000000001
phoToq	2021-11-16	7	28	3	10	0.7612000000000001
Larry The Unlucky Part 3	2021-11-11	6	28	3	9	0.7612000000000001
Heidelberg 1693	2021-05-21	9	57	9	18	0.7611
Two Strikes	2021-05-31	23	88	16	39	0.7609
OCO	2021-08-11	11	66	11	22	0.7609
Last Soul	2021-10-19	13	38	5	18	0.7609
Good Night, Knight	2021-02-16	12	33	4	16	0.7608
Descending I - House of Nightmares	2021-04-09	6	33	4	10	0.7608
Russian Fishing 4	2021-11-11	14317	23024	6768	21085	0.7605
Somewhere in the Shadow	2021-08-23	70	449	108	178	0.7605
流言侦探	2021-04-23	91	79	14	105	0.7605
Prince of Qin	2021-10-26	16	52	8	24	0.7603
Erica	2021-05-25	133	1098	286	419	0.7601000000000001
WanderLust	2021-02-12	30	154	32	62	0.76
Sword and Fairy 5 Prequel	2021-06-17	89	83	15	104	0.7599
Hero by Chance	2021-01-08	1133	833	213	1346	0.7598
No Umbrellas Allowed	2021-09-03	527	882	227	754	0.7595000000000001
There Is No Light 616	2021-11-10	115	221	49	164	0.7595000000000001
Dungeon Royale	2021-12-22	142	87	16	158	0.7595000000000001
Glider Sim	2021-01-28	14	74	13	27	0.7595000000000001
Tetra Cube	2021-03-21	14	47	7	21	0.7595000000000001
Zenko: A Fox's Tale	2021-08-06	12	47	7	19	0.7595000000000001
God Damn The Garden	2021-12-20	4	47	7	11	0.7595000000000001
Winning Post 9 2021	2021-04-15	3794	112	22	3816	0.7591
Helicopter Simulator VR 2021 - Rescue Missions	2021-04-01	10	116	23	33	0.7590000000000001
Castle Cardians	2021-10-08	124	95	18	142	0.7587999999999999
[TDA01] Muv-Luv Unlimited: THE DAY AFTER - Episode 01 REMASTERED	2021-02-05	38	42	6	44	0.7587999999999999
Secrets Of Soil	2021-06-11	4	42	6	10	0.7587999999999999
Little Witch Academia: VR Broom Racing	2021-07-15	5	22	2	7	0.7586
Stack Up (or dive trying)	2021-07-16	17	22	2	19	0.7586
The prisoner of the night	2021-10-01	4	22	2	6	0.7586
Save Iron Globe	2021-08-17	4	22	2	6	0.7586
Green world: Catharsis 	2021-02-06	3	22	2	5	0.7586
Inkslinger	2021-04-08	4	22	2	6	0.7586
LX Patterns	2021-02-17	4	22	2	6	0.7586
FALCO AXE	2021-03-23	3	22	2	5	0.7586
Embraced By Autumn	2021-08-24	8	22	2	10	0.7586
Lost Kittens: Maze Garden	2021-09-02	5	22	2	7	0.7586
AE86 EUROBEAT DRIFT	2021-07-17	4	22	2	6	0.7586
Cooks Girls	2021-10-21	3	22	2	5	0.7586
Eldritch Lands: The Witch Queen's Eternal War	2021-12-23	5	22	2	7	0.7586
69 Mary Love	2021-11-05	5	22	2	7	0.7586
The Wheel of Fortune	2021-12-01	5	22	2	7	0.7586
Sweet Surrender	2021-09-30	12	82	15	27	0.7585
Pirates	2021-12-11	672	520	129	801	0.7584000000000001
失格冒險者與惡魔之石	2021-07-24	83	168	36	119	0.7584000000000001
Wanted Raccoon	2021-03-19	135	345	82	217	0.7583
Horny Girl Hentai Puzzle	2021-06-16	8	107	21	29	0.7582
末日竟在我身边 - Zombies Everywhere	2021-01-26	11	60	10	21	0.7582
DOOMER'S ADVENTURE	2021-06-12	3	51	8	11	0.7582
Monkey Doomsday	2021-12-11	3	37	5	8	0.7582
Ninja Frog	2021-06-23	4	37	5	9	0.7582
Go Home, Mr. Fisk!	2021-09-27	13	37	5	18	0.7582
Lost Alone Ep.1 - Little Sister	2021-12-21	8	73	13	21	0.7579000000000001
Demons of Asteborg	2021-08-04	6	32	4	10	0.7576999999999999
Re.Surs	2021-11-08	18	32	4	22	0.7576999999999999
Treasure Adventure Game	2021-03-19	7	27	3	10	0.7576999999999999
Shadows on the Vatican: Nightingale	2021-07-27	3	27	3	6	0.7576999999999999
BitBattle	2021-03-07	9	27	3	12	0.7576999999999999
Celestial Hearts	2021-02-15	12	27	3	15	0.7576999999999999
Lost in Abyss	2021-11-11	3	27	3	6	0.7576999999999999
Day Repeat Day	2021-04-14	6	27	3	9	0.7576999999999999
Universe Generator: The Golden Sword	2021-06-08	3	27	3	6	0.7576999999999999
DOG'S DONUTS	2021-09-15	5	27	3	8	0.7576999999999999
Break Bounds: Exile	2021-10-02	5	27	3	8	0.7576999999999999
DERE EXE: Rebirth of Horror	2021-04-24	9	64	11	20	0.7574
ComPressure	2021-05-03	16	46	7	23	0.7572
Love in Belarus	2021-06-21	6	46	7	13	0.7572
DinoScape	2021-09-10	118	186	41	159	0.7571
猫不语	2021-11-19	96	102	20	116	0.7571
Abacus	2021-07-05	11	10	0	11	0.7571
IronCommando	2021-04-20	3	10	0	3	0.7571
Dain Squares	2021-07-16	2	10	0	2	0.7571
Hoverflow	2021-04-30	4	10	0	4	0.7571
Game-Kun: Input Challenge	2021-02-09	7	10	0	7	0.7571
Cardful Planning	2021-05-19	2	10	0	2	0.7571
Nyanroo The Supercat	2021-03-10	2	10	0	2	0.7571
The Game of Squids: Ultimate Parody Game	2021-11-08	4	10	0	4	0.7571
Robobo TM	2021-06-23	2	10	0	2	0.7571
Asian Riddles 4	2021-02-03	5	10	0	5	0.7571
Barrage Fantasia	2021-03-24	4	10	0	4	0.7571
She turned me into a newt!	2021-01-31	2	10	0	2	0.7571
Curatours	2021-11-09	9	10	0	9	0.7571
Flying Flogger	2021-04-15	3	10	0	3	0.7571
Childhood Fears	2021-03-27	3	10	0	3	0.7571
PuppetNetiK: SpeedRun Challenge!	2021-08-10	2	10	0	2	0.7571
Gimmick in the Chaos Dimension	2021-05-30	3	10	0	3	0.7571
Super Head Ball	2021-12-17	5	10	0	5	0.7571
HIGH&LOW　～めざせ！　26連勝！　5000兆円への道～	2021-05-11	6	10	0	6	0.7571
Der Geisterjäger / The Ghost Hunter	2021-08-26	4	10	0	4	0.7571
Herder	2021-07-27	3	10	0	3	0.7571
31st prototype	2021-05-05	2	10	0	2	0.7571
Pasta Master	2021-07-15	3	10	0	3	0.7571
AI Battle Royale Generator	2021-07-16	3	10	0	3	0.7571
VR Europe Tour	2021-05-19	2	10	0	2	0.7571
Clutter 1000	2021-06-01	8	10	0	8	0.7571
TempleFight	2021-05-25	2	10	0	2	0.7571
The Village	2021-07-31	1	10	0	1	0.7571
猜拳为尊	2021-11-01	2	10	0	2	0.7571
Be The ONE	2021-08-02	2	10	0	2	0.7571
REVO	2021-08-24	3	10	0	3	0.7571
Golf For Fun	2021-07-30	3	10	0	3	0.7571
Kosmo Laika: Space and Beyond	2021-09-23	2	10	0	2	0.7571
Love Duction! The Guide for Galactic Lovers	2021-10-15	22	10	0	22	0.7571
EOS 27	2021-11-25	3	10	0	3	0.7571
Parking light	2021-09-11	1	10	0	1	0.7571
Base Wars	2021-10-31	4	10	0	4	0.7571
Catana	2021-11-10	3	10	0	3	0.7571
Kromaticube	2021-12-15	2	10	0	2	0.7571
Kitty Cat Squash	2021-12-08	2	10	0	2	0.7571
Marmalade box	2021-12-15	2	10	0	2	0.7571
越狱挑战	2021-12-23	3	10	0	3	0.7571
Metro Sim Hustle	2021-07-24	84	228	52	136	0.7567
Castle of the Underdogs : Episode 1	2021-08-14	3	16	1	4	0.7564000000000001
Lotus Bloom	2021-02-26	3	16	1	4	0.7564000000000001
Aurora - Cores Ocultas	2021-09-02	3	16	1	4	0.7564000000000001
Everlasting Guilt	2021-07-12	4	16	1	5	0.7564000000000001
Kosta Projekt	2021-08-25	3	16	1	4	0.7564000000000001
Dragon Mission	2021-01-21	2	16	1	3	0.7564000000000001
Blind Shot	2021-03-30	2	16	1	3	0.7564000000000001
BulletGarden	2021-02-06	10	16	1	11	0.7564000000000001
Binky's Trash Service	2021-01-16	3	16	1	4	0.7564000000000001
Waifu's Spooky Space Station	2021-02-25	9	16	1	10	0.7564000000000001
Sparkles & Gems	2021-04-23	3	16	1	4	0.7564000000000001
The Game For Skippers	2021-03-14	2	16	1	3	0.7564000000000001
Clean Slate	2021-08-14	3	16	1	4	0.7564000000000001
The Death Into Trouble	2021-10-22	4	16	1	5	0.7564000000000001
Appetite for Detestation	2021-05-19	98	16	1	99	0.7564000000000001
Dream Catcher	2021-06-16	4	16	1	5	0.7564000000000001
Pill Puzzle: One Move	2021-07-29	3	16	1	4	0.7564000000000001
天气	2021-09-22	3	16	1	4	0.7564000000000001
Richard West and the Golden Mask	2021-12-15	2	16	1	3	0.7564000000000001
二狗子历险记	2021-10-22	17	16	1	18	0.7564000000000001
Sleep and Girls	2021-10-28	2	16	1	3	0.7564000000000001
Mushroom Hunter	2021-11-30	5	16	1	6	0.7564000000000001
Learning Life - Mysteeri 24/7	2021-12-17	21	16	1	22	0.7564000000000001
The Psychoduck	2021-12-14	3	16	1	4	0.7564000000000001
Holodrive	2021-03-16	1635	979	260	1895	0.7562000000000001
Warhammer 40,000: Dakka Squadron - Flyboyz Edition	2021-02-19	107	284	67	174	0.7562000000000001
Girl Jigsaw	2021-04-30	38	261	61	99	0.756
Iron Rebellion	2021-11-09	26	200	45	71	0.756
Dot's Home	2021-10-22	31	50	8	39	0.756
Gromopoli	2021-07-14	23	105	21	44	0.7558
眼中的世界 - Conviction -	2021-02-17	53	137	29	82	0.7556
Ecosystem	2021-03-16	158	237	55	213	0.7553000000000001
War Mines: WW2	2021-05-19	6	36	5	11	0.7553000000000001
Dangerous! TOO SWEET!!	2021-05-21	5	36	5	10	0.7553000000000001
Fancy the Frog	2021-07-02	4	36	5	9	0.7553000000000001
Fear Protocol: Shadow Paradigm	2021-08-06	4	36	5	9	0.7553000000000001
Not Another Dungeon?!	2021-11-19	16	36	5	21	0.7553000000000001
Encodya	2021-01-26	67	267	63	130	0.7552
8089	2021-11-05	21	54	9	30	0.755
Geadows	2021-05-24	139	54	9	148	0.755
Games and Girls	2021-04-09	5	45	7	12	0.7548
Last Light	2021-08-25	51	140	30	81	0.7547
Silent Sector	2021-02-17	46	96	19	65	0.7547
正宗台灣十六張麻將2	2021-02-08	45	31	4	49	0.7545999999999999
Marmoset	2021-10-26	11	31	4	15	0.7545999999999999
Battle Heroine Crisis	2021-12-17	106	167	37	143	0.7545000000000001
School For The Friendless	2021-10-20	24	124	26	50	0.7545000000000001
Hot Tub Simulator	2021-08-26	32	108	22	54	0.7545000000000001
Yin yang	2021-01-10	6	21	2	8	0.7544
Jewel Match Atlantis Solitaire 2 - Collector's Edition	2021-03-16	15	21	2	17	0.7544
蚂蚁模拟器（Ant simulator）	2021-04-01	5	21	2	7	0.7544
Eden's Ritter 1:2 - Priestess of Pleasure	2021-05-14	5	21	2	7	0.7544
Anatidae	2021-05-25	5	21	2	7	0.7544
HOT WHEELS UNLEASHED™	2021-09-30	2579	3989	1156	3735	0.7543000000000001
Axis & Allies 1942 Online	2021-11-09	1227	2896	828	2055	0.7543000000000001
Furry Feet	2021-08-10	23	680	178	201	0.7543000000000001
Metamorphos	2021-05-08	34	324	79	113	0.7541
Undead & Beyond	2021-06-26	7	26	3	10	0.7541
Monster's Mall	2021-01-29	3	26	3	6	0.7541
Sleep Tight	2021-03-24	4	26	3	7	0.7541
Sokocat - Islands	2021-05-14	4	26	3	7	0.7541
Noctambulant	2021-08-22	5	26	3	8	0.7541
Gear of Glass: Eolarn's war	2021-11-07	3	26	3	6	0.7541
DEATHLOOP	2021-09-14	20094	19171	5843	25937	0.7538
寂寞神明的心愿手记	2021-09-17	104	253	60	164	0.7537
Horny Sekai	2021-08-29	34	135	29	63	0.7537
Wild Dose: First Session	2021-03-01	8	62	11	19	0.7537
SATANIC PANIC 666	2021-06-05	4	62	11	15	0.7537
Deca	2021-07-16	7	49	8	15	0.7537
Cypherpunk Essentials	2021-08-11	12	49	8	20	0.7537
SKIIIIIIIIIIIIIIID	2021-01-27	6	40	6	12	0.7536
Peter's Adventures in English	2021-11-12	8	40	6	14	0.7536
Kore	2021-01-14	14	115	24	38	0.7534000000000001
Security Guy vs AI: The Dawn of AI	2021-01-24	13	66	12	25	0.7533
MXGP 2021 - The Official Motocross Videogame	2021-11-30	130	307	75	205	0.753
Project Demigod	2021-10-08	17	70	13	30	0.7529000000000001
Get To Work, Succubus-Chan!	2021-04-28	33	314	77	110	0.7528
Serious Sam: Kamikaze Attack!	2021-07-27	17	134	29	46	0.7526999999999999
Skeletal Avenger	2021-09-29	49	157	35	84	0.7525000000000001
Greak: Memories of Azur	2021-08-17	157	759	203	360	0.7524
Samurai Cat	2021-01-19	5	35	5	10	0.7524
Kochu's Dream	2021-06-10	4	35	5	9	0.7524
INSIGHT	2021-10-07	17	57	10	27	0.7523000000000001
Mighty Fight Federation	2021-02-26	18	44	7	25	0.7523000000000001
Big Farm Story	2021-08-02	433	853	231	664	0.7519
SimplePlanes VR	2021-12-17	49	137	30	79	0.7518000000000001
Suspects: Mystery Mansion	2021-11-11	304	912	249	553	0.7514000000000001
Tavern of Gods	2021-08-20	800	598	158	958	0.7514000000000001
Epic Chef	2021-11-11	272	397	101	373	0.7514000000000001
The Last Hex	2021-12-13	88	167	38	126	0.7514000000000001
Rocket Skates VR	2021-04-16	11	48	8	19	0.7514000000000001
Rogue State Revolution	2021-03-18	295	336	84	379	0.7513
Sunlight	2021-01-14	20	197	46	66	0.7513
Dum-Dum	2021-09-20	7	30	4	11	0.7512000000000001
Demon Keeper 2+	2021-01-22	9	30	4	13	0.7512000000000001
A Kiss from Death	2021-07-01	36	30	4	40	0.7512000000000001
Partitas	2021-05-10	5	30	4	9	0.7512000000000001
Sakura Forest Girls 2	2021-07-26	6	30	4	10	0.7512000000000001
Haley's story	2021-12-06	18	30	4	22	0.7512000000000001
东方十昊狱 ~ Hella Dazzling Hell!!	2021-04-30	64	73	14	78	0.751
乡间	2021-07-31	54	73	14	68	0.751
Colors!	2021-08-06	4	73	14	18	0.751
FORZA POLPO	2021-11-24	5	15	1	6	0.751
Fairyfail	2021-07-22	8	15	1	9	0.751
Carestia	2021-06-01	3	15	1	4	0.751
Where the Snow Settles	2021-07-22	4	15	1	5	0.751
Do I smell Pizza?	2021-03-05	4	15	1	5	0.751
GravKitten	2021-01-21	2	15	1	3	0.751
Blockdown	2021-09-17	2	15	1	3	0.751
Two Brain Sides	2021-06-18	3	15	1	4	0.751
Retro Classix: Gate of Doom	2021-03-02	4	15	1	5	0.751
Dairy Dave	2021-03-20	4	15	1	5	0.751
Blon	2021-09-07	3	15	1	4	0.751
Build Molecules for Vick	2021-05-10	3	15	1	4	0.751
Hard Minus Classic Redux	2021-04-17	3	15	1	4	0.751
Jessie 'Boom' James - a jigsaw chess tale	2021-06-04	3	15	1	4	0.751
Jeanne at the Clock Tower 	2021-06-10	6	15	1	7	0.751
Randy And Teddy Adventure Road	2021-09-03	2	15	1	3	0.751
Snake Deluxe	2021-07-04	3	15	1	4	0.751
OctoQuest	2021-08-17	4	15	1	5	0.751
Roskis: A Boozy Beginning	2021-12-06	4	15	1	5	0.751
Mind Scanners	2021-05-20	174	672	180	354	0.7509
Atomic Girls	2021-01-08	5	77	15	20	0.7509
The Curse of Feldar Vale	2021-08-30	13	39	6	19	0.7509
BoltBreak	2021-02-01	27	39	6	33	0.7509
Middle Age Conquest	2021-02-22	4	39	6	10	0.7509
Astatos	2021-12-17	122	155	35	157	0.7508
Horatio Goes Snowboarding	2021-07-10	204	97	20	224	0.7508
Gladiator Manager	2021-01-28	26	81	16	42	0.7508
D-Corp	2021-09-20	21	52	9	30	0.7506999999999999
Accident	2021-09-21	271	960	265	536	0.7503000000000001
MakerKing	2021-08-18	216	225	54	270	0.7503000000000001
Hepta Beats	2021-05-07	3	25	3	6	0.7503000000000001
Dark Flowers	2021-02-03	5	25	3	8	0.7503000000000001
Two Legs	2021-05-27	3	25	3	6	0.7503000000000001
藏梦：序曲	2021-08-06	7	25	3	10	0.7503000000000001
Auto Cell: Game of Life	2021-09-09	7	25	3	10	0.7503000000000001
Perfectly Balanced	2021-10-21	4	25	3	7	0.7503000000000001
Impious Pumpkins	2021-12-14	3	25	3	6	0.7503000000000001
Fire Tonight	2021-08-12	12	56	10	22	0.7502
Lights Orb	2021-02-05	7	9	0	7	0.75
SkyPrimal	2021-02-03	3	9	0	3	0.75
Trouble Hunter Chronicles: The Stolen Creed	2021-10-17	4	9	0	4	0.75
Lonely Birds	2021-04-13	2	9	0	2	0.75
U27RA R3Z0NANC3	2021-03-12	3	9	0	3	0.75
Tichu	2021-12-21	8	9	0	8	0.75
喰人記	2021-04-29	3	9	0	3	0.75
Two Die	2021-01-06	4	9	0	4	0.75
Tomb of The Lost Sentry	2021-11-15	3	9	0	3	0.75
Faraway Qualia	2021-05-18	10	9	0	10	0.75
Rebels - Under the Spell of Magic (Chapter 1)	2021-01-19	2	9	0	2	0.75
Rope Cow	2021-02-04	3	9	0	3	0.75
Inglorious Aztecs	2021-12-10	22	9	0	22	0.75
The Other: Rosie's Road of Love	2021-05-13	4	9	0	4	0.75
Hazordhu	2021-03-26	11	9	0	11	0.75
消灭魔王军-改 Destroy the Demon Army - Modified	2021-03-12	7	9	0	7	0.75
Typed82	2021-02-24	2	9	0	2	0.75
Ascii the Brave Cat	2021-02-27	3	9	0	3	0.75
Mask Up	2021-03-12	4	9	0	4	0.75
Book of the Old	2021-03-24	7	9	0	7	0.75
Apolune 2	2021-04-01	2	9	0	2	0.75
All-Inn	2021-03-22	2	9	0	2	0.75
Typo	2021-04-09	5	9	0	5	0.75
Outright	2021-03-31	3	9	0	3	0.75
Freyr's Love	2021-04-09	1	9	0	1	0.75
Raccoon Arrival	2021-10-12	3	9	0	3	0.75
Seishin Destiny	2021-09-07	5	9	0	5	0.75
マグネクション磁	2021-05-15	3	9	0	3	0.75
Curving Over It with Evgeny Podoynikov	2021-10-02	3	9	0	3	0.75
World CHAMPIONS: Decathlon	2021-08-30	5	9	0	5	0.75
Love of Dragons	2021-05-28	2	9	0	2	0.75
Dungeon Brawlers	2021-07-03	4	9	0	4	0.75
Mémoire d'Arumac	2021-09-13	4	9	0	4	0.75
Little Devourers	2021-11-18	2	9	0	2	0.75
CarsFuckingDragons	2021-10-01	2	9	0	2	0.75
Alley Catz Bowling	2021-07-23	7	9	0	7	0.75
Sword Maker	2021-12-08	5	9	0	5	0.75
LabTrainingVR: Personal Protective Equipment Edition	2021-10-06	3	9	0	3	0.75
The Revenge of Sophia Red	2021-09-22	3	9	0	3	0.75
The Prince of Landis	2021-11-05	2	9	0	2	0.75
Too Many Santas	2021-12-14	3	9	0	3	0.75
Storms II	2021-11-08	3	9	0	3	0.75
Tilting Tiles	2021-11-23	3	9	0	3	0.75
Spookity Hollow	2021-09-16	5	9	0	5	0.75
FORTRESS DEFENDER	2021-09-22	3	9	0	3	0.75
Blocks Must Fall!	2021-10-15	3	9	0	3	0.75
Zombie Dinos from Planet Zeltoid	2021-10-01	1	9	0	1	0.75
Romino's Adventure	2021-11-19	2	9	0	2	0.75
Pacifist Outside	2021-10-31	3	9	0	3	0.75
Déjà-vu VR	2021-12-29	2	9	0	2	0.75
Basketball	2021-10-30	3	9	0	3	0.75
Poppy Toast	2021-11-03	3	9	0	3	0.75
Neo Spectrum	2021-11-16	2	9	0	2	0.75
A Distant Stabbing	2021-12-15	4	9	0	4	0.75
MOLOGA	2021-12-28	1	9	0	1	0.75
Flowing Lights	2021-05-07	4	20	2	6	0.7499
Wrestledunk Sports	2021-08-20	11	20	2	13	0.7499
Death Becomes You	2021-11-09	5	20	2	7	0.7499
Rotatex 2	2021-02-18	7	20	2	9	0.7499
Starlight Shores	2021-05-07	4	20	2	6	0.7499
Destroy the Hexons	2021-03-15	3	20	2	5	0.7499
Before the battery´s over	2021-04-07	5	20	2	7	0.7499
A Cat in Dungeons	2021-03-24	4	20	2	6	0.7499
The Guardian	2021-06-14	5	20	2	7	0.7499
Planet Surf: The Last Wave	2021-06-18	4	20	2	6	0.7499
Catarro	2021-06-17	6	20	2	8	0.7499
Sakura Forest Girls 3	2021-11-15	9	20	2	11	0.7499
Onmyoji in the Otherworld: Sayaka's Story	2021-09-22	8	20	2	10	0.7499
单身狗的最后机会	2021-04-09	6	43	7	13	0.7498
Gachi Dungeon Master	2021-03-26	7	43	7	14	0.7498
JUNKPUNK	2021-11-12	345	389	100	445	0.7497
M.E.A.T.	2021-02-14	59	150	34	93	0.7497
Island of Lust	2021-10-15	163	131	29	192	0.7497
涨粉二维码	2021-08-18	92	176	41	133	0.7495999999999999
Olaguna Chronicles 命运启示录-阿尔巴雷克战纪-	2021-08-02	43	100	21	64	0.7495999999999999
记得我	2021-10-15	45	100	21	66	0.7495999999999999
FINAL FANTASY II	2021-07-28	1612	1264	357	1969	0.7495
Never Return	2021-08-20	1491	1253	354	1845	0.7494
Crash And Run	2021-11-06	58	123	27	85	0.7493000000000001
Equinox	2021-12-04	20	88	18	38	0.7493000000000001
Commie Killer 2069	2021-02-06	5	72	14	19	0.7493000000000001
No!Ah!'s Ark	2021-09-03	46	72	14	60	0.7493000000000001
Watch Me Stream My Mental Breakdown	2021-01-19	11	34	5	16	0.7493000000000001
Hungry Dino	2021-10-18	14	34	5	19	0.7493000000000001
Charming Girls	2021-08-12	5	34	5	10	0.7493000000000001
Hammerheart	2021-09-06	8	34	5	13	0.7493000000000001
からかい上手の高木さんVR 2学期	2021-12-24	4	34	5	9	0.7493000000000001
RoboSquare	2021-12-31	73	168	39	112	0.7491
Happy Guy	2021-09-26	218	457	120	338	0.7490000000000001
Tap Wizard 2	2021-12-20	746	295	74	820	0.7490000000000001
Steel Assault	2021-09-28	63	223	54	117	0.7490000000000001
Voronica Cleans House: a Vore Adventure	2021-09-24	21	47	8	29	0.7490000000000001
Gachi Bird	2021-10-28	5	47	8	13	0.7490000000000001
幽灵高校	2021-05-28	64	309	78	142	0.7488
Cricket 22	2021-12-01	470	994	278	748	0.7487
War on the Sea	2021-02-02	856	1702	492	1348	0.7484999999999999
Lumberhill	2021-06-13	181	126	28	209	0.7484999999999999
Alveole	2021-04-09	5	51	9	14	0.7484999999999999
GUNZO!	2021-12-28	4	51	9	13	0.7484999999999999
Avalon	2021-06-04	39	122	27	66	0.7483
TRADER LIFE SIMULATOR	2021-02-19	787	1508	434	1221	0.7482
E.E.R.I.E	2021-06-12	156	364	94	250	0.7482
TurnTack	2021-01-16	6	38	6	12	0.748
The Remainder - Act 1	2021-06-09	6	38	6	12	0.748
神魔契约	2021-08-13	232	363	94	326	0.7478
Handball Manager 2021	2021-01-28	70	59	11	81	0.7478
The Faraway Land	2021-06-15	18	59	11	29	0.7478
Super Sports Blast	2021-01-29	10	29	4	14	0.7478
G-MODEアーカイブス+ 怒首領蜂大往生DX	2021-11-16	8	29	4	12	0.7478
Alchemist Adventure	2021-06-10	22	79	16	38	0.7477
A House of Thieves	2021-01-21	17	71	14	31	0.7476
Halloween SEX Party [18+]	2021-10-29	158	71	14	172	0.7476
Time Machine - Hidden Object Game	2021-01-22	21	67	13	34	0.7476
8Doors: Arum's Afterlife Adventure	2021-04-08	233	759	210	443	0.7475
Hot And Lovely 4	2021-09-15	23	140	32	55	0.7474
Grim Realms	2021-10-12	67	184	44	111	0.7472
RussianPunk 2007	2021-11-04	9	136	31	40	0.7471
After The Fall	2021-12-09	903	1712	500	1403	0.747
Dungeon Town	2021-09-25	418	269	68	486	0.7465
The Book of Bondmaids	2021-09-24	107	251	63	170	0.7464000000000001
The Labyrinth	2021-01-08	6	24	3	9	0.7463
Spirit Oath	2021-12-06	7	24	3	10	0.7463
Vapormaze	2021-06-09	4	24	3	7	0.7463
The Dark Inside Me - Chapter: II	2021-06-05	10	24	3	13	0.7463
For Sparta	2021-03-22	5	24	3	8	0.7463
Loving You Fully	2021-04-20	3	24	3	6	0.7463
Sensual Adventures - Episode 6	2021-07-19	9	24	3	12	0.7463
Hentai Waifu Girls	2021-08-26	7	24	3	10	0.7463
Ultimate Super Powers Old Maid～3Days～	2021-12-10	34	24	3	37	0.7463
Tribes of Midgard	2021-07-27	30930	12892	4069	34999	0.7462000000000001
Sweet House	2021-07-21	200	328	85	285	0.7462000000000001
Panty&Demons	2021-12-06	8	33	5	13	0.7461
Girls and Dragons	2021-04-20	3	33	5	8	0.7461
Predator: Hunting Grounds	2021-04-29	1504	2391	714	2218	0.746
Stuffed	2021-12-09	56	186	45	101	0.746
Blackhaven	2021-07-27	27	175	42	69	0.7459
Aery - Calm Mind	2021-07-22	8	54	10	18	0.7459
Alfred Hitchcock - Vertigo	2021-12-16	46	250	63	109	0.7458
Desolatium: Prologue	2021-06-22	5	70	14	19	0.7458
Go For Launch: Mercury	2021-07-04	11	58	11	22	0.7458
Centipede: Recharged	2021-09-29	7	62	12	19	0.7456999999999999
이라	2021-08-31	42	97	21	63	0.7456
Wrought Flesh	2021-12-10	182	460	124	306	0.7454000000000001
Chroma: Bloom And Blight	2021-01-28	346	402	107	453	0.7454000000000001
MONOLISK	2021-02-04	137	333	87	224	0.7454000000000001
CreatorCrate	2021-08-11	4	14	1	5	0.7453000000000001
Motor Assailant	2021-03-30	2	14	1	3	0.7453000000000001
Sole Iron Tail	2021-11-09	2	14	1	3	0.7453000000000001
Lovely Goddess	2021-04-08	4	14	1	5	0.7453000000000001
CAGE-FACE | Case 1: The Mine	2021-10-06	6	14	1	7	0.7453000000000001
琪露诺的信仰之战	2021-07-31	4	14	1	5	0.7453000000000001
Magic Trick	2021-05-15	2	14	1	3	0.7453000000000001
Touhou Multi Scroll Shooting 2	2021-10-26	2	14	1	3	0.7453000000000001
Night: Silent Killer	2021-07-09	6	14	1	7	0.7453000000000001
Forgotten Spirits	2021-05-10	4	14	1	5	0.7453000000000001
Super Bombinhas	2021-11-30	3	14	1	4	0.7453000000000001
BasCatball Saturn	2021-04-01	2	14	1	3	0.7453000000000001
Online Adult Content Manager	2021-05-13	4	14	1	5	0.7453000000000001
Crime District	2021-08-25	12	14	1	13	0.7453000000000001
Retro Classix: Joe & Mac Returns	2021-06-24	3	14	1	4	0.7453000000000001
Unshaded	2021-07-21	3	14	1	4	0.7453000000000001
Chronicles of Sarval: Bridges of Koni	2021-11-12	2	14	1	3	0.7453000000000001
Slide Stories: Bucky's Quest	2021-10-14	2	14	1	3	0.7453000000000001
Blox 3D World	2021-11-18	2	14	1	3	0.7453000000000001
Jericho Dungeon	2021-12-14	2	14	1	3	0.7453000000000001
The Fermi Paradox	2021-07-01	423	601	166	589	0.7452
Leenie Boog	2021-12-02	11	134	31	42	0.7451000000000001
白马非马	2021-11-28	19	37	6	25	0.7451000000000001
Remember When	2021-02-04	3	37	6	9	0.7451000000000001
●LIVE IN DUNGEON	2021-06-05	18	37	6	24	0.7451000000000001
HANI	2021-02-26	8	19	2	10	0.7451000000000001
The OmniGallery	2021-04-30	3	19	2	5	0.7451000000000001
Horses and Girls	2021-11-16	2	19	2	4	0.7451000000000001
Cards of Patience	2021-11-13	5	19	2	7	0.7451000000000001
Tiny Robots Recharged	2021-09-09	8	19	2	10	0.7451000000000001
Aran's Bike Trip	2021-08-06	2	19	2	4	0.7451000000000001
Winds & Leaves	2021-12-08	6	19	2	8	0.7451000000000001
Slime Escape	2021-11-17	2	19	2	4	0.7451000000000001
Quarantineer	2021-12-27	73	266	68	141	0.7449
Buddy and Lucky Solitaire	2021-06-23	7	85	18	25	0.7449
Industry Idle	2021-03-29	566	845	240	806	0.7448
江湖余生：缘起	2021-04-19	270	505	138	408	0.7447
L.S.D.: Prologue to Lasting Spiritual Derangement	2021-04-07	20	195	48	68	0.7447
Swordcery: Prologue	2021-10-08	27	100	22	49	0.7445999999999999
Noara: The Conspiracy	2021-11-15	87	77	16	103	0.7444
Elmarion: the Lost Temple	2021-08-26	30	77	16	46	0.7444
DOOMBRINGER	2021-06-04	21	41	7	28	0.7444
Felix The Toy	2021-03-21	4	41	7	11	0.7444
異星病毒Alien virus	2021-05-11	27	41	7	34	0.7444
Transformation Tycoon	2021-12-18	26	41	7	33	0.7444
am i the baddie?	2021-10-05	8	28	4	12	0.7441
Magicians Legacy: Prologue	2021-04-06	8	28	4	12	0.7441
Dice and the Tower of the Reanimator: Glorious Princess	2021-09-13	6	28	4	10	0.7441
瓶子先生和他的梦想/Mr.Bottle and his dream	2021-12-10	7	28	4	11	0.7441
Agent Murphy	2021-01-22	4	28	4	8	0.7441
Newton's Life at Home	2021-04-13	5	28	4	9	0.7441
Dear Future	2021-04-20	4	28	4	8	0.7441
Remains	2021-06-08	176	187	46	222	0.7440000000000001
Rising Constellation	2021-10-27	24	45	8	32	0.7440000000000001
Jumpy Haha	2021-12-07	6	45	8	14	0.7440000000000001
WWII Tanks Battle Battlefield	2021-12-09	5	45	8	13	0.7440000000000001
Brisk Square	2021-06-04	137	65	13	150	0.7439
Deep Despair 2	2021-10-08	18	65	13	31	0.7439
White Shadows	2021-12-07	68	264	68	136	0.7438
In My Shadow	2021-04-09	14	49	9	23	0.7438
The Good Life	2021-10-15	207	186	46	253	0.7432
Might is Right	2021-02-19	30	110	25	55	0.7431
Disjunction	2021-01-28	35	95	21	56	0.7429000000000001
Project Nightmares	2021-09-29	25	231	59	84	0.7428
最后的守护者之虚幻的梦	2021-02-16	16	32	5	21	0.7428
One Day	2021-12-28	7	32	5	12	0.7428
Dash Dash World	2021-12-06	24	128	30	54	0.7427
СИМУЛЯТОР ОДИНОЧЕСТВА В РУССКОЙ ДЕРЕВНЕ	2021-04-09	14	659	187	201	0.7423000000000001
Touhou Genso Wanderer -Lotus Labyrinth R-	2021-05-25	655	244	63	718	0.7423000000000001
Urban Cards	2021-02-10	58	124	29	87	0.7423000000000001
Dofamine	2021-05-27	79	87	19	98	0.7422
A Comfortable Burden	2021-01-21	3	23	3	6	0.742
Arnold	2021-02-23	4	23	3	7	0.742
Pixelot	2021-03-31	9	23	3	12	0.742
Light Infantry	2021-08-03	15	23	3	18	0.742
SPYCITY	2021-05-03	10	23	3	13	0.742
ConnecTank	2021-09-28	28	23	3	31	0.742
Last Blossom	2021-05-20	4	23	3	7	0.742
Cloud Bashers DX	2021-06-30	6	23	3	9	0.742
Logic Car	2021-07-09	15	23	3	18	0.742
Gachimuchi Life Simulator	2021-07-31	3	23	3	6	0.742
// OVERDRIVE	2021-11-30	11	23	3	14	0.742
Super Dream Dasher	2021-10-29	3	8	0	3	0.7419
Spoockey	2021-12-13	4	8	0	4	0.7419
Battle Map Studio	2021-10-20	5	8	0	5	0.7419
Goalienator	2021-05-22	4	8	0	4	0.7419
The Epsilon Outcome	2021-01-21	2	8	0	2	0.7419
Rocket Shipment	2021-01-15	3	8	0	3	0.7419
Blue Flame	2021-01-29	2	8	0	2	0.7419
方块给爷爬	2021-02-16	3	8	0	3	0.7419
トラウマーメイド	2021-02-09	4	8	0	4	0.7419
Space Smack!	2021-01-18	4	8	0	4	0.7419
Stay Safe 2020	2021-12-08	3	8	0	3	0.7419
Lumpy	2021-02-05	3	8	0	3	0.7419
Bananarun	2021-08-05	3	8	0	3	0.7419
Minesweeper NG	2021-12-01	2	8	0	2	0.7419
PSweet	2021-03-23	3	8	0	3	0.7419
Memory Maze	2021-01-19	3	8	0	3	0.7419
GeometryBricks	2021-06-08	2	8	0	2	0.7419
Survival RPG 3: Lost in time	2021-02-19	3	8	0	3	0.7419
Boulders: Puzzle	2021-10-02	2	8	0	2	0.7419
制服少女	2021-10-21	7	8	0	7	0.7419
The Unbreakable Chain	2021-02-01	1	8	0	1	0.7419
Red Galaxy	2021-02-16	2	8	0	2	0.7419
StalakMiner	2021-10-07	6	8	0	6	0.7419
Zenith Into Maronarium	2021-03-19	2	8	0	2	0.7419
TrackMaster: Free For All Motorsport	2021-03-08	2	8	0	2	0.7419
Fractal Block World	2021-10-18	2	8	0	2	0.7419
ANOTHER DERBY!	2021-05-08	5	8	0	5	0.7419
Rosemary's Fate Life Worth Living	2021-06-16	2	8	0	2	0.7419
合成大西瓜 | Big watermelon	2021-04-07	9	8	0	9	0.7419
Super Maze Labyrinth	2021-04-05	3	8	0	3	0.7419
Legend Of Maratha Warriors	2021-03-29	1	8	0	1	0.7419
Ambidextrous Psychopath	2021-06-29	2	8	0	2	0.7419
Box Cat Bash	2021-06-03	2	8	0	2	0.7419
Pazing By	2021-11-12	3	8	0	3	0.7419
Sentry：Obelisk Of Dawn	2021-06-22	5	8	0	5	0.7419
Henry's Day	2021-11-11	2	8	0	2	0.7419
Mouse adventure	2021-08-20	2	8	0	2	0.7419
BATS	2021-10-20	3	8	0	3	0.7419
Little Dog Bob	2021-08-26	3	8	0	3	0.7419
Duelist	2021-07-19	4	8	0	4	0.7419
Junebug vs. Evil	2021-07-13	2	8	0	2	0.7419
Into the Loop	2021-10-14	3	8	0	3	0.7419
3AM	2021-10-29	4	8	0	4	0.7419
You Can't Finish	2021-07-22	3	8	0	3	0.7419
Vizzle	2021-08-12	2	8	0	2	0.7419
Believe	2021-08-31	2	8	0	2	0.7419
DarkCoating	2021-08-10	2	8	0	2	0.7419
Bloopy & Droopy	2021-09-10	2	8	0	2	0.7419
Sorcerer Knights	2021-09-20	3	8	0	3	0.7419
OplitisAV	2021-11-29	3	8	0	3	0.7419
Soul Climb	2021-11-01	2	8	0	2	0.7419
日记簿	2021-10-20	3	8	0	3	0.7419
Trials of Proelium	2021-12-16	5	8	0	5	0.7419
El Pescador	2021-10-08	2	8	0	2	0.7419
The Giraffe World	2021-11-26	3	8	0	3	0.7419
The van of justice	2021-11-19	2	8	0	2	0.7419
Underwater Rescue	2021-10-31	6	8	0	6	0.7419
Queue Simulator	2021-12-16	4	8	0	4	0.7419
琴覆天下	2021-11-09	3	8	0	3	0.7419
航天计划	2021-11-25	2	8	0	2	0.7419
Grim Tales: Echo of the Past Collector's Edition	2021-11-05	6	8	0	6	0.7419
Nebula Invasion	2021-12-13	2	8	0	2	0.7419
Criminal Archives: City on Fire Collector's Edition	2021-12-14	10	8	0	10	0.7419
Superposition	2021-12-15	3	8	0	3	0.7419
The Albino Hunter™ {Revamp}	2021-12-23	3	8	0	3	0.7419
Space Balls	2021-12-15	2	8	0	2	0.7419
Wave Jumper	2021-12-21	4	8	0	4	0.7419
Tower of Waifus 2	2021-06-18	92	163	40	132	0.7418000000000001
Hentai Boy	2021-05-31	6	191	48	54	0.7417
What's Your Gender?	2021-10-12	4	60	12	16	0.7417
Tempo	2021-11-01	36	127	30	66	0.7415999999999999
Agent Roswell	2021-09-09	5	40	7	12	0.7415999999999999
Evening Starter	2021-06-19	135	94	21	156	0.7415
Bounty Below	2021-10-15	136	105	24	160	0.7414000000000001
みんなで空気読み。3	2021-06-23	26	52	10	36	0.7414000000000001
Wife Quest	2021-09-30	19	141	34	53	0.7412000000000001
Essays on Empathy	2021-05-18	36	90	20	56	0.7411
Rogue Company	2021-07-20	12189	15275	4990	17179	0.7409
The Bus	2021-03-25	1660	3349	1049	2709	0.7406
Pro Cycling Manager 2021	2021-06-03	2328	452	126	2454	0.7404999999999999
Torque Drift	2021-04-21	1264	6478	2077	3341	0.7404000000000001
Minute of Islands	2021-06-13	67	369	101	168	0.7404000000000001
The Wicked Days	2021-06-30	6	27	4	10	0.7403000000000001
Tricky Machines	2021-01-21	9	27	4	13	0.7403000000000001
Pill Puzzle	2021-06-17	4	27	4	8	0.7403000000000001
Hentai VR 3	2021-05-13	3	27	4	7	0.7403000000000001
BzzzController	2021-06-05	7	27	4	11	0.7403000000000001
Mission 1985	2021-10-04	4	27	4	8	0.7403000000000001
咸鱼的挂机游戏	2021-12-08	50	27	4	54	0.7403000000000001
Hundred Days	2021-05-13	813	556	158	971	0.7402
Blocky Ball	2021-03-26	13	63	13	26	0.74
Drive Buy	2021-03-31	10	18	2	12	0.74
World Soccer Strikers '91	2021-08-18	6	18	2	8	0.74
Persephone	2021-01-21	7	18	2	9	0.74
16bit vs Reality	2021-06-17	8	18	2	10	0.74
Good Mourning	2021-04-29	3	18	2	5	0.74
Transpire	2021-03-19	6	18	2	8	0.74
Arcaxer	2021-02-25	4	18	2	6	0.74
Space Dance Harmony	2021-02-18	6	18	2	8	0.74
Flying Girls	2021-02-16	4	18	2	6	0.74
The Magnets	2021-02-25	5	18	2	7	0.74
connected!	2021-05-18	5	18	2	7	0.74
Let's Turn Pick-Up Beach to a Nudist Fucking Beach!	2021-06-11	11	18	2	13	0.74
Hell Blasters	2021-10-07	4	18	2	6	0.74
Game Of Mafia	2021-03-25	7	89	20	27	0.7395999999999999
Chronicle of Innsmouth: Mountains of Madness	2021-03-23	25	59	12	37	0.7395999999999999
Medievalien	2021-02-11	29	59	12	41	0.7395999999999999
Super Dirt Racers	2021-02-08	44	188	48	92	0.7394
Trainslation	2021-04-13	5	31	5	10	0.7393000000000001
Kotoba no Puzzle: Mojipittan Encore	2021-04-07	58	31	5	63	0.7393000000000001
Arden's Wake	2021-02-26	9	31	5	14	0.7393000000000001
Rabbit Riot	2021-04-05	58	31	5	63	0.7393000000000001
Matanga 2	2021-09-24	6	31	5	11	0.7393000000000001
Симулятор Сидения на Крыше	2021-04-01	3	51	10	13	0.7390000000000001
Sex with the Devil	2021-06-04	615	3192	1008	1623	0.7389
Fragmented Mind	2021-02-02	4	35	6	10	0.7389
Necroball	2021-10-26	8	13	1	9	0.7389
Helga: Euphorium's Song	2021-04-14	6	13	1	7	0.7389
2D Baseball Duel	2021-05-04	4	13	1	5	0.7389
Drone VR	2021-11-24	3	13	1	4	0.7389
Ghost Run 3D	2021-01-06	4	13	1	5	0.7389
Tetracosm	2021-06-04	3	13	1	4	0.7389
TITANKIN: Prologue	2021-08-13	7	13	1	8	0.7389
MECHA AND TANK FIGHTING	2021-03-15	4	13	1	5	0.7389
Moonshot - The Great Espionage	2021-07-30	3	13	1	4	0.7389
Nemesis - RPG	2021-02-04	7	13	1	8	0.7389
Hypoxia - One Last Breath	2021-09-07	3	13	1	4	0.7389
Hot Dodge!	2021-01-31	2	13	1	3	0.7389
My Eyes	2021-09-24	4	13	1	5	0.7389
Neon Snake	2021-03-27	3	13	1	4	0.7389
Murder at Midnight	2021-05-26	19	13	1	20	0.7389
Pixel Speedrun	2021-05-21	5	13	1	6	0.7389
VOICE	2021-12-09	4	13	1	5	0.7389
Daardoa	2021-05-25	3	13	1	4	0.7389
Our Battle Has Just Begun! episode 1	2021-07-14	6	13	1	7	0.7389
莫西比亚岛	2021-06-11	6	13	1	7	0.7389
OnlyGame: Gamer Girl	2021-06-17	3	13	1	4	0.7389
Shin Lotion Samurai	2021-07-30	18	13	1	19	0.7389
UFO vs Bikini	2021-08-23	2	13	1	3	0.7389
The Secret Blue Forest	2021-07-16	2	13	1	3	0.7389
Lyonesse	2021-10-19	2	13	1	3	0.7389
Engineer Alpha	2021-11-10	4	13	1	5	0.7389
王国旅行者（Kingdom Traveler）	2021-12-03	6	13	1	7	0.7389
My name is velcro	2021-10-13	2	13	1	3	0.7389
Hello World	2021-11-08	4	13	1	5	0.7389
Spacefolk City	2021-11-10	3	13	1	4	0.7389
Cubstacle	2021-12-02	4	13	1	5	0.7389
Te Encontré	2021-11-19	3	13	1	4	0.7389
Prototype Blocks 2	2021-12-02	3	13	1	4	0.7389
Dungeon Death	2021-12-07	3	13	1	4	0.7389
Gordon Adventure	2021-03-31	5	47	9	14	0.7388
Cheongchunhyang Jeon	2021-12-20	58	47	9	67	0.7388
Lotus Reverie: First Nexus	2021-01-14	21	43	8	29	0.7387
Cyberplug	2021-05-24	13	43	8	21	0.7387
Swarm the City: Prologue	2021-08-26	36	43	8	44	0.7387
Confessions	2021-08-19	4	39	7	11	0.7387
구운몽	2021-12-21	26	39	7	33	0.7387
LOLLIPOP!	2021-05-31	201	883	262	463	0.7386
BALSA Model Flight Simulator	2021-09-14	120	187	48	168	0.7386
WE ARE FOOTBALL	2021-06-10	3905	1002	300	4205	0.7384999999999999
Lumione	2021-10-13	134	381	106	240	0.7384999999999999
The Divine Invasion	2021-12-03	458	173	44	502	0.7384999999999999
aerofly RC 8	2021-02-05	15	66	14	29	0.7384000000000001
Undead Development	2021-01-13	24	251	67	91	0.7383
Franchise Hockey Manager 8	2021-10-26	266	152	38	304	0.7383
Dead Age 2	2021-03-12	775	833	247	1022	0.7382
Clash of Chefs VR	2021-09-16	20	106	25	45	0.7381000000000001
天下为棋	2021-11-10	194	327	90	284	0.738
Railroad Ink Challenge	2021-06-17	35	62	13	48	0.738
Kill The Dragon	2021-10-07	3	62	13	16	0.738
SAMURAI SHODOWN	2021-06-14	538	625	182	720	0.7379000000000001
SimCasino	2021-11-16	189	480	137	326	0.7378
Atlas Architect	2021-04-26	28	155	39	67	0.7378
Fareo: Shadowlands	2021-06-10	31	95	22	53	0.7378
The Ascent	2021-07-29	14013	13508	4483	18496	0.7377
My Furry Neighbour	2021-08-28	26	127	31	57	0.7377
The Radio Station | 深夜放送	2021-10-31	123	233	62	185	0.7376
Fate of WINDSHIFT	2021-06-25	6	22	3	9	0.7375
Curved Space	2021-06-29	10	22	3	13	0.7375
The Roy Game	2021-12-30	8	22	3	11	0.7375
Master of Pieces © Jigsaw Puzzles	2021-12-24	11	22	3	14	0.7375
Outcasts of Orion	2021-03-15	6	22	3	9	0.7375
Vaccine A	2021-07-21	6	22	3	9	0.7375
Spacious Snake	2021-10-21	2	22	3	5	0.7375
残秽的我们	2021-12-08	53	219	58	111	0.7372
The Captain is Dead	2021-02-01	26	54	11	37	0.7371
Rico-Jump	2021-01-24	14	69	15	29	0.737
Farm Manager 2021: Prologue	2021-01-14	748	719	213	961	0.7368000000000001
Zombie Simulator	2021-02-24	14	87	20	34	0.7366
Run, Kitty! - A Furry Visual Novel	2021-11-12	12	50	10	22	0.7366
NMNE	2021-11-08	4	50	10	14	0.7366
反图灵测试	2021-09-13	12	26	4	16	0.7363
Loot Train	2021-09-02	10	26	4	14	0.7363
Slit Mouthed - 口裂け女	2021-12-11	21	46	9	30	0.7362000000000001
Empires in Ruins	2021-03-25	49	108	26	75	0.7361
Terrain of Magical Expertise	2021-09-09	124	108	26	150	0.7361
Dr Livingstone, I presume? - Reversed Escape Room	2021-05-20	14	61	13	27	0.7359
Calamity Eliminator	2021-12-15	14	61	13	27	0.7359
Momentum	2021-09-29	11	42	8	19	0.7359
Recoiled	2021-04-04	8	38	7	15	0.7356999999999999
Hidden Shapes Lovely Cats - Jigsaw Puzzle Game	2021-05-21	4	38	7	11	0.7356999999999999
Gachi Dash	2021-11-04	6	38	7	13	0.7356999999999999
ChronoBreach Ultra	2021-11-19	5	30	5	10	0.7356999999999999
MIguelshroom: First day at school	2021-04-15	3	30	5	8	0.7356999999999999
Penguin Climbing	2021-03-26	2	30	5	7	0.7356999999999999
Lawnmower Game: Battle	2021-10-05	5	30	5	10	0.7356999999999999
Putin kills: Christmas	2021-03-15	2	34	6	8	0.7356
Digital Zoo Gallery	2021-02-02	17	34	6	23	0.7356
The Space in Between	2021-01-18	24	97	23	47	0.7354999999999999
Femboy Besties	2021-04-01	7	331	93	100	0.7353000000000001
Photo-Life - Rina's Journey	2021-07-30	12	57	12	24	0.7353000000000001
Z-Race	2021-12-10	20	68	15	35	0.7352
Cardnarok: Raid with Gods	2021-05-14	27	86	20	47	0.7351000000000001
Project Chemistry	2021-06-22	31	93	22	53	0.7349
PolyClassic: Wild	2021-10-11	8	53	11	19	0.7347
Defend the Rook	2021-10-26	226	148	38	264	0.7345
MR 333	2021-05-08	3	64	14	17	0.7345
Suicide For Him	2021-11-24	5	17	2	7	0.7345
Balloon Blast	2021-04-05	11	17	2	13	0.7345
ChefSquad	2021-10-22	17	17	2	19	0.7345
Digital Diamond Baseball V9	2021-03-24	11	17	2	13	0.7345
Tezz: Portals	2021-03-18	2	17	2	4	0.7345
The Wave Story	2021-04-23	3	17	2	5	0.7345
Recall	2021-06-25	3	17	2	5	0.7345
Filthy Animals | Halloween Heist	2021-10-22	16	17	2	18	0.7345
Murder Diaries 3 - Santa's Trail of Blood	2021-12-17	6	17	2	8	0.7345
Spooky Typing: The Ghost Plague	2021-10-30	5	17	2	7	0.7345
Cube Space	2021-11-25	7	17	2	9	0.7345
Tunche	2021-11-02	216	466	136	352	0.7342000000000001
Lewd Girls, Leave Me Alone! I Just Want to Play Video Games and Watch Anime! Hentai Edition	2021-04-03	20	254	70	90	0.7342000000000001
ゆるキャン△ VIRTUAL CAMP ～本栖湖編～ / Laid-Back Camp - Virtual - Lake Motosu	2021-03-04	82	263	73	155	0.7337
HENTAICRAFT	2021-04-17	8	207	56	64	0.7334999999999999
Joyspring	2021-08-17	26	106	26	52	0.7334999999999999
Pixel Puzzles Illustrations & Anime	2021-02-23	49	85	20	69	0.7334999999999999
Ven VR Adventure	2021-01-28	13	67	15	28	0.7332
69 Erika Love	2021-09-18	7	41	8	15	0.733
山河伏妖录	2021-09-03	552	415	121	673	0.7329000000000001
Monkey Split	2021-03-05	29	74	17	46	0.7329000000000001
DateJournal	2021-02-26	10	21	3	13	0.7327
Foxen Island	2021-03-18	6	21	3	9	0.7327
At Eve's Wake	2021-10-26	4	21	3	7	0.7327
Sniper Ships: Shoot'em Up on Rails	2021-03-26	3	21	3	6	0.7327
u evade	2021-03-12	3	21	3	6	0.7327
Reality's Reverse Side	2021-07-22	4	21	3	7	0.7327
Sprite Sequence Chapter 1	2021-07-14	7	21	3	10	0.7327
Install Wizard	2021-05-14	8	21	3	11	0.7327
Belle-de-Nuit	2021-06-17	17	21	3	20	0.7327
Albacete Warrior	2021-12-15	4	21	3	7	0.7327
69 Samantha Love	2021-10-14	6	21	3	9	0.7327
Mommy-Goddess of Unconditional Love ~Wow, You Sure Gave It Your All Out There!~	2021-12-17	3	21	3	6	0.7327
Sex Girlfriend Simulator	2021-12-11	5	21	3	8	0.7327
剑魄 JianPo	2021-09-23	88	430	126	214	0.7326
The fairy tale you don't know	2021-01-23	53	136	35	88	0.7326
CIBOS	2021-11-04	6	7	0	6	0.7326
Jazz Lightning : Castle Dungeons	2021-12-21	2	7	0	2	0.7326
Matrix Brain Twister	2021-07-02	1	7	0	1	0.7326
Graviter	2021-04-08	2	7	0	2	0.7326
Blobert	2021-03-13	1	7	0	1	0.7326
Unicorns on Unicycles	2021-09-28	3	7	0	3	0.7326
Lightsmith	2021-08-25	4	7	0	4	0.7326
Dualism	2021-01-14	3	7	0	3	0.7326
Apollyon: River of Life	2021-03-31	3	7	0	3	0.7326
Death Ski	2021-01-05	2	7	0	2	0.7326
Tobari 2: Nightmare	2021-07-09	4	7	0	4	0.7326
FEEET	2021-05-31	2	7	0	2	0.7326
Star Aegis	2021-02-17	2	7	0	2	0.7326
Horatama	2021-02-19	1	7	0	1	0.7326
Short Fuse	2021-09-25	3	7	0	3	0.7326
NORSK: Epistle	2021-02-08	5	7	0	5	0.7326
Myriavora	2021-07-05	3	7	0	3	0.7326
Orbatron	2021-03-01	2	7	0	2	0.7326
蕾米的挑战	2021-02-16	2	7	0	2	0.7326
Radon Blast	2021-02-27	2	7	0	2	0.7326
Allan	2021-03-24	1	7	0	1	0.7326
白玉的幻梦	2021-03-15	2	7	0	2	0.7326
龙骑战歌	2021-05-11	4	7	0	4	0.7326
小邦迪的奇妙冒险	2021-03-28	4	7	0	4	0.7326
Starlight X-2: Galactic Puzzles	2021-04-15	3	7	0	3	0.7326
Ziode Shadow	2021-11-11	2	7	0	2	0.7326
Rounded Hills	2021-04-05	2	7	0	2	0.7326
Elijah and the Out of this World Adventure	2021-09-24	2	7	0	2	0.7326
Queer and Chill	2021-06-16	3	7	0	3	0.7326
Long Ago: A Puzzle Tale	2021-05-28	2	7	0	2	0.7326
Traveler	2021-12-11	4	7	0	4	0.7326
暴打萌鼠	2021-05-08	2	7	0	2	0.7326
FTD2	2021-05-18	2	7	0	2	0.7326
Acheron's Souls	2021-05-28	3	7	0	3	0.7326
リアリティ×マインズ	2021-08-30	3	7	0	3	0.7326
Clockwork Dungeon	2021-08-27	1	7	0	1	0.7326
ANIME MATCH	2021-05-25	2	7	0	2	0.7326
A Clever Label	2021-08-13	3	7	0	3	0.7326
Soran	2021-06-14	8	7	0	8	0.7326
Devoul- Curse of the Soulless	2021-06-04	1	7	0	1	0.7326
The Handbook	2021-06-04	4	7	0	4	0.7326
Build a Boss	2021-07-15	8	7	0	8	0.7326
Minotaur Maze	2021-05-28	2	7	0	2	0.7326
VALAKAS: Immortal	2021-06-25	2	7	0	2	0.7326
Tiny Hunter	2021-07-06	3	7	0	3	0.7326
Latarnix Puzzle	2021-12-24	3	7	0	3	0.7326
战球英雄	2021-11-16	2	7	0	2	0.7326
idolYAKI: From Delinquents to Pop Stars	2021-07-22	2	7	0	2	0.7326
我的未婚妻	2021-08-11	2	7	0	2	0.7326
Master Theft TVs	2021-12-24	1	7	0	1	0.7326
Traffic Chase	2021-09-21	3	7	0	3	0.7326
King Of The Pit	2021-08-24	5	7	0	5	0.7326
Door3:Insignia	2021-11-15	6	7	0	6	0.7326
Faircroft's Antiques: The Forbidden Crypt	2021-11-20	9	7	0	9	0.7326
MageRun	2021-11-26	3	7	0	3	0.7326
Gutting Goblins!	2021-10-01	2	7	0	2	0.7326
Argonauts Agency: Captive of Circe	2021-12-21	7	7	0	7	0.7326
SUPER ICK	2021-11-16	2	7	0	2	0.7326
ReTox	2021-11-10	2	7	0	2	0.7326
Re：サバイバー	2021-12-08	2	7	0	2	0.7326
Mr.Addon in Sulpicius Gallus M	2021-12-08	2	7	0	2	0.7326
Examination Chambers	2021-12-02	5	7	0	5	0.7326
Atelier Firis: The Alchemist and the Mysterious Journey DX	2021-04-22	141	176	47	188	0.7325
Puzzletronics Digital Infinite	2021-04-20	5	37	7	12	0.7325
Inquisitor’s Heart and Soul	2021-10-22	198	37	7	205	0.7325
Century: Age of Ashes	2021-12-02	12222	11496	3916	16138	0.7323999999999999
Pet idle	2021-12-09	169	344	99	268	0.7323999999999999
Cubzh	2021-10-25	23	52	11	34	0.7323999999999999
Shop Tycoon	2021-08-25	32	139	36	68	0.7322
Ezaron Defense	2021-04-15	13	70	16	29	0.7321
[TDA02] Muv-Luv Unlimited: THE DAY AFTER - Episode 02 REMASTERED	2021-02-05	17	33	6	23	0.7321
С любовью из царства ночи	2021-05-20	11	33	6	17	0.7321
A Painter's Tale : Curon, 1950	2021-01-29	3	25	4	7	0.7320000000000001
纸飞机的呼唤	2021-01-11	3	25	4	7	0.7320000000000001
VR Immortal Fight	2021-08-05	3	25	4	7	0.7320000000000001
The Stonks Market	2021-05-05	5	25	4	9	0.7320000000000001
Alexey's Winter	2021-04-04	2	25	4	6	0.7320000000000001
Quantum League	2021-04-15	547	1749	562	1109	0.7319
Fresh Body	2021-07-22	175	987	308	483	0.7319
Succubus Connect	2021-05-14	111	384	112	223	0.7319
Yummy Girl	2021-05-14	11	132	34	45	0.7319
Hentai Girls - Anime Puzzle 18+	2021-07-24	7	77	18	25	0.7319
Skjoldur Story	2021-04-30	4	29	5	9	0.7319
Drunk Soccer is the Best Soccer	2021-07-16	3	29	5	8	0.7319
Jardinains!	2021-04-01	8	12	1	9	0.7319
Synthwave Hop	2021-04-16	4	12	1	5	0.7319
Heroine for Hire	2021-05-25	4	12	1	5	0.7319
Splash Cars	2021-11-15	4	12	1	5	0.7319
Dead Herring VR	2021-02-26	2	12	1	3	0.7319
Rorschach Plus	2021-01-19	4	12	1	5	0.7319
Mage Hunters	2021-01-07	3	12	1	4	0.7319
[Neolithic]To the End	2021-12-08	3	12	1	4	0.7319
Ein Abend im Großen Schauspielhaus - Berlin 1927	2021-05-04	2	12	1	3	0.7319
PaperCraft	2021-02-25	3	12	1	4	0.7319
Disco Ball	2021-03-26	2	12	1	3	0.7319
LOOSEPO	2021-12-03	3	12	1	4	0.7319
Wilma's Dreams	2021-07-29	2	12	1	3	0.7319
The Marionette 提线木偶	2021-05-15	4	12	1	5	0.7319
Martin Goes on the Attack	2021-07-16	7	12	1	8	0.7319
The Last Stand	2021-06-18	4	12	1	5	0.7319
Lilly's rescue	2021-06-11	3	12	1	4	0.7319
Incredible Dracula: Legacy of the Valkyries	2021-06-17	18	12	1	19	0.7319
Space Drone: Rescue Mission	2021-08-23	4	12	1	5	0.7319
SGS Afrika Korps: Tunisia	2021-09-28	6	12	1	7	0.7319
Destroy All The Cubes	2021-07-27	5	12	1	6	0.7319
Baking Bustle: Ashley’s Dream	2021-10-27	7	12	1	8	0.7319
Slimefrog	2021-09-22	591	12	1	592	0.7319
QUICKDRAW	2021-11-16	5	12	1	6	0.7319
Sunny Beach	2021-10-18	6	12	1	7	0.7319
PhyTetris-Physics Tetris	2021-10-26	5	12	1	6	0.7319
Fitforce	2021-01-29	165	185	50	215	0.7318000000000001
Otaku's Rage: Waifu Strikes Back	2021-02-23	69	185	50	119	0.7318000000000001
Help Me!	2021-08-20	79	224	62	141	0.7317
Monster Jam Steel Titans 2	2021-03-02	105	175	47	152	0.7317
DØM RUSALOK	2021-01-06	27	135	35	62	0.7316
磨难之间 / SUFFERING	2021-05-28	19	48	10	29	0.7316
Wonder Boy: Asha in monster world	2021-06-29	17	94	23	40	0.7313
Greedy Goblin	2021-04-26	15	66	15	30	0.7313
中年失业模拟器When a man lose his job	2021-05-15	325	249	70	395	0.7311
做了个魔塔	2021-12-26	53	73	17	70	0.7311
Ghost Exorcism INC	2021-07-15	3791	3862	1287	5078	0.731
Twin Mirror	2021-12-01	80	284	81	161	0.731
Packing House	2021-12-10	21	55	12	33	0.7308
Ninja Stealth 4	2021-08-16	209	55	12	221	0.7308
Puzzletronics Analog Logic	2021-03-24	5	44	9	14	0.7308
Of Bird And Cage	2021-05-20	37	164	44	81	0.7306999999999999
Edge Of Eternity	2021-06-08	736	2427	797	1533	0.7306
Eldest Souls	2021-07-29	748	1863	606	1354	0.7303000000000001
Super Totally Ultimate Dad Showdown	2021-05-09	92	273	78	170	0.7302
列传：革新战争	2021-01-06	34	170	46	80	0.7302
R-Type Final 2	2021-04-30	925	516	156	1081	0.7301000000000001
Cow Girls	2021-12-17	13	137	36	49	0.7301000000000001
Age of Fear 4: The Iron Killer	2021-04-30	33	40	8	41	0.73
로스팅 리포트:대학생 수면제 사망사건	2021-06-30	9	51	11	20	0.7299
Zero Chastity: A Sultry Summer Holiday	2021-11-23	18	51	11	29	0.7299
Saint Kotar	2021-10-28	63	110	28	91	0.7298
Stranded Sails - Prologue	2021-06-22	61	86	21	82	0.7295
The Slimeking's Tower	2021-08-21	110	169	46	156	0.7293000000000001
The List	2021-06-30	23	65	15	38	0.7293000000000001
Free Kick X	2021-01-19	4	36	7	11	0.7293000000000001
Summit in Space	2021-01-24	4	36	7	11	0.7293000000000001
Street karate 3	2021-02-01	9	36	7	16	0.7293000000000001
Draft Day Sports: College Basketball 2021	2021-03-05	85	36	7	92	0.7293000000000001
Cute Nurses	2021-10-20	5	36	7	12	0.7293000000000001
Water Physics Simulation	2021-10-06	6	36	7	13	0.7293000000000001
Asteroids: Recharged	2021-12-14	6	36	7	13	0.7293000000000001
Grow Defense	2021-01-11	1269	390	116	1385	0.7292000000000001
Picture Perfect	2021-06-15	93	214	60	153	0.7292000000000001
Negligee: Spring Clean Prelude	2021-08-06	268	116	30	298	0.7290000000000001
Planet Miner	2021-05-04	6	47	10	16	0.7290000000000001
Evertried	2021-10-21	19	47	10	29	0.7290000000000001
Hentai X	2021-10-23	4	47	10	14	0.7290000000000001
Sherwood Extreme	2021-05-12	90	245	70	160	0.7287
Arena of Kings	2021-12-17	3310	1255	405	3715	0.7286
Actraiser Renaissance	2021-09-23	987	407	122	1109	0.7286
Silence Channel	2021-04-29	13	82	20	33	0.7286
Parasomnia Verum	2021-06-29	3	32	6	9	0.7286
Uphold The Realm	2021-01-15	7	16	2	9	0.7286
Epic Palace : Knossos	2021-05-25	6	16	2	8	0.7286
Mastermine	2021-02-26	8	16	2	10	0.7286
Unfolded : Camellia Tales - Prologue	2021-01-07	6	16	2	8	0.7286
Gospel of Abaddon	2021-08-12	2	16	2	4	0.7286
Kombi Travels - Jigsaw Landscapes	2021-04-08	5	16	2	7	0.7286
Rise of Mavros	2021-07-23	3	16	2	5	0.7286
The Last Order Dungeons	2021-04-16	2	16	2	4	0.7286
Spaceship Simulator	2021-08-07	5	16	2	7	0.7286
Green Fairy VR	2021-06-23	4	16	2	6	0.7286
Lucid Dream Simulator	2021-06-18	3	16	2	5	0.7286
Higgs Boson: Timed Puzzle	2021-09-29	2	16	2	4	0.7286
Dungeon Danger Traps	2021-09-23	4	16	2	6	0.7286
Our Personal Space	2021-08-13	7	16	2	9	0.7286
Hotel on the Grate	2021-11-04	2	16	2	4	0.7286
Memetric: Final Lifeforms	2021-11-09	2	16	2	4	0.7286
Russian Drunken Boxers 2	2021-11-12	3	16	2	5	0.7286
Bikini Tits	2021-12-17	3	16	2	5	0.7286
Solaris	2021-07-05	23	54	12	35	0.7284
TASOMACHI: Behind the Twilight	2021-04-14	255	329	97	352	0.7283
Pickup Basketball VR	2021-02-26	12	61	14	26	0.7283
Aeon Drive: Tournament	2021-09-03	60	43	9	69	0.728
Sakura Forest Girls	2021-04-19	19	43	9	28	0.728
Y: The Game	2021-12-27	6	43	9	15	0.728
Shunga Frame	2021-10-28	4	43	9	13	0.728
Serin Fate	2021-08-25	298	393	118	416	0.7279000000000001
Destructive physics	2021-08-20	9	85	21	30	0.7279000000000001
Gamedev Beatdown	2021-09-24	5	28	5	10	0.7279000000000001
Soma Union	2021-11-01	5	28	5	10	0.7279000000000001
Tales From The Under-Realm: Hazel	2021-03-03	9	20	3	12	0.7276
Bibou Quest	2021-03-17	2	20	3	5	0.7276
Love Colors	2021-09-17	9	20	3	12	0.7276
Bullets Squared	2021-05-07	8	20	3	11	0.7276
Alice Trapped Beyond Wonderland	2021-08-20	6	20	3	9	0.7276
Speedway Challenge 2021	2021-09-17	37	20	3	40	0.7276
69 Lisa Love	2021-10-08	7	20	3	10	0.7276
ChickenZ	2021-12-04	3	20	3	6	0.7276
LastCloudiaTc	2021-02-18	7862	532	164	8026	0.7275
trip=true	2021-10-07	30	218	62	92	0.7275
Anti-Jump-Man	2021-10-22	3	24	4	7	0.7275
LootLite	2021-03-25	4	24	4	8	0.7275
Dead Night	2021-05-01	5	24	4	9	0.7275
Hidden Office	2021-10-21	6	24	4	10	0.7275
Kselebox	2021-07-20	7	50	11	18	0.7273999999999999
Hitler On The Moon	2021-09-01	5	88	22	27	0.7273000000000001
Melodramatica	2021-06-24	15	64	15	30	0.7272
Uninvited Guest	2021-11-05	14	147	40	54	0.7270000000000001
Alek - The Lost Kingdom	2021-03-27	99	201	57	156	0.7267
Aeon Drive	2021-09-30	35	74	18	53	0.7266
Sub Rosa	2021-03-25	283	2359	793	1076	0.7264
Introvert: A Teenager Simulator	2021-03-02	125	546	170	295	0.7263
COLLECTION of SaGa FINAL FANTASY LEGEND	2021-10-21	123	60	14	137	0.7261
Coin Treasures	2021-11-08	71	77	19	90	0.7259000000000001
Pecaminosa - a pixel noir game	2021-05-27	16	35	7	23	0.7259000000000001
R18Plus Monster Girl You-ki chan	2021-05-01	13	35	7	20	0.7259000000000001
Heart of Enya	2021-03-26	6	35	7	13	0.7259000000000001
Pathfinders: Mini Words	2021-06-03	4	35	7	11	0.7259000000000001
My Furry Detective	2021-12-04	10	35	7	17	0.7259000000000001
The Architect: Paris	2021-09-30	182	165	46	228	0.7258
Disciples: Liberation	2021-10-22	2568	2167	729	3297	0.7256999999999999
Agatha Christie - Hercule Poirot: The First Cases	2021-09-27	175	481	149	324	0.7256999999999999
[NINJA GAIDEN: Master Collection] NINJA GAIDEN Σ2	2021-06-10	722	863	278	1000	0.7256
No More Heroes	2021-06-09	463	800	257	720	0.7253000000000001
Bigfoot Forest	2021-01-08	5	100	26	31	0.7253000000000001
My Furry Dictator	2021-10-09	18	100	26	44	0.7253000000000001
Call Of Unity	2021-10-21	13	255	75	88	0.7252
The Whisperer	2021-12-16	7	56	13	20	0.7249
GLADIUM	2021-06-24	16	49	11	27	0.7248
Nemezis: Mysterious Journey III Prolog	2021-06-02	138	49	11	149	0.7248
I Make Saints (Steam Edition)	2021-04-05	5	31	6	11	0.7248
Friend ReQuest - A Playable Teaser	2021-07-08	8	31	6	14	0.7248
Cards and Castles 2	2021-11-02	33	31	6	39	0.7248
Viy: Retold Story	2021-12-09	4	31	6	10	0.7248
cyberpunkdreams	2021-05-14	298	511	160	458	0.7247
Sid Classic	2021-02-19	96	93	24	120	0.7247
SHIPS AT WAR	2021-08-05	30	170	48	78	0.7245999999999999
Mercenaries Blaze	2021-06-10	414	360	110	524	0.7243
WRC 9 FIA World Rally Championship	2021-09-16	151	345	105	256	0.7243
Super Retro Fighter	2021-04-12	15	66	16	31	0.7243
Angry Giant	2021-04-08	3	11	1	4	0.7242000000000001
JETBOY	2021-05-02	2	11	1	3	0.7242000000000001
One Way To Exit 2	2021-09-24	2	11	1	3	0.7242000000000001
Henry Mosse and the Wormhole Conspiracy	2021-02-04	10	11	1	11	0.7242000000000001
SPACE TOW TRUCK	2021-07-29	4	11	1	5	0.7242000000000001
ヘルズ・ハイ・ハーモナイザーズ	2021-11-23	4	11	1	5	0.7242000000000001
Project Boost	2021-04-17	3	11	1	4	0.7242000000000001
Rainbow Laser Disco Dungeon	2021-09-27	2	11	1	3	0.7242000000000001
The Book of Shadows	2021-01-28	9	11	1	10	0.7242000000000001
Warp Out	2021-01-28	3	11	1	4	0.7242000000000001
Journey On	2021-10-07	7	11	1	8	0.7242000000000001
Red Laser Z	2021-03-30	2	11	1	3	0.7242000000000001
Death Box	2021-02-12	3	11	1	4	0.7242000000000001
Sokpop S10: vissekom	2021-03-08	3	11	1	4	0.7242000000000001
Darkilson	2021-02-23	3	11	1	4	0.7242000000000001
VR Chinese Garden Tour (HD): Flying as a dragonfly	2021-03-23	2	11	1	3	0.7242000000000001
Bit Orchard	2021-05-19	3	11	1	4	0.7242000000000001
Where is my mom	2021-08-01	3	11	1	4	0.7242000000000001
Pavel Repin's Collection	2021-10-23	3	11	1	4	0.7242000000000001
Word Hunt Fever	2021-05-14	2	11	1	3	0.7242000000000001
Carma	2021-06-03	9	11	1	10	0.7242000000000001
Frog Hands Steve	2021-05-12	2	11	1	3	0.7242000000000001
Dice Knight: Mystery of the Moirai	2021-06-11	5	11	1	6	0.7242000000000001
Beat the Beat Up!	2021-05-18	2	11	1	3	0.7242000000000001
侦查故事：枪声	2021-09-09	4	11	1	5	0.7242000000000001
GoBlaster	2021-08-03	3	11	1	4	0.7242000000000001
IsoCubes	2021-06-04	3	11	1	4	0.7242000000000001
BSurfing	2021-08-01	4	11	1	5	0.7242000000000001
DAMA GALLERIA	2021-07-10	2	11	1	3	0.7242000000000001
Rhythmetallic	2021-07-17	4	11	1	5	0.7242000000000001
Payload	2021-11-05	4	11	1	5	0.7242000000000001
Please Duology	2021-10-25	4	11	1	5	0.7242000000000001
Sand Story	2021-10-28	3	11	1	4	0.7242000000000001
Secrets of Magic 5: Back to School	2021-10-25	7	11	1	8	0.7242000000000001
Special Education Modules	2021-10-25	4	11	1	5	0.7242000000000001
Jewel Match Atlantis Solitaire 3 - Collector's Edition	2021-12-20	16	11	1	17	0.7242000000000001
Chezzle	2021-10-05	4	11	1	5	0.7242000000000001
Super Gunfight	2021-10-27	2	11	1	3	0.7242000000000001
Puzzle Art: Cats	2021-10-06	3	11	1	4	0.7242000000000001
Pieces of Beauty 2	2021-10-21	2	11	1	3	0.7242000000000001
Being Left The Fuck Alone Simulator	2021-11-17	2	11	1	3	0.7242000000000001
Deborg Desolation Pre-Born	2021-12-03	4	11	1	5	0.7242000000000001
Santa's Slippery Slope	2021-12-17	6	11	1	7	0.7242000000000001
Hacker Simulator	2021-10-20	432	589	187	619	0.7241
Penimorta	2021-04-30	34	185	53	87	0.7240000000000001
Savior of the Abyss	2021-08-12	53	163	46	99	0.7239
Pnevmo-Capsula: Domiki	2021-10-04	5	99	26	31	0.7239
Club Hentai: Girls, Love, Sex	2021-11-21	25	38	8	33	0.7238
Grapple Hoops	2021-10-18	7	38	8	15	0.7238
Guardian of Lore	2021-05-18	3	27	5	8	0.7238
A Rogue Escape	2021-06-10	7	27	5	12	0.7238
Fantastic Honey	2021-06-26	12	27	5	17	0.7238
Mix Hentai Girls	2021-08-30	4	27	5	9	0.7238
Mistake	2021-11-26	3	27	5	8	0.7238
Aragami 2	2021-09-17	1948	1964	666	2614	0.7237
Deadswitch 3	2021-05-07	235	1378	460	695	0.7237
Rustler	2021-08-31	236	958	314	550	0.7237
Deepest Chamber: Resurrection	2021-07-22	110	150	42	152	0.7236
Save the Pirate	2021-02-25	19	45	10	29	0.7234999999999999
A Lose Hero in the Castle of the Succubi	2021-10-07	6	45	10	16	0.7234999999999999
Nickelodeon All-Star Brawl	2021-10-05	13314	3925	1367	14681	0.7234
Causa, Voices of the Dusk	2021-05-26	97	243	72	169	0.7234
救公主？救个屁！ Save the princess？Save a fart！	2021-12-17	91	196	57	148	0.7228
My Dear Prince	2021-04-30	10	23	4	14	0.7228
Razenroth 2	2021-08-06	6	23	4	10	0.7228
Loopomotive	2021-03-31	5	23	4	9	0.7228
Math Hero - Minimalist Puzzle	2021-01-20	3	23	4	7	0.7228
Escape from Terror City	2021-07-14	3	23	4	7	0.7228
M.A.R.S.S.	2021-05-24	5	23	4	9	0.7228
BeeFense BeeMastered	2021-06-24	6	23	4	10	0.7228
Murder Diaries	2021-09-17	7	23	4	11	0.7228
Knights of the Tiny Table	2021-10-21	6	23	4	10	0.7228
CURSED NIGHT - The House	2021-09-17	5	23	4	9	0.7228
Soulstopia -PHI-	2021-09-28	5	23	4	9	0.7228
HUNDRED FIRES: The rising of red star - EPISODE 1	2021-12-10	3	23	4	7	0.7228
Sword and Fairy 4	2021-06-17	96	130	36	132	0.7225
World Wide Hack	2021-12-22	30	55	13	43	0.7225
Watch Your Ride	2021-08-26	9	34	7	16	0.7223999999999999
Ink Paper Minesweeper	2021-05-21	7	34	7	14	0.7223999999999999
Kitaria Fables	2021-09-02	1001	809	265	1266	0.7223
Neko Puzzle	2021-07-26	10	75	19	29	0.7222
SkyDrift Infinity	2021-07-29	17	65	16	33	0.7222
Twin Ruin	2021-12-22	3	15	2	5	0.7222
Kakatte Koi Yo!	2021-04-30	6	15	2	8	0.7222
Rhythm Race	2021-07-22	4	15	2	6	0.7222
軟体轟輪ゲルタンク	2021-04-28	9	15	2	11	0.7222
Mightyy's FPS Aim Trainer	2021-08-26	8	15	2	10	0.7222
A Murmur in the Trees	2021-06-16	2	15	2	4	0.7222
Survival RPG: The lost treasure	2021-01-10	6	15	2	8	0.7222
Micro Annihilation	2021-03-01	5	15	2	7	0.7222
Silent Earth	2021-03-05	3	15	2	5	0.7222
Space Mages: D33	2021-03-19	2	15	2	4	0.7222
Dreams of an Exile	2021-05-21	5	15	2	7	0.7222
World Splitter	2021-04-21	3	15	2	5	0.7222
SPY ESCAPE	2021-03-11	18	15	2	20	0.7222
Wind Angel Ⅱ	2021-04-15	5	15	2	7	0.7222
Memories of East Coast	2021-06-01	3	15	2	5	0.7222
Willage	2021-11-16	2	15	2	4	0.7222
Inside the Memories	2021-06-17	5	15	2	7	0.7222
Digital Expo Center	2021-07-14	7	15	2	9	0.7222
Race for Your Life	2021-12-01	6	15	2	8	0.7222
Cold Verdict	2021-12-17	2	15	2	4	0.7222
Yavi	2021-12-13	3	15	2	5	0.7222
LIP! Lewd Idol Project Vol. 1 - Hot Springs and Beach Episodes	2021-12-15	9	15	2	11	0.7222
Wonhon: Prologue	2021-03-01	7	48	11	18	0.7221
東方覚醒珠（※二次創作） ～ Fan-made Virtual Autography.	2021-03-20	18	19	3	21	0.7221
Heaven vs Hell	2021-04-28	14	19	3	17	0.7221
Dungeons & Cocks	2021-01-27	9	19	3	12	0.7221
ChessLocke	2021-03-05	11	19	3	14	0.7221
Inukari - Chase of Deception	2021-03-18	4	19	3	7	0.7221
Facing	2021-04-08	6	19	3	9	0.7221
Incarna: R•AI•D	2021-03-19	3	19	3	6	0.7221
Age of Legion	2021-05-01	9	19	3	12	0.7221
Shots fired in the Dark Forest	2021-04-23	2	19	3	5	0.7221
Sokpop S10: WILD-9	2021-03-08	3	19	3	6	0.7221
Destroy Geometric Shapes	2021-04-01	3	19	3	6	0.7221
Geo-Duck	2021-08-16	5	19	3	8	0.7221
Zen World	2021-10-07	59	41	9	68	0.7220000000000001
Song in the Smoke	2021-12-16	10	41	9	19	0.7220000000000001
Ashwalkers	2021-04-15	75	123	34	109	0.7217
Phoenix Hope	2021-12-14	50	91	24	74	0.7217
Teknedia	2021-01-08	8	6	0	8	0.7217
Secret of the Rendrasha Blade	2021-08-04	5	6	0	5	0.7217
Foodtruck Arena	2021-07-02	6	6	0	6	0.7217
Mystery Solitaire. Dreamcatcher	2021-04-01	4	6	0	4	0.7217
Whone	2021-01-29	5	6	0	5	0.7217
Hoops Madness	2021-03-18	7	6	0	7	0.7217
Space Pioneer	2021-08-25	2	6	0	2	0.7217
最后一个地球人 The last earth man	2021-09-18	2	6	0	2	0.7217
AvoidVania	2021-09-25	3	6	0	3	0.7217
The Game is ON	2021-01-21	3	6	0	3	0.7217
Drifters Don't Brake	2021-07-04	3	6	0	3	0.7217
Practical Shooting Simulator	2021-07-22	4	6	0	4	0.7217
ThrustLander	2021-11-30	2	6	0	2	0.7217
Kombo King	2021-12-31	2	6	0	2	0.7217
Detours	2021-02-10	3	6	0	3	0.7217
The Ultimate Game	2021-10-08	6	6	0	6	0.7217
Plague Doctor- Contagion: 430 BCE-2020 AD	2021-10-15	3	6	0	3	0.7217
Sketchbots	2021-06-24	4	6	0	4	0.7217
Eternal Liiivie EP2- Hiding in the dark	2021-08-29	2	6	0	2	0.7217
Kick it, Bunny!	2021-02-17	10	6	0	10	0.7217
Battle Mine Sweeper	2021-02-23	4	6	0	4	0.7217
Paradigm Shift	2021-06-01	2	6	0	2	0.7217
MARK-I: Mission Pilot	2021-06-12	2	6	0	2	0.7217
Stream Quest	2021-01-22	5	6	0	5	0.7217
Evil Seal	2021-02-08	2	6	0	2	0.7217
Wildfire - Ticket to Rock	2021-06-18	3	6	0	3	0.7217
AmIHero	2021-02-19	3	6	0	3	0.7217
The Lost Game: Royal Game Of Ur	2021-03-18	2	6	0	2	0.7217
Toodles & Toddlers	2021-02-16	2	6	0	2	0.7217
Jigsaw Pieces 2 - Shades of Mood	2021-04-01	4	6	0	4	0.7217
Atrius Star	2021-02-10	136	6	0	136	0.7217
FoxPaww	2021-02-19	2	6	0	2	0.7217
Redeliver	2021-05-10	2	6	0	2	0.7217
Roguely	2021-06-25	3	6	0	3	0.7217
Flipol	2021-02-26	3	6	0	3	0.7217
Hook Only	2021-03-18	3	6	0	3	0.7217
Faircroft's Antiques: The Heir of Glen Kinnoch	2021-03-19	9	6	0	9	0.7217
Passengers Of Execution	2021-12-22	2	6	0	2	0.7217
Red Frozen	2021-07-23	2	6	0	2	0.7217
Small Town Robot	2021-04-03	1	6	0	1	0.7217
Streamer Dancefloor	2021-04-23	4	6	0	4	0.7217
Red White Yellow	2021-03-30	4	6	0	4	0.7217
Slayers, Inc.	2021-09-24	5	6	0	5	0.7217
Bear Haven Nights 2	2021-03-22	2	6	0	2	0.7217
stardust	2021-05-29	2	6	0	2	0.7217
Guns and Grapples	2021-11-01	5	6	0	5	0.7217
Low-Key: A Dope Game	2021-04-14	3	6	0	3	0.7217
Super Pixel World	2021-04-02	2	6	0	2	0.7217
Knights of Grumthorr 2	2021-03-29	2	6	0	2	0.7217
G-MODEアーカイブス01 フライハイトクラウディア	2021-04-27	6	6	0	6	0.7217
Super Vili	2021-04-09	2	6	0	2	0.7217
Experience the Energy: Take the Tour	2021-05-03	1	6	0	1	0.7217
Northern Blades	2021-05-22	3	6	0	3	0.7217
Revolver and Co	2021-07-02	3	6	0	3	0.7217
Small Press Tycoon	2021-05-03	2	6	0	2	0.7217
Red Colony 2 Uncensored	2021-11-19	4	6	0	4	0.7217
Schmutznik	2021-10-15	2	6	0	2	0.7217
ULTRA NINJA SOUL	2021-06-01	2	6	0	2	0.7217
Heard There Was A Chosen One	2021-05-17	3	6	0	3	0.7217
Mirror Of Life	2021-05-21	6	6	0	6	0.7217
BrainLand	2021-06-19	1	6	0	1	0.7217
Shipwreck Escape	2021-06-24	2	6	0	2	0.7217
Thermonuclear	2021-11-11	2	6	0	2	0.7217
Going the Distance	2021-10-27	5	6	0	5	0.7217
Devileader	2021-06-25	2	6	0	2	0.7217
Wishlair	2021-07-28	2	6	0	2	0.7217
Escape War	2021-07-04	3	6	0	3	0.7217
跳蛋的故事	2021-08-31	2	6	0	2	0.7217
Finding A Prince: The Game	2021-07-15	3	6	0	3	0.7217
They All Come Back	2021-07-15	2	6	0	2	0.7217
Anima Forest	2021-07-21	5	6	0	5	0.7217
BOPPING DRIVE	2021-12-14	3	6	0	3	0.7217
Brotate	2021-08-11	3	6	0	3	0.7217
Slime Killer	2021-08-17	2	6	0	2	0.7217
Infinity treasures	2021-12-15	2	6	0	2	0.7217
Photo Puzzles HD	2021-08-25	4	6	0	4	0.7217
Holiday Mosaics Halloween Puzzles	2021-10-01	3	6	0	3	0.7217
WORLD OF PARANOIA	2021-09-06	2	6	0	2	0.7217
The Judgement of Q	2021-10-04	2	6	0	2	0.7217
FBG Arcade Machine	2021-09-16	2	6	0	2	0.7217
The Twins' Experiment	2021-10-01	2	6	0	2	0.7217
Hordebreaker	2021-12-18	2	6	0	2	0.7217
Netherspace	2021-10-05	1	6	0	1	0.7217
Dungeon Arsenal	2021-10-20	7	6	0	7	0.7217
SquaredUp	2021-10-05	4	6	0	4	0.7217
Spirit Overflow	2021-10-06	4	6	0	4	0.7217
Marriage to the demon wife!	2021-10-20	2	6	0	2	0.7217
Fantasy Sliding Puzzle 2	2021-09-16	2	6	0	2	0.7217
Chair Spinning Simulator	2021-12-24	14	6	0	14	0.7217
Chao's Collection of Random Games	2021-11-17	3	6	0	3	0.7217
Echo - An Indie Tale	2021-11-17	1	6	0	1	0.7217
Emi & The Super Boba	2021-10-17	7	6	0	7	0.7217
Twin Mind: Power of Love Collector's Edition	2021-10-22	9	6	0	9	0.7217
Tomb Keeper Mansion Deluxe Pinball	2021-11-15	3	6	0	3	0.7217
Edwardo	2021-11-12	2	6	0	2	0.7217
LTO Arcade	2021-10-19	2	6	0	2	0.7217
Flappy Octane	2021-11-01	4	6	0	4	0.7217
Bubble POP IT ASMR	2021-10-13	5	6	0	5	0.7217
Mestres do GDO	2021-11-04	3	6	0	3	0.7217
全托教师	2021-11-30	4	6	0	4	0.7217
Ani Leaving Sirius	2021-11-08	2	6	0	2	0.7217
Coolbit	2021-11-10	1	6	0	1	0.7217
Fantasy Sliding Puzzle 4	2021-10-20	2	6	0	2	0.7217
Twinland	2021-11-18	2	6	0	2	0.7217
Alpha Zoo	2021-11-29	2	6	0	2	0.7217
Clou - Roll & Heist	2021-11-24	3	6	0	3	0.7217
Santa Protects the Christmas Tree	2021-12-20	6	6	0	6	0.7217
Sumy Shelltris - ICEBLOCKS 3	2021-11-26	2	6	0	2	0.7217
Find The Sunbed	2021-12-07	3	6	0	3	0.7217
Neon Horizon:Eclipse	2021-12-21	2	6	0	2	0.7217
The Christmas Spirit: Golden Ticket Collector's Edition	2021-12-28	9	6	0	9	0.7217
Fireworks Simulator: Realistic	2021-03-10	27	107	29	56	0.7216
Soulworker	2021-05-13	10332	6948	2487	12819	0.7214
Puff Town	2021-09-29	17	252	76	93	0.7214
City of Gangsters	2021-08-09	1184	807	266	1450	0.7212999999999999
BARRICADEZ	2021-09-29	63	110	30	93	0.7212999999999999
与芙兰朵露一起捉迷藏吧	2021-11-13	12	51	12	24	0.721
Memory Booster	2021-09-30	5	30	6	11	0.7209000000000001
Destined to Die	2021-07-13	27	141	40	67	0.7208
Total War: ROME REMASTERED	2021-04-29	18526	6552	2352	20878	0.7206
Fortuito: Lost History	2021-02-05	5	44	10	15	0.7206
Come with Me	2021-05-14	225	889	296	521	0.7205
13:ORIGIN Prologue	2021-08-27	41	122	34	75	0.7205
Ghost in the pool	2021-01-28	14	202	60	74	0.7204
AGAINST	2021-12-16	74	205	61	135	0.7203
The Legend of Karl	2021-02-21	198	223	67	265	0.7202
Construct VR - The Volumetric Movie	2021-12-23	7	64	16	23	0.7201000000000001
Anarchy: Wolf's law : Prologue	2021-08-26	201	412	131	332	0.7199
Love Fantasy	2021-03-06	222	210	63	285	0.7195
Cute Girl	2021-09-24	6	96	26	32	0.7195
Black Hole Simulator	2021-09-05	5	80	21	26	0.7195
Beth the Exhibitionist	2021-07-02	24	47	11	35	0.7194
Tanuki Justice	2021-04-15	4	26	5	9	0.7194
SATORI	2021-08-06	10	26	5	15	0.7194
Half Past Fate: Romantic Distancing	2021-02-14	6	26	5	11	0.7194
Retroninjacyberassassin	2021-04-01	2	26	5	7	0.7194
Inverse Evolver	2021-12-16	6	26	5	11	0.7194
Black Widow: Recharged	2021-10-28	5	26	5	10	0.7194
Into the Metaverse	2021-10-16	4	26	5	9	0.7194
Patron	2021-08-10	1611	1546	533	2144	0.7192000000000001
Garbage: Hobo Prophecy	2021-01-28	888	1032	349	1237	0.7192000000000001
Firelight Fantasy: Resistance	2021-07-11	12	57	14	26	0.7192000000000001
Beat Souls	2021-07-30	10	57	14	24	0.7192000000000001
No Longer Home	2021-07-30	25	182	54	79	0.7189
Classified Stories	2021-04-08	10	40	9	19	0.7189
How To Bathe Your Cat: Drawing	2021-11-17	5	33	7	12	0.7187
Remnants	2021-03-05	186	541	177	363	0.7184999999999999
Yacht Dice	2021-09-30	73	73	19	92	0.7184999999999999
Gearshifters	2021-10-01	11	60	15	26	0.7184999999999999
Horny Crush	2021-09-10	7	60	15	22	0.7184999999999999
WISH Paradise	2021-04-26	110	385	123	233	0.7184
Scars of Summer	2021-04-10	500	799	268	768	0.7183
Fight Party	2021-05-15	34	98	27	61	0.7178
InfiniteCorp	2021-02-22	3	22	4	7	0.7178
G for Gravity	2021-05-10	4	22	4	8	0.7178
Lord of the Click 2	2021-09-10	10	22	4	14	0.7178
Scale Enchanter	2021-10-15	3	22	4	7	0.7178
Silent dream	2021-06-14	35	132	38	73	0.7177
Void Tyrant	2021-09-03	30	43	10	40	0.7176
Saints & Sinners	2021-04-16	33	43	10	43	0.7176
Shatter Keep	2021-05-07	136	43	10	146	0.7176
Dark Deity	2021-06-15	2043	1516	528	2571	0.7173
Black Forest	2021-09-24	52	245	76	128	0.7170000000000001
Game Theory At Christmas	2021-10-05	13	36	8	21	0.7170000000000001
The Companion	2021-05-13	8	56	14	22	0.7169
Ynglet: Prologue	2021-02-18	11	29	6	17	0.7169
피피숲의 연금술사	2021-08-29	11	29	6	17	0.7169
Summer~Life in the Countryside~	2021-03-25	223	535	177	400	0.7166
Minesweeper Ultimate	2021-09-10	19	72	19	38	0.7166
THE SHORE	2021-02-19	179	954	327	506	0.7162999999999999
Spirit	2021-06-01	10	18	3	13	0.7162999999999999
Hentai Gothic Girl	2021-08-23	2	18	3	5	0.7162999999999999
Boom	2021-02-14	118	18	3	121	0.7162999999999999
Solo Fox	2021-02-13	3	18	3	6	0.7162999999999999
ViruZ	2021-03-19	4	18	3	7	0.7162999999999999
Starfighter: Eclipse	2021-04-20	6	18	3	9	0.7162999999999999
Gardens and Girls	2021-07-18	2	18	3	5	0.7162999999999999
异界转生 这次变成了传说中的勇者呢（受）	2021-11-18	12	18	3	15	0.7162999999999999
Tricks Magician	2021-08-31	5	18	3	8	0.7162999999999999
VGL: Imperative	2021-08-23	3	18	3	6	0.7162999999999999
- R E F L E C T E D -	2021-08-12	4	18	3	7	0.7162999999999999
Obscura	2021-08-06	4	18	3	7	0.7162999999999999
Bridge of Dawn	2021-09-30	4	18	3	7	0.7162999999999999
Tranquil Cove	2021-11-02	2	18	3	5	0.7162999999999999
Cursed Island	2021-12-09	7	18	3	10	0.7162999999999999
69 Moriko Love	2021-11-17	5	18	3	8	0.7162999999999999
BEACHED	2021-08-04	300	1700	600	900	0.7159000000000001
Saimin Gakushū: Secret Desire	2021-11-05	101	199	61	162	0.7156999999999999
Summertime Madness	2021-06-17	14	62	16	30	0.7156999999999999
Aluna: Sentinel of the Shards	2021-05-26	10	39	9	19	0.7156999999999999
Unravel 2	2021-03-09	7	39	9	16	0.7156999999999999
Atomic Cards	2021-10-29	9	39	9	18	0.7156999999999999
Distancing	2021-03-17	14	121	35	49	0.7155
Karl's Kooky Warehouse	2021-12-06	14	10	1	15	0.7155
Blood of Darkness	2021-04-19	2	10	1	3	0.7155
L.S.S II	2021-03-12	4	10	1	5	0.7155
Where Shadows Slumber	2021-03-12	2	10	1	3	0.7155
Gooberries	2021-03-03	3	10	1	4	0.7155
SRX	2021-10-23	12	10	1	13	0.7155
Systematic Insanity	2021-03-28	37	10	1	38	0.7155
Defend Them !	2021-02-16	2	10	1	3	0.7155
Hard Vacuum	2021-05-17	3	10	1	4	0.7155
Golden Fall 2	2021-03-18	2	10	1	3	0.7155
Jurassic Fantasy	2021-04-13	2	10	1	3	0.7155
Neon Wings: Air Race	2021-05-15	6	10	1	7	0.7155
Aircraft Sketch Shooter	2021-01-11	3	10	1	4	0.7155
Sucker Punch	2021-11-18	5	10	1	6	0.7155
Yabgits: Haunted Cemetery	2021-04-15	2	10	1	3	0.7155
HarmonEy	2021-03-15	4	10	1	5	0.7155
Piozila	2021-04-12	2	10	1	3	0.7155
Just get in through the door	2021-04-26	3	10	1	4	0.7155
Ball Challenge	2021-03-30	1	10	1	2	0.7155
SDST: Deluxe	2021-04-05	3	10	1	4	0.7155
Descent Vector: Space Runner	2021-08-17	3	10	1	4	0.7155
Memento Infernum	2021-04-16	3	10	1	4	0.7155
Katja's Abyss: Tactics	2021-04-23	4	10	1	5	0.7155
Eddie Hill in the Curse of the Skull Medallion	2021-04-29	4	10	1	5	0.7155
Toverblade	2021-05-06	5	10	1	6	0.7155
Academy Quest	2021-10-09	3	10	1	4	0.7155
孤胆惊魂2：消失的207（Fear 2: The Disappeared 207）	2021-06-29	3	10	1	4	0.7155
Cyber Defence	2021-08-06	4	10	1	5	0.7155
GUN GUN CREATE	2021-08-05	2	10	1	3	0.7155
Puzzle Soccer	2021-08-02	2	10	1	3	0.7155
Sengoku - A Time of Warriors and Demons	2021-08-16	3	10	1	4	0.7155
Grim Tales: The Heir Collector's Edition	2021-07-30	14	10	1	15	0.7155
Robo-Boy Risky Venture	2021-08-17	2	10	1	3	0.7155
Marble Mage	2021-09-07	4	10	1	5	0.7155
Spacecraft speed	2021-10-13	2	10	1	3	0.7155
Challenge Dream Cat	2021-11-04	6	10	1	7	0.7155
Kingdom of Dinza	2021-12-23	2	10	1	3	0.7155
ReDrawn: The Painted Tower Collector's Edition	2021-11-12	7	10	1	8	0.7155
Drone Crash Course	2021-11-12	3	10	1	4	0.7155
Square Shooter	2021-11-06	3	10	1	4	0.7155
Halloween Chronicles: Behind the Door Collector's Edition	2021-10-22	8	10	1	9	0.7155
Hide and Seek	2021-11-13	35	84	23	58	0.7154
HENTAI PRINCESS	2021-04-23	16	163	49	65	0.7153
Fantasy Town Regional Manager	2021-11-05	24	65	17	41	0.7153
RunnerDot	2021-07-20	167	306	98	265	0.7152
触尾少女	2021-01-08	101	219	68	169	0.7152
Life In Yima	2021-04-05	4	14	2	6	0.7152
Best Day Ever	2021-06-07	5	14	2	7	0.7152
Beholder's Lair	2021-01-06	3	14	2	5	0.7152
Conspiracy!	2021-01-20	7	14	2	9	0.7152
Airstrife: Assault of the Aviators	2021-02-26	119	14	2	121	0.7152
Orange Santa	2021-01-08	2	14	2	4	0.7152
Poker Squadrons	2021-04-13	6	14	2	8	0.7152
Gnomes Garden: Return Of The Queen	2021-04-20	9	14	2	11	0.7152
A Day	2021-02-04	3	14	2	5	0.7152
Cat’s Princess - Visual novel / Otome	2021-08-11	3	14	2	5	0.7152
Rogue Sentry	2021-04-15	3	14	2	5	0.7152
Vitality Girl	2021-05-13	3	14	2	5	0.7152
Run and Jump Little Vico	2021-07-08	3	14	2	5	0.7152
JUST HOOPS	2021-07-21	4	14	2	6	0.7152
Christmas Stories: Puss in Boots Collector's Edition	2021-06-08	10	14	2	12	0.7152
Sur	2021-07-23	3	14	2	5	0.7152
Rudymical	2021-11-06	9	14	2	11	0.7152
归家	2021-09-15	12	14	2	14	0.7152
Abettor	2021-09-25	2	14	2	4	0.7152
Dungeon Explorer	2021-11-12	5	14	2	7	0.7152
The Wanderer	2021-11-30	5	14	2	7	0.7152
Drift21	2021-06-10	827	1447	510	1337	0.715
Eos	2021-05-14	8	52	13	21	0.715
You Must	2021-09-03	11	198	61	72	0.7149
Tetragon	2021-08-12	4	32	7	11	0.7149
Holt	2021-12-28	12	32	7	19	0.7149
War Wind	2021-09-16	11	32	7	18	0.7149
Sanae Toumaden X	2021-02-26	7	25	5	12	0.7148000000000001
An Un-epic story: The adventure of Enki and Tiny Freddie	2021-07-20	4	25	5	9	0.7148000000000001
Devil, It's me	2021-08-03	13	25	5	18	0.7148000000000001
Flexibility and Girls	2021-05-16	3	25	5	8	0.7148000000000001
Pretty Girls Rivers (Shisen-Sho)	2021-12-03	5	25	5	10	0.7148000000000001
Femboys of the Phalanx	2021-04-01	5	99	28	33	0.7147
Twelve Minutes	2021-08-19	8021	4559	1675	9696	0.7145999999999999
Blacksmith of the Sand Kingdom	2021-01-07	351	102	29	380	0.7145999999999999
Coffin Mall	2021-10-21	5	42	10	15	0.7145999999999999
Himeko Sutori	2021-01-31	99	162	49	148	0.7144
Dream Engines: Nomad Cities	2021-07-14	524	313	101	625	0.7143
Aron's Adventure	2021-04-07	99	153	46	145	0.7143
Malum	2021-09-02	212	392	129	341	0.7140000000000001
GunSoul Girl	2021-02-25	356	1082	379	735	0.7138
Gamer Girls (18+)	2021-04-09	464	397	131	595	0.7138
Gwan Moon High School : The Ghost Gate	2021-03-12	9	45	11	20	0.7137000000000001
I Am Fish	2021-09-16	390	1179	415	805	0.7136
Gun Duel	2021-02-24	24	61	16	40	0.7134999999999999
Megacraft Hentai Battlegrounds	2021-05-14	6	61	16	22	0.7134999999999999
Red Algorithm	2021-06-15	15	61	16	31	0.7134999999999999
Cantaloper	2021-06-24	7	35	8	15	0.7134999999999999
Helper Cat	2021-09-17	5	35	8	13	0.7134999999999999
Deluded	2021-12-20	6	35	8	14	0.7134999999999999
Mining Cats	2021-12-16	4	35	8	12	0.7134999999999999
Crimson Colosseum	2021-07-31	144	92	26	170	0.7133
Role Player: Full Immersion	2021-03-24	11	143	43	54	0.7132
Heads Will Roll	2021-09-05	32	119	35	67	0.713
Wonhon: the Beginning	2021-05-04	19	67	18	37	0.7128
Puzzle Forge Dungeon	2021-09-07	12	28	6	18	0.7126
Pinball Groupies	2021-12-21	4	28	6	10	0.7126
DeMagnete VR	2021-07-27	6	21	4	10	0.7125
Mister Burnhouse	2021-04-13	2	21	4	6	0.7125
Deichgraf	2021-04-19	9	21	4	13	0.7125
TinyShot	2021-02-19	4	21	4	8	0.7125
Island of the Lost	2021-10-22	4	21	4	8	0.7125
LP	2021-02-19	4	21	4	8	0.7125
Angry Space Bees	2021-04-30	2	21	4	6	0.7125
Wild Wild Chess	2021-04-23	4	21	4	8	0.7125
PandaSG	2021-04-21	3	21	4	7	0.7125
Submarine War	2021-07-13	5	21	4	9	0.7125
Game For Anna	2021-07-06	9	73	20	29	0.7123999999999999
Gone Viral	2021-08-31	34	51	13	47	0.7123999999999999
Endless Voyage	2021-01-08	592	469	158	750	0.7123
ネジ込みシミュレーターVol1 -おかっぱ巨乳ちゃんを簡単マウス操作で極太ディルドーにずぽずぽさせる疑似オナホアプリ-【拡張・オナホ化・石化・時間停止】	2021-04-01	32	76	21	53	0.7122
荧火微光	2021-07-29	17	54	14	31	0.7119
Shades Of Rayna	2021-05-10	57	127	38	95	0.7118000000000001
Sovietpunk	2021-04-02	4	118	35	39	0.7117
Game Master Engine	2021-03-09	30	94	27	57	0.7117
First Feudal	2021-04-08	135	364	121	256	0.7116
Danger Scavenger	2021-03-25	64	274	89	153	0.7116
Tennis Manager 2021	2021-09-07	338	165	51	389	0.7116
Super Clown: Lost Diamonds	2021-12-06	9	57	15	24	0.7115
Obsideo	2021-08-28	364	608	210	574	0.711
Silicon City	2021-10-14	20	31	7	27	0.711
Diamond Hands: To The Moon	2021-09-23	34	31	7	41	0.711
Forest adventure	2021-10-10	5	31	7	12	0.711
Biolum	2021-12-02	9	63	17	26	0.7109000000000001
Lonely Catgirl is the Purrfect Pussy	2021-02-05	20	63	17	37	0.7109000000000001
Ragdoll: Fall Simulator	2021-07-23	7	63	17	24	0.7109000000000001
Citystate II	2021-09-23	343	561	193	536	0.7108
Wheel of Fate	2021-02-12	9	44	11	20	0.7107
VR JAPAN	2021-01-09	6	44	11	17	0.7107
Norega	2021-07-06	159	123	37	196	0.7105
Swing Dunk	2021-09-16	129	364	122	251	0.7103
Sarawak	2021-01-28	4	17	3	7	0.71
Ardein.Fall	2021-12-15	4	17	3	7	0.71
群鹰之岛	2021-02-18	6	17	3	9	0.71
Outsider: After Life	2021-07-13	5	17	3	8	0.71
Little Hats	2021-09-30	5	17	3	8	0.71
Raging Ball	2021-02-28	12	17	3	15	0.71
Pirat Island	2021-03-13	5	17	3	8	0.71
Trekking and Camping | 远足与露营	2021-05-04	3	17	3	6	0.71
Endless Furry Killer Infinity	2021-05-18	4	17	3	7	0.71
Sovereign Tea	2021-07-30	8	17	3	11	0.71
MouseBot: Escape from CatLab	2021-07-21	5	17	3	8	0.71
My name is human	2021-09-17	6	17	3	9	0.71
Jewel Match Solitaire Summertime	2021-09-02	13	17	3	16	0.71
Visual Novel Sisters	2021-09-23	3	17	3	6	0.71
Farm and Girls	2021-10-28	2	17	3	5	0.71
69 Megumi Love	2021-11-26	5	17	3	8	0.71
~府城少女~ 以妳為名的府城情書	2021-02-25	5	24	5	10	0.7099
Retro Classix: Joe & Mac - Caveman Ninja	2021-03-02	4	24	5	9	0.7099
My Sexy Waitress	2021-06-18	587	240	78	665	0.7098000000000001
Daughter of Essence	2021-03-12	16	34	8	24	0.7098000000000001
Mount Serenity: Guardian of the Spirits	2021-05-17	7	34	8	15	0.7098000000000001
Dick Hook	2021-12-12	3	34	8	11	0.7098000000000001
PixPhys	2021-04-25	15	151	47	62	0.7093
Angels Cove	2021-10-08	5	53	14	19	0.7093
Waifu Secret	2021-02-05	1006	479	165	1171	0.7090000000000001
Waifus Smash	2021-12-04	125	142	44	169	0.7089
Quinterra	2021-04-07	29	37	9	38	0.7088
Floor is Lava	2021-11-30	12	37	9	21	0.7088
Soul Nomad & the World Eaters	2021-08-31	96	101	30	126	0.7087000000000001
Re:Destiny	2021-11-19	208	269	89	297	0.7086
Siren Head Hentai Edition	2021-06-04	4	92	27	31	0.7084999999999999
Celerity	2021-12-16	10	92	27	37	0.7084999999999999
Live Inc.	2021-01-29	21	86	25	46	0.7084
Looking for Heals	2021-03-25	24	83	24	48	0.7084
Train Chase	2021-05-27	3	5	0	3	0.7084
Decoherence	2021-10-28	16	5	0	16	0.7084
Khaos Wind	2021-07-05	2	5	0	2	0.7084
Curves	2021-04-15	2	5	0	2	0.7084
Ashi	2021-12-10	2	5	0	2	0.7084
Fractalis	2021-02-02	4	5	0	4	0.7084
Trial Of Destiny	2021-04-07	2	5	0	2	0.7084
Have a Blast	2021-08-26	3	5	0	3	0.7084
Once More	2021-10-27	3	5	0	3	0.7084
Solar Rogue	2021-12-15	3	5	0	3	0.7084
Deadly Maze	2021-01-01	3	5	0	3	0.7084
Kooring VR Wonderland : Heart Castle Crush	2021-03-26	2	5	0	2	0.7084
摇摆地牢 swing dungeon	2021-09-09	3	5	0	3	0.7084
ZOMBIE MATHters	2021-05-02	3	5	0	3	0.7084
Super CosmoJet	2021-08-04	2	5	0	2	0.7084
Corg of the Dead	2021-09-09	2	5	0	2	0.7084
Vapor Music Tour	2021-01-06	2	5	0	2	0.7084
REM Cycles	2021-03-31	3	5	0	3	0.7084
Lumiland	2021-02-11	2	5	0	2	0.7084
Tunnel Blast	2021-01-25	1	5	0	1	0.7084
Pristiq: Tash's Trilogy	2021-09-13	2	5	0	2	0.7084
Mr. Walker's Basement	2021-03-16	1	5	0	1	0.7084
Why pizza?	2021-06-02	2	5	0	2	0.7084
Wound of the West	2021-02-12	3	5	0	3	0.7084
Deadzone: Exodus	2021-04-15	2	5	0	2	0.7084
Vulgord's Tower	2021-08-10	4	5	0	4	0.7084
Time Freeze	2021-11-19	2	5	0	2	0.7084
Because its hot!	2021-05-08	2	5	0	2	0.7084
Slidungeon	2021-02-15	1	5	0	1	0.7084
Beyond The Diorama: Caribou World	2021-01-19	2	5	0	2	0.7084
Demonicute	2021-01-16	2	5	0	2	0.7084
JankBrain	2021-01-19	4	5	0	4	0.7084
Forge Squad	2021-11-10	5	5	0	5	0.7084
The Sisters - Party of the Year	2021-06-21	3	5	0	3	0.7084
Grab Toy	2021-11-10	3	5	0	3	0.7084
Broken Thorns: West Gate	2021-10-14	2	5	0	2	0.7084
After Meeting	2021-02-14	2	5	0	2	0.7084
Droplet: States of Matter	2021-03-16	2	5	0	2	0.7084
Minesweeper Versus	2021-01-22	8	5	0	8	0.7084
Haunted Nightmares	2021-02-05	1	5	0	1	0.7084
Just Shake It	2021-02-08	2	5	0	2	0.7084
Trenga Unlimited	2021-05-28	4	5	0	4	0.7084
Tales of Farhollow	2021-05-01	5	5	0	5	0.7084
WhiteWash	2021-02-10	3	5	0	3	0.7084
ThroughHelltoHeaven	2021-02-03	2	5	0	2	0.7084
SpacePOM	2021-10-15	3	5	0	3	0.7084
A Walk Through Echoes	2021-07-23	3	5	0	3	0.7084
Pixel Game Maker Series Osyaberi! Horijyo! Holin Slash	2021-04-08	5	5	0	5	0.7084
Twilight Drive	2021-06-16	2	5	0	2	0.7084
Youmu Konpaku & Dungeon of Lewd Creatures	2021-06-23	5	5	0	5	0.7084
Ballistic M.A.D.ness	2021-03-15	3	5	0	3	0.7084
The Lost Dog	2021-08-31	4	5	0	4	0.7084
Sophistry - Love & Despair	2021-12-09	2	5	0	2	0.7084
Bunker Down	2021-02-27	2	5	0	2	0.7084
Retro Classix: Express Raider	2021-03-02	1	5	0	1	0.7084
Ultra Bushwick	2021-04-21	2	5	0	2	0.7084
Infinity Square	2021-05-19	4	5	0	4	0.7084
音符之光传说	2021-10-02	2	5	0	2	0.7084
Ponk's Jam	2021-03-16	3	5	0	3	0.7084
Gob	2021-05-06	5	5	0	5	0.7084
Nevertales: Faryon Collector's Edition	2021-03-12	7	5	0	7	0.7084
Somewhere in a Clay Nowhere	2021-11-21	2	5	0	2	0.7084
To Save Humanity From Virus	2021-04-09	2	5	0	2	0.7084
雪国の少女	2021-03-27	4	5	0	4	0.7084
The Steps as we know them	2021-05-31	2	5	0	2	0.7084
One4	2021-06-02	3	5	0	3	0.7084
CrateTastrophe	2021-04-07	1	5	0	1	0.7084
Tiddy Bounce	2021-04-16	2	5	0	2	0.7084
Frail Faces	2021-07-23	3	5	0	3	0.7084
Soulbound Steel	2021-08-18	2	5	0	2	0.7084
Little Octopus	2021-04-08	1	5	0	1	0.7084
勇者大冒险	2021-09-15	2	5	0	2	0.7084
Happy Z-Day	2021-05-03	3	5	0	3	0.7084
Haywire	2021-04-23	2	5	0	2	0.7084
Escape Room VR: Vaudeville	2021-04-30	2	5	0	2	0.7084
Long Ago: A Puzzle Tale - Demo Version	2021-04-29	3	5	0	3	0.7084
Pippu - Bauble Quest	2021-09-03	2	5	0	2	0.7084
Gun'eM	2021-05-15	2	5	0	2	0.7084
Immortus Temporus	2021-06-16	3	5	0	3	0.7084
Gunmancer	2021-07-26	2	5	0	2	0.7084
The Remainder - Act 2	2021-10-18	4	5	0	4	0.7084
trappuzzler	2021-05-31	4	5	0	4	0.7084
Rescue Teddy	2021-06-30	1	5	0	1	0.7084
Mystery Solitaire Grimm Tales 3	2021-07-23	7	5	0	7	0.7084
Aplestia: Retold	2021-12-18	6	5	0	6	0.7084
Smackit hamster	2021-06-20	2	5	0	2	0.7084
Infinity Valley	2021-07-09	3	5	0	3	0.7084
DEMIGOD™ NFT Gallery	2021-06-16	2	5	0	2	0.7084
煉獄紅葉 MOMIJI FROM PURGATORY	2021-06-23	2	5	0	2	0.7084
Kestrel	2021-06-18	2	5	0	2	0.7084
Loopindex	2021-06-25	3	5	0	3	0.7084
Schematic	2021-07-28	4	5	0	4	0.7084
Crimson Glaive Sigma	2021-07-29	2	5	0	2	0.7084
Only Me	2021-07-12	3	5	0	3	0.7084
XSection	2021-07-21	2	5	0	2	0.7084
Path of Vidya	2021-07-13	3	5	0	3	0.7084
Gemstone Defense	2021-08-17	3	5	0	3	0.7084
Xenomare	2021-08-29	2	5	0	2	0.7084
Unholy Alliance - Tower Defense	2021-09-01	3	5	0	3	0.7084
One thousand baht simulator	2021-07-29	1	5	0	1	0.7084
The Witch Doctor	2021-07-29	3	5	0	3	0.7084
Ha_Bits	2021-08-28	3	5	0	3	0.7084
Carnal Coup - Overseer's Edition	2021-10-01	13	5	0	13	0.7084
Ki11er Clutter	2021-08-24	10	5	0	10	0.7084
CoWorker	2021-12-01	5	5	0	5	0.7084
renderB	2021-11-24	2	5	0	2	0.7084
ASTERO INC	2021-10-15	3	5	0	3	0.7084
Angelic Waves	2021-11-01	2	5	0	2	0.7084
Dragon Question	2021-09-02	2	5	0	2	0.7084
Holiday Jigsaw Easter	2021-09-10	2	5	0	2	0.7084
Holiday Jigsaw Thanksgiving Day	2021-09-28	2	5	0	2	0.7084
Endless mahjong	2021-08-22	2	5	0	2	0.7084
Wild West Rogue	2021-09-05	2	5	0	2	0.7084
Captain Jackson	2021-10-26	4	5	0	4	0.7084
异星夺宝	2021-10-26	5	5	0	5	0.7084
Hedgie Simulator	2021-09-16	3	5	0	3	0.7084
心灵迷宫（ Mind maze）	2021-10-08	2	5	0	2	0.7084
This Game is Crap	2021-10-05	2	5	0	2	0.7084
The Summit High School: Prologue Episode	2021-09-30	1	5	0	1	0.7084
Crazy Fatties	2021-10-19	3	5	0	3	0.7084
Red Triangle Super Collection	2021-10-27	2	5	0	2	0.7084
Feral Flowers	2021-11-24	2	5	0	2	0.7084
Cat Jumper	2021-10-13	5	5	0	5	0.7084
Interstellar Airgap	2021-10-07	7	5	0	7	0.7084
The Modest Handmaid’s Sex Work	2021-11-19	4	5	0	4	0.7084
Adventures Of Two Foxes	2021-10-27	1	5	0	1	0.7084
Arrows	2021-11-30	2	5	0	2	0.7084
Brooke Vs World Doom	2021-11-18	1	5	0	1	0.7084
Puzzle Art: Rodents	2021-10-26	2	5	0	2	0.7084
Princess Defender Episode 1	2021-12-15	1	5	0	1	0.7084
Hungry Wolf	2021-12-28	1	5	0	1	0.7084
Roman Wars: Deck Building Game	2021-12-10	3	5	0	3	0.7084
Nihongo Heroes	2021-11-03	2	5	0	2	0.7084
超越梦境	2021-11-18	2	5	0	2	0.7084
Guide and Throw	2021-12-02	2	5	0	2	0.7084
The World's Hardest Game 3D 2	2021-12-11	2	5	0	2	0.7084
QuizPoker: Mix of Quiz and Poker	2021-12-08	7	5	0	7	0.7084
Mystery Case Files: Incident at Pendle Tower Collector's Edition	2021-12-08	11	5	0	11	0.7084
Tile Runner	2021-09-29	24	80	23	47	0.7083
CALL OF LDPR	2021-01-19	164	167	53	217	0.7081000000000001
Insiders	2021-10-29	68	40	10	78	0.7081000000000001
Ludicrous Speed	2021-02-06	8	27	6	14	0.7081000000000001
Guardian of the future	2021-11-15	15	27	6	21	0.7081000000000001
最末行程：胜利路19号 Last Journey: 19 Shengli Road	2021-08-23	10	27	6	16	0.7081000000000001
Hentai Animation Puzzle	2021-01-18	3	27	6	9	0.7081000000000001
The Vampire Regent	2021-09-09	31	27	6	37	0.7081000000000001
Now you can't see me	2021-07-20	6	27	6	12	0.7081000000000001
Repit	2021-12-07	3	27	6	9	0.7081000000000001
Sword and Fairy 7	2021-10-22	15245	10610	4122	19367	0.708
SMASH LEGENDS	2021-04-13	1526	4331	1650	3176	0.7078
Youtubers Life 2	2021-10-19	1581	1251	457	2038	0.7077
Faded Grey	2021-07-22	16	112	34	50	0.7077
Scratch Girl	2021-12-15	77	158	50	127	0.7076000000000001
The Sealed Ampoule	2021-03-04	49	43	11	60	0.7076000000000001
Tank Wars: Anniversary Edition	2021-03-13	7	13	2	9	0.7075
Pipeline VR	2021-12-13	3	13	2	5	0.7075
Lihue	2021-08-09	6	13	2	8	0.7075
Assimilate! (A Party Game)	2021-08-26	6	13	2	8	0.7075
12 Labours of Hercules XII: Timeless Adventure	2021-06-28	21	13	2	23	0.7075
Annual Intruders	2021-01-28	3	13	2	5	0.7075
Push The Box 3D	2021-02-25	5	13	2	7	0.7075
Limitless Bit	2021-04-30	10	13	2	12	0.7075
ORIMON.1 - Bilfy & Krotroklon	2021-05-17	2	13	2	4	0.7075
Robin Hood: Hail to the King	2021-04-29	15	13	2	17	0.7075
A Sketchbook About Her Sun	2021-06-11	2	13	2	4	0.7075
Dungeon Crawler Daniel	2021-09-10	3	13	2	5	0.7075
Shape Shift Shawn Episode 1: Tale of the Transmogrified	2021-11-19	1	13	2	3	0.7075
BLOCK HEIST	2021-12-09	3	13	2	5	0.7075
Lake Road	2021-10-05	2	13	2	4	0.7075
Fallen Flowers	2021-11-05	2	13	2	4	0.7075
Coffee Noir - Business Detective Game	2021-09-30	43	46	12	55	0.7072
Deep Lake: Prologue	2021-06-22	9	46	12	21	0.7072
Ghost of Tomorrow: Chapter 1	2021-03-23	4	49	13	17	0.7069
Sakura MMO Extra	2021-01-11	12	49	13	25	0.7069
Cards of the Dead	2021-10-21	20	49	13	33	0.7069
Nebraska	2021-10-20	7	49	13	20	0.7069
Master of Wills	2021-03-01	25	30	7	32	0.7068000000000001
The Farm	2021-02-17	7	30	7	14	0.7068000000000001
Kamu's Offering	2021-05-25	8	30	7	15	0.7068000000000001
Maken-shi Sara	2021-12-10	12	30	7	19	0.7068000000000001
Please Wake Up	2021-01-29	4	20	4	8	0.7068000000000001
Visiting a celebrity	2021-02-26	4	20	4	8	0.7068000000000001
Collisus	2021-02-25	5	20	4	9	0.7068000000000001
Kawaii Girls	2021-08-14	3	20	4	7	0.7068000000000001
Horny Elves and a Moral Orc	2021-11-18	8	20	4	12	0.7068000000000001
История бомжа 2: полицеский беспредел	2021-10-07	2	20	4	6	0.7068000000000001
Shores Unknown	2021-02-17	52	85	25	77	0.7067
Star Dynasties	2021-09-01	292	285	96	388	0.7066
Demon Skin	2021-04-13	24	79	23	47	0.7065
Geometric Sniper - Blood in Paris	2021-09-09	5	55	15	20	0.7065
Tour de France 2021	2021-06-03	162	73	21	183	0.7064
D3L3T3.exe	2021-05-31	138	61	17	155	0.7064
Axilon: Legend of Artifacts - Prologue	2021-09-19	174	182	59	233	0.7062999999999999
[TDA00] Muv-Luv Unlimited: THE DAY AFTER - Episode 00 REMASTERED	2021-02-05	51	70	20	71	0.7062999999999999
Mortal Shell	2021-08-18	1931	3317	1265	3196	0.7062
Horny Honey	2021-04-22	11	33	8	19	0.7059000000000001
Kellogg's Gut Bacteria Reef	2021-07-05	8	33	8	16	0.7059000000000001
Zombie Killer Drift - Racing Survival	2021-08-27	6	33	8	14	0.7059000000000001
Last Stop	2021-07-22	35	142	45	80	0.7057
REalM: Walk of Soul	2021-10-30	5	9	1	6	0.7057
Majestic Trials	2021-03-11	3	9	1	4	0.7057
Ollie-Oop	2021-11-16	22	9	1	23	0.7057
The Bad the Worse & Djanky	2021-07-07	5	9	1	6	0.7057
Cyberless: Online	2021-01-01	8	9	1	9	0.7057
A Crooked Heart	2021-01-08	2	9	1	3	0.7057
Boolean	2021-03-11	4	9	1	5	0.7057
Alien Function	2021-01-21	4	9	1	5	0.7057
Frontier Quest	2021-01-29	3	9	1	4	0.7057
Little Brother's Turn	2021-01-03	4	9	1	5	0.7057
Couplinked	2021-08-17	2	9	1	3	0.7057
Control:Override	2021-04-20	3	9	1	4	0.7057
Broken Sky	2021-05-12	3	9	1	4	0.7057
GravitreX Arcade	2021-03-03	4	9	1	5	0.7057
The Best BJ	2021-07-21	3	9	1	4	0.7057
Panmorphia: Enchanted	2021-01-08	5	9	1	6	0.7057
Insights - Maniac Vortex	2021-04-15	4	9	1	5	0.7057
Until Sunset	2021-01-18	2	9	1	3	0.7057
Pebble Witch	2021-01-25	1	9	1	2	0.7057
Motor Assailant: Betrayal	2021-03-02	16	9	1	17	0.7057
Bonkey Trek Quimdung Edition	2021-03-11	2	9	1	3	0.7057
Lilith Was Dead	2021-02-02	2	9	1	3	0.7057
Billiards Dungeon	2021-07-30	4	9	1	5	0.7057
Vampire Slave	2021-02-21	3	9	1	4	0.7057
权谋韬略	2021-03-02	3	9	1	4	0.7057
Caribbean Jigsaw	2021-03-15	3	9	1	4	0.7057
焚魂之梦	2021-03-10	5	9	1	6	0.7057
My Dear Frankenstein	2021-02-27	2	9	1	3	0.7057
1, 2 BLAME!	2021-05-14	10	9	1	11	0.7057
New Yankee: Under the Genie's Thumb	2021-04-01	23	9	1	24	0.7057
Neocense	2021-04-17	3	9	1	4	0.7057
Cooking Trip New Challenge	2021-08-10	6	9	1	7	0.7057
Haunting At Cliffhouse	2021-04-01	8	9	1	9	0.7057
Romance of Raskya	2021-06-02	4	9	1	5	0.7057
Afterlife Beans	2021-09-01	2	9	1	3	0.7057
Midnight Calling: Jeronimo Collector's Edition	2021-05-07	12	9	1	13	0.7057
Magic Manny	2021-07-30	2	9	1	3	0.7057
Big Bang West	2021-06-08	5	9	1	6	0.7057
Cat Dungeon Escape	2021-06-21	4	9	1	5	0.7057
ZpellCatz: Pumpkin Prologue	2021-10-14	3	9	1	4	0.7057
Catch The Donut	2021-09-13	4	9	1	5	0.7057
Space to Grow	2021-08-13	5	9	1	6	0.7057
The Müll Littoral	2021-08-27	2	9	1	3	0.7057
My Dear Frankenstein -English Edition-	2021-10-01	4	9	1	5	0.7057
Nuclear Drifter	2021-10-08	4	9	1	5	0.7057
Тайна планеты Венера	2021-11-04	1	9	1	2	0.7057
Furry Hentai Jigsaw	2021-11-18	4	9	1	5	0.7057
Solaris Rift	2021-11-14	6	9	1	7	0.7057
Tumble	2021-12-16	2	9	1	3	0.7057
解药公司: 救世行动	2021-02-08	73	119	37	110	0.7055
Out of Sight	2021-03-10	30	96	29	59	0.7055
Listen to the Wind	2021-09-23	239	329	113	352	0.7053
Living with Temptation 1 - REDUX	2021-10-07	200	90	27	227	0.7051999999999999
Guild of Ascension	2021-09-21	43	36	9	52	0.7051999999999999
Eximius: Seize the Frontline	2021-03-16	318	486	172	490	0.7048000000000001
Rise of Humanity	2021-10-21	17	39	10	27	0.7048000000000001
Strike Team Gladius	2021-04-08	7	23	5	12	0.7048000000000001
Fragments	2021-01-21	3	23	5	8	0.7048000000000001
Happy Funtime Labs	2021-05-24	140	23	5	145	0.7048000000000001
Asteroids Belt: Try to Survive!	2021-01-06	2	23	5	7	0.7048000000000001
Would you like to run an idol café?	2021-06-07	11	23	5	16	0.7048000000000001
The Octots	2021-09-09	4	23	5	9	0.7048000000000001
Art of Fury: Virtual Gallery	2021-07-26	2	23	5	7	0.7048000000000001
幸存者乐园	2021-08-28	3	23	5	8	0.7048000000000001
Hanako: Honor & Blade	2021-09-15	149	155	50	199	0.7046
回门 Way Back Home	2021-01-29	183	295	101	284	0.7045
Stories of Liane	2021-03-01	22	72	21	43	0.7044
Flak	2021-01-18	6	42	11	17	0.7044
My journey to your world	2021-09-16	5	42	11	16	0.7044
Idle Monster TD	2021-06-21	1090	524	187	1277	0.7042
Sons of Ra	2021-04-15	19	45	12	31	0.7042
The Third Day	2021-03-28	5	45	12	17	0.7042
Astonia Resurgence	2021-05-24	20	48	13	33	0.7041
Acolyte: Prologue	2021-01-11	11	60	17	28	0.7040000000000001
Cions of Vega	2021-04-09	8	51	14	22	0.7040000000000001
This Land Is My Land	2021-10-20	839	2707	1039	1878	0.7039
Мухосранск | Russian City Sim	2021-07-02	6	115	36	42	0.7039
Comet 64	2021-02-05	81	112	35	116	0.7037000000000001
Clip maker	2021-06-24	9	89	27	36	0.7034999999999999
Project Venus.RP	2021-08-27	34	89	27	61	0.7034999999999999
ASCENXION	2021-05-14	9	26	6	15	0.7034
Treasure Drifter: Nian	2021-10-29	8	26	6	14	0.7034
Astrodogs	2021-04-08	8	26	6	14	0.7034
Survive The Dark	2021-03-18	4	26	6	10	0.7034
Photographer	2021-07-09	6	26	6	12	0.7034
Hot Hentai Puzzle Vol.2	2021-11-22	3	26	6	9	0.7034
AKIBA'S TRIP: Hellbound & Debriefed	2021-07-20	63	123	39	102	0.7033
勇闯恶魔岛 Crazy Jump	2021-06-20	4	16	3	7	0.7033
Endless Firepower	2021-10-29	6	16	3	9	0.7033
CamGirls: Sophie X Rias	2021-01-22	4	16	3	7	0.7033
Space Ship Infinity	2021-08-04	3	16	3	6	0.7033
Relax Fly	2021-06-13	6	16	3	9	0.7033
Leave The Red	2021-01-20	4	16	3	7	0.7033
Oracle Trials	2021-02-12	379	16	3	382	0.7033
FreeDraw	2021-03-04	3	16	3	6	0.7033
Midnight is Lost	2021-03-17	3	16	3	6	0.7033
Sky Goddess	2021-03-18	3	16	3	6	0.7033
Magnus Failure	2021-07-01	4	16	3	7	0.7033
Colibri XR Immersive Art Gallery	2021-12-15	3	16	3	6	0.7033
Broken Blades	2021-09-13	4	16	3	7	0.7033
Ping Pong Pufferfish	2021-12-04	4	16	3	7	0.7033
The Defaloon	2021-12-29	2	16	3	5	0.7033
The Sinking City	2021-02-26	465	1588	601	1066	0.7031999999999999
Megacraft Hentai Survival	2021-02-06	12	244	83	95	0.7031000000000001
ArtFormer the Game	2021-09-30	4	29	7	11	0.7025
Echo	2021-12-16	5	29	7	12	0.7025
ETERNAL BLOOD	2021-02-19	5	68	20	25	0.7021
Aces in the Dust	2021-07-15	6	32	8	14	0.7019
Succubus Farm	2021-03-20	150	293	102	252	0.7018000000000001
Wonhon: A Vengeful Spirit	2021-07-15	18	62	18	36	0.7017
The Mansion	2021-03-31	10	85	26	36	0.7016
Jumpala	2021-01-19	10	35	9	19	0.7015000000000001
Jack Axe: The Trial	2021-08-31	25	35	9	34	0.7015000000000001
Lawn Mowing Simulator	2021-08-10	2108	1337	508	2616	0.7012999999999999
dig	2021-11-14	8	53	15	23	0.7012999999999999
Peachleaf Pirates	2021-09-27	17	38	10	27	0.7012999999999999
Fruit Hunter	2021-05-17	7	38	10	17	0.7012999999999999
Creatures of Aether	2021-08-02	279	358	127	406	0.7012
GLIM	2021-07-15	96	41	11	107	0.7012
Sentience	2021-03-25	58	76	23	81	0.7008
RHEM III SE	2021-03-25	13	19	4	17	0.7008
Squirrel Divorce	2021-02-11	4	19	4	8	0.7008
DARK AROUND YOU	2021-03-31	3	19	4	7	0.7008
Cyberpunk Fighting	2021-11-12	6	19	4	10	0.7008
69 Iris Hot	2021-12-28	4	19	4	8	0.7008
Royal Revolt II	2021-05-19	75	121	39	114	0.7007
Laptop Tycoon	2021-10-29	90	192	65	155	0.7006
Natsuki's Life In Prison	2021-11-19	131	285	100	231	0.7003
A Total War Saga: TROY	2021-09-02	4704	1675	646	5350	0.7001999999999999
Sands of Aura	2021-10-21	50	159	53	103	0.7001999999999999
Purplis Sandbox	2021-01-14	11	137	45	56	0.7001000000000001
Star Chef 2: Cooking Game	2021-08-10	200	175	59	259	0.7000000000000001
HonkaiImpact 3rd	2021-10-21	2275	5195	2074	4349	0.6999
Bloody Raid	2021-05-20	45	67	20	65	0.6999
Echo of Combats	2021-07-27	39	112	36	75	0.6998000000000001
Residual	2021-09-09	14	22	5	19	0.6994
MINDMIST	2021-06-22	3	22	5	8	0.6994
Viking Story	2021-02-26	8	22	5	13	0.6994
Armageddon Empires	2021-04-16	5	22	5	10	0.6994
TURK: The Demon Slayer	2021-05-15	8	22	5	13	0.6994
Rogue Lords	2021-09-30	2075	1026	390	2465	0.6993
Lumberjack's Dynasty	2021-02-25	1348	1596	618	1966	0.6990999999999999
The Miserable Crimson Hooded Girl	2021-12-31	5	12	2	7	0.6990999999999999
Aim Bot	2021-05-20	5	12	2	7	0.6990999999999999
Farlight Commanders	2021-11-19	7	12	2	9	0.6990999999999999
Timewalk Tower Defense	2021-01-01	6	12	2	8	0.6990999999999999
Lion Quest Infinity	2021-03-05	3	12	2	5	0.6990999999999999
Legend of Krannia: Cursed Fate	2021-01-25	3	12	2	5	0.6990999999999999
CAOS	2021-06-21	7	12	2	9	0.6990999999999999
Oscar & Gems: Puzzle Quest	2021-03-07	2	12	2	4	0.6990999999999999
White Girl	2021-02-01	10	12	2	12	0.6990999999999999
Wild West Crops	2021-02-16	5	12	2	7	0.6990999999999999
Time to GOLF	2021-02-18	13	12	2	15	0.6990999999999999
Spring Flower	2021-02-12	3	12	2	5	0.6990999999999999
Vaccine Delivery Simulator	2021-03-23	2	12	2	4	0.6990999999999999
Flying Angel	2021-02-24	3	12	2	5	0.6990999999999999
Morkredd Demo	2021-03-25	8	12	2	10	0.6990999999999999
Russian Drunken Boxers	2021-03-26	4	12	2	6	0.6990999999999999
JustDefense	2021-03-25	2	12	2	4	0.6990999999999999
Antonball Deluxe Lite	2021-06-07	136	12	2	138	0.6990999999999999
Would you like to run an idol café? 2	2021-09-27	5	12	2	7	0.6990999999999999
The Way Home	2021-06-02	3	12	2	5	0.6990999999999999
Buck Borris in Action	2021-06-17	4	12	2	6	0.6990999999999999
Wraiths of SENTINEL	2021-09-16	20	12	2	22	0.6990999999999999
Advent Crossroad	2021-08-11	3	12	2	5	0.6990999999999999
Air Traffic BLITZ VR	2021-12-25	2	12	2	4	0.6990999999999999
Typer Hero	2021-10-03	3	12	2	5	0.6990999999999999
Miraculo Island	2021-10-21	5	12	2	7	0.6990999999999999
Now Boarding	2021-10-17	7	12	2	9	0.6990999999999999
The Vellescian Gambit	2021-11-15	2	12	2	4	0.6990999999999999
Campground Owner	2021-10-26	3	12	2	5	0.6990999999999999
Destroy The Cubes 2	2021-11-18	3	12	2	5	0.6990999999999999
Shadow Сave	2021-11-30	3	12	2	5	0.6990999999999999
The Labyrinth of Greed	2021-11-29	2	12	2	4	0.6990999999999999
Tiny Tank	2021-12-04	3	12	2	5	0.6990999999999999
Defenders Glory	2021-12-06	6	12	2	8	0.6990999999999999
Explosive Snooker	2021-12-15	2	12	2	4	0.6990999999999999
Traffic Jams	2021-04-08	15	55	16	31	0.6988
末日纷争	2021-11-18	44	89	28	72	0.6987000000000001
Striving for Light	2021-11-29	21	52	15	36	0.6986
Three Kingdoms: The Last Warlord	2021-02-05	799	2470	974	1773	0.6985
Wizard Bros	2021-01-25	9	25	6	15	0.6985
Brain Games	2021-09-06	13	25	6	19	0.6985
Tortured Hearts - Or How I Saved The Universe. Again.	2021-03-01	9	25	6	15	0.6985
Endless Furry Clicker	2021-02-20	5	25	6	11	0.6985
Ragdoll Madness	2021-05-08	20	25	6	26	0.6985
​Cubeetle - Game of creation	2021-06-12	5	25	6	11	0.6985
Magical Valkyrie Lyristia	2021-07-17	203	197	68	271	0.6981
A.D. 2047	2021-07-08	3481	108	35	3516	0.6981
A Warmer Shade of Summer	2021-06-03	94	69	21	115	0.6981
Lost At Sea	2021-07-15	8	28	7	15	0.698
Fruit Girls: Hentai Jigsaw Photo Studio	2021-06-13	42	28	7	49	0.698
Super Soccer Blast: America vs Europe	2021-06-11	18	28	7	25	0.698
Killsquad	2021-10-21	2784	2435	963	3747	0.6979000000000001
Hentai Killer: Girls & Chess	2021-06-04	5	66	20	25	0.6977
见习侦探	2021-07-15	59	66	20	79	0.6977
Maelstrom: A Yaoi Visual Novel	2021-04-07	22	31	8	30	0.6977
into the dangerous world i leapt	2021-10-05	9	31	8	17	0.6977
PIXASSO 3	2021-09-03	5	31	8	13	0.6977
Furious Seas	2021-07-19	19	175	60	79	0.6973999999999999
Mech Mechanic Simulator: Prologue	2021-02-18	65	91	29	94	0.6973999999999999
Halo Infinite	2021-11-15	272586	110600	46819	319405	0.6970999999999999
My Stepsis is a Futanari	2021-10-27	8	126	42	50	0.6966
Grim wanderings 2	2021-09-16	42	57	17	59	0.6966
Tartapolis	2021-02-12	5	15	3	8	0.6959000000000001
Levi Chronicles	2021-07-09	8	15	3	11	0.6959000000000001
Star Tank	2021-07-21	2	15	3	5	0.6959000000000001
Quick Square	2021-03-01	2	15	3	5	0.6959000000000001
Relics of the Lost Age	2021-01-07	19	15	3	22	0.6959000000000001
Star Hunter DX	2021-08-05	6	15	3	9	0.6959000000000001
Puzlkind	2021-03-01	12	15	3	15	0.6959000000000001
A Token War	2021-04-28	5	15	3	8	0.6959000000000001
Tanky Tanks	2021-03-12	4	15	3	7	0.6959000000000001
A Strange City	2021-05-20	3	15	3	6	0.6959000000000001
Knighted	2021-05-18	5	15	3	8	0.6959000000000001
SEDOMAIRI	2021-08-02	21	15	3	24	0.6959000000000001
ITRP _ Gas Prison	2021-10-08	4	15	3	7	0.6959000000000001
Neon Bricks	2021-11-19	3	15	3	6	0.6959000000000001
babyquick : Adventure of the Moon Dragon	2021-12-02	6	15	3	9	0.6959000000000001
BOXNIGMA	2021-11-30	2	15	3	5	0.6959000000000001
异世界攻略组 Isekai Team	2021-06-01	29	48	14	43	0.6954000000000001
Super Clown Adventures	2021-02-12	4	48	14	18	0.6954000000000001
Boodunnit	2021-02-03	53	292	106	159	0.6951999999999999
Anime Zodiac	2021-08-12	10	76	24	34	0.6951999999999999
Summer with Mia Season 1	2021-03-25	182	427	159	341	0.6951
Gaia Project	2021-05-31	164	183	64	228	0.6951
Chuckle Phrase Builder	2021-09-06	17	45	13	30	0.6950000000000001
MONOPOLY Poker	2021-06-03	471	2730	1102	1573	0.6947
HORROR BAR	2021-02-25	9	111	37	46	0.6946
A Little Shop in Squirrel Town	2021-01-08	17	42	12	29	0.6946
Praesidium	2021-04-28	25	59	18	43	0.6945
Billion Beat	2021-07-14	3	18	4	7	0.6944
Gunnhildr	2021-09-08	5	18	4	9	0.6944
Nectar of the Gods	2021-01-27	6	18	4	10	0.6944
Atom	2021-09-17	2	18	4	6	0.6944
Doomsday Vault	2021-08-05	7	18	4	11	0.6944
Goddess Of Card War	2021-03-04	5	18	4	9	0.6944
The Animal Bash	2021-04-14	17	18	4	21	0.6944
Daenerys Miracle	2021-04-07	2	18	4	6	0.6944
VR Bukkake	2021-04-15	2	18	4	6	0.6944
From Earth To Heaven	2021-09-05	4	18	4	8	0.6944
THE FANGS HUNTRESS	2021-05-21	2	18	4	6	0.6944
Aptly Rolling	2021-08-27	8	18	4	12	0.6944
The Master Club	2021-10-18	3	8	1	4	0.6944
Hieroglyph: Prologue	2021-01-04	2	8	1	3	0.6944
Pon Para and the Unconquerable Scorpion	2021-12-16	10	8	1	11	0.6944
BETRAYER: Curse of the Spine	2021-08-26	5	8	1	6	0.6944
Impossible Pixels	2021-07-14	5	8	1	6	0.6944
Our Hero! Two	2021-10-29	2	8	1	3	0.6944
Load Roll Die	2021-10-06	6	8	1	7	0.6944
Z Arena	2021-06-10	2	8	1	3	0.6944
Erazer - Devise & Destroy	2021-12-16	5	8	1	6	0.6944
Low Story	2021-01-11	4	8	1	5	0.6944
Tower Defense Hero - 塔防英雄	2021-01-02	4	8	1	5	0.6944
eia	2021-01-21	4	8	1	5	0.6944
荣光的见证	2021-01-21	2	8	1	3	0.6944
Cannon Lab 13	2021-01-20	2	8	1	3	0.6944
Hisato no Saku	2021-09-17	3	8	1	4	0.6944
Beyond Horror: Episode One, A Father's Journey	2021-02-05	4	8	1	5	0.6944
CELLAR	2021-02-11	2	8	1	3	0.6944
The Great Empire: Relic of Egypt	2021-02-18	8	8	1	9	0.6944
Chickenman	2021-04-23	2	8	1	3	0.6944
Feudalia	2021-05-06	4	8	1	5	0.6944
RoHoEn Rumble	2021-03-03	2	8	1	3	0.6944
Legacy of Vane	2021-07-16	3	8	1	4	0.6944
6 Feet Behind	2021-03-16	2	8	1	3	0.6944
冲击五十关	2021-05-22	2	8	1	3	0.6944
Clan of Death	2021-10-01	9	8	1	10	0.6944
Brian the Brain	2021-06-03	2	8	1	3	0.6944
No Hope	2021-07-23	2	8	1	3	0.6944
Overlay Balls & Mouse Tails	2021-06-05	2	8	1	3	0.6944
Cube Flip	2021-11-19	2	8	1	3	0.6944
Super Fowlst 2	2021-05-03	2	8	1	3	0.6944
Connect The Dots	2021-08-12	3	8	1	4	0.6944
Haunted Hotel: Eternity Collector's Edition	2021-04-23	7	8	1	8	0.6944
Mad Wild Fairy Tale	2021-10-24	4	8	1	5	0.6944
Rangerdog	2021-06-18	4	8	1	5	0.6944
Superpantsu Harematchii	2021-06-04	8	8	1	9	0.6944
学院逃生	2021-06-15	3	8	1	4	0.6944
Laruaville 11	2021-05-29	8	8	1	9	0.6944
少女首領の推理領域 -黄金島の密約-	2021-06-23	8	8	1	9	0.6944
SPACE BANDITOS	2021-06-24	28	8	1	29	0.6944
MY TIME ALIVE	2021-08-03	2	8	1	3	0.6944
Kensei	2021-07-12	2	8	1	3	0.6944
Perfect Affection Plan: Cassiopeia	2021-07-20	7	8	1	8	0.6944
Road Bustle	2021-07-24	1	8	1	2	0.6944
Baklava Simulator	2021-08-25	2	8	1	3	0.6944
Chimeras: Cursed and Forgotten Collector's Edition	2021-07-23	8	8	1	9	0.6944
AirGun	2021-08-27	3	8	1	4	0.6944
The Fortress of Varnolis	2021-10-13	2	8	1	3	0.6944
Fantasy Gardens	2021-12-01	4	8	1	5	0.6944
Rocket Jump	2021-10-07	2	8	1	3	0.6944
Battlecruiser Generations	2021-09-21	3	8	1	4	0.6944
Oasis: Dark Forest	2021-12-23	3	8	1	4	0.6944
惑星游侠-Planet Rogue	2021-10-30	5	8	1	6	0.6944
The Throne of Bernicia	2021-11-01	8	8	1	9	0.6944
Limita Luminii	2021-12-19	2	8	1	3	0.6944
Vortle	2021-12-15	3	8	1	4	0.6944
PlanetDrop - A Tiny Space Adventure	2021-11-04	5	8	1	6	0.6944
Failure simulator	2021-11-11	2	8	1	3	0.6944
Welcome Home 2	2021-11-05	4	8	1	5	0.6944
Creatures: The Albian Years	2021-12-20	3	8	1	4	0.6944
Maze Art: Red	2021-12-04	53	8	1	54	0.6944
로스팅 리포트: 대학 교수 살인사건	2021-12-23	2	8	1	3	0.6944
New World	2021-09-28	913634	177063	76251	989885	0.6943
Sexorcist Academy	2021-05-14	16	39	11	27	0.6943
Hentai Hack-Her	2021-05-14	6	39	11	17	0.6943
玉言·离光	2021-08-06	86	124	42	128	0.6940999999999999
Innocent Girl	2021-12-17	27	213	76	103	0.6940000000000001
Peblito: Rock and Roll	2021-08-10	15	56	17	32	0.6940000000000001
Cyber Rider	2021-08-10	5	36	10	15	0.6939000000000001
Last Village	2021-08-16	6	36	10	16	0.6939000000000001
Fear Therapy	2021-12-24	356	2002	805	1161	0.6937000000000001
Clid the Snail	2021-12-15	31	78	25	56	0.6937000000000001
Undungeon	2021-11-18	183	228	82	265	0.6936
Evil Mansion	2021-03-27	314	113	38	352	0.6936
星月之歌	2021-02-03	10	33	9	19	0.6936
Shadows Behind the Throne 2	2021-07-25	10	33	9	19	0.6936
Garden of Mooj	2021-10-06	6	21	5	11	0.6936
Kinetic Edge	2021-02-05	16	21	5	21	0.6936
Robot Robert	2021-03-09	4	21	5	9	0.6936
The Space Between	2021-04-16	3	21	5	8	0.6936
祛魅·格心（祛魅3） - Disenchantment Heart	2021-08-02	6	21	5	11	0.6936
The Last Yandere: Cursed Dark	2021-06-24	5	21	5	10	0.6936
Do 11	2021-08-10	6	21	5	11	0.6936
HOPE VR: Progressive Meditation	2021-10-07	4	21	5	9	0.6936
Tails & Titties Hot Spring	2021-10-11	14	21	5	19	0.6936
Island Crusaders	2021-11-12	3	21	5	8	0.6936
John Christian	2021-07-07	3	30	8	11	0.6934
The Birth of an Artificial Intelligence	2021-10-11	7	30	8	15	0.6934
69 Yuki Love	2021-09-06	8	30	8	16	0.6934
Space Kettle	2021-02-07	17	27	7	24	0.6933
Chicken Holmes - O Mistério de Bartolomeu	2021-04-12	5	27	7	12	0.6933
Pop it, Please!	2021-07-23	9	27	7	16	0.6933
Sniper Game	2021-10-28	3	27	7	10	0.6933
Hammer time!	2021-10-19	13	24	6	19	0.6933
Wildshape - Map Editor + VTT (demo)	2021-04-09	64	64	20	84	0.6931
古剑奇谭网络版 海外版	2021-08-04	9336	3114	1275	10611	0.6927
Waifu Secret 2	2021-05-06	580	265	97	677	0.6927
Tomb Rumble	2021-09-15	174	170	60	234	0.6927
直播经纪人	2021-09-24	66	72	23	89	0.6926000000000001
Bloodshore	2021-11-03	29	368	138	167	0.6924
Veneficium	2021-03-12	65	295	109	174	0.6924
Team Tower	2021-09-10	26	47	14	40	0.6924
Miner Gun Builder	2021-11-09	15	47	14	29	0.6924
Love Tavern	2021-07-31	424	455	173	597	0.6923
100 hidden cupcakes	2021-01-11	4	141	49	53	0.6923
Scrapnaut	2021-09-15	378	425	161	539	0.6922
堕落千金—黑蔷薇与欲望之火	2021-05-29	368	845	332	700	0.6920000000000001
Shwip	2021-08-04	5	4	0	5	0.6920000000000001
Exo	2021-06-16	2	4	0	2	0.6920000000000001
HOLY COW! Milking Simulator	2021-12-02	5	4	0	5	0.6920000000000001
MekaFighters	2021-07-13	4	4	0	4	0.6920000000000001
Beard of Stone	2021-12-10	4	4	0	4	0.6920000000000001
Magnesium_173	2021-08-19	2	4	0	2	0.6920000000000001
Wolfie's Break Out	2021-09-21	1	4	0	1	0.6920000000000001
Woody Chopper	2021-08-16	3	4	0	3	0.6920000000000001
Adriatic Pizza	2021-05-28	3	4	0	3	0.6920000000000001
Mark One	2021-02-17	2	4	0	2	0.6920000000000001
Orb Overload	2021-02-26	3	4	0	3	0.6920000000000001
Raider Bots	2021-07-23	2	4	0	2	0.6920000000000001
The Majesti	2021-10-07	2	4	0	2	0.6920000000000001
シーフガールズカルテット	2021-02-03	4	4	0	4	0.6920000000000001
Running Challenge	2021-12-23	1	4	0	1	0.6920000000000001
Manalith	2021-01-29	2	4	0	2	0.6920000000000001
Modulo	2021-01-23	3	4	0	3	0.6920000000000001
In It Together	2021-01-28	3	4	0	3	0.6920000000000001
Grub Gauntlet	2021-12-08	2	4	0	2	0.6920000000000001
Temple Hunters	2021-07-21	2	4	0	2	0.6920000000000001
Cosmoscope	2021-07-20	1	4	0	1	0.6920000000000001
Gun Mage	2021-12-29	4	4	0	4	0.6920000000000001
Orbiterrion	2021-04-15	3	4	0	3	0.6920000000000001
Escape from Covid	2021-12-20	3	4	0	3	0.6920000000000001
Soviet Arcade Machine Basketball	2021-02-02	3	4	0	3	0.6920000000000001
Puff Puff The Magic Pipe	2021-04-20	2	4	0	2	0.6920000000000001
Fizik	2021-01-12	3	4	0	3	0.6920000000000001
The Astronomy Game	2021-01-12	1	4	0	1	0.6920000000000001
Atomic Guardians	2021-02-12	3	4	0	3	0.6920000000000001
Twinstick Arcade	2021-07-16	1	4	0	1	0.6920000000000001
Cyber Dodge	2021-02-14	4	4	0	4	0.6920000000000001
Content Creator's Internet Adventure	2021-10-15	2	4	0	2	0.6920000000000001
Fairytale Mosaics Beauty And The Beast 2	2021-01-04	4	4	0	4	0.6920000000000001
Fairytale Mosaics Cinderella 2	2021-01-04	4	4	0	4	0.6920000000000001
Centrifugal	2021-02-11	2	4	0	2	0.6920000000000001
Retro Classix: SRD - Super Real Darwin	2021-03-02	3	4	0	3	0.6920000000000001
Road To Adventure!	2021-04-11	3	4	0	3	0.6920000000000001
Yeminj	2021-01-05	2	4	0	2	0.6920000000000001
Hexacore	2021-02-23	2	4	0	2	0.6920000000000001
Meat Lead Fire	2021-01-26	2	4	0	2	0.6920000000000001
As Fast As Possible	2021-03-22	2	4	0	2	0.6920000000000001
Reek N' Havok	2021-02-16	2	4	0	2	0.6920000000000001
RC Airplane Challenge	2021-12-30	6	4	0	6	0.6920000000000001
Astrokicker	2021-01-29	2	4	0	2	0.6920000000000001
EPEJSODION Lodge	2021-07-30	3	4	0	3	0.6920000000000001
Skullbangers!	2021-05-15	7	4	0	7	0.6920000000000001
Casual Commando	2021-02-08	14	4	0	14	0.6920000000000001
LightWave	2021-02-24	5	4	0	5	0.6920000000000001
MessiahEnd Refrain	2021-01-29	3	4	0	3	0.6920000000000001
Dual Cars	2021-01-29	2	4	0	2	0.6920000000000001
Pit of Ascension	2021-02-19	2	4	0	2	0.6920000000000001
Rubicon : a conspiracy of silence 	2021-10-20	3	4	0	3	0.6920000000000001
Swiss Alps Jigsaw Puzzles	2021-02-13	2	4	0	2	0.6920000000000001
The Curse of Illmoore Bay	2021-02-17	2	4	0	2	0.6920000000000001
FIREFIGHTER	2021-07-09	2	4	0	2	0.6920000000000001
Smart Moves 2	2021-04-06	2	4	0	2	0.6920000000000001
Charlie The Roach	2021-03-05	2	4	0	2	0.6920000000000001
Cats In Space	2021-02-17	2	4	0	2	0.6920000000000001
Hack Jump	2021-03-26	1	4	0	1	0.6920000000000001
Intergalactic Rescue	2021-05-12	1	4	0	1	0.6920000000000001
Red Man 1	2021-06-29	1	4	0	1	0.6920000000000001
Herman Electro	2021-06-11	4	4	0	4	0.6920000000000001
Present Danger	2021-07-26	1	4	0	1	0.6920000000000001
Quick Packer 2	2021-04-18	3	4	0	3	0.6920000000000001
Too Many Zombies!	2021-10-27	5	4	0	5	0.6920000000000001
Binger Ninja	2021-04-07	3	4	0	3	0.6920000000000001
A Snake In A Maze	2021-05-05	2	4	0	2	0.6920000000000001
重叠·前夜谭：猫与少女	2021-03-20	3	4	0	3	0.6920000000000001
子非猫	2021-04-15	1	4	0	1	0.6920000000000001
CLOSED HANDS	2021-10-04	2	4	0	2	0.6920000000000001
Adam The Storyteller	2021-06-24	2	4	0	2	0.6920000000000001
Doge to the Moon	2021-03-19	2	4	0	2	0.6920000000000001
Scaper Dash	2021-05-12	1	4	0	1	0.6920000000000001
Castle Itter	2021-04-30	4	4	0	4	0.6920000000000001
Terra Earth	2021-05-12	1	4	0	1	0.6920000000000001
Choco Pixel X	2021-03-18	2	4	0	2	0.6920000000000001
Universe 25	2021-09-20	3	4	0	3	0.6920000000000001
Gun Game	2021-07-27	3	4	0	3	0.6920000000000001
Robin: Race!	2021-03-30	3	4	0	3	0.6920000000000001
In the Wild	2021-11-02	3	4	0	3	0.6920000000000001
SUPER METBOY!	2021-04-21	5	4	0	5	0.6920000000000001
The Black Hole	2021-05-31	1	4	0	1	0.6920000000000001
The Five Covens	2021-11-17	2	4	0	2	0.6920000000000001
BURNT ASHES	2021-04-14	1	4	0	1	0.6920000000000001
Stellar Raid	2021-09-01	2	4	0	2	0.6920000000000001
Dwarves: build and survive	2021-08-18	1	4	0	1	0.6920000000000001
Akyrikon VR	2021-05-05	1	4	0	1	0.6920000000000001
Calculate It!	2021-08-02	3	4	0	3	0.6920000000000001
Before Began 开始之前	2021-04-29	6	4	0	6	0.6920000000000001
Experience the Energy: Take the Challenge	2021-05-03	1	4	0	1	0.6920000000000001
Wednesday Basketball	2021-11-30	2	4	0	2	0.6920000000000001
Marcella Moon: Curse of the Black Cat	2021-10-01	3	4	0	3	0.6920000000000001
Sam & MaRU	2021-08-05	2	4	0	2	0.6920000000000001
Through Rust We Are Returned	2021-05-14	5	4	0	5	0.6920000000000001
Larger Than Light	2021-05-29	1	4	0	1	0.6920000000000001
MINICHEF	2021-05-12	2	4	0	2	0.6920000000000001
Cosmophage	2021-05-07	2	4	0	2	0.6920000000000001
MONSTER SLAYER	2021-06-24	1	4	0	1	0.6920000000000001
Rescue Rover Collection	2021-05-07	3	4	0	3	0.6920000000000001
Uniboom-War of Unicorns	2021-05-07	2	4	0	2	0.6920000000000001
Endless Zombie Tower	2021-12-17	2	4	0	2	0.6920000000000001
Everpixel Tactics	2021-09-17	4	4	0	4	0.6920000000000001
Beat Boy	2021-06-09	2	4	0	2	0.6920000000000001
Hexio	2021-09-06	4	4	0	4	0.6920000000000001
Yupi	2021-05-31	2	4	0	2	0.6920000000000001
Mortal and Monster	2021-06-22	2	4	0	2	0.6920000000000001
The Witch's Maze	2021-05-26	2	4	0	2	0.6920000000000001
Mystery Solitaire Powerful Alchemist	2021-06-09	6	4	0	6	0.6920000000000001
Gazmatera: Return Of The Generals	2021-06-21	2	4	0	2	0.6920000000000001
Stinky Feet: The adventure of BigFoot	2021-12-17	3	4	0	3	0.6920000000000001
Whispered Secrets: Ripple of the Heart Collector's Edition	2021-05-14	7	4	0	7	0.6920000000000001
jolly bunny's adventure	2021-06-09	1	4	0	1	0.6920000000000001
Chromatic Fantasy	2021-08-17	2	4	0	2	0.6920000000000001
Alien Flex	2021-08-04	2	4	0	2	0.6920000000000001
Changes	2021-10-12	2	4	0	2	0.6920000000000001
Word Escape	2021-06-21	2	4	0	2	0.6920000000000001
Hour Night	2021-10-21	7	4	0	7	0.6920000000000001
FIGHT BOTS	2021-11-25	21	4	0	21	0.6920000000000001
Alice's Jigsaw Time Travel 2	2021-07-08	2	4	0	2	0.6920000000000001
Fill and Cross Pirate Riddles 2	2021-07-09	3	4	0	3	0.6920000000000001
LGBT Color by Number for Adults	2021-07-27	3	4	0	3	0.6920000000000001
Pluvia - Episode I	2021-11-08	3	4	0	3	0.6920000000000001
Kanamono	2021-07-19	2	4	0	2	0.6920000000000001
They're Coming	2021-07-20	3	4	0	3	0.6920000000000001
My Downtown	2021-07-07	5	4	0	5	0.6920000000000001
Castle of Delights	2021-07-22	3	4	0	3	0.6920000000000001
Arcadius	2021-07-21	3	4	0	3	0.6920000000000001
StickyOrbs	2021-07-27	3	4	0	3	0.6920000000000001
My Living Things	2021-07-26	1	4	0	1	0.6920000000000001
Escape to Mars	2021-08-05	3	4	0	3	0.6920000000000001
Meteor Storm	2021-08-02	4	4	0	4	0.6920000000000001
Am Madness	2021-08-27	2	4	0	2	0.6920000000000001
Hoop the Loop	2021-10-12	2	4	0	2	0.6920000000000001
Ball Partner	2021-08-19	1	4	0	1	0.6920000000000001
地獄廚房RPG	2021-10-07	1	4	0	1	0.6920000000000001
Overheat	2021-08-16	3	4	0	3	0.6920000000000001
Fracture Hell	2021-08-24	2	4	0	2	0.6920000000000001
Watermelon Country	2021-08-19	1	4	0	1	0.6920000000000001
Raygun Chess	2021-09-28	2	4	0	2	0.6920000000000001
Puzzle Box	2021-08-24	3	4	0	3	0.6920000000000001
Reflections of Life: Meridiem Collector's Edition	2021-08-07	6	4	0	6	0.6920000000000001
Cosmo 02	2021-08-25	1	4	0	1	0.6920000000000001
Always The Same Nightmare	2021-10-18	4	4	0	4	0.6920000000000001
Project: Cow	2021-10-02	1	4	0	1	0.6920000000000001
Hope Trigger	2021-09-06	2	4	0	2	0.6920000000000001
Alone	2021-09-24	4	4	0	4	0.6920000000000001
メイジズメイズ　PLAY　～淫魔の洞窟に挑む冒険者～	2021-10-06	2	4	0	2	0.6920000000000001
Your Show Has Been Cancelled	2021-09-17	2	4	0	2	0.6920000000000001
Yarn	2021-09-06	1	4	0	1	0.6920000000000001
Tea Time	2021-12-02	1	4	0	1	0.6920000000000001
Rolling Balls	2021-12-31	3	4	0	3	0.6920000000000001
Lola - The Escape	2021-09-16	2	4	0	2	0.6920000000000001
City Legends: The Curse of the Crimson Shadow Collector's Edition	2021-09-21	5	4	0	5	0.6920000000000001
Ballin'	2021-09-29	2	4	0	2	0.6920000000000001
Legendary Mahjong 2	2021-10-12	5	4	0	5	0.6920000000000001
Juicy Bois: Fashion & Conflict	2021-10-25	5	4	0	5	0.6920000000000001
DARK MAGIC 2	2021-10-15	2	4	0	2	0.6920000000000001
Moonsters	2021-11-11	3	4	0	3	0.6920000000000001
Ceilless	2021-10-12	3	4	0	3	0.6920000000000001
Cat Capacity	2021-11-02	2	4	0	2	0.6920000000000001
ЖД	2021-11-04	1	4	0	1	0.6920000000000001
Toolnich Village	2021-10-13	1	4	0	1	0.6920000000000001
Unveiled	2021-11-05	2	4	0	2	0.6920000000000001
天国病院-Heaven's Hospital-	2021-10-31	2	4	0	2	0.6920000000000001
Sky DarkCrow	2021-11-29	2	4	0	2	0.6920000000000001
Thanksgiving Day Griddlers	2021-11-05	4	4	0	4	0.6920000000000001
Zovid-19 Remake	2021-12-22	1	4	0	1	0.6920000000000001
Winter Dream	2021-12-01	2	4	0	2	0.6920000000000001
Girls on puzzle 5	2021-12-04	2	4	0	2	0.6920000000000001
Dinosaur Race	2021-12-21	2	4	0	2	0.6920000000000001
Atomic Cyclecar Racing	2021-11-30	1	4	0	1	0.6920000000000001
Ending Way	2021-12-27	2	4	0	2	0.6920000000000001
MMA Championship	2021-12-20	2	4	0	2	0.6920000000000001
Auro The Bunny	2021-12-06	2	4	0	2	0.6920000000000001
Buy it now!	2021-12-02	3	4	0	3	0.6920000000000001
Hen in the Foxhouse	2021-12-31	2	4	0	2	0.6920000000000001
ToS Gamepad Companion	2021-12-29	3	4	0	3	0.6920000000000001
Uncolored Bob II	2021-12-31	2	4	0	2	0.6920000000000001
Ball	2021-12-27	1	4	0	1	0.6920000000000001
LiS: Achados & Perdidos dos Confins do Universo	2021-12-31	2	4	0	2	0.6920000000000001
amazin' George	2021-12-29	2	4	0	2	0.6920000000000001
Motorcycle Mechanic Simulator 2021	2021-11-17	434	759	297	731	0.6919
AutoChess of Gensokyo	2021-08-28	159	218	79	238	0.6919
Alien Marauder	2021-11-18	260	195	70	330	0.6919
Decks & Daggers	2021-10-08	18	44	13	31	0.6918000000000001
Nyctophobia: Devil Unleashed	2021-07-07	7	44	13	20	0.6918000000000001
The Wolf	2021-10-25	56	93	31	87	0.6916
Presence	2021-03-24	5	66	21	26	0.6914
My Stepmom is a Futanari	2021-07-30	18	240	88	106	0.6912
Trump Loves Russia	2021-08-11	4	41	12	16	0.6912
ANIME TETRIS	2021-10-14	7	41	12	19	0.6912
Song of Iron	2021-08-31	111	270	100	211	0.691
World Nations Game	2021-12-24	37	119	41	78	0.691
Red Solstice 2: Survivors	2021-06-17	3826	2036	832	4658	0.6908
MahjongSchool	2021-05-01	21	52	16	37	0.6907
Visite virtuelle de l'Assemblée nationale	2021-09-16	6	38	11	17	0.6907
Worn Thin	2021-02-19	15	116	40	55	0.6904000000000001
Soccer Manager 2022	2021-11-26	1116	1278	516	1632	0.6901
hexurb	2021-05-31	6	49	15	21	0.6900000000000001
The Last Town: Excape	2021-04-30	14	49	15	29	0.6900000000000001
Sword of the Necromancer	2021-01-28	111	185	67	178	0.6899
Ice Station Z	2021-12-02	21	84	28	49	0.6898000000000001
Zombie Slayers	2021-02-21	4	11	2	6	0.6897
Ambush: Convoy Strike	2021-07-15	5	11	2	7	0.6897
One Tile Man	2021-07-25	6	11	2	8	0.6897
Winter Wastelands	2021-04-23	3	11	2	5	0.6897
Blaze and the Monster Machines: Axle City Racers	2021-10-01	6	11	2	8	0.6897
A Pretty Odd Bunny	2021-11-11	5	11	2	7	0.6897
Artillery Royale	2021-03-31	4	11	2	6	0.6897
Doomsday Room	2021-01-15	5	11	2	7	0.6897
Tower of Doom	2021-07-30	3	11	2	5	0.6897
Parkalien	2021-06-11	4	11	2	6	0.6897
Jigsaw Pieces - Romance	2021-02-17	4	11	2	6	0.6897
守卫魔兽-Guardian of Warcraft	2021-03-26	3	11	2	5	0.6897
High Smileson	2021-02-18	3	11	2	5	0.6897
Infected spaceship generator	2021-06-14	3	11	2	5	0.6897
Allura: The Three Realms	2021-03-23	6	11	2	8	0.6897
Spaceship - Visual Effect Graph Demo	2021-10-04	4	11	2	6	0.6897
ENEMIES	2021-08-30	2	11	2	4	0.6897
Helix	2021-05-14	2	11	2	4	0.6897
Mysterious Blocks 2	2021-06-17	3	11	2	5	0.6897
Witchaven II: Blood Vengeance	2021-06-17	3	11	2	5	0.6897
PHYSARUM: Slime Mold Simulator	2021-08-30	5	11	2	7	0.6897
莉莉的梦：恐龙历险记	2021-10-08	3	11	2	5	0.6897
Runic Relay: The Trials	2021-07-14	14	11	2	16	0.6897
Rent's Due: The Game	2021-08-26	4	11	2	6	0.6897
AimGoGoGo	2021-08-23	6	11	2	8	0.6897
PIXASSO 2	2021-08-24	3	11	2	5	0.6897
Diner Bros Inc	2021-09-06	6	11	2	8	0.6897
ROUGH KUTS: The Thirsty Dead	2021-09-24	4	11	2	6	0.6897
Para Bellum - Hold the Line	2021-12-31	4	11	2	6	0.6897
EXQUISITE GHORPSE STORY	2021-11-19	3	11	2	5	0.6897
Hentai Sakura 🌸🌊	2021-10-10	804	172	62	866	0.6896
Endless Becoming - Apartment	2021-09-03	12	57	18	30	0.6894
Maid for Pleasure	2021-12-10	14	32	9	23	0.6894
Trash Sailors	2021-12-16	259	164	59	318	0.6893000000000001
Monster Crown	2021-10-12	222	457	177	399	0.6892
Surviving the Aftermath	2021-11-16	4637	2589	1075	5712	0.6890999999999999
Flowering Nightshade	2021-06-11	7	29	8	15	0.6888
Shadows: Price For Our Sins	2021-10-27	13	29	8	21	0.6888
Make the Burger	2021-02-22	6	54	17	23	0.6887000000000001
下一站江湖Ⅰ	2021-04-02	372	392	151	523	0.6886
Vampire Slave 1	2021-06-30	9	43	13	22	0.6885
Punk Wars: Prologue	2021-10-12	28	62	20	48	0.6884
魔女秘药（witch elixir）	2021-08-18	52	70	23	75	0.6883
Inversion	2021-02-18	7	26	7	14	0.6883
Quest: Escape Room 3	2021-03-09	3	26	7	10	0.6883
The Vagabond Emperor	2021-07-29	8	26	7	15	0.6883
MTB Dirt	2021-07-10	9	26	7	16	0.6883
TripleBuilder	2021-08-10	10	26	7	17	0.6883
Psychocat The Door	2021-01-12	4	14	3	7	0.688
Pulse Jumper	2021-02-06	3	14	3	6	0.688
无限次元	2021-03-29	8	14	3	11	0.688
Evolution of a Mini World: Physics Wonderland	2021-02-13	3	14	3	6	0.688
Black Ido	2021-02-10	4	14	3	7	0.688
Rebellion Gaia	2021-06-29	6	14	3	9	0.688
Skill at Time	2021-01-26	3	14	3	6	0.688
Itadaki Smash	2021-05-20	5	14	3	8	0.688
Sky Goddess Ⅱ	2021-04-22	2	14	3	5	0.688
Medieval Heros	2021-06-01	5	14	3	8	0.688
Balloon Jump	2021-06-17	2	14	3	5	0.688
Wildlife Match	2021-07-15	5	14	3	8	0.688
Marble Parkour 2: Roll and roll	2021-08-08	3	14	3	6	0.688
Caveman Hunt	2021-12-31	3	14	3	6	0.688
Alan Sharp	2021-05-23	10	51	16	26	0.6879000000000001
Until We Die	2021-06-03	2335	2753	1153	3488	0.6878000000000001
Time Trap 2 - Search and Find Objects Game	2021-03-19	8	23	6	14	0.6878000000000001
Cash Horse - Match 3 Puzzle Adventure	2021-02-03	5	23	6	11	0.6878000000000001
SGS Halls of Montezuma	2021-05-20	9	23	6	15	0.6878000000000001
Bite At The Museum	2021-05-04	4	23	6	10	0.6878000000000001
snowboarding	2021-08-04	5	23	6	11	0.6878000000000001
里帰り - Satogaeri -	2021-11-24	12	23	6	18	0.6878000000000001
Angry Squirrel	2021-04-24	6	75	25	31	0.6877
The World After	2021-05-05	9	40	12	21	0.6877
The Hidden Room	2021-10-14	41	185	68	109	0.6876000000000001
Making History: The First World War	2021-03-05	22	67	22	44	0.6876000000000001
Radio Viscera	2021-07-13	10	20	5	15	0.6875
Race To Sanity	2021-01-15	4	20	5	9	0.6875
Frauki's Adventure	2021-04-30	3	20	5	8	0.6875
Wonderful Girls	2021-04-29	3	20	5	8	0.6875
Rift Adventure	2021-09-16	5	20	5	10	0.6875
无限重启	2021-08-18	5	20	5	10	0.6875
Super Drag Race	2021-09-14	6	20	5	11	0.6875
Summer In Trigue	2021-10-18	14	17	4	18	0.6875
MAZEMAN	2021-10-08	6	17	4	10	0.6875
StarCrawlers Chimera	2021-11-16	19	17	4	23	0.6875
Crossbow Crusade	2021-04-30	3	17	4	7	0.6875
At Your Feet	2021-09-01	9	17	4	13	0.6875
The Chronicles of Hercules: The 12 Labours	2021-02-24	6	17	4	10	0.6875
City Maker	2021-02-25	5	17	4	9	0.6875
Salto	2021-03-18	6	17	4	10	0.6875
CorePiercer	2021-04-07	4	17	4	8	0.6875
Gelly Break Deluxe	2021-08-12	11	17	4	15	0.6875
Sudokolorful	2021-08-04	5	17	4	9	0.6875
The Oath of The Dark Magic Queen	2021-11-05	8	17	4	12	0.6875
Scarred Stars: Traumatic Edition	2021-10-22	3	17	4	7	0.6875
夢獸之島Isles of Monsters	2021-11-02	5	17	4	9	0.6875
Trick or Treat	2021-11-05	6	17	4	10	0.6875
Tower of Waifus	2021-04-09	275	207	77	352	0.6870999999999999
Evaverse	2021-08-02	391	93	32	423	0.6870999999999999
7th Chance	2021-07-15	2	37	11	13	0.6869
Mad Ball	2021-03-12	56	64	21	77	0.6868000000000001
Survival Engine	2021-02-22	15	56	18	33	0.6868000000000001
Inferno - Beyond the 7th Circle	2021-04-30	20	45	14	34	0.6861
Aircraft Carrier Survival: Prolouge	2021-03-31	647	829	337	984	0.6858
Heal Hitler	2021-07-22	25	133	48	73	0.6858
Chupacabras: Night Hunt	2021-08-21	32	87	30	62	0.6857
Bomber Dudes	2021-01-15	20	42	13	33	0.6851999999999999
The Colossus Is Coming: The Interactive Experience	2021-11-05	7	42	13	20	0.6851999999999999
Yearning: A Gay Story	2021-08-02	9	42	13	22	0.6851999999999999
Carebotz	2021-05-07	6	31	9	15	0.6851
Mini Car Racing - Tiny Split Screen Tournament	2021-04-23	9	31	9	18	0.6851
Dark Chronicles: The Soul Reaver	2021-04-23	6	31	9	15	0.6851
Ship Graveyard Simulator	2021-11-10	1262	776	316	1578	0.685
Godstrike	2021-04-15	55	102	36	91	0.685
Overcooked! All You Can Eat	2021-03-23	3077	1968	829	3906	0.6849
Cyber Hentai	2021-01-08	3	50	16	19	0.6849
ScrewUp	2021-07-29	191	187	70	261	0.6848000000000001
Cover Fire	2021-11-04	86	187	70	156	0.6848000000000001
PC Creator - PC Building Simulator	2021-12-14	21	112	40	61	0.6847
INDUSTRIA	2021-09-30	226	1278	532	758	0.6845
Nigate Tale	2021-04-12	544	476	190	734	0.6844
Incremental Epic Hero	2021-02-23	895	184	69	964	0.6844
戾谈	2021-01-16	28	76	26	54	0.6844
My Cute Pagangirl	2021-07-22	19	63	21	40	0.6844
Psychic Guardian Super Splendor	2021-05-29	226	99	35	261	0.6843000000000001
TinShift	2021-06-03	35	104	37	72	0.6840999999999999
Obscurite Magie: The City of Sin	2021-11-20	153	55	18	171	0.6840999999999999
Highway Traffic Racer	2021-03-05	6	39	12	18	0.6840999999999999
Hero of the Demon	2021-08-13	69	39	12	81	0.6840999999999999
Conqueror 940 AD	2021-04-01	21	28	8	29	0.6840999999999999
頭痛	2021-11-20	96	114	41	137	0.684
Thunder Tier One	2021-12-07	6453	2783	1190	7643	0.6839000000000001
Horror Story: Hallowseed	2021-10-28	32	161	60	92	0.6836
Incremental Cubes	2021-11-03	1052	464	186	1238	0.6834
War Mongrels	2021-10-19	681	883	365	1046	0.6833
an Orc's Tale: Kriegsruf	2021-04-18	14	25	7	21	0.6831
Cat Go! Ultimate Challenge	2021-01-30	4	25	7	11	0.6831
Little Traveler	2021-04-28	5	25	7	12	0.6831
Conquest	2021-11-19	5	25	7	12	0.6831
Burst Squad	2021-06-11	8	36	11	19	0.6829999999999999
Jurassic Attack	2021-03-27	9	36	11	20	0.6829999999999999
Custodian: Beginning of the End	2021-09-01	6	36	11	17	0.6829999999999999
100 Hidden Animalnaults - Felicat & Laika	2021-12-20	6	36	11	17	0.6829999999999999
Somni	2021-10-09	27	65	22	49	0.6829000000000001
全战天下	2021-04-13	15	44	14	29	0.6828000000000001
Hell Architect	2021-08-18	426	262	102	528	0.6826000000000001
Grandiose	2021-07-07	14	123	45	59	0.6826000000000001
Imprisoned Queen	2021-09-16	147	216	83	230	0.6825
RevolVR 3	2021-02-23	22	113	41	63	0.6825
WRC 10 FIA World Rally Championship	2021-09-02	854	1235	520	1374	0.6822
Meria and The Island of Orcs	2021-12-24	12	22	6	18	0.682
CompactO - Idle Game	2021-07-01	100	49	16	116	0.6819
Crypto Mining Simulator	2021-04-24	237	897	374	611	0.6818000000000001
Garbage	2021-06-04	553	612	251	804	0.6818000000000001
FURRY SEX: Cabaret 💋🔞	2021-11-13	1926	280	110	2036	0.6818000000000001
魔塔地牢	2021-09-14	150	105	38	188	0.6818000000000001
Low Light Combat	2021-07-21	142	95	34	176	0.6818000000000001
Club Girl	2021-01-11	3	41	13	16	0.6817000000000001
封神榜 伏魔三太子（重制版）	2021-10-12	41	41	13	54	0.6817000000000001
Typing Incremental	2021-08-21	57	67	23	80	0.6816
Stones of Harlath	2021-08-19	2	7	1	3	0.6815000000000001
Smintheus	2021-11-11	375	7	1	376	0.6815000000000001
Survive the Rift	2021-04-15	3	7	1	4	0.6815000000000001
The Trivial Dead	2021-03-17	2	7	1	3	0.6815000000000001
King of Cooking	2021-05-06	4	7	1	5	0.6815000000000001
CosmoDrive:Infinity	2021-05-16	3	7	1	4	0.6815000000000001
E.X.P.L.O.R.™: A New World	2021-06-11	4	7	1	5	0.6815000000000001
Super Dango	2021-01-19	4	7	1	5	0.6815000000000001
Winter Wonderland	2021-10-10	6	7	1	7	0.6815000000000001
All Hit All Her	2021-05-17	2	7	1	3	0.6815000000000001
Traceur's Dreamlab VR	2021-01-05	3	7	1	4	0.6815000000000001
Roads of Time 2: Odyssey	2021-04-08	5	7	1	6	0.6815000000000001
Last Kingdom - The Card Game	2021-02-14	3	7	1	4	0.6815000000000001
Planetary Control!	2021-03-18	4	7	1	5	0.6815000000000001
SIK Space Invader Kreature	2021-07-24	4	7	1	5	0.6815000000000001
Lost to Time	2021-02-12	3	7	1	4	0.6815000000000001
RECONNECT - The Heart of Darkness	2021-06-10	3	7	1	4	0.6815000000000001
Final Winter	2021-02-03	3	7	1	4	0.6815000000000001
RUSHING BEAT OF RAGE	2021-01-05	3	7	1	4	0.6815000000000001
Fluid Simulator	2021-02-01	2	7	1	3	0.6815000000000001
Re;Lord 2 ~The witch of Cologne and black cat~	2021-11-19	6	7	1	7	0.6815000000000001
Knight Throde	2021-03-10	2	7	1	3	0.6815000000000001
Dichotomy	2021-05-07	1	7	1	2	0.6815000000000001
Garetto	2021-02-19	3	7	1	4	0.6815000000000001
Sokpop S10: Post Cards	2021-03-04	2	7	1	3	0.6815000000000001
Wall Street Bets	2021-03-01	5	7	1	6	0.6815000000000001
Welcome To... Chichester 2 - Part II : No Extra Regrets For The Future	2021-09-30	4	7	1	5	0.6815000000000001
Bridge2Code	2021-04-20	8	7	1	9	0.6815000000000001
Nova Odessa - The Strange Tower	2021-02-27	2	7	1	3	0.6815000000000001
Let's Learn Xiangqi	2021-03-17	3	7	1	4	0.6815000000000001
Froggerty Arcade	2021-03-30	4	7	1	5	0.6815000000000001
Bongo Arena	2021-03-15	4	7	1	5	0.6815000000000001
Demonsions: Industry	2021-04-22	3	7	1	4	0.6815000000000001
ファイヤーエムブレイス～選ばれしチー牛の剣～	2021-06-14	2	7	1	3	0.6815000000000001
Chubby Bear Smash	2021-06-05	4	7	1	5	0.6815000000000001
Arcade Drift	2021-06-28	3	7	1	4	0.6815000000000001
1001 Jigsaw Detective	2021-08-16	7	7	1	8	0.6815000000000001
Allura: Curse of the Mermaid	2021-05-19	6	7	1	7	0.6815000000000001
HUMBLE ZOMBIE	2021-05-27	5	7	1	6	0.6815000000000001
Cross Numbers	2021-06-30	2	7	1	3	0.6815000000000001
The Married Manager's Scandalous Services - The Pleasures of the Night Shift	2021-09-18	5	7	1	6	0.6815000000000001
Two Hundred Ways	2021-09-03	3	7	1	4	0.6815000000000001
Slime Story	2021-07-09	3	7	1	4	0.6815000000000001
Domino Sandbox	2021-07-30	3	7	1	4	0.6815000000000001
Tiger Trio's Tasty Travels	2021-10-05	4	7	1	5	0.6815000000000001
Hodl Simulator	2021-07-30	1	7	1	2	0.6815000000000001
Crusade in Europe	2021-11-30	4	7	1	5	0.6815000000000001
GUN&DUN	2021-08-09	1	7	1	2	0.6815000000000001
Aqua Boy	2021-10-07	2	7	1	3	0.6815000000000001
Fishing at Lotus Lakes	2021-11-26	1	7	1	2	0.6815000000000001
Ball Ranger	2021-09-28	3	7	1	4	0.6815000000000001
Master-Servant Sex with the Beauty from the Orient ~Contract with a Semen-Sucking Demon~	2021-10-23	5	7	1	6	0.6815000000000001
吾王的荣耀 Honor of Knight King	2021-10-16	2	7	1	3	0.6815000000000001
蜚	2021-09-29	3	7	1	4	0.6815000000000001
Haunted Hotel: The Axiom Butcher Collector's Edition	2021-09-17	9	7	1	10	0.6815000000000001
A Visit to Friends	2021-12-02	3	7	1	4	0.6815000000000001
Halloween Stories: The Neglected Dead Collector's Edition	2021-10-15	10	7	1	11	0.6815000000000001
The rise of Tianling Sect	2021-12-27	3	7	1	4	0.6815000000000001
Cream Me 2	2021-12-25	2	7	1	3	0.6815000000000001
Temple of Endless Night	2021-11-12	10	7	1	11	0.6815000000000001
Pizza Man	2021-12-05	2	7	1	3	0.6815000000000001
Rescue Team: Power Eaters	2021-12-22	23	7	1	24	0.6815000000000001
Christmas Stories: Yulemen Collector's Edition	2021-12-01	8	7	1	9	0.6815000000000001
Get Together	2021-10-14	37	54	18	55	0.6813
30 days to survive	2021-03-16	10	77	27	37	0.6812
Saving Punyville	2021-01-13	9	19	5	14	0.6809999999999999
Neko Chan	2021-11-02	5	19	5	10	0.6809999999999999
Desktop Honey	2021-01-12	5	19	5	10	0.6809999999999999
Hungry Fish	2021-07-20	3	19	5	8	0.6809999999999999
Road Builder	2021-11-04	7	19	5	12	0.6809999999999999
Bounceables	2021-12-03	5	19	5	10	0.6809999999999999
Splash Girls	2021-09-07	10	46	15	25	0.6807
Tomorrow	2021-02-12	6	30	9	15	0.6805
BEATris	2021-09-30	5	38	12	17	0.6804000000000001
FurBall	2021-07-30	8	38	12	20	0.6804000000000001
Hentai Detective	2021-11-02	6	38	12	18	0.6804000000000001
Once in Flowerlake	2021-11-17	8	69	24	32	0.6803
Escape From School	2021-09-07	51	360	145	196	0.6802
Back 4 Boobs: Sakura's Escape	2021-10-01	11	51	17	28	0.6801
Inheritors2078	2021-04-02	7	16	4	11	0.68
Maniac Path 2	2021-02-09	6	16	4	10	0.68
Librarian	2021-03-04	4	16	4	8	0.68
Depths Of Horror: Mushroom Day	2021-06-16	3	16	4	7	0.68
The Hurt in Secret	2021-06-12	6	16	4	10	0.68
LOGistICAL 3	2021-06-17	24	16	4	28	0.68
Hot Summer	2021-06-07	4	16	4	8	0.68
Bubble Shooter FX	2021-09-09	9	16	4	13	0.68
Typomancer in the Feather's Way	2021-10-15	4	16	4	8	0.68
Paradise Delight	2021-12-11	4	16	4	8	0.68
Prototype Blocks	2021-11-14	5	16	4	9	0.68
Iron Conflict	2021-01-08	481	1378	591	1072	0.6795
Haunt Chaser	2021-10-06	155	461	189	344	0.6795
Woodfel	2021-04-30	8	13	3	11	0.6793000000000001
Cartridge Monsters	2021-02-05	6	13	3	9	0.6793000000000001
天虹书店 Tian Hong Bookstore	2021-09-01	3	13	3	6	0.6793000000000001
How to Win	2021-03-30	6	13	3	9	0.6793000000000001
Wilhelm Gustloff's Death	2021-01-30	5	13	3	8	0.6793000000000001
My Dream Sport Dating Simulator	2021-02-18	2	13	3	5	0.6793000000000001
Restless Night	2021-06-16	4	13	3	7	0.6793000000000001
Synth Drift	2021-03-23	2	13	3	5	0.6793000000000001
그녀가 공작저로 가야 했던 사정	2021-05-27	13	13	3	16	0.6793000000000001
Music95	2021-03-29	2	13	3	5	0.6793000000000001
A Night Before the Deadline	2021-06-01	2	13	3	5	0.6793000000000001
Leaf on Wind	2021-05-07	3	13	3	6	0.6793000000000001
Insect Adventure	2021-05-17	3	13	3	6	0.6793000000000001
Sweeping the Ruins	2021-08-01	5	13	3	8	0.6793000000000001
Strip Black Jack - Cyber Sex	2021-07-16	5	13	3	8	0.6793000000000001
Spectral Ascension	2021-06-18	8	13	3	11	0.6793000000000001
Chess Valley 2	2021-06-22	4	13	3	7	0.6793000000000001
The Absolutely Hilarious Cat Game	2021-07-09	4	13	3	7	0.6793000000000001
Police Sentri	2021-08-24	22	13	3	25	0.6793000000000001
Animals Memory: Monkeys	2021-08-10	2	13	3	5	0.6793000000000001
V-Fighter 2000	2021-12-23	3	13	3	6	0.6793000000000001
Gun Skaters	2021-03-17	6	10	2	8	0.6793000000000001
Dark Abyss	2021-06-06	2	10	2	4	0.6793000000000001
Magical Strings	2021-04-26	11	10	2	13	0.6793000000000001
WOMG Lite Version	2021-07-18	4	10	2	6	0.6793000000000001
Hatchpunk	2021-02-18	2	10	2	4	0.6793000000000001
Rising Noracam	2021-02-27	7	10	2	9	0.6793000000000001
引力魔方	2021-02-12	2	10	2	4	0.6793000000000001
Conspiracy Girls	2021-02-25	3	10	2	5	0.6793000000000001
Animal Drop Safari	2021-02-24	5	10	2	7	0.6793000000000001
ASMR LIGHTness - Light painting	2021-04-23	3	10	2	5	0.6793000000000001
Overgrown	2021-05-14	5	10	2	7	0.6793000000000001
Stardrytch	2021-11-04	3	10	2	5	0.6793000000000001
World War 2 Operation Husky	2021-07-05	3	10	2	5	0.6793000000000001
Salt and Sails	2021-07-01	2	10	2	4	0.6793000000000001
SIGURAT	2021-07-27	4	10	2	6	0.6793000000000001
The Craft of the Samurai	2021-08-25	2	10	2	4	0.6793000000000001
OnlyGame: Working Girls	2021-09-14	3	10	2	5	0.6793000000000001
The Cruel kings	2021-09-11	2	10	2	4	0.6793000000000001
Hidden Words	2021-10-08	27	10	2	29	0.6793000000000001
Horror Maze	2021-09-29	3	10	2	5	0.6793000000000001
SUL 3D - Schütze Unser Land	2021-12-01	2	10	2	4	0.6793000000000001
The Legend of the War Axe	2021-12-25	4	10	2	6	0.6793000000000001
Crysis Remastered	2021-09-17	1244	3721	1642	2886	0.6792
Evil Inside - Prologue	2021-03-04	85	550	228	313	0.6790999999999999
My Cashy Side Job at Lost&Found in the Subway of Million-Person City	2021-11-25	4	27	8	12	0.6790999999999999
2236 A.D. Secretary Stories	2021-07-23	5	35	11	16	0.679
Crazy Santa	2021-12-19	4	35	11	15	0.679
Hide and Run	2021-05-28	45	183	71	116	0.6789000000000001
Smelter	2021-04-22	59	130	49	108	0.6789000000000001
冰橘布丁	2021-11-02	4	40	13	17	0.6781
Vain Riser | 空梦	2021-08-19	21	68	24	45	0.6779999999999999
Immortal Legacy: The Jade Cipher VR	2021-03-19	10	68	24	34	0.6779999999999999
Larcenauts	2021-06-17	42	146	56	98	0.6778000000000001
Firegirl: Hack 'n Splash Rescue	2021-12-14	59	117	44	103	0.6777
Flight of the Amazon Queen: 25th Anniversary Edition	2021-05-17	9	24	7	16	0.6776000000000001
Hermitage: Strange Case Files	2021-10-26	10	24	7	17	0.6776000000000001
HENTAISLAND: Lost Pantsu	2021-03-27	2	24	7	9	0.6776000000000001
Matraquinha PAIR	2021-04-02	2	24	7	9	0.6776000000000001
Craft Craft Craft!	2021-07-21	4	24	7	11	0.6776000000000001
Global City	2021-11-30	608	417	172	780	0.6775
Sefir: Mafia Story	2021-08-24	4	45	15	19	0.6775
《Drifting : Weight of Feathers》	2021-12-16	9	32	10	19	0.6775
Genderbend Me! Sayonara Demon Dong	2021-08-20	13	32	10	23	0.6775
Parking Slide	2021-07-26	5	32	10	15	0.6775
Tsugunohi	2021-08-13	163	321	131	294	0.6768000000000001
Fast Food Manager	2021-12-26	41	169	66	107	0.6768000000000001
Fossilfuel	2021-08-21	26	65	23	49	0.6768000000000001
Surgeon Simulator 2	2021-09-02	1104	724	308	1412	0.6766
Chased by Darkness	2021-06-01	62	220	88	150	0.6761
疯狂炮炮捕鱼	2021-10-22	151	271	110	261	0.6759999999999999
ROG CITADEL XV	2021-01-12	591	386	160	751	0.6759000000000001
Epic City Builder 4	2021-10-14	4	21	6	10	0.6759000000000001
Lumexa	2021-02-26	4	21	6	10	0.6759000000000001
ACIIIIIIIIIIIIIIID	2021-05-15	2	21	6	8	0.6759000000000001
Legends of Snooker: One Shot	2021-09-16	6	21	6	12	0.6759000000000001
Super Mecha Champions	2021-03-25	2304	5147	2327	4631	0.6758
Where Cards Fall	2021-11-04	19	29	9	28	0.6758
Synthbiotic Dungeon	2021-04-24	14	29	9	23	0.6758
HitchHiker	2021-04-15	16	106	40	56	0.6757
Cute Honey: Bunny Girl	2021-11-26	385	517	218	603	0.6755
Bus Simulator 21	2021-09-07	2629	2314	1031	3660	0.6751
Shattered - Tale of the Forgotten King	2021-02-17	192	407	170	362	0.6751
A-Train: All Aboard! Tourism	2021-12-08	306	91	34	340	0.6748000000000001
No More Heroes 2: Desperate Struggle	2021-06-09	64	308	127	191	0.6747
[NINJA GAIDEN: Master Collection] NINJA GAIDEN 3: Razor's Edge	2021-06-10	647	676	290	937	0.6746
HellSign	2021-02-24	205	1436	634	839	0.6743000000000001
Among Trees	2021-11-10	695	1234	542	1237	0.6743000000000001
Gamer Girls [18+]: eSports SEX	2021-08-05	340	608	260	600	0.6743000000000001
Deep Night Detective	2021-06-16	9	39	13	22	0.6743000000000001
Sexy Sniper	2021-04-03	4	39	13	17	0.6743000000000001
Virtual Hunter	2021-12-02	15	59	21	36	0.6742
Futanari Vampire Girlfriend	2021-08-20	6	54	19	25	0.6741
BloodRayne Betrayal: Fresh Bites	2021-09-09	24	49	17	41	0.6741
Futanari of the Amazon	2021-04-08	6	44	15	21	0.6741
Gunslingers & Zombies	2021-10-28	8	18	5	13	0.674
Invisible Wings: Chapter One	2021-04-15	5	18	5	10	0.674
Hot Pot	2021-05-28	5	18	5	10	0.674
A Day In Space	2021-08-23	6	18	5	11	0.674
Horror Stories: Please Comply	2021-11-12	3	18	5	8	0.674
Tightrope Walking	2021-10-22	5	18	5	10	0.674
ANOTHER EDEN	2021-03-31	935	980	428	1363	0.6739
Reforged Tower Defense	2021-12-09	8	26	8	16	0.6739
Z.O.M.B.I.E.	2021-03-05	7	26	8	15	0.6739
PROJECT: Halloween	2021-10-21	4	26	8	12	0.6739
This Is the President	2021-12-06	169	168	67	236	0.6734
Royal Crown	2021-02-23	5442	2227	1001	6443	0.6731999999999999
Giants Uprising	2021-11-02	56	128	50	106	0.6731
Vampire: The Masquerade — Out for Blood	2021-07-29	265	102	39	304	0.6731
Dee-6: Dice Defenders	2021-03-31	16	31	10	26	0.6729999999999999
Desktop NEKO Girl	2021-01-22	14	31	10	24	0.6729999999999999
VILLAGE THE SIBERIA	2021-11-29	5	31	10	15	0.6729999999999999
IWOCon 2021	2021-03-26	57	85	32	89	0.6726000000000001
I'm Strongest Legend	2021-07-07	7	51	18	25	0.6726000000000001
Raptor Territory	2021-11-30	12	36	12	24	0.6725
My Stepmom is a Futanari 3	2021-10-08	4	46	16	20	0.6724
The Last Sin	2021-01-09	889	41	14	903	0.6724
KeepUp Survival	2021-02-26	135	347	146	281	0.6723
ArcticBoy Story	2021-04-30	7	68	25	32	0.6723
DRAMA	2021-08-06	6	68	25	31	0.6723
ネジ込みシミュレーターVol2 -三編みちゃんのおまんこキックチャレンジ!!超動くバーチャルオナホアプリ-【拡張・オナホ化・石化・時間停止】	2021-07-12	40	80	30	70	0.6722
Gnomancer	2021-04-07	4	15	4	8	0.672
Café International	2021-07-01	7	15	4	11	0.672
Boulder Dash Deluxe	2021-09-08	7	15	4	11	0.672
Kindred Fates: Combat Arena Alpha	2021-05-03	11	15	4	15	0.672
Sentinel: Cursed Knight	2021-04-08	3	15	4	7	0.672
Where's Samantha?	2021-03-25	4	15	4	8	0.672
Hero's everyday life	2021-11-02	5	15	4	9	0.672
Crash Race	2021-03-23	3	15	4	7	0.672
Whispers in the Dark	2021-08-26	3	15	4	7	0.672
Magic LightHouse	2021-05-15	4	15	4	8	0.672
Virtual Becomes Reality: A Stanford VR Experience	2021-06-30	4	15	4	8	0.672
Paper Enchantress	2021-12-21	3	15	4	7	0.672
Hungry Bunny	2021-07-20	2	15	4	6	0.672
Reborn Tribe	2021-11-12	5	15	4	9	0.672
EBOLA 2	2021-01-06	46	155	62	108	0.6718999999999999
Cyberpunk Madness	2021-03-12	7	23	7	14	0.6718000000000001
Line of War	2021-05-22	10	23	7	17	0.6718000000000001
Terra Atlantis	2021-06-14	5	23	7	12	0.6718000000000001
Kitty Adventure	2021-08-11	7	23	7	14	0.6718000000000001
My Stepmom is a Futanari 2	2021-09-20	7	58	21	28	0.6716
Implements of Hell	2021-11-27	10	58	21	31	0.6716
Shadowplay: Metropolis Foe	2021-08-20	72	143	57	129	0.6714
Strangest.io's myFloppy Online!	2021-04-30	25	89	34	59	0.6712
JARS	2021-10-20	72	53	19	91	0.6712
Moonlaw	2021-12-20	8	53	19	27	0.6712
Drunken Fight Simulator	2021-02-23	1707	138	55	1762	0.6709999999999999
I Am The Prosecutor: No Evidence? No Problem!	2021-04-30	7	28	9	16	0.6709
Farmer's Life: Prologue	2021-01-15	45	147	59	104	0.6707
HardLander	2021-04-12	4	3	0	4	0.6706000000000001
Hero's Descent	2021-04-28	3	3	0	3	0.6706000000000001
Rain of Arrows	2021-05-26	2	3	0	2	0.6706000000000001
Flight of the Athena	2021-10-26	2	3	0	2	0.6706000000000001
Super Hyperspace Avenger	2021-01-05	2	3	0	2	0.6706000000000001
Stacksquatch	2021-04-08	2	3	0	2	0.6706000000000001
Microwasp Seekers	2021-12-01	2	3	0	2	0.6706000000000001
Flow Weaver	2021-05-03	2	3	0	2	0.6706000000000001
Alien Earth	2021-02-18	2	3	0	2	0.6706000000000001
Code Zero	2021-07-29	1	3	0	1	0.6706000000000001
The Golden Cross	2021-02-26	3	3	0	3	0.6706000000000001
Goonya Fighter	2021-11-12	4	3	0	4	0.6706000000000001
Altidudes	2021-01-26	1	3	0	1	0.6706000000000001
Twin Stick Heroes	2021-02-25	2	3	0	2	0.6706000000000001
Metal Swarm Infinity	2021-09-07	3	3	0	3	0.6706000000000001
Furries & Scalies & Bears OH MY! 2: Return to Kale Bay	2021-04-30	2	3	0	2	0.6706000000000001
DeRailed	2021-11-22	6	3	0	6	0.6706000000000001
Kyma	2021-03-25	3	3	0	3	0.6706000000000001
Lone Wolf: World War 2	2021-01-11	2	3	0	2	0.6706000000000001
The Lost Cube	2021-02-25	3	3	0	3	0.6706000000000001
District 99	2021-02-12	2	3	0	2	0.6706000000000001
Toad On Fire	2021-12-25	2	3	0	2	0.6706000000000001
Dead TD	2021-06-08	2	3	0	2	0.6706000000000001
Rank: Warmaster	2021-12-01	3	3	0	3	0.6706000000000001
Jay Schilling's Edge of Chaos	2021-12-21	2	3	0	2	0.6706000000000001
Disturbed R.I.P.	2021-03-24	1	3	0	1	0.6706000000000001
The Missing Link	2021-11-22	4	3	0	4	0.6706000000000001
Phantom Typist	2021-07-14	3	3	0	3	0.6706000000000001
Conet	2021-06-24	3	3	0	3	0.6706000000000001
Neighbor Watching	2021-01-13	2	3	0	2	0.6706000000000001
Busty Maid Creampie Heaven!	2021-01-13	3	3	0	3	0.6706000000000001
Flashlight	2021-10-26	10	3	0	10	0.6706000000000001
L'intrépide, le futur de l'imparfait	2021-04-01	9	3	0	9	0.6706000000000001
Odenavirus Online	2021-01-22	2	3	0	2	0.6706000000000001
Gravity in Space	2021-01-27	2	3	0	2	0.6706000000000001
Moon Caves	2021-02-04	2	3	0	2	0.6706000000000001
Space Nations - Battlearena	2021-01-22	20	3	0	20	0.6706000000000001
Retro Run	2021-06-30	2	3	0	2	0.6706000000000001
Eternal Secret	2021-07-30	1	3	0	1	0.6706000000000001
Survival RPG 2: Temple ruins	2021-01-28	3	3	0	3	0.6706000000000001
Discover	2021-01-17	2	3	0	2	0.6706000000000001
Mage Mountain	2021-11-11	3	3	0	3	0.6706000000000001
Detective Solitaire: Inspector Magic And The Forbidden Magic	2021-02-02	4	3	0	4	0.6706000000000001
Pour There	2021-01-13	2	3	0	2	0.6706000000000001
The Chaos Gene	2021-03-09	2	3	0	2	0.6706000000000001
PePiBo	2021-01-06	1	3	0	1	0.6706000000000001
Maze Party	2021-01-19	7	3	0	7	0.6706000000000001
labyrinth 3	2021-01-13	3	3	0	3	0.6706000000000001
Crafty	2021-05-23	6	3	0	6	0.6706000000000001
Oculux	2021-03-01	2	3	0	2	0.6706000000000001
Wind Wind	2021-07-23	2	3	0	2	0.6706000000000001
DW	2021-04-22	2	3	0	2	0.6706000000000001
The Light of Summer	2021-02-18	3	3	0	3	0.6706000000000001
BIRBOUT!	2021-12-05	2	3	0	2	0.6706000000000001
Necore Tower - Redux Edition	2021-10-21	2	3	0	2	0.6706000000000001
Red Mist: River of Blood	2021-01-24	1	3	0	1	0.6706000000000001
Confusing game	2021-05-20	2	3	0	2	0.6706000000000001
Ultimatum: Casting	2021-02-04	2	3	0	2	0.6706000000000001
DreamCatcher: Reflections Volume 1	2021-02-19	2	3	0	2	0.6706000000000001
Rome 2077: Space Wars	2021-02-25	2	3	0	2	0.6706000000000001
A Knights Adventure	2021-02-05	1	3	0	1	0.6706000000000001
#Snake2 DX: Reawakening	2021-03-01	2	3	0	2	0.6706000000000001
Kakuro Blend	2021-03-14	2	3	0	2	0.6706000000000001
DaCapo Delivers	2021-07-01	3	3	0	3	0.6706000000000001
Food Comes From Above	2021-03-10	1	3	0	1	0.6706000000000001
Toggle	2021-02-20	1	3	0	1	0.6706000000000001
Mariuccha Alchemy Queen	2021-06-01	4	3	0	4	0.6706000000000001
Vacation Adventures: Park Ranger 5	2021-02-26	4	3	0	4	0.6706000000000001
Rise 2.0	2021-03-17	1	3	0	1	0.6706000000000001
Bara Giants	2021-07-24	5	3	0	5	0.6706000000000001
Tapeworm Disco Puzzle	2021-09-01	2	3	0	2	0.6706000000000001
Darkened Glory	2021-03-08	5	3	0	5	0.6706000000000001
Void Explorer	2021-06-21	2	3	0	2	0.6706000000000001
Halloween Sweetplechase	2021-03-01	2	3	0	2	0.6706000000000001
Raptors of SouthEdge	2021-03-09	2	3	0	2	0.6706000000000001
The Girl Who Sees	2021-06-11	2	3	0	2	0.6706000000000001
Smackball	2021-05-27	4	3	0	4	0.6706000000000001
CodeWalkers	2021-03-26	5	3	0	5	0.6706000000000001
鸭子达奇 Duck Duchy	2021-03-26	2	3	0	2	0.6706000000000001
Deep Therapy	2021-03-15	2	3	0	2	0.6706000000000001
Dream's Reach: Village of the Gods	2021-06-29	3	3	0	3	0.6706000000000001
Replay - A Puzzle Game	2021-03-20	2	3	0	2	0.6706000000000001
Zombie Friday	2021-04-01	3	3	0	3	0.6706000000000001
Cpt.Balloney - painful days at home	2021-04-04	3	3	0	3	0.6706000000000001
雪糕猫	2021-03-26	2	3	0	2	0.6706000000000001
Maya's Dice	2021-11-02	2	3	0	2	0.6706000000000001
Road Flash	2021-03-17	2	3	0	2	0.6706000000000001
Strife: The Expanse	2021-05-14	4	3	0	4	0.6706000000000001
KingdomDefense	2021-03-22	1	3	0	1	0.6706000000000001
Retrograde	2021-05-25	3	3	0	3	0.6706000000000001
Herbis	2021-03-25	2	3	0	2	0.6706000000000001
Nami	2021-10-20	1	3	0	1	0.6706000000000001
Liberation Mutagenix	2021-05-06	2	3	0	2	0.6706000000000001
Drone Gladiator	2021-09-20	2	3	0	2	0.6706000000000001
Old Stories: Fireheart	2021-10-13	4	3	0	4	0.6706000000000001
Saighead	2021-04-19	4	3	0	4	0.6706000000000001
Superhero Recruitment Simulator	2021-04-01	2	3	0	2	0.6706000000000001
Neon GraVel	2021-04-20	3	3	0	3	0.6706000000000001
Robo-Worms	2021-07-15	6	3	0	6	0.6706000000000001
REDITUM	2021-08-08	2	3	0	2	0.6706000000000001
Ember Knight Solitaire	2021-03-30	4	3	0	4	0.6706000000000001
The Floor is [Blank]	2021-09-17	1	3	0	1	0.6706000000000001
Toilet Paper War	2021-05-07	2	3	0	2	0.6706000000000001
Dark Runner	2021-09-16	4	3	0	4	0.6706000000000001
Color Pixel Heroes	2021-04-08	3	3	0	3	0.6706000000000001
Shiba Inu Rescue	2021-05-21	3	3	0	3	0.6706000000000001
Elevated	2021-07-12	3	3	0	3	0.6706000000000001
Clessidra	2021-06-15	2	3	0	2	0.6706000000000001
Cowboys, Vampires, Pirates & Ghosts	2021-05-10	3	3	0	3	0.6706000000000001
Jumpin' Tanks	2021-04-14	3	3	0	3	0.6706000000000001
Bullfrogs	2021-08-19	2	3	0	2	0.6706000000000001
BARBAROS	2021-05-05	2	3	0	2	0.6706000000000001
Kells	2021-06-01	3	3	0	3	0.6706000000000001
Sweet Home Puzzle	2021-06-04	4	3	0	4	0.6706000000000001
The Great Pickle Adventure	2021-05-31	1	3	0	1	0.6706000000000001
Keyboard Master	2021-05-24	2	3	0	2	0.6706000000000001
Solitaire Jack Frost Winter Adventures 2	2021-05-14	4	3	0	4	0.6706000000000001
Halloween Night Mahjong 2	2021-05-20	3	3	0	3	0.6706000000000001
Spooky Mahjong	2021-05-24	4	3	0	4	0.6706000000000001
Touching Live2D Ork Sex With Lady Knight	2021-05-28	3	3	0	3	0.6706000000000001
Need For Conquest	2021-06-07	2	3	0	2	0.6706000000000001
Avarice	2021-05-08	1	3	0	1	0.6706000000000001
Gun on the Chickahominy	2021-05-21	2	3	0	2	0.6706000000000001
OGgolf	2021-05-29	2	3	0	2	0.6706000000000001
Calluna	2021-09-30	2	3	0	2	0.6706000000000001
The Annoying Game	2021-07-15	2	3	0	2	0.6706000000000001
Mayhem in Single Valley: Prologue	2021-05-06	5	3	0	5	0.6706000000000001
ShootRun	2021-05-10	1	3	0	1	0.6706000000000001
Exvelten	2021-06-27	1	3	0	1	0.6706000000000001
Zen Landscape Editor	2021-05-17	2	3	0	2	0.6706000000000001
Sword of Paladin RE	2021-06-28	3	3	0	3	0.6706000000000001
Mosaic Hearts Prototype	2021-10-06	2	3	0	2	0.6706000000000001
Shackled	2021-05-21	2	3	0	2	0.6706000000000001
AutoCube	2021-12-01	3	3	0	3	0.6706000000000001
Retro Classix: BreakThru	2021-06-24	1	3	0	1	0.6706000000000001
QB Planets	2021-08-16	4	3	0	4	0.6706000000000001
Monster Academy	2021-07-26	2	3	0	2	0.6706000000000001
幻想殇物语	2021-08-10	2	3	0	2	0.6706000000000001
Escape From Ruby Castle	2021-06-03	1	3	0	1	0.6706000000000001
Yoko & Yuki: Dr. Rat's Revenge	2021-06-01	3	3	0	3	0.6706000000000001
最后的坦克大战	2021-06-08	1	3	0	1	0.6706000000000001
Chuhou Joutai 2: Paraided!	2021-07-02	2	3	0	2	0.6706000000000001
Children's Jigsaw Puzzles - Beautifully Illustrated	2021-05-27	2	3	0	2	0.6706000000000001
Protect the Earth	2021-09-20	2	3	0	2	0.6706000000000001
Last Boss -9x9 Action Battle-	2021-06-07	1	3	0	1	0.6706000000000001
Order Road	2021-08-05	2	3	0	2	0.6706000000000001
Another Eye	2021-06-05	2	3	0	2	0.6706000000000001
ChineseZodiac	2021-06-24	1	3	0	1	0.6706000000000001
Selection Process	2021-06-21	1	3	0	1	0.6706000000000001
INFEES	2021-06-22	3	3	0	3	0.6706000000000001
Rover Simulator	2021-09-03	3	3	0	3	0.6706000000000001
Abridged	2021-08-10	3	3	0	3	0.6706000000000001
Aeos: The 18 Plus NSFW Adventure Generator	2021-06-25	3	3	0	3	0.6706000000000001
Chicken Utopia	2021-08-06	1	3	0	1	0.6706000000000001
Short Hop Laser	2021-10-06	1	3	0	1	0.6706000000000001
GlassSmash 2	2021-08-27	2	3	0	2	0.6706000000000001
Grandmaster Chess	2021-09-03	3	3	0	3	0.6706000000000001
The Last Chimera	2021-07-01	2	3	0	2	0.6706000000000001
Nekoba RocknRoll	2021-06-30	2	3	0	2	0.6706000000000001
Party Host 85	2021-06-25	1	3	0	1	0.6706000000000001
Karanos Solitaire	2021-07-15	2	3	0	2	0.6706000000000001
The New Earth	2021-07-14	3	3	0	3	0.6706000000000001
Retrowave universe	2021-07-23	2	3	0	2	0.6706000000000001
The Tragedy of little Joy	2021-12-16	2	3	0	2	0.6706000000000001
ChibiClubTD	2021-09-14	2	3	0	2	0.6706000000000001
Pogo Rocket	2021-08-15	3	3	0	3	0.6706000000000001
Surface: Lost Tales Collector's Edition	2021-06-24	7	3	0	7	0.6706000000000001
Wing Chun Pak Sung Bo Legends	2021-08-24	2	3	0	2	0.6706000000000001
Knotfiction	2021-08-13	4	3	0	4	0.6706000000000001
Emotion	2021-07-27	1	3	0	1	0.6706000000000001
Sphere Arena	2021-08-17	9	3	0	9	0.6706000000000001
Dead-End Detective: The Sixpence Strangler	2021-07-21	1	3	0	1	0.6706000000000001
The Long Journey to Farewell	2021-09-21	3	3	0	3	0.6706000000000001
Glisten to your heart: The courage within you	2021-07-22	1	3	0	1	0.6706000000000001
TeleNovela	2021-07-30	1	3	0	1	0.6706000000000001
Fm45's Sprite Man Adventures	2021-08-03	1	3	0	1	0.6706000000000001
Spherical Trilogy	2021-07-28	2	3	0	2	0.6706000000000001
XOMBEE MPFPS	2021-07-29	5	3	0	5	0.6706000000000001
You Have to Play This Game	2021-11-26	2	3	0	2	0.6706000000000001
ヴァジアルサーガ愚民化戦略XX（ダブルエックス）	2021-09-02	11	3	0	11	0.6706000000000001
灵异AE	2021-08-19	3	3	0	3	0.6706000000000001
Magical Girls Second Magic	2021-10-01	3	3	0	3	0.6706000000000001
Captures	2021-08-26	2	3	0	2	0.6706000000000001
Air Hunter	2021-08-21	1	3	0	1	0.6706000000000001
MouthSimulater: MelonSeedsCracker	2021-08-24	2	3	0	2	0.6706000000000001
Holiday Jigsaw Halloween	2021-09-09	2	3	0	2	0.6706000000000001
Snakelaw Island	2021-10-25	2	3	0	2	0.6706000000000001
Mini Island: Autumn	2021-09-03	4	3	0	4	0.6706000000000001
Haunted Game	2021-11-05	1	3	0	1	0.6706000000000001
Aeternum Quest™	2021-11-05	2	3	0	2	0.6706000000000001
Deep Madness	2021-08-31	2	3	0	2	0.6706000000000001
Spellarium 7	2021-09-01	7	3	0	7	0.6706000000000001
Me Vs You	2021-09-24	2	3	0	2	0.6706000000000001
Plunger Simulator	2021-08-30	1	3	0	1	0.6706000000000001
BASIC ROGUE	2021-09-11	2	3	0	2	0.6706000000000001
MoveUp	2021-09-15	1	3	0	1	0.6706000000000001
World of MiniMonsters	2021-09-06	2	3	0	2	0.6706000000000001
Escape The Outbreak	2021-09-10	2	3	0	2	0.6706000000000001
Lucent Bounds	2021-11-24	2	3	0	2	0.6706000000000001
Captures II	2021-09-15	1	3	0	1	0.6706000000000001
Pathological Tires	2021-10-15	2	3	0	2	0.6706000000000001
Delta Zero	2021-12-24	3	3	0	3	0.6706000000000001
Fairy Godmother Stories: Miraculous Dream Collector's Edition	2021-09-03	9	3	0	9	0.6706000000000001
Too Many Humans	2021-11-04	3	3	0	3	0.6706000000000001
Neverspring Chronicles	2021-11-03	2	3	0	2	0.6706000000000001
Gazmatera 2: America's Least Wanted	2021-10-28	1	3	0	1	0.6706000000000001
Super Punchy Face	2021-11-06	1	3	0	1	0.6706000000000001
Table Gun	2021-10-18	1	3	0	1	0.6706000000000001
CyberWhiskey: Guy's Room	2021-10-05	2	3	0	2	0.6706000000000001
Treffen	2021-09-29	2	3	0	2	0.6706000000000001
FUUU...!	2021-10-20	1	3	0	1	0.6706000000000001
In The Valley of Death -Prologue-	2021-10-08	2	3	0	2	0.6706000000000001
Polyslime	2021-10-13	3	3	0	3	0.6706000000000001
大小串串烧	2021-10-31	4	3	0	4	0.6706000000000001
Splodge Royale	2021-12-20	2	3	0	2	0.6706000000000001
Second to Nun	2021-10-14	2	3	0	2	0.6706000000000001
Alien Age	2021-12-02	1	3	0	1	0.6706000000000001
Geo Zombies	2021-11-12	1	3	0	1	0.6706000000000001
找心脏 Find the heart	2021-10-18	1	3	0	1	0.6706000000000001
Mini Island: Winter	2021-11-01	3	3	0	3	0.6706000000000001
Saboteur	2021-10-30	5	3	0	5	0.6706000000000001
Helium Electric	2021-12-15	3	3	0	3	0.6706000000000001
Legend of Krilona	2021-11-09	1	3	0	1	0.6706000000000001
Unfair Souls: Darkest Grind	2021-11-30	2	3	0	2	0.6706000000000001
Bolt Action	2021-12-01	2	3	0	2	0.6706000000000001
Asteroids Extreme	2021-12-23	4	3	0	4	0.6706000000000001
Banzai Bat	2021-12-07	4	3	0	4	0.6706000000000001
虚空架构 	2021-12-15	2	3	0	2	0.6706000000000001
Cursed House 10	2021-11-25	7	3	0	7	0.6706000000000001
Creator's Asteroid	2021-12-22	2	3	0	2	0.6706000000000001
The Happy Dismal Town	2021-12-21	3	3	0	3	0.6706000000000001
sol3000	2021-12-30	3	3	0	3	0.6706000000000001
Space Extra	2021-12-19	1	3	0	1	0.6706000000000001
Shrumblo and the Magical Grumblo	2021-12-30	2	3	0	2	0.6706000000000001
69 Cindy Love	2021-08-13	7	38	13	20	0.6705
GRAVEN	2021-05-26	639	482	209	848	0.67
Within the Range	2021-07-28	28	144	58	86	0.6698999999999999
World's End Club	2021-11-30	39	100	39	78	0.6698999999999999
DIY MY LADY IN VR WORLD	2021-02-11	4	67	25	29	0.6698999999999999
Slotracers VR	2021-03-04	4	12	3	7	0.6698000000000001
Unfolded : Camellia Tales	2021-03-24	6	12	3	9	0.6698000000000001
SMFly: Ice Age	2021-02-18	6	12	3	9	0.6698000000000001
Burg Battle	2021-03-22	5	12	3	8	0.6698000000000001
Elemental	2021-03-30	4	12	3	7	0.6698000000000001
Planeta	2021-01-15	3	12	3	6	0.6698000000000001
Y.E.T.I	2021-01-30	2	12	3	5	0.6698000000000001
KING PONG	2021-02-18	8	12	3	11	0.6698000000000001
Vamp Night	2021-01-26	2	12	3	5	0.6698000000000001
aMAZE Gears 3	2021-02-18	3	12	3	6	0.6698000000000001
Goddess Of War Ashley	2021-03-25	3	12	3	6	0.6698000000000001
-A-	2021-05-20	2	12	3	5	0.6698000000000001
The Dream is Coming...	2021-05-03	3	12	3	6	0.6698000000000001
Pegasus: Broken Wings	2021-09-15	5	12	3	8	0.6698000000000001
Animal Defense Versus	2021-11-04	15	12	3	18	0.6698000000000001
Thrice in a row: A new adventure	2021-06-28	2	12	3	5	0.6698000000000001
Yummy Mahjong	2021-07-29	2	12	3	5	0.6698000000000001
Mummy, mummy, mummy!	2021-08-25	4	12	3	7	0.6698000000000001
Mysterious warrior	2021-09-02	5	12	3	8	0.6698000000000001
Brave Doggy Quest	2021-11-12	3	12	3	6	0.6698000000000001
Labyrinth of death	2021-12-07	5	12	3	8	0.6698000000000001
Plokoth	2021-07-09	220	212	88	308	0.6696
HUMANKIND™	2021-08-17	55284	14743	6992	62276	0.6695000000000001
Trailer Shop Simulator	2021-07-21	32	109	43	75	0.6694
Amazing Pyramids: Rebirth	2021-01-14	4	20	6	10	0.6694
AV Company	2021-01-24	9	20	6	15	0.6694
Cargo Transportation: Low Poly 	2021-01-13	3	20	6	9	0.6694
Gate to Site 8	2021-09-09	3	20	6	9	0.6694
Hyposphere Z	2021-03-22	2	20	6	8	0.6694
Not It: Spookiest Edition	2021-10-12	5	20	6	11	0.6694
Pascal's Wager: Definitive Edition	2021-03-12	624	727	322	946	0.6693000000000001
Frontier Pilot Simulator	2021-12-07	130	562	247	377	0.6688
游戏开发的二三事	2021-06-24	89	222	93	182	0.6686
POG	2021-04-27	3	25	8	11	0.6685
Aussie Clowns At War	2021-12-15	6	25	8	14	0.6685
Higher Critters - 1v4	2021-06-25	131	35	12	143	0.6684
Touhou Double Focus	2021-05-25	37	52	19	56	0.6683
TwoGuysOneCabin	2021-01-25	2	52	19	21	0.6683
Bite Sized Puzzle	2021-05-29	4	30	10	14	0.6683
Ghost blood	2021-09-22	6	30	10	16	0.6683
SafeZoneVR	2021-08-31	9	30	10	19	0.6683
Froggy	2021-10-31	49	30	10	59	0.6683
XERA: Survival	2021-09-27	3079	4755	2231	5310	0.6681
副作用之瞳 (Tlicolity Eyes)	2021-06-30	67	85	33	100	0.6681
Icarus	2021-12-03	52501	20068	9622	62123	0.668
Noch	2021-05-19	18	101	40	58	0.6677
Horny Housewives Booty Call Blackmail	2021-07-16	24	47	17	41	0.6677
Super Arcade Football	2021-09-06	17	133	54	71	0.6676000000000001
Ice Demon	2021-01-07	3	9	2	5	0.6676000000000001
Cyber Lemur	2021-09-15	4	9	2	6	0.6676000000000001
Trix and the Horny Tower	2021-04-01	11	9	2	13	0.6676000000000001
CRASH: Autodrive	2021-04-20	2	9	2	4	0.6676000000000001
Midjungard	2021-11-22	14	9	2	16	0.6676000000000001
Sweet Pea	2021-04-20	2	9	2	4	0.6676000000000001
Super Walrus Entertainment System	2021-05-06	2	9	2	4	0.6676000000000001
Nominal	2021-02-09	8	9	2	10	0.6676000000000001
All is Fair in Dust and Air	2021-09-21	2	9	2	4	0.6676000000000001
My House My Rules	2021-03-05	2	9	2	4	0.6676000000000001
Symphony of Delights	2021-01-24	3	9	2	5	0.6676000000000001
Balance Ball	2021-04-28	4	9	2	6	0.6676000000000001
4 Witch Seasons & Convenant	2021-09-30	2	9	2	4	0.6676000000000001
Out Of The Shelter	2021-03-21	53	9	2	55	0.6676000000000001
Captain Coffer 2D	2021-04-06	4	9	2	6	0.6676000000000001
Easy Quiz	2021-03-24	2	9	2	4	0.6676000000000001
Mini Island: Spring	2021-03-19	9	9	2	11	0.6676000000000001
Battle Royale Craft	2021-03-23	3	9	2	5	0.6676000000000001
狗蛋神冒险	2021-04-23	2	9	2	4	0.6676000000000001
Dangerous Chris	2021-04-10	1	9	2	3	0.6676000000000001
Mind-Blowing Girls 2	2021-04-15	3	9	2	5	0.6676000000000001
Rekindle	2021-09-25	5	9	2	7	0.6676000000000001
Bub Block	2021-06-02	7	9	2	9	0.6676000000000001
B-17 Flying Fortress: World War II Bombers in Action	2021-11-19	7	9	2	9	0.6676000000000001
The Play's the Thing	2021-08-26	16	9	2	18	0.6676000000000001
Lounge zone	2021-08-19	1	9	2	3	0.6676000000000001
World of bombs	2021-08-18	4	9	2	6	0.6676000000000001
Roseblight	2021-09-25	7	9	2	9	0.6676000000000001
Everlife	2021-10-08	3	9	2	5	0.6676000000000001
Stella's Spikey Dream	2021-11-08	4	9	2	6	0.6676000000000001
Slot Idler	2021-11-20	9	9	2	11	0.6676000000000001
Bavity	2021-12-01	4	9	2	6	0.6676000000000001
2048 3D	2021-12-15	3	9	2	5	0.6676000000000001
Sphere Game Epic	2021-12-27	2	9	2	4	0.6676000000000001
Dice Legacy	2021-09-09	1591	603	268	1859	0.6673
Ultimate Tag	2021-12-02	59	126	51	110	0.6673
Warbox	2021-03-22	142	1720	792	934	0.6672
Creatura	2021-03-31	26	96	38	64	0.667
Into the Pit	2021-10-19	141	112	45	186	0.6668999999999999
Key To Heaven	2021-04-23	162	105	42	204	0.6667000000000001
DesktopMMD3:Miss Fish	2021-01-22	137	175	73	210	0.6666
Battle Cat vs Treacherous Mice	2021-04-16	5	17	5	10	0.6666
BETRAYER: Curse of the Spine - Prologue	2021-07-27	5	17	5	10	0.6666
Lamp Chronicle	2021-01-21	14	49	18	32	0.6664
Woman's Prison	2021-10-13	265	329	143	408	0.6662
Album Corvus	2021-05-21	3	6	1	4	0.6662
SPAGHET 2	2021-01-01	4	6	1	5	0.6662
RoboBunnies In Space!	2021-02-18	2	6	1	3	0.6662
Furs of Fury	2021-07-17	21	6	1	22	0.6662
Naked Little Dude	2021-10-28	2	6	1	3	0.6662
Smashroom	2021-01-22	2	6	1	3	0.6662
Alpha Particle	2021-04-28	2	6	1	3	0.6662
MushrooMonster	2021-04-29	2	6	1	3	0.6662
Blobkin Blaster	2021-08-19	1	6	1	2	0.6662
Super Neo Tanks	2021-01-28	4	6	1	5	0.6662
Klomanager - Hochgewürgt	2021-10-15	7	6	1	8	0.6662
Citizens Unite!: Earth x Space	2021-01-28	6	6	1	7	0.6662
Princess Daphne and the Orcs	2021-04-02	5	6	1	6	0.6662
Shell Shuffle	2021-04-01	3	6	1	4	0.6662
A Knight Never Yields	2021-02-25	2	6	1	3	0.6662
Project Entertainment System	2021-02-26	3	6	1	4	0.6662
The Worst Game Ever	2021-01-02	6	6	1	7	0.6662
M.A.I.D.s	2021-06-25	4	6	1	5	0.6662
Tin Tandem	2021-06-24	2	6	1	3	0.6662
Cosmic Magus	2021-04-10	2	6	1	3	0.6662
Bog Lord	2021-02-05	3	6	1	4	0.6662
Scramble	2021-03-01	3	6	1	4	0.6662
You Are Weak	2021-10-20	1	6	1	2	0.6662
Toewr le Fence	2021-03-24	2	6	1	3	0.6662
Boxed-In	2021-12-10	3	6	1	4	0.6662
Fluffy Gore	2021-05-28	5	6	1	6	0.6662
Angkor: Runefall	2021-01-25	5	6	1	6	0.6662
Primeval	2021-02-01	91	6	1	92	0.6662
Tiny Defender	2021-02-11	3	6	1	4	0.6662
STOP AND MOVE	2021-01-25	2	6	1	3	0.6662
Manic Archers	2021-03-03	4	6	1	5	0.6662
BoomXR	2021-08-12	2	6	1	3	0.6662
Broken Dungeon	2021-04-20	2	6	1	3	0.6662
Football Academy Clicker	2021-08-19	3	6	1	4	0.6662
Princess Tier:First episode	2021-03-22	1	6	1	2	0.6662
Escape Underground	2021-11-05	2	6	1	3	0.6662
Colossus Mission	2021-03-08	2	6	1	3	0.6662
王国英雄志 Kingdom and hero	2021-03-10	5	6	1	6	0.6662
Combat Chess	2021-02-23	3	6	1	4	0.6662
Another Warfare	2021-03-11	2	6	1	3	0.6662
StarStruck	2021-06-01	3	6	1	4	0.6662
Dominating the skies	2021-03-26	2	6	1	3	0.6662
Bouncy Cloud	2021-07-27	3	6	1	4	0.6662
Slime Dungeon Escape	2021-04-27	4	6	1	5	0.6662
Contact Me	2021-04-08	2	6	1	3	0.6662
Ghost Cash Collect	2021-04-16	4	6	1	5	0.6662
Kanojo xx Switch	2021-04-06	2	6	1	3	0.6662
Kupechestvo	2021-11-14	3	6	1	4	0.6662
Cliffhanger: Challenger of Tomorrow	2021-11-24	17	6	1	18	0.6662
Bridge to Another World: Endless Game Collector's Edition	2021-04-30	7	6	1	8	0.6662
Hold The Dots!	2021-06-09	1	6	1	2	0.6662
Orbital Defence Command	2021-08-07	5	6	1	6	0.6662
Flaskoman	2021-10-02	1	6	1	2	0.6662
Wilford - Deep Underground	2021-06-15	2	6	1	3	0.6662
Grim Tales: Threads of Destiny Collector's Edition	2021-06-04	9	6	1	10	0.6662
Amneron's Legacy	2021-06-17	3	6	1	4	0.6662
Erotic Jigsaw Puzzle 4	2021-06-18	2	6	1	3	0.6662
Tiny Gods Of The Nile	2021-11-29	5	6	1	6	0.6662
CubeCube	2021-12-16	2	6	1	3	0.6662
Demon Sighting	2021-11-15	3	6	1	4	0.6662
Doodle Art: Drawing Games	2021-12-06	3	6	1	4	0.6662
Mind-Blowing Girls 3	2021-08-17	2	6	1	3	0.6662
Cattle 101 Library Sampler	2021-11-22	2	6	1	3	0.6662
CAGE-FACE | Case 2: The Sewer	2021-10-25	4	6	1	5	0.6662
DOGS.IO	2021-09-19	3	6	1	4	0.6662
FishWitch Halloween	2021-10-25	4	6	1	5	0.6662
Puzzle Art: Dogs	2021-09-30	3	6	1	4	0.6662
Sniper Road	2021-11-25	2	6	1	3	0.6662
The Cruise	2021-10-04	2	6	1	3	0.6662
Seditionis Crutarch Royale	2021-10-14	3	6	1	4	0.6662
Alone In The Mars	2021-11-10	2	6	1	3	0.6662
Monster Adventure	2021-10-20	2	6	1	3	0.6662
Cyndefense 2	2021-10-25	2	6	1	3	0.6662
Doomsday Scavenger | 末日清道夫	2021-12-10	3	6	1	4	0.6662
HOGuru Presents: The House With Too Many Zombies In It	2021-12-07	3	6	1	4	0.6662
Noobkillers	2021-12-28	3	6	1	4	0.6662
DOOM DAY	2021-11-25	2	6	1	3	0.6662
Fatal Paws	2021-11-26	2	6	1	3	0.6662
Maze Art: Brown	2021-12-02	2	6	1	3	0.6662
Huygens Principle	2021-12-13	3	6	1	4	0.6662
Elements of Dreams	2021-12-28	2	6	1	3	0.6662
Pixel Game Maker Series MEDIUM-NAUT	2021-12-22	10	6	1	11	0.6662
Jet Fighters with Friends (Multiplayer)	2021-12-29	11	6	1	12	0.6662
Infinity Kingdom	2021-07-02	531	311	135	666	0.6659
Furry Pride	2021-05-22	4	118	48	52	0.6657
Tourney	2021-11-04	21	27	9	30	0.6657
Masochistic Elves from Another World	2021-09-10	16	27	9	25	0.6657
Internet Court	2021-04-06	5	22	7	12	0.6657
Shanghai1920	2021-07-20	6	22	7	13	0.6657
Lucid Cycle	2021-02-19	4	44	16	20	0.6656000000000001
SEARCH ALL - ANIMALS	2021-10-19	3	44	16	19	0.6656000000000001
TOGETHER BnB	2021-04-09	4241	4003	1898	6139	0.6653
Swords of Legends Online	2021-07-09	18806	3875	1836	20642	0.6653
Moonglow Bay	2021-10-26	298	242	104	402	0.6651
巨龙召唤	2021-01-18	215	65	25	240	0.6651
Many Bricks Breaker	2021-04-30	24	65	25	49	0.6651
Hunter Girls	2021-08-07	7	58	22	29	0.6651
Ancient Abyss	2021-01-15	161	131	54	215	0.6648999999999999
Legacy of Sin the father sacrifice	2021-10-20	4	39	14	18	0.6648999999999999
真砂楼	2021-03-26	39	39	14	53	0.6648999999999999
Jacob The Farmer	2021-04-15	6	39	14	20	0.6648999999999999
Andor - the Cards of Wonder	2021-04-15	13	74	29	42	0.6645000000000001
Super Squad	2021-06-25	35	74	29	64	0.6645000000000001
Until the Last Plane	2021-03-04	73	74	29	102	0.6645000000000001
The Glade	2021-11-16	9	46	17	26	0.6643000000000001
Night Book	2021-07-27	73	269	117	190	0.6641
Tactical Troops: Anthracite Shift	2021-04-15	16	34	12	28	0.6641
Fractal Fury	2021-04-04	38	101	41	79	0.6638
Maquette	2021-03-02	211	357	158	369	0.6637000000000001
Fleeting Iris	2021-04-24	459	320	141	600	0.6635
Junkyard Simulator: First Car (Prologue 2)	2021-03-31	180	322	142	322	0.6634000000000001
Shadowbane	2021-02-06	692	296	130	822	0.6634000000000001
Mental Hospital VR	2021-02-11	5	41	15	20	0.6634000000000001
Touhou DollDraft	2021-08-13	58	29	10	68	0.6633
Project Grove: Prologue	2021-09-11	11	29	10	21	0.6633
Cream Me	2021-06-24	3	14	4	7	0.6633
Hero Among Us	2021-02-26	7	14	4	11	0.6633
A Hole In Space	2021-02-04	3	14	4	7	0.6633
CHACAL	2021-02-19	2	14	4	6	0.6633
Active Mummy	2021-02-28	2	14	4	6	0.6633
ROUGH KUTS: Night of the Living Dead	2021-03-23	3	14	4	7	0.6633
True Spring Love	2021-03-19	3	14	4	7	0.6633
Carrot Girl Adventures	2021-09-02	2	14	4	6	0.6633
Match Three Pirates II	2021-12-16	8	14	4	12	0.6633
No Tyrant	2021-10-13	17	14	4	21	0.6633
Lab Bio-Terror	2021-12-01	3	14	4	7	0.6633
3D Hentai SeaBattle	2021-12-15	3	14	4	7	0.6633
Under Lock	2021-01-12	31	55	21	52	0.6631999999999999
Innocence Or Money - Prelude	2021-10-01	336	254	111	447	0.6628000000000001
Brave Hand	2021-08-06	30	24	8	38	0.6627
AnShi	2021-02-22	4	24	8	12	0.6627
Martha	2021-02-08	4	24	8	12	0.6627
Bro, where is my head???	2021-03-25	7	24	8	15	0.6627
Destruction Time!	2021-07-27	4	24	8	12	0.6627
Harvested	2021-03-20	6	19	6	12	0.6625
Speedy Gun Savage	2021-04-08	3	19	6	9	0.6625
Inside My Mind	2021-04-13	4	19	6	10	0.6625
My Lovely Noblewomen	2021-05-20	3	19	6	9	0.6625
Smithy Wars	2021-07-31	4	19	6	10	0.6625
GhostHunter	2021-12-10	11	19	6	17	0.6625
Sunny Beach Dolls	2021-12-24	6	19	6	12	0.6625
Among Waifus 18+	2021-12-17	44	221	96	140	0.6624
Underwater	2021-07-13	8	50	19	27	0.6620999999999999
Hentai Coloring Game	2021-01-08	10	43	16	26	0.6620999999999999
Anima : The Reign of Darkness	2021-06-02	276	390	175	451	0.662
First Class Escape: The Train of Thought	2021-09-17	100	188	81	181	0.662
Shades of Sakura	2021-07-22	289	302	134	423	0.6618
Gravewood High	2021-10-20	2891	325	145	3036	0.6615000000000001
开心扑克Happy Poker	2021-06-10	46	308	137	183	0.6615000000000001
The Lightbringer	2021-10-07	14	31	11	25	0.6614
MY FOX - Desktop Wild Pet	2021-06-23	100	31	11	111	0.6614
Battle of Hunters : Beast Zone	2021-03-02	45	52	20	65	0.6611
Escapeworld Dilemma	2021-01-29	9	45	17	26	0.6609
Click Quest	2021-04-30	6	45	17	23	0.6609
Dark Treasury	2021-02-01	6	38	14	20	0.6609
Dream Girls Collection	2021-08-27	11	54	21	32	0.6603
Echo of Ayllu	2021-10-15	11	26	9	20	0.6603
69 Hitomi Love	2021-09-29	6	26	9	15	0.6603
Ghoul Castle 3D: Gold Edition	2021-11-30	3	26	9	12	0.6603
Pro Basketball Manager 2022	2021-11-15	60	90	37	97	0.6602
Evil Genius 2	2021-03-31	37117	7070	3477	40594	0.6598999999999999
Necromunda: Hired Gun	2021-05-31	5497	3950	1927	7424	0.6595000000000001
Rebirth2:Beware of Mr.Wang	2021-09-30	1883	1455	694	2577	0.6595000000000001
Hot Pot For One 	2021-06-12	10	105	44	54	0.6594
Helios	2021-07-16	37	65	26	63	0.6594
Azure Sky	2021-01-25	6	21	7	13	0.6593000000000001
RASPBERRY MASH	2021-03-24	12	21	7	19	0.6593000000000001
VR Masturbate	2021-04-01	4	21	7	11	0.6593000000000001
Spoils of Plunder	2021-08-31	7	11	3	10	0.6593000000000001
Portal Dungeon: Goblin Escape	2021-11-01	6	11	3	9	0.6593000000000001
Seeker: My Shadow	2021-08-12	3	11	3	6	0.6593000000000001
Epocria	2021-07-14	3	11	3	6	0.6593000000000001
末日杀	2021-06-04	5	11	3	8	0.6593000000000001
Dispersio 2	2021-01-21	8	11	3	11	0.6593000000000001
Elon's Dream 2	2021-01-07	3	11	3	6	0.6593000000000001
Warriors Of Titus - F2P	2021-01-22	6	11	3	9	0.6593000000000001
Anna The Series Test	2021-05-10	7	11	3	10	0.6593000000000001
Destroyer of Worlds	2021-03-16	4	11	3	7	0.6593000000000001
JUNK	2021-04-25	10	11	3	13	0.6593000000000001
Abarenbo Tengu & Zombie Nation	2021-10-27	6	11	3	9	0.6593000000000001
Scampr	2021-06-07	3	11	3	6	0.6593000000000001
東方3Dダンジョン	2021-07-08	3	11	3	6	0.6593000000000001
Devils Gold	2021-08-27	3	11	3	6	0.6593000000000001
Jigsaw Frame: Relax	2021-08-07	11	11	3	14	0.6593000000000001
Shawarma or Shaverma	2021-09-04	2	11	3	5	0.6593000000000001
Bad animals - rabbit	2021-10-22	4	11	3	7	0.6593000000000001
Princess Maira: Initiation	2021-10-22	3	11	3	6	0.6593000000000001
重装燎原	2021-12-03	6	11	3	9	0.6593000000000001
知更鸟-The Robin	2021-11-02	5	11	3	8	0.6593000000000001
Dune Girls Attack!	2021-11-27	2	11	3	5	0.6593000000000001
Epic Tower for Tireless Lovers	2021-12-18	5	11	3	8	0.6593000000000001
Propnight	2021-12-01	6919	11406	5664	12583	0.6592
Reactor Tech²	2021-08-31	49	215	95	144	0.6592
A Way To Be Dead	2021-07-23	35	67	27	62	0.6587000000000001
Beside Myself	2021-07-27	15	163	71	86	0.6586
Chicken Holmes - Chanislavksi Whispers	2021-06-17	2	16	5	7	0.6586
Pretty Girls Breakout!	2021-09-29	5	16	5	10	0.6586
TripSync	2021-12-01	7	16	5	12	0.6586
Mines of Frostheim	2021-12-17	11	16	5	16	0.6586
Do U Copy?	2021-12-09	3	16	5	8	0.6586
Endless Furry Ping-Pong	2021-04-13	4	42	16	20	0.6585
The Night Way Home | 帰り道	2021-08-07	164	165	72	236	0.6584000000000001
Peekaboo Lite	2021-03-04	19	124	53	72	0.6584000000000001
Crash the Core	2021-11-26	15	35	13	28	0.6581999999999999
地牢勇者(dungeon & heros)	2021-03-04	10	35	13	23	0.6581999999999999
Neko Hacker+	2021-09-20	7	35	13	20	0.6581999999999999
打工人的十日女友 My Ten-day Girlfriend	2021-02-04	25	51	20	45	0.6581
Hatch	2021-10-22	9	51	20	29	0.6581
Airline Manager 4	2021-06-23	359	725	341	700	0.658
DRINK BAR MAID -REGRESSION-	2021-02-13	11	80	33	44	0.658
NARAKA: BLADEPOINT	2021-08-12	187468	114786	58633	246101	0.6576000000000001
Last Room	2021-06-14	2007	270	122	2129	0.6575
BIOMUTANT	2021-05-25	55048	11590	5808	60856	0.6574
Heroes of Eldemor	2021-05-25	12	53	21	33	0.6573000000000001
MazM: The Phantom of the Opera	2021-03-25	11	37	14	25	0.6569
Ionia	2021-09-23	13	64	26	39	0.6568
The Commission 1920	2021-02-11	18	23	8	26	0.6567000000000001
Euclyca	2021-04-01	8	23	8	16	0.6567000000000001
Dome Discover	2021-06-11	12	23	8	20	0.6567000000000001
DancingReaper	2021-06-07	9	23	8	17	0.6567000000000001
星月之歌2	2021-09-24	16	23	8	24	0.6567000000000001
LOST BUBBLES: Sweet mates	2021-11-13	136	46	18	154	0.6565000000000001
Block Dungeon	2021-02-19	10	30	11	21	0.6565000000000001
King under the Mountain	2021-11-24	113	90	38	151	0.6561
玄女诛魔录	2021-10-10	14	192	86	100	0.6557
Hired Ops	2021-04-13	1835	8911	4490	6325	0.6555
Booobjz	2021-02-28	4	18	6	10	0.6551
Underlings	2021-05-21	7	18	6	13	0.6551
Ciel Nosurge -Ushinawareta Hoshi e Sasagu Uta- DX	2021-03-04	118	18	6	124	0.6551
Second Star: Prelude	2021-04-14	5	18	6	11	0.6551
Lionfish Reef Patrol	2021-04-02	6	18	6	12	0.6551
HuGe	2021-07-27	5	18	6	11	0.6551
Traffic Racing	2021-11-12	3	18	6	9	0.6551
MilkChoco	2021-12-21	295	645	307	602	0.655
Tokyo Detectives	2021-12-30	17	32	12	29	0.655
Мафия Онлайн: Дикий Запад	2021-03-20	85	235	107	192	0.6548999999999999
DarkHouse	2021-12-01	4	25	9	13	0.6546
团长别生气	2021-08-06	74	74	31	105	0.6545000000000001
Magical Battle Cry	2021-02-08	181	651	311	492	0.6544
Futanari Quest	2021-02-10	57	199	90	147	0.6544
The Immortal Mayor	2021-07-15	3232	1724	848	4080	0.6543000000000001
Wall Force	2021-02-28	110	8	2	112	0.6542
Berserker	2021-02-26	2	8	2	4	0.6542
Operation DogFight	2021-10-13	7	8	2	9	0.6542
Rugida	2021-02-26	4	8	2	6	0.6542
Voodoo Kid	2021-04-20	4	8	2	6	0.6542
Adapted Adventures: Crystal Cave	2021-01-12	3	8	2	5	0.6542
Tip Top	2021-06-01	3	8	2	5	0.6542
Detective notes. Lighthouse Mystery Solitaire	2021-03-03	7	8	2	9	0.6542
Quintaesencia	2021-03-05	3	8	2	5	0.6542
Shonen Adventure : The Dual Blades Hero	2021-12-23	5	8	2	7	0.6542
LineArt Jigsaw Puzzle - Erotica Valentines	2021-03-05	2	8	2	4	0.6542
Sweep	2021-03-20	2	8	2	4	0.6542
Marble Muse Arcade	2021-05-10	2	8	2	4	0.6542
The Simplest Game	2021-05-05	1	8	2	3	0.6542
Bunny Factory	2021-06-02	5	8	2	7	0.6542
Fish. Love. Danger.	2021-12-18	3	8	2	5	0.6542
The night of fire stealing 2/盗火之夜2	2021-05-25	4	8	2	6	0.6542
Retrowave Road	2021-05-08	2	8	2	4	0.6542
Rift Drifter	2021-05-31	6	8	2	8	0.6542
Hyde & Seek	2021-06-08	8	8	2	10	0.6542
Nightwalker 2	2021-11-16	4	8	2	6	0.6542
Topper Carrier	2021-06-11	2	8	2	4	0.6542
Tukki & Champ	2021-10-21	3	8	2	5	0.6542
Toilet paper wants to be a basketball	2021-06-18	8	8	2	10	0.6542
Dress-up Pups	2021-06-24	3	8	2	5	0.6542
OnlyGame: Athlete girls	2021-07-23	4	8	2	6	0.6542
Arcano: The Trickery	2021-09-23	3	8	2	5	0.6542
Wolf Attack	2021-09-06	4	8	2	6	0.6542
Savior of Light 	2021-10-15	7	8	2	9	0.6542
Friends of little Yus	2021-09-27	5	8	2	7	0.6542
Edgar's Room	2021-10-12	3	8	2	5	0.6542
Frontier of Fortune	2021-10-20	7	8	2	9	0.6542
그랑 엠파이어 : 아마네	2021-10-27	5	8	2	7	0.6542
New Lands	2021-12-24	8	8	2	10	0.6542
150+ Card Games Solitaire Pack	2021-12-01	15	8	2	17	0.6542
Pussy Palace	2021-11-25	2	8	2	4	0.6542
Alone With You	2021-12-04	3	8	2	5	0.6542
Anime Jigsaw Girls - Christmas	2021-11-13	2	8	2	4	0.6542
死亡编码-Death Code	2021-12-08	7	8	2	9	0.6542
Midnight Driver	2021-12-20	13	91	39	52	0.6539
QUICAL	2021-02-23	29	13	4	33	0.6537999999999999
HexiHashi	2021-01-19	4	13	4	8	0.6537999999999999
Rift Runner	2021-07-31	21	13	4	25	0.6537999999999999
Vermitron	2021-01-23	3	13	4	7	0.6537999999999999
Quiet Thoughts	2021-04-02	3	13	4	7	0.6537999999999999
1000 Shards	2021-01-22	2	13	4	6	0.6537999999999999
BlackJack Math Cross Numbers	2021-09-22	2	13	4	6	0.6537999999999999
Merchants of the Caribbean	2021-03-04	8	13	4	12	0.6537999999999999
Galaxy Arena	2021-04-03	3	13	4	7	0.6537999999999999
Christmas Stories: The Gift of the Magi Collector's Edition	2021-03-26	15	13	4	19	0.6537999999999999
Gallantry	2021-06-25	3	13	4	7	0.6537999999999999
Reknum Cheri Dreamland	2021-04-29	3	13	4	7	0.6537999999999999
Cards of the Dead - Prologue	2021-10-14	6	13	4	10	0.6537999999999999
OFFICESCAPE	2021-08-02	3	13	4	7	0.6537999999999999
Battle tops	2021-10-15	9	13	4	13	0.6537999999999999
Mistral	2021-09-30	15	13	4	19	0.6537999999999999
Lawnmower Game: Pinball	2021-11-17	4	13	4	8	0.6537999999999999
Day After Day	2021-11-18	4	13	4	8	0.6537999999999999
Fears of Glasses o-o	2021-11-04	5	13	4	9	0.6537999999999999
Jo-Jo Fighter	2021-11-20	4	13	4	8	0.6537999999999999
Firelight Fantasy: Phoenix Crew	2021-08-16	10	34	13	23	0.6537000000000001
Project Lounge	2021-07-09	668	54	22	690	0.6536
Wyvern	2021-03-09	45	69	29	74	0.6529
Project Terminus VR	2021-03-04	10	27	10	20	0.6529
Key Escape	2021-02-21	3	27	10	13	0.6529
Slaughterhouse	2021-04-27	5	27	10	15	0.6529
Rage Quit: The Beginning!	2021-08-13	18	27	10	28	0.6529
OUTRIDERS	2021-04-01	125143	38708	20064	145207	0.6528
To The Rescue!	2021-11-02	575	1017	497	1072	0.6528
Collapse: A Political Simulator	2021-02-23	1226	101	44	1270	0.6527
Usurper: Soulbound	2021-11-02	12	36	14	26	0.6526000000000001
Castlehold	2021-03-03	99	58	24	123	0.6525
Hell of Men : Blood Brothers	2021-06-29	6	20	7	13	0.6525
Warlike	2021-06-10	4	20	7	11	0.6525
Dungless	2021-07-02	5	20	7	12	0.6525
Machine Ruin Self-Destruction Masturbation Life of the Sky Temple	2021-12-09	6	20	7	13	0.6525
Faraway: Director's Cut	2021-03-05	12	47	19	31	0.6523000000000001
Skid Cities	2021-02-25	19	47	19	38	0.6523000000000001
GodGirl	2021-02-17	14	49	20	34	0.6517000000000001
Mini Countries	2021-02-12	24	38	15	39	0.6517000000000001
Chang'an of Tang Dynasty	2021-05-13	13	38	15	28	0.6517000000000001
Town Of The Dead Life 死寂之城	2021-01-13	209	113	50	259	0.6516
Coronation	2021-10-01	19	62	26	45	0.6516
Valor & Victory	2021-06-17	60	96	42	102	0.6514
Eternal Quest	2021-08-27	128	96	42	170	0.6514
Harem Hunter: Sex-ray Vision	2021-01-15	53	96	42	95	0.6514
Battle Cube	2021-09-24	9	29	11	20	0.6514
Romance after dark	2021-12-16	57	29	11	68	0.6514
"Imperivm RTC - HD Edition ""Great Battles of Rome"""	2021-08-16	337	513	247	584	0.6513
契约唤灵师	2021-11-10	177	119	53	230	0.6512000000000001
EVERSLAUGHT	2021-07-31	36	232	108	144	0.6508
S.W.A.N.: Chernobyl Unexplored	2021-04-26	10	40	16	26	0.6508
Terra Alia	2021-05-14	21	53	22	43	0.6506000000000001
Guardian Chronicle	2021-03-25	889	678	331	1220	0.6505
Edge Of Galaxy	2021-07-22	3	22	8	11	0.6503
Big Larry	2021-12-03	4	22	8	12	0.6503
Nuumonsters	2021-02-18	6	22	8	14	0.6503
Cuboid Bouncer	2021-06-04	7	22	8	15	0.6503
Cardaclysm	2021-02-26	177	320	152	329	0.6501
Atomic Society	2021-08-09	253	374	179	432	0.65
Jurisdiction	2021-03-02	8	15	5	13	0.65
XPock	2021-02-27	4	15	5	9	0.65
Eviron's Chronicles	2021-04-22	8	15	5	13	0.65
Childhood Friends	2021-04-16	10	15	5	15	0.65
Rise of the Slime: Prologue	2021-05-06	14	15	5	19	0.65
Occupation 2.5	2021-07-20	3	15	5	8	0.65
孑游列国	2021-07-14	8	15	5	13	0.65
Cursed Dungeon	2021-10-15	6	15	5	11	0.65
Simkea	2021-12-01	6	15	5	11	0.65
Back 4 Blood	2021-10-12	65987	30191	15839	81826	0.6497
just a game to test your lQ	2021-03-22	58	202	94	152	0.6496
Tiny Tina's Assault on Dragon Keep: A Wonderlands One-shot Adventure	2021-11-09	7202	1234	617	7819	0.6494
Wild Wet West	2021-12-24	56	97	43	99	0.6494
Element Quest	2021-11-24	30	76	33	63	0.6493000000000001
Wall of insanity	2021-08-19	8	33	13	21	0.6492
Revn	2021-11-08	29	46	19	48	0.6489
BioBots	2021-12-26	75	46	19	94	0.6489
Midnight Mahjong	2021-11-20	101	138	63	164	0.6487999999999999
Soer Dolls	2021-07-02	3	24	9	12	0.6487
TramSim Munich	2021-11-04	431	325	156	587	0.6483
Lost in Dungeon	2021-02-12	13	48	20	33	0.6483
Misery Mansion	2021-01-19	8	48	20	28	0.6483
桃夭塔 Taoyaota	2021-05-27	18	35	14	32	0.6483
Jack Axe	2021-10-06	18	67	29	47	0.648
Warhammer Age of Sigmar: Tempestfall	2021-11-17	56	127	58	114	0.6478
Struggle For Talyria	2021-07-02	3	5	1	4	0.6478
Floogen	2021-05-05	3	5	1	4	0.6478
Stephino RPG	2021-07-16	3	5	1	4	0.6478
ShotKill	2021-06-21	4	5	1	5	0.6478
Emperium	2021-04-27	4	5	1	5	0.6478
Miriel Saga	2021-08-02	2	5	1	3	0.6478
URG	2021-02-02	3	5	1	4	0.6478
Burst Planet	2021-03-30	14	5	1	15	0.6478
Gamitate - Meditate, Relax, Feel Better	2021-05-10	2	5	1	3	0.6478
Reginald's Death Arena	2021-06-24	5	5	1	6	0.6478
Chibi Horror: The School	2021-01-27	2	5	1	3	0.6478
逃离地球	2021-05-06	3	5	1	4	0.6478
Memories of Tomorrow	2021-01-26	2	5	1	3	0.6478
WordTactics	2021-01-01	3	5	1	4	0.6478
Bedroom Blackjack	2021-08-31	2	5	1	3	0.6478
Red Hands	2021-01-30	3	5	1	4	0.6478
Pangea	2021-11-17	2	5	1	3	0.6478
pleXus	2021-01-07	2	5	1	3	0.6478
Death off the Cuff	2021-01-11	2	5	1	3	0.6478
Debatto: Delivery Battle	2021-03-31	5	5	1	6	0.6478
StreamSavers	2021-01-20	3	5	1	4	0.6478
16-Bit Soccer	2021-01-07	3	5	1	4	0.6478
Halloween Night Mahjong	2021-02-01	4	5	1	5	0.6478
3D辉针城	2021-09-30	3	5	1	4	0.6478
Der Blaue Diamant	2021-01-01	2	5	1	3	0.6478
Madness Robots	2021-02-04	2	5	1	3	0.6478
Corona Frustration Elimination	2021-01-19	2	5	1	3	0.6478
VHAIP	2021-04-28	4	5	1	5	0.6478
Elly	2021-02-05	2	5	1	3	0.6478
Crumbling City	2021-10-07	2	5	1	3	0.6478
Four Kings: Video Poker	2021-06-08	4	5	1	5	0.6478
Chinese Bull	2021-02-02	2	5	1	3	0.6478
Paper Jam!	2021-04-01	3	5	1	4	0.6478
Attack of the Mutant Penguins	2021-03-30	2	5	1	3	0.6478
Karakuri-kun: A Japanese Tale	2021-03-18	2	5	1	3	0.6478
Neonverse Defenders	2021-02-16	2	5	1	3	0.6478
Cursed House 9	2021-03-04	9	5	1	10	0.6478
Sept jours, sept lieux, sept vies	2021-04-02	2	5	1	3	0.6478
Necromancer : Winter	2021-03-31	2	5	1	3	0.6478
Chroma Quaternion	2021-05-07	8	5	1	9	0.6478
Catsperience	2021-05-17	3	5	1	4	0.6478
Last Dance	2021-04-15	2	5	1	3	0.6478
Tetrix 3D	2021-09-01	4	5	1	5	0.6478
VirtualRehabART4Health	2021-05-07	2	5	1	3	0.6478
Little Fighters on Stream	2021-05-03	3	5	1	4	0.6478
Tower Of Wishes	2021-05-03	5	5	1	6	0.6478
Let's Learn Janggi	2021-05-15	2	5	1	3	0.6478
Monster Battle Quest	2021-05-04	2	5	1	3	0.6478
梦落凡尘	2021-05-25	2	5	1	3	0.6478
task	2021-08-25	5	5	1	6	0.6478
Silent Night - A Christmas Delivery	2021-12-01	2	5	1	3	0.6478
VR Puppet Game	2021-10-29	2	5	1	3	0.6478
Action Commando 2	2021-07-27	2	5	1	3	0.6478
Dark Light	2021-10-01	5	5	1	6	0.6478
OMNIA	2021-08-16	3	5	1	4	0.6478
Zombaliens	2021-07-19	3	5	1	4	0.6478
Ultimate Physical Wrestling	2021-09-02	3	5	1	4	0.6478
Dragon's Vengeance	2021-08-02	3	5	1	4	0.6478
Ultra Boat Game!!!	2021-07-02	2	5	1	3	0.6478
Mystery Trackers: Paxton Creek Avenger Collector's Edition	2021-06-22	12	5	1	13	0.6478
Creepy Pizza Arcade	2021-08-20	3	5	1	4	0.6478
WoodHeart	2021-08-20	1	5	1	2	0.6478
Azurael’s Circle: Chapter 5	2021-07-24	2	5	1	3	0.6478
THE ADVENTURES OF LWANDA MAGERE	2021-09-10	2	5	1	3	0.6478
Man's body: For adults	2021-08-18	1	5	1	2	0.6478
The Crafter's Defense	2021-11-19	7	5	1	8	0.6478
Outergalactic Aliens Pinball	2021-09-30	2	5	1	3	0.6478
Car Wash TD - Tower Defense	2021-12-29	10	5	1	11	0.6478
TIMESCAPE: Altitude	2021-11-19	2	5	1	3	0.6478
Impulse	2021-10-01	4	5	1	5	0.6478
贸易与马车	2021-12-17	5	5	1	6	0.6478
ELE RAMPAGE	2021-09-29	2	5	1	3	0.6478
M2K	2021-10-23	2	5	1	3	0.6478
Cat Fish Island	2021-11-23	1	5	1	2	0.6478
Funny Card	2021-11-02	2	5	1	3	0.6478
SCP Foundation: Iris Through The Looking Glass - Chapter 1	2021-10-13	2	5	1	3	0.6478
Marimoth	2021-10-28	2	5	1	3	0.6478
The Open League	2021-12-29	4	5	1	5	0.6478
Ghoul Dungeon	2021-12-27	2	5	1	3	0.6478
Dungeonball	2021-12-13	3	5	1	4	0.6478
Mech Mechanic Simulator	2021-03-25	609	322	155	764	0.6476999999999999
Simpocalypse	2021-05-11	102	69	30	132	0.6476999999999999
Potentia	2021-02-11	72	250	119	191	0.6476000000000001
TOXICANT	2021-03-05	2	10	3	5	0.6476000000000001
Forgotten Souls	2021-11-19	5	10	3	8	0.6476000000000001
11th Dream	2021-09-17	7	10	3	10	0.6476000000000001
The Undisputables : Online Multiplayer	2021-12-05	4	10	3	7	0.6476000000000001
1984 Rewired	2021-09-09	2	10	3	5	0.6476000000000001
Mischance	2021-11-23	2	10	3	5	0.6476000000000001
Flyist	2021-06-18	2	10	3	5	0.6476000000000001
CLT	2021-10-16	2	10	3	5	0.6476000000000001
Quarantine: Global Pandemic	2021-01-13	3	10	3	6	0.6476000000000001
Quantum Project 	2021-05-20	3	10	3	6	0.6476000000000001
Crime Stories 2: In the Shadows	2021-02-06	7	10	3	10	0.6476000000000001
Pirate Story	2021-03-18	4	10	3	7	0.6476000000000001
Girls on puzzle 3	2021-04-03	3	10	3	6	0.6476000000000001
Love Decision	2021-03-30	2	10	3	5	0.6476000000000001
VR fighter jets war	2021-05-05	3	10	3	6	0.6476000000000001
Little drift	2021-04-13	2	10	3	5	0.6476000000000001
SwapOut	2021-10-20	6	10	3	9	0.6476000000000001
The Far Kingdoms: Forgotten Relics	2021-05-07	4	10	3	7	0.6476000000000001
Trap Adventure	2021-06-11	2	10	3	5	0.6476000000000001
Speeder	2021-06-29	2	10	3	5	0.6476000000000001
The Little Black Bestiary: The Salted Cookies of Carthaginia	2021-07-03	3	10	3	6	0.6476000000000001
Haunted Hotel: The X Collector's Edition	2021-07-06	9	10	3	12	0.6476000000000001
4 Months of You	2021-08-30	2	10	3	5	0.6476000000000001
Heart Lock	2021-08-27	7	10	3	10	0.6476000000000001
Osylla	2021-09-11	2	10	3	5	0.6476000000000001
Three Pigeons in a Trench Coat	2021-12-16	5	10	3	8	0.6476000000000001
Skautfold: Knight's End	2021-12-26	4	10	3	7	0.6476000000000001
TRACHI – AUTONOMY	2021-11-24	4	10	3	7	0.6476000000000001
Furry Hentai Jigsaw 2	2021-12-15	5	10	3	8	0.6476000000000001
Cruise Ship Handling	2021-12-15	5	10	3	8	0.6476000000000001
Lost Dream	2021-03-12	11	52	22	33	0.6474
Cute Girl 2	2021-09-30	6	52	22	28	0.6474
Blair Witch VR	2021-08-12	20	100	45	65	0.6473000000000001
Soul of Giga	2021-03-05	13	26	10	23	0.6473000000000001
Street Outlaws 2: Winner Takes All	2021-12-03	17	26	10	27	0.6473000000000001
the office simulation	2021-05-20	5	26	10	15	0.6473000000000001
Soulsland	2021-11-04	7	26	10	17	0.6473000000000001
BlackberryNOVA	2021-08-19	8	17	6	14	0.6473000000000001
Sigma Draconis	2021-04-10	5	17	6	11	0.6473000000000001
Hentai Girl Clicker	2021-08-25	4	17	6	10	0.6473000000000001
Alas Astra	2021-12-26	5	17	6	11	0.6473000000000001
Casual Challenge Players Club- Bilhar game	2021-01-25	3	17	6	9	0.6473000000000001
Concealment	2021-03-14	3	17	6	9	0.6473000000000001
Lux, City of Secrets	2021-05-06	22	17	6	28	0.6473000000000001
Escape from the Office	2021-07-26	3	17	6	9	0.6473000000000001
Haunted Hell House	2021-10-29	3	17	6	9	0.6473000000000001
Deiland: Pocket Planet Edition	2021-12-15	44	106	48	92	0.6470999999999999
Etched Memories Demo	2021-02-22	22	75	33	55	0.6470999999999999
ПОСЛЕДНИЙ ДЕНЬ В УРЮПИНСКЕ	2021-12-25	10	209	99	109	0.6468
Lost Existence	2021-01-07	16	39	16	32	0.6468
Let Me Die (inside)	2021-09-04	9	39	16	25	0.6468
Project Hive	2021-02-04	15	41	17	32	0.6463
Alchemist Adventure Prologue	2021-04-27	24	28	11	35	0.6462000000000001
Alexei Run	2021-03-14	9	28	11	20	0.6462000000000001
Destinies	2021-06-09	22	28	11	33	0.6462000000000001
Seed of Life	2021-08-11	23	60	26	49	0.6461
反抗吧！纯爱战士！	2021-10-02	60	66	29	89	0.6455
BOOTS VS PLANTS	2021-03-14	2	19	7	9	0.6452
Run Ralph Run	2021-03-03	6	19	7	13	0.6452
Wax Museum - Seek and Find	2021-06-11	9	19	7	16	0.6452
Planet B24	2021-07-21	3	34	14	17	0.6437999999999999
Do Animals Dream?	2021-06-15	7	55	24	31	0.6437
Lewd Island	2021-02-22	68	114	53	121	0.6436000000000001
The Rebellion	2021-04-01	5	21	8	13	0.6436000000000001
Hentai Balloons 2	2021-04-10	4	21	8	12	0.6436000000000001
中华富甲三国	2021-08-06	11	21	8	19	0.6436000000000001
Midnight Caravan	2021-06-25	4	12	4	8	0.6435
ZOMBEEZ: A Killer Queen Remix	2021-09-01	7	12	4	11	0.6435
Requiescat	2021-10-02	3	12	4	7	0.6435
Glittering sword	2021-02-05	3	12	4	7	0.6435
Rogues Adventure	2021-03-30	2	12	4	6	0.6435
Academy of Magic - Lair of the Beast	2021-03-06	6	12	4	10	0.6435
The Alien Way	2021-05-10	3	12	4	7	0.6435
Phantom Thief Sylphy	2021-09-08	12	12	4	16	0.6435
Сhick Boy Adventures	2021-11-12	4	12	4	8	0.6435
Gunner Deadly Expedition	2021-12-05	2	12	4	6	0.6435
Sentenced VR	2021-06-25	8	36	15	23	0.6432
polity	2021-11-05	24	36	15	39	0.6432
Furry Lust	2021-06-19	4	67	30	34	0.6428
DUNGEON ENCOUNTERS	2021-10-14	931	298	147	1078	0.6426000000000001
Ant Empire	2021-07-19	9	23	9	18	0.6424
Go to IT	2021-12-15	11	23	9	20	0.6424
Ragdoll Party Online	2021-08-03	7	23	9	16	0.6424
TOOTHY HISTORY	2021-03-20	7	23	9	16	0.6424
The Last Hope: Zombie Defense TD	2021-08-10	7	23	9	16	0.6424
25 Layers of Pain	2021-10-13	4	23	9	13	0.6424
STAR WARS™: The Old Republic™ - Public Test Server	2021-03-19	157	40	17	174	0.6423000000000001
Inventory Manager	2021-10-08	16	25	10	26	0.6414
VR Hentai Hot	2021-12-22	4	25	10	14	0.6414
Cricket Captain 2021	2021-07-13	150	48	21	171	0.6412000000000001
The Wolf's Girl	2021-07-23	23	48	21	44	0.6412000000000001
Himegimi Detective	2021-11-24	2	2	0	2	0.6408
BombGears	2021-02-27	5	2	0	5	0.6408
Garenburg Woods	2021-09-29	1	2	0	1	0.6408
Starship	2021-09-14	3	2	0	3	0.6408
Stuck Together	2021-07-20	2	2	0	2	0.6408
Trakker	2021-07-04	2	2	0	2	0.6408
天牢 -Tianlao Sokoban-	2021-03-29	2	2	0	2	0.6408
Thingamajig	2021-05-05	4	2	0	4	0.6408
RCRacer VR	2021-10-08	2	2	0	2	0.6408
Partition Sector	2021-01-29	2	2	0	2	0.6408
Transcender Starship	2021-03-29	1	2	0	1	0.6408
Fail to Win	2021-05-19	2	2	0	2	0.6408
Pixels can fight	2021-03-16	3	2	0	3	0.6408
Labirinto 3	2021-06-15	3	2	0	3	0.6408
Ink	2021-02-03	4	2	0	4	0.6408
A Mysterious Gallery	2021-04-26	3	2	0	3	0.6408
Gladii	2021-01-20	1	2	0	1	0.6408
Arker: The legend of Ohm	2021-04-27	1	2	0	1	0.6408
Net King's Call	2021-02-19	2	2	0	2	0.6408
Synth War Tactics	2021-03-02	1	2	0	1	0.6408
Draginsanity	2021-12-05	1	2	0	1	0.6408
Escape Planet 17	2021-01-09	2	2	0	2	0.6408
The Ninth Way	2021-08-02	1	2	0	1	0.6408
Lost Knight	2021-12-25	2	2	0	2	0.6408
Rodent & Plank: Secret Origin	2021-04-30	2	2	0	2	0.6408
Crypt of the Gods	2021-10-01	1	2	0	1	0.6408
Batallas Galacticas	2021-02-17	2	2	0	2	0.6408
Space Fuel	2021-04-09	2	2	0	2	0.6408
Dragonium	2021-02-07	2	2	0	2	0.6408
Lair Hockey	2021-04-12	1	2	0	1	0.6408
Joy the Pug	2021-02-19	5	2	0	5	0.6408
Buildmark	2021-01-28	2	2	0	2	0.6408
Cube	2021-09-12	1	2	0	1	0.6408
Juicy Army	2021-05-21	2	2	0	2	0.6408
Star Mine	2021-01-06	1	2	0	1	0.6408
DECO:BLOCK SIMULATOR	2021-09-03	2	2	0	2	0.6408
Safari Zone	2021-04-09	2	2	0	2	0.6408
ARCADEON VR	2021-07-10	2	2	0	2	0.6408
Fled fierce city	2021-01-14	2	2	0	2	0.6408
Training Grounds	2021-01-08	2	2	0	2	0.6408
Escape The Tank	2021-02-25	2	2	0	2	0.6408
Lithoi - Trials of Memory	2021-01-28	2	2	0	2	0.6408
Leak Elite	2021-01-14	2	2	0	2	0.6408
Revizor	2021-07-02	3	2	0	3	0.6408
Tormenta do Tempo	2021-10-12	2	2	0	2	0.6408
Elastic Fantastic	2021-02-03	2	2	0	2	0.6408
Hikeshi	2021-01-08	1	2	0	1	0.6408
Eluxia Enigma	2021-08-05	3	2	0	3	0.6408
The Chaser's Voyage	2021-09-17	2	2	0	2	0.6408
Gondola's Adventure	2021-02-24	3	2	0	3	0.6408
Laser Burst	2021-01-06	2	2	0	2	0.6408
PetrifactionUnderRuin	2021-02-04	2	2	0	2	0.6408
NA.NO	2021-01-20	3	2	0	3	0.6408
Tortuga	2021-01-05	1	2	0	1	0.6408
Drabidiboo	2021-03-03	2	2	0	2	0.6408
Shoot Your Friends	2021-02-19	3	2	0	3	0.6408
Super Huey™ 1 & 2 Airdrop	2021-04-27	1	2	0	1	0.6408
Weatherworn: The Adventure of Pap & Pup	2021-09-24	1	2	0	1	0.6408
Wind from city	2021-01-15	1	2	0	1	0.6408
Gun-REViper	2021-02-04	2	2	0	2	0.6408
A Western Drama	2021-02-02	3	2	0	3	0.6408
Refuge For Troubles. Episode 1: Dear Stranger	2021-01-21	3	2	0	3	0.6408
StarPicker	2021-07-09	2	2	0	2	0.6408
Rogun Arena	2021-01-29	1	2	0	1	0.6408
Corona Samurai	2021-01-27	2	2	0	2	0.6408
Winter Sleigh	2021-01-06	2	2	0	2	0.6408
Darkest Hour	2021-05-18	2	2	0	2	0.6408
ダリアの惑溺～団地妻・亜希子が堕ちる事情～	2021-01-20	1	2	0	1	0.6408
Roboggled	2021-01-22	2	2	0	2	0.6408
Lux mina	2021-04-11	3	2	0	3	0.6408
Kuguru	2021-04-15	1	2	0	1	0.6408
To The Snowland	2021-09-07	2	2	0	2	0.6408
Soobmarinno	2021-01-07	1	2	0	1	0.6408
Rage Chicken 2	2021-11-05	2	2	0	2	0.6408
Hajji Tours	2021-01-26	2	2	0	2	0.6408
Lonza the Bounty Hunter	2021-02-01	1	2	0	1	0.6408
Pond Scum	2021-02-01	2	2	0	2	0.6408
JPN Burst	2021-05-14	1	2	0	1	0.6408
Yellowlooper	2021-01-26	2	2	0	2	0.6408
Spin & Roll	2021-02-01	2	2	0	2	0.6408
Die Rangliste	2021-06-15	2	2	0	2	0.6408
The Interview	2021-02-14	4	2	0	4	0.6408
Thrilling Triple Treat	2021-03-07	2	2	0	2	0.6408
双重次元、穴曲堡Double world. cave song castle	2021-02-03	3	2	0	3	0.6408
The Help Desk	2021-03-17	1	2	0	1	0.6408
Nakadashi Banzai 4	2021-02-12	2	2	0	2	0.6408
Charge Champs	2021-02-18	4	2	0	4	0.6408
Nonestory	2021-02-16	1	2	0	1	0.6408
Pixelstar Hero	2021-02-15	1	2	0	1	0.6408
Dance with me	2021-07-16	1	2	0	1	0.6408
Nebuli	2021-02-16	1	2	0	1	0.6408
Cyclotronica	2021-03-14	2	2	0	2	0.6408
Player City	2021-07-09	1	2	0	1	0.6408
奇迹大陆	2021-02-20	1	2	0	1	0.6408
MultiDimensional 4-in-a-Row	2021-04-04	2	2	0	2	0.6408
Slav Dangerous	2021-02-17	2	2	0	2	0.6408
Candy Fall	2021-02-18	2	2	0	2	0.6408
Paintings Jigsaw Puzzles	2021-02-23	4	2	0	4	0.6408
Mind Lock	2021-03-05	1	2	0	1	0.6408
Car Looper	2021-07-27	1	2	0	1	0.6408
4th & Inches	2021-03-05	1	2	0	1	0.6408
A Nasty Farm	2021-03-04	1	2	0	1	0.6408
Power Of Slide	2021-07-19	2	2	0	2	0.6408
Tatarian aster	2021-04-06	1	2	0	1	0.6408
Unlikely Heroes	2021-03-08	3	2	0	3	0.6408
Race On Ice 2021 Pro	2021-04-07	22	2	0	22	0.6408
Dominant Mind	2021-05-18	3	2	0	3	0.6408
Veg Out Crew	2021-07-16	2	2	0	2	0.6408
The Architect's Game	2021-09-17	8	2	0	8	0.6408
Tartaron	2021-03-04	1	2	0	1	0.6408
Neon Shooter	2021-03-05	2	2	0	2	0.6408
PLACEFRONT	2021-03-05	2	2	0	2	0.6408
Life Is Not The End	2021-03-10	2	2	0	2	0.6408
Aritana and the Twin Masks	2021-03-10	3	2	0	3	0.6408
Chiasm	2021-06-18	3	2	0	3	0.6408
ITERRIA ZONE	2021-04-03	2	2	0	2	0.6408
Survival on Amazonia	2021-03-10	4	2	0	4	0.6408
Goblins!	2021-04-01	1	2	0	1	0.6408
SunSenSim™	2021-03-16	2	2	0	2	0.6408
Little Monkeys Eat Bananas	2021-04-07	2	2	0	2	0.6408
Helix	2021-07-10	2	2	0	2	0.6408
Fight for that Ball	2021-05-19	2	2	0	2	0.6408
Dwarves Craft. Father's home	2021-05-24	4	2	0	4	0.6408
Top Gang	2021-10-25	2	2	0	2	0.6408
Scientific Shutdown	2021-10-01	3	2	0	3	0.6408
My Simple Puzzle	2021-11-04	2	2	0	2	0.6408
Lotto Life	2021-10-15	1	2	0	1	0.6408
ONNANOKO KEEPER 3	2021-11-23	2	2	0	2	0.6408
Monster In The Dark	2021-05-16	2	2	0	2	0.6408
Curiosity	2021-04-11	1	2	0	1	0.6408
WaveTiles	2021-08-13	3	2	0	3	0.6408
Spirit Bounce	2021-06-28	4	2	0	4	0.6408
ShootOut(SystemD)	2021-09-30	1	2	0	1	0.6408
Code Lab	2021-05-03	2	2	0	2	0.6408
Total Toon Race	2021-04-09	2	2	0	2	0.6408
Endless Furry Asteroids	2021-04-12	2	2	0	2	0.6408
Trial of Two	2021-12-23	2	2	0	2	0.6408
R-Naught	2021-11-24	1	2	0	1	0.6408
Battle Guns Simulator	2021-04-16	3	2	0	3	0.6408
Spacey Vade	2021-11-01	1	2	0	1	0.6408
Dream Catchers	2021-04-22	1	2	0	1	0.6408
Super TECHPACK	2021-07-01	1	2	0	1	0.6408
Rescue Friends Solitaire	2021-07-20	4	2	0	4	0.6408
Marionette lab	2021-06-21	1	2	0	1	0.6408
Frogiee	2021-04-15	2	2	0	2	0.6408
Lords of the Darkreign	2021-07-21	2	2	0	2	0.6408
Woebegone Woods	2021-05-07	1	2	0	1	0.6408
Keezeh The Spector of Time	2021-05-02	1	2	0	1	0.6408
Trouble Inn: Jonny's Room	2021-07-23	2	2	0	2	0.6408
Chrome Switcher	2021-06-11	1	2	0	1	0.6408
ArtPuzzle VR	2021-07-09	1	2	0	1	0.6408
Astralis	2021-04-28	1	2	0	1	0.6408
Solitaire Victorian Picnic 2	2021-05-10	4	2	0	4	0.6408
Slordax: The Unknown Enemy	2021-05-07	1	2	0	1	0.6408
Opa Definitive Edition	2021-04-27	5	2	0	5	0.6408
Metaverse: Origins	2021-05-17	1	2	0	1	0.6408
Chromatic Labyrinth	2021-04-30	1	2	0	1	0.6408
Daffy Fish	2021-06-19	1	2	0	1	0.6408
Mecha Tactics	2021-06-28	1	2	0	1	0.6408
Ele-Mental	2021-06-01	3	2	0	3	0.6408
Bunny's Buddy	2021-09-23	2	2	0	2	0.6408
the secret of dyes	2021-06-04	1	2	0	1	0.6408
Akinofa	2021-07-15	2	2	0	2	0.6408
Valley of Dragons	2021-10-11	1	2	0	1	0.6408
G-MODEアーカイブス09 フライハイトクラウディア2	2021-05-25	3	2	0	3	0.6408
The Chronicler	2021-06-02	4	2	0	4	0.6408
Cleithrophobia	2021-11-03	2	2	0	2	0.6408
Monkey Hit	2021-05-15	1	2	0	1	0.6408
Lingering Legacy	2021-08-16	2	2	0	2	0.6408
Whack A Rat VR	2021-05-13	1	2	0	1	0.6408
Ball Twist	2021-05-15	2	2	0	2	0.6408
Slime Labs	2021-06-08	2	2	0	2	0.6408
Super Hot Potato	2021-05-19	2	2	0	2	0.6408
Peg Solitaire	2021-05-28	3	2	0	3	0.6408
Color Escape: VR Coop	2021-10-05	2	2	0	2	0.6408
Tree Strike	2021-06-04	2	2	0	2	0.6408
Frosty Jumper	2021-06-17	2	2	0	2	0.6408
Mud River	2021-09-21	4	2	0	4	0.6408
DREAMWORLD	2021-06-15	1	2	0	1	0.6408
Lethal Pongbat	2021-08-07	2	2	0	2	0.6408
Green Steel	2021-07-30	2	2	0	2	0.6408
Mahjong Gold 2. Pirates Island	2021-05-27	3	2	0	3	0.6408
Freddy Frog	2021-06-08	1	2	0	1	0.6408
Football Bus	2021-06-28	3	2	0	3	0.6408
To Kill A King	2021-06-25	2	2	0	2	0.6408
Oftalmogarden	2021-12-28	2	2	0	2	0.6408
Weapons Knight	2021-08-20	3	2	0	3	0.6408
Battle Rollers	2021-06-18	2	2	0	2	0.6408
The Adventures of Herbie & Katt LeChatt	2021-07-17	1	2	0	1	0.6408
海の世界の星追い	2021-07-20	1	2	0	1	0.6408
Icewords	2021-12-27	4	2	0	4	0.6408
G-MODEアーカイブス15 ちゅら島暮らし	2021-08-10	2	2	0	2	0.6408
Griddlers TED and PET 2	2021-07-14	4	2	0	4	0.6408
Coalhero	2021-06-29	1	2	0	1	0.6408
Maze Mania: The Ultimate 3D Maze Game	2021-11-11	1	2	0	1	0.6408
「３」	2021-07-23	2	2	0	2	0.6408
Beta Escape	2021-09-16	2	2	0	2	0.6408
In Space No One Can Hear You Clean	2021-07-28	1	2	0	1	0.6408
Ultimo Soccer UDC	2021-07-14	1	2	0	1	0.6408
Antithesis	2021-07-23	2	2	0	2	0.6408
简单的跑酷	2021-07-23	1	2	0	1	0.6408
Seblen: Battle!	2021-07-23	2	2	0	2	0.6408
PRINCESS IN AIRINESS	2021-07-26	1	2	0	1	0.6408
冰嬉图卷	2021-08-04	2	2	0	2	0.6408
Endless Soul Light Solitaire	2021-10-12	4	2	0	4	0.6408
Killer Gin Battle Arcade	2021-08-18	2	2	0	2	0.6408
duamo	2021-08-01	3	2	0	3	0.6408
Bizarre Mutation World	2021-07-30	1	2	0	1	0.6408
Robots n Lasers	2021-12-29	2	2	0	2	0.6408
Nilia	2021-09-12	2	2	0	2	0.6408
Multia Space Program	2021-09-01	2	2	0	2	0.6408
Light Up The Room	2021-11-03	2	2	0	2	0.6408
ShiroKuro'sAdventure	2021-08-20	2	2	0	2	0.6408
Station 17	2021-09-01	3	2	0	3	0.6408
Ark of Loif	2021-09-07	2	2	0	2	0.6408
Rising - Hungry Lizard	2021-08-30	2	2	0	2	0.6408
Time's Up in Tiny Town	2021-10-14	2	2	0	2	0.6408
Fill and Cross Trick or Treat 3	2021-09-13	4	2	0	4	0.6408
Holiday Jigsaw Halloween 2	2021-09-23	2	2	0	2	0.6408
2 Synchro Hedgehogs	2021-09-07	1	2	0	1	0.6408
FiberTales: DummyKart	2021-10-06	2	2	0	2	0.6408
Tar Alterra Adventure Game	2021-08-30	1	2	0	1	0.6408
Songs of Armageddopolis	2021-11-18	2	2	0	2	0.6408
Sex Robot Road Trip: Highway to Harrisburg	2021-09-22	2	2	0	2	0.6408
Ada And Cal	2021-08-28	1	2	0	1	0.6408
Creepy Mahjong	2021-10-26	2	2	0	2	0.6408
Pilie Pals	2021-10-15	2	2	0	2	0.6408
Infinite Cube Defense	2021-09-24	1	2	0	1	0.6408
Raster Prime [REMIX]	2021-09-13	1	2	0	1	0.6408
Detective Gman	2021-10-04	2	2	0	2	0.6408
明途之境	2021-09-12	4	2	0	4	0.6408
Almazy	2021-09-21	1	2	0	1	0.6408
Surface: Virtual Detective Collector's Edition	2021-08-20	6	2	0	6	0.6408
Where's My Lunch?!	2021-09-18	1	2	0	1	0.6408
RX Racing 2021 Pro	2021-09-28	1	2	0	1	0.6408
指示厨	2021-10-13	4	2	0	4	0.6408
Bokuhime Project	2021-10-15	4	2	0	4	0.6408
Extrorb	2021-09-14	2	2	0	2	0.6408
Prop Factory	2021-09-10	2	2	0	2	0.6408
Station 35	2021-10-20	1	2	0	1	0.6408
Vortex	2021-09-09	1	2	0	1	0.6408
魔王的简易用法	2021-09-16	5	2	0	5	0.6408
Cubyrinth	2021-09-20	2	2	0	2	0.6408
Drag Engineer	2021-09-17	2	2	0	2	0.6408
CornMaze Craze	2021-10-29	6	2	0	6	0.6408
KEMONOPOLY	2021-11-11	3	2	0	3	0.6408
Zippo	2021-09-27	2	2	0	2	0.6408
Ripple 涟	2021-10-01	3	2	0	3	0.6408
邪恶勇者	2021-09-30	2	2	0	2	0.6408
Escape From Planet Aelea	2021-10-03	3	2	0	3	0.6408
Rectitude	2021-09-28	2	2	0	2	0.6408
The 8 Sins: New Hell Order	2021-11-26	3	2	0	3	0.6408
Coloring Pixel - Fantasy Characters	2021-09-25	3	2	0	3	0.6408
Code.Breaker()	2021-12-18	1	2	0	1	0.6408
Shifting Dungeon	2021-11-11	2	2	0	2	0.6408
PolyBoost	2021-10-26	3	2	0	3	0.6408
FAWE: Enchanted Forest	2021-10-12	2	2	0	2	0.6408
Lucy	2021-10-06	2	2	0	2	0.6408
Miasma 2: Freedom Uprising	2021-12-03	1	2	0	1	0.6408
Typeds	2021-10-22	3	2	0	3	0.6408
TealGrounds	2021-10-15	1	2	0	1	0.6408
Puzzle Art: Snakes	2021-10-06	2	2	0	2	0.6408
This & Cats	2021-10-21	1	2	0	1	0.6408
Heatris	2021-11-25	1	2	0	1	0.6408
The Flea Evolution: La Pulga	2021-10-29	1	2	0	1	0.6408
Battle Chess 4000	2021-10-14	3	2	0	3	0.6408
Starblast: Retro Wars	2021-10-18	1	2	0	1	0.6408
The House	2021-10-29	2	2	0	2	0.6408
Dragon War	2021-10-22	1	2	0	1	0.6408
Dead Tunnel	2021-10-30	2	2	0	2	0.6408
KarmaCrown	2021-11-03	2	2	0	2	0.6408
Make The Jump	2021-12-01	2	2	0	2	0.6408
Project Runner	2021-11-01	1	2	0	1	0.6408
Rakuten	2021-12-02	3	2	0	3	0.6408
Knockball pool arcade	2021-11-08	2	2	0	2	0.6408
Kungen	2021-10-28	2	2	0	2	0.6408
Resonance Wars	2021-11-11	1	2	0	1	0.6408
VR Pictures	2021-12-08	1	2	0	1	0.6408
Chronicles of Deeps	2021-11-17	1	2	0	1	0.6408
Castle Mascot	2021-10-29	1	2	0	1	0.6408
Little Stars	2021-11-11	1	2	0	1	0.6408
Icing	2021-12-03	5	2	0	5	0.6408
RoboLingo	2021-11-24	2	2	0	2	0.6408
DayDream Mosaics 2: Juliette's Tale	2021-11-12	3	2	0	3	0.6408
The Shattered Elements Arena	2021-12-15	3	2	0	3	0.6408
The Knight of Turn	2021-12-19	1	2	0	1	0.6408
Airball	2021-11-22	1	2	0	1	0.6408
Scientifically Accurate Dinosaur Mating Simulator 2021	2021-12-24	2	2	0	2	0.6408
Bogdanoff vs. Wojak Simulator	2021-11-21	1	2	0	1	0.6408
Magnificent-1	2021-12-15	2	2	0	2	0.6408
Sabotage	2021-12-02	1	2	0	1	0.6408
Christmas Wonderland 12	2021-12-14	9	2	0	9	0.6408
Trisceli特里西利	2021-12-14	1	2	0	1	0.6408
黑白米拖更记	2021-12-06	2	2	0	2	0.6408
Popped Up	2021-12-09	1	2	0	1	0.6408
Umille	2021-12-19	3	2	0	3	0.6408
HYPERJUSTICE	2021-12-17	2	2	0	2	0.6408
Balls and Dungeons	2021-12-15	1	2	0	1	0.6408
Devil's Eyes	2021-12-28	2	2	0	2	0.6408
The Devils - A Visual Novel Of WWII	2021-12-23	1	2	0	1	0.6408
The Last Days of Sodom	2021-12-28	2	2	0	2	0.6408
Xenia's Ark	2021-08-12	7	14	5	12	0.6406999999999999
Operation Armstrong	2021-05-18	6	14	5	11	0.6406999999999999
Puerto Viejo	2021-09-17	3	14	5	8	0.6406999999999999
Starcaller	2021-04-01	4	14	5	9	0.6406999999999999
Ninja Lexx	2021-03-27	6	14	5	11	0.6406999999999999
Lab BreakOut	2021-03-19	4	14	5	9	0.6406999999999999
PhotoWorld: Smooth Сorners	2021-05-11	2	14	5	7	0.6406999999999999
Succubus Runa and the Erotic Dungeon	2021-11-05	11	14	5	16	0.6406999999999999
Hentai VR 4	2021-06-24	2	14	5	7	0.6406999999999999
Save The Octo	2021-07-20	2	14	5	7	0.6406999999999999
AirFighter	2021-07-20	4	14	5	9	0.6406999999999999
Without Pain	2021-11-19	6	14	5	11	0.6406999999999999
Lovely Archeologists	2021-10-22	3	14	5	8	0.6406999999999999
Girls Gym	2021-10-25	3	14	5	8	0.6406999999999999
Slide Furry	2021-11-21	4	14	5	9	0.6406999999999999
Goat over it	2021-02-12	20	27	11	31	0.6406000000000001
Life On A Pizza	2021-06-21	42	118	56	98	0.6405
The Plague: Kingdom Wars	2021-10-22	43	116	55	98	0.6405
Craftlands Workshoppe	2021-12-17	65	114	54	119	0.6405
International Basketball Manager	2021-01-28	41	94	44	85	0.6401000000000001
Nyaa-kuza!!	2021-04-13	6	29	12	18	0.64
Project Hunter	2021-05-24	8	29	12	20	0.64
Night Blade	2021-05-01	10	29	12	22	0.64
Bakery Shop Simulator	2021-04-20	89	172	84	173	0.6395000000000001
VR Hentai Date	2021-02-06	3	31	13	16	0.6395000000000001
MIR4	2021-08-25	97173	8469	4602	101775	0.6394
SCP: Escape Together	2021-01-06	379	2147	1143	1522	0.6393
Paradise Lost	2021-03-24	367	1272	670	1037	0.6391
Robonauts	2021-09-09	4	7	2	6	0.6389
Dot Debugger	2021-07-11	5	7	2	7	0.6389
Timothy vs the Aliens	2021-07-21	2	7	2	4	0.6389
Elfin Clay	2021-12-03	26	7	2	28	0.6389
Underwater Wars	2021-05-10	2	7	2	4	0.6389
CuberPunk 2090	2021-04-27	2	7	2	4	0.6389
Fighting for Justice Episode 1	2021-11-08	1	7	2	3	0.6389
Sneaky Kitten	2021-12-24	2	7	2	4	0.6389
ROGUERIA: Roguelikes X Tactics	2021-02-13	5	7	2	7	0.6389
Military Crusaders	2021-06-10	2	7	2	4	0.6389
Decaying Delicacy	2021-04-30	3	7	2	5	0.6389
Saturn Quest: Blast Effect	2021-01-12	3	7	2	5	0.6389
Galaxy's Extreme	2021-10-08	2	7	2	4	0.6389
Voxel Battle Simulator	2021-04-29	7	7	2	9	0.6389
Retrowave Drive	2021-02-04	4	7	2	6	0.6389
Carotic - Academic Version	2021-03-08	5	7	2	7	0.6389
Word Wise	2021-04-01	3	7	2	5	0.6389
MicroProse™ Soccer	2021-03-05	3	7	2	5	0.6389
Place for Hero	2021-06-15	3	7	2	5	0.6389
Flirtatious	2021-04-01	2	7	2	4	0.6389
Hyper Dungeon Crawler	2021-08-01	4	7	2	6	0.6389
Brytag Studio	2021-06-19	137	7	2	139	0.6389
Survival Z	2021-04-26	4	7	2	6	0.6389
Paladin Dream	2021-07-12	4	7	2	6	0.6389
XOMBEE	2021-06-02	4	7	2	6	0.6389
Pleasurepunk: Drug Dealer	2021-12-15	4	7	2	6	0.6389
Dabado Puzzles	2021-06-30	2	7	2	4	0.6389
IT TAKES THE BALL	2021-06-04	3	7	2	5	0.6389
Broken Robot	2021-06-15	3	7	2	5	0.6389
Welcome To Lakewood	2021-06-17	2	7	2	4	0.6389
Woute	2021-06-18	1	7	2	3	0.6389
The Elysian Field	2021-08-06	2	7	2	4	0.6389
1001 Jigsaw: Earth Chronicles 4	2021-07-05	3	7	2	5	0.6389
Soccer Cup Solitaire	2021-07-25	3	7	2	5	0.6389
ESTEN	2021-12-14	2	7	2	4	0.6389
Custom Machinery	2021-08-16	3	7	2	5	0.6389
Night Hunter	2021-09-08	2	7	2	4	0.6389
Sweet Desire: Hentai Puzzle	2021-10-22	3	7	2	5	0.6389
Academy of Magic: The Great Dark Wizard's Curse	2021-10-19	4	7	2	6	0.6389
Golf Solitaire Simple	2021-10-22	4	7	2	6	0.6389
After the first station	2021-11-18	1	7	2	3	0.6389
Wonky Wizard	2021-11-19	3	7	2	5	0.6389
畢業生模擬器	2021-12-03	5	7	2	7	0.6389
Heroes of Xanfurth	2021-11-26	6	7	2	8	0.6389
The Infecting 3	2021-11-30	2	7	2	4	0.6389
Sculpture Hentai Edition	2021-09-04	4	35	15	19	0.6388
Green Marquis	2021-02-23	4	16	6	10	0.6388
HENTAI CLIMBING	2021-04-10	3	16	6	9	0.6388
A.R.C Alien raid combat	2021-10-06	5	16	6	11	0.6388
The story of archer	2021-11-09	6	16	6	12	0.6388
戦国の木こり	2021-11-27	4	16	6	10	0.6388
Attraction	2021-12-22	2	16	6	8	0.6388
PABG: PLAYER ANIME BATTLEGROUNDS	2021-12-25	5	37	16	21	0.6385000000000001
Trials of Wilderness	2021-12-25	22	39	17	39	0.6383
Sensual Adventures - Episode 5	2021-03-05	17	39	17	34	0.6383
Horror Royale	2021-07-12	16	39	17	33	0.6383
Shelter Manager	2021-12-03	47	190	94	141	0.6382
Camping Simulator: The Squad	2021-05-28	155	468	241	396	0.6379
Farming Life	2021-10-18	104	81	38	142	0.6379
Nongunz: Doppelganger Edition	2021-05-07	32	75	35	67	0.6378
GunWorld VR	2021-10-14	9	73	34	43	0.6377
True Mining Simulator	2021-01-07	12	47	21	33	0.6377
Nayati River	2021-08-20	21	53	24	45	0.6376
KEEP OUT	2021-01-30	13	51	23	36	0.6376
Saints Row The Third Remastered	2021-05-21	1560	1351	719	2279	0.6373
RIO - Raised In Oblivion	2021-07-30	410	482	250	660	0.6367
Drawing	2021-04-27	276	232	117	393	0.6365
The Dark World: Edge of Eternity	2021-06-14	13	20	8	21	0.6365
Arm Of Revenge	2021-01-14	7	20	8	15	0.6365
魔物娘捕获大陆	2021-10-22	6	20	8	14	0.6365
Keep Trying! Zombie Apocalypse	2021-07-07	139	20	8	147	0.6365
Lona: Realm Of Colors	2021-07-09	7	20	8	15	0.6365
3 O'clock Horror	2021-07-19	6	20	8	14	0.6365
Violet Girl	2021-08-06	5	20	8	13	0.6365
EFO: Escape From Outerworld	2021-08-28	4	20	8	12	0.6365
1940	2021-11-11	5	20	8	13	0.6365
Castle Constructor	2021-10-18	18	22	9	27	0.6358
Squeaky Clean	2021-05-01	4	22	9	13	0.6358
RPG: Squad battle	2021-07-22	3	22	9	12	0.6358
Lemon Run	2021-12-12	6	22	9	15	0.6358
Blightbound	2021-07-27	1439	802	425	1864	0.6356
DIY MY LADY	2021-03-21	8	107	52	60	0.6354
Atlantica Europe	2021-05-20	195	105	51	246	0.6353
PYTHIAN	2021-03-15	223	24	10	233	0.6353
Stronghold: Warlords	2021-03-09	4434	2545	1389	5823	0.6348
Knights and Castles	2021-10-19	46	58	27	73	0.6346
Don't Give Up	2021-04-02	4	28	12	16	0.6346
Mik	2021-11-01	6	28	12	18	0.6346
Recompile	2021-08-19	66	93	45	111	0.6345000000000001
Gear.Club Unlimited 2 Ultimate Edition	2021-12-07	16	54	25	41	0.6345000000000001
The Creature	2021-02-01	9	9	3	12	0.6345000000000001
Victory At Sea Ironclad	2021-02-25	9	9	3	12	0.6345000000000001
Unnatural Disaster	2021-07-28	4	9	3	7	0.6345000000000001
Requiem	2021-05-04	4	9	3	7	0.6345000000000001
Wonder Defense: Chapter Earth	2021-11-19	2	9	3	5	0.6345000000000001
Alien Life Simulator	2021-02-18	5	9	3	8	0.6345000000000001
Nullmaze	2021-05-20	5	9	3	8	0.6345000000000001
Mythic Zombies	2021-02-13	5	9	3	8	0.6345000000000001
Legacy - Witch Island 3	2021-02-18	5	9	3	8	0.6345000000000001
Retro Classix: Two Crude	2021-03-02	3	9	3	6	0.6345000000000001
Sausage Fiesta	2021-03-31	5	9	3	8	0.6345000000000001
Kitchen Island VR	2021-03-31	5	9	3	8	0.6345000000000001
The Trigger	2021-04-08	2	9	3	5	0.6345000000000001
LaserShotz	2021-04-21	5	9	3	8	0.6345000000000001
Mini Madness	2021-07-30	5	9	3	8	0.6345000000000001
Sicko Island	2021-08-27	3	9	3	6	0.6345000000000001
Zombie Wars	2021-06-03	2	9	3	5	0.6345000000000001
VR SEX	2021-06-17	2	9	3	5	0.6345000000000001
Robo Vacuum Simulator	2021-11-08	3	9	3	6	0.6345000000000001
Hope Despair Chaos	2021-11-08	7	9	3	10	0.6345000000000001
Airship Killer	2021-11-09	3	9	3	6	0.6345000000000001
Block Collide	2021-11-05	2	9	3	5	0.6345000000000001
Ice sugar	2021-12-02	2	9	3	5	0.6345000000000001
陌生人	2021-12-22	2	9	3	5	0.6345000000000001
Tea Garden Simulator	2021-04-12	11	30	13	24	0.6344
Rise of Humanity Prologue	2021-06-24	14	48	22	36	0.6342
Cute Girls: Find Secrets	2021-05-19	4	34	15	19	0.6342
Animalia Survival	2021-09-09	461	1118	602	1063	0.6341
Spheria's Familiar	2021-04-20	16	44	20	36	0.6341
Sanity of Morris	2021-03-23	11	40	18	29	0.6341
Learn Programming: Python - Retro	2021-02-18	35	40	18	53	0.6341
Merge Nymphs	2021-02-11	218	199	101	319	0.634
Almighty: Kill Your Gods	2021-05-05	544	236	121	665	0.6336
Combat Mission Cold War	2021-11-16	74	100	49	123	0.6333
Fighting Robots	2021-11-21	151	111	55	206	0.6325000000000001
Survival | Classic	2021-01-22	47	212	109	156	0.6322
Consolation: Board Meeting - Jam Edition	2021-10-15	7	11	4	11	0.6321
Cave Confectioner	2021-03-16	2	11	4	6	0.6321
Chef Chen - FantasyCook	2021-01-19	7	11	4	11	0.6321
Star Steel	2021-02-28	3	11	4	7	0.6321
Dangerous Lands	2021-03-12	2	11	4	6	0.6321
Coastline Flight Simulator	2021-07-07	8	11	4	12	0.6321
Dininho Space Adventure	2021-06-15	3	11	4	7	0.6321
Unicorn and Sweets	2021-05-17	3	11	4	7	0.6321
The Wolf's Den	2021-07-06	2	11	4	6	0.6321
Pop This Pop-It	2021-08-07	4	11	4	8	0.6321
Match3 mania!	2021-07-23	2	11	4	6	0.6321
太空震惊模拟器	2021-10-13	6	11	4	10	0.6321
Aeroplane Blaster	2021-11-09	2	11	4	6	0.6321
Patriots: Back to Civilization	2021-11-20	6	11	4	10	0.6321
Lust for Darkness VR: M Edition	2021-11-18	4	11	4	8	0.6321
Endless Match	2021-12-05	3	11	4	7	0.6321
Angry Rocketeer Frenzy	2021-12-27	4	11	4	8	0.6321
Reptiles: In Hunt	2021-07-29	25	55	26	51	0.6315
New Meaning	2021-08-17	14	53	25	39	0.6313000000000001
Backbone	2021-06-08	739	1274	698	1437	0.6312
Lumberjack Simulator	2021-10-03	39	127	64	103	0.631
Intruder on the Bridge	2021-12-02	51	74	36	87	0.6309
Love with Furry	2021-12-07	17	108	54	71	0.6307
Motherland	2021-11-11	8	47	22	30	0.6307
Pest Control	2021-07-15	34	13	5	39	0.6306
Dear Mom,	2021-02-01	2	13	5	7	0.6306
Counter Fight ICHIRAN	2021-02-26	5	13	5	10	0.6306
Maguntsche: Chapter One Remastered	2021-06-22	3	13	5	8	0.6306
罪印	2021-06-22	4	13	5	9	0.6306
Farm Fatale	2021-06-30	6	13	5	11	0.6306
再来一局能否组成最强阵容	2021-06-18	7	13	5	12	0.6306
Hentai Sexy	2021-07-31	4	13	5	9	0.6306
Flappy Shooter	2021-10-08	7	13	5	12	0.6306
Mega Monster Party	2021-10-22	6	13	5	11	0.6306
Hunted	2021-10-09	4	13	5	9	0.6306
Setr's Auto Battler	2021-12-24	5	13	5	10	0.6306
GangV	2021-04-17	55	320	169	224	0.6305
Lust for Darkness VR	2021-10-26	12	45	21	33	0.6305
Storybook Brawl	2021-06-18	2770	2248	1251	4021	0.6303
Life is Hard	2021-08-14	2816	367	195	3011	0.6303
Don't Forget Me	2021-04-20	35	68	33	68	0.6302000000000001
Cute Honey 3	2021-04-05	160	421	225	385	0.6301
Castle Flipper	2021-05-26	1031	538	290	1321	0.63
Death Rattle - Hell Unleashed	2021-06-03	3	15	6	9	0.6298
Tube Tussle	2021-02-12	10	15	6	16	0.6298
无名骑士	2021-07-15	4	15	6	10	0.6298
The Bounty Huntress	2021-07-01	3	15	6	9	0.6298
Earth Marines	2021-07-13	3	15	6	9	0.6298
Throw Knives	2021-05-06	2	15	6	8	0.6298
The Cube Factory	2021-05-14	5	15	6	11	0.6298
Nothing To Remember	2021-07-29	8	15	6	14	0.6298
Adventures With a Girl	2021-06-01	3	15	6	9	0.6298
DUMB: Treasure	2021-09-17	4	15	6	10	0.6298
Escape from hospital	2021-03-31	6	33	15	21	0.6294
BOOOOOOOOOOOOOOOUNCE	2021-02-22	6	17	7	13	0.6293
Treasure of Barracuda	2021-08-23	35	17	7	42	0.6293
A Princess of Fallen Kingdom	2021-09-03	16	17	7	23	0.6293
They Look Like People	2021-11-29	2	17	7	9	0.6293
ARAIGNEES	2021-12-03	4	17	7	11	0.6293
"A Nerd who has sex with girls in ""Another world"" has become a HERO"	2021-04-19	8	31	14	22	0.6292
SuperMash	2021-01-13	11	29	13	24	0.6291
Tale of Ninja: Fall of the Miyoshi	2021-07-22	5	29	13	18	0.6291
Massage Salon Story: Spring Breeze	2021-03-11	12	29	13	25	0.6291
Range is HOT!	2021-03-09	7	29	13	20	0.6291
Rifle Strike	2021-03-19	8	29	13	21	0.6291
SgyuinBaldo	2021-03-11	12	29	13	25	0.6291
Realm Engine | Virtual Tabletop	2021-03-05	10	27	12	22	0.629
Chimes	2021-07-30	22	27	12	34	0.629
Intralism: Rebuild	2021-12-22	20	27	12	32	0.629
Humanity	2021-04-26	5	19	8	13	0.629
Town of Machine	2021-03-22	7	19	8	15	0.629
IDIOT	2021-01-30	2	19	8	10	0.629
Bear Adventures	2021-10-23	6	19	8	14	0.629
Lucidscape™	2021-01-15	12	25	11	23	0.6289
忍の娘	2021-04-28	5	25	11	16	0.6289
The Altered Lands	2021-05-28	4	25	11	15	0.6289
Help Me	2021-10-26	3	25	11	14	0.6289
SOTANO - Mystery Escape Room Adventure	2021-12-04	6	25	11	17	0.6289
Faye/Sleepwalker	2021-01-24	32	21	9	41	0.6289
Dungeon Delver	2021-03-15	14	21	9	23	0.6289
Samurai Chess	2021-04-16	5	21	9	14	0.6289
Love in the distance	2021-02-05	179	221	116	295	0.6288
大城主战略版	2021-10-12	161	75	37	198	0.6288
Totally Working Game	2021-08-20	5	23	10	15	0.6288
Tower Ball - Incremental Tower Defense	2021-06-15	451	118	60	511	0.6287
The Dark Side of the Moon	2021-03-12	23	86	43	66	0.6282
Cris Tales	2021-07-20	348	220	116	464	0.6279
Lady Sonia	2021-05-22	25	207	109	134	0.6277
Dragon VR	2021-05-01	19	67	33	52	0.6276
Game Company Simulator: Back To 2000	2021-04-25	291	152	79	370	0.6273
Unplugged	2021-12-14	13	44	21	34	0.6268
Disc Golf Valley VR	2021-05-19	12	42	20	32	0.6264000000000001
Avalom: Ancestral Heroes	2021-09-13	8	59	29	37	0.6263000000000001
Idle Pins	2021-10-16	1259	272	146	1405	0.6262
Black Legend	2021-03-25	180	120	62	242	0.6261
Cat Simulator	2021-06-08	138	72	36	174	0.6261
A furry house	2021-10-04	24	40	19	43	0.6261
NightMaresToBe	2021-08-14	63	40	19	82	0.6261
Hideout: Face your fears	2021-07-14	148	70	35	183	0.6257
Gamer Girls: Cyberpunk 2069	2021-12-11	997	161	85	1082	0.6251
Super Red-Hot Hero	2021-02-17	2	4	1	3	0.6251
ionAXXIA	2021-12-03	2	4	1	3	0.6251
non - The First Warp	2021-08-12	4	4	1	5	0.6251
Fish and Bubbles	2021-10-15	2	4	1	3	0.6251
LithoBreak	2021-02-23	3	4	1	4	0.6251
Kung Fu Jesus and the Search for Celestial Gold	2021-05-27	3	4	1	4	0.6251
The Abnormal Place	2021-12-15	2	4	1	3	0.6251
Balrog	2021-11-17	4	4	1	5	0.6251
Space Shooter	2021-07-11	2	4	1	3	0.6251
Planet's Edge	2021-02-05	3	4	1	4	0.6251
IN THE DARK	2021-08-20	3	4	1	4	0.6251
Niko and the Cubic Curse	2021-09-23	3	4	1	4	0.6251
The Caretaker	2021-04-30	3	4	1	4	0.6251
Black Maou & Rainbow Kingdom	2021-02-22	4	4	1	5	0.6251
Sir War-A-Lot	2021-03-26	4	4	1	5	0.6251
Wasting Away	2021-10-27	2	4	1	3	0.6251
FEVER: FIGHT THE FEVER	2021-02-11	1	4	1	2	0.6251
Heterodox Beta	2021-05-14	2	4	1	3	0.6251
51号太空站	2021-11-30	1	4	1	2	0.6251
Mexican Train Dominoes Gold	2021-03-03	11	4	1	12	0.6251
Vylan	2021-04-22	2	4	1	3	0.6251
Healing Animal	2021-12-19	3	4	1	4	0.6251
Tower Arena	2021-07-09	3	4	1	4	0.6251
Hyperblade	2021-08-31	3	4	1	4	0.6251
Cosmotronik	2021-01-07	2	4	1	3	0.6251
Hell Pages	2021-01-07	2	4	1	3	0.6251
Snake Man's Adventure	2021-06-08	2	4	1	3	0.6251
Slave Application	2021-03-26	3	4	1	4	0.6251
Pirate of Madagascar Island	2021-02-16	1	4	1	2	0.6251
The Holy Silence	2021-01-16	3	4	1	4	0.6251
Swingy boy	2021-02-09	2	4	1	3	0.6251
Gang wars	2021-03-06	2	4	1	3	0.6251
Utopia Process	2021-03-26	2	4	1	3	0.6251
Steel Graves	2021-02-12	5	4	1	6	0.6251
Sports Paradise VR	2021-06-17	1	4	1	2	0.6251
Appease the Spider	2021-02-08	2	4	1	3	0.6251
CityPunk	2021-02-20	3	4	1	4	0.6251
Nano Fighter Anti Disease	2021-03-22	2	4	1	3	0.6251
Netorare Sankaku Kankei	2021-03-12	2	4	1	3	0.6251
Kosmonavtes: Academy Escape	2021-02-22	6	4	1	7	0.6251
Detective Riddles - Sherlock's Heritage 2	2021-04-13	4	4	1	5	0.6251
The Depths	2021-04-25	1	4	1	2	0.6251
Skyfall	2021-03-01	7	4	1	8	0.6251
Disaster crisis	2021-03-07	2	4	1	3	0.6251
Freedom Physics	2021-04-01	2	4	1	3	0.6251
Little Shell's Adventure	2021-06-12	3	4	1	4	0.6251
PROJECT:SOLACE	2021-06-08	2	4	1	3	0.6251
cherry blossom fleet	2021-07-21	2	4	1	3	0.6251
Towards the Sky	2021-07-15	2	4	1	3	0.6251
Tiger Tank	2021-04-02	2	4	1	3	0.6251
Red Measures	2021-05-31	3	4	1	4	0.6251
Survive Into Night	2021-08-04	3	4	1	4	0.6251
Slickpoo The Clown	2021-05-28	2	4	1	3	0.6251
Archer boy	2021-04-13	1	4	1	2	0.6251
MAZE: A VR Adventure	2021-04-16	2	4	1	3	0.6251
Sorcs: Siege Chronicles	2021-05-06	3	4	1	4	0.6251
Acquiescence	2021-11-15	1	4	1	2	0.6251
Midnight Ohota	2021-11-01	1	4	1	2	0.6251
Mini Island: Summer	2021-04-30	4	4	1	5	0.6251
Loot City	2021-05-17	2	4	1	3	0.6251
Gravitaze: Two	2021-06-28	3	4	1	4	0.6251
JEFF-16	2021-06-02	1	4	1	2	0.6251
Smirkers	2021-06-29	2	4	1	3	0.6251
Wood Brothers Flying Colours	2021-09-03	4	4	1	5	0.6251
Archon-9 : Alien Defense	2021-06-02	2	4	1	3	0.6251
芯之迷城	2021-05-28	2	4	1	3	0.6251
Bodies of Water VR	2021-06-30	1	4	1	2	0.6251
Miss Intelligence	2021-12-31	4	4	1	5	0.6251
Dot Dash Dot	2021-07-21	1	4	1	2	0.6251
Rain Island: Orange	2021-07-06	3	4	1	4	0.6251
Home Office	2021-07-08	1	4	1	2	0.6251
Selene's Nightmare	2021-07-12	2	4	1	3	0.6251
More_The_Eternal_Utopia	2021-07-09	1	4	1	2	0.6251
Indigo 7	2021-07-26	4	4	1	5	0.6251
G-MODEアーカイブス28 セパスチャンネル	2021-07-27	3	4	1	4	0.6251
Veronica's Body	2021-07-16	8	4	1	9	0.6251
SINGULARITY WORLD	2021-07-13	7	4	1	8	0.6251
Destroy The Shogun	2021-07-30	1	4	1	2	0.6251
Color Your World	2021-09-30	2	4	1	3	0.6251
Summer Mission	2021-09-10	2	4	1	3	0.6251
New Supper Banana!	2021-12-15	2	4	1	3	0.6251
QuestNotes	2021-11-29	22	4	1	23	0.6251
DeadLock	2021-08-24	2	4	1	3	0.6251
Armada	2021-08-09	6	4	1	7	0.6251
Unnatural Freaks: Episode 1 Wolf At Evergreen	2021-09-05	1	4	1	2	0.6251
Dash Realm	2021-10-08	6	4	1	7	0.6251
Polybius Invaders	2021-10-03	3	4	1	4	0.6251
DRK-Story - Black Book -	2021-08-14	10	4	1	11	0.6251
Circe's revenge	2021-09-30	3	4	1	4	0.6251
Justice Chronicles	2021-12-03	4	4	1	5	0.6251
Ghost Sync	2021-11-05	8	4	1	9	0.6251
beVaiR	2021-12-06	3	4	1	4	0.6251
Little Cube Trip	2021-08-20	2	4	1	3	0.6251
Halloween Riddles Mysterious Griddlers	2021-09-09	4	4	1	5	0.6251
from view	2021-09-16	2	4	1	3	0.6251
Pots and Potions	2021-09-15	2	4	1	3	0.6251
DANGER: ELECTRIC SHOCK	2021-09-06	3	4	1	4	0.6251
じじまごRPGmini	2021-12-11	2	4	1	3	0.6251
Crazy Invader ShootEm Down	2021-10-10	1	4	1	2	0.6251
A Day in the Park	2021-09-07	2	4	1	3	0.6251
Defend the Fort	2021-09-24	2	4	1	3	0.6251
Fantasy Jigsaw Puzzle 4	2021-09-10	2	4	1	3	0.6251
ATRIA-1	2021-11-30	3	4	1	4	0.6251
Ecchi Beauties	2021-10-20	2	4	1	3	0.6251
100 Pumpkins	2021-10-08	2	4	1	3	0.6251
Power Pushout	2021-12-17	2	4	1	3	0.6251
Chimeras: Mortal Medicine Collector's Edition	2021-10-08	11	4	1	12	0.6251
Starbase Gunship	2021-12-02	2	4	1	3	0.6251
Xangel	2021-11-17	1	4	1	2	0.6251
经典象棋	2021-11-23	4	4	1	5	0.6251
KeyHero	2021-12-01	2	4	1	3	0.6251
Color by Number - Monster Heroes	2021-12-03	4	4	1	5	0.6251
Creatures Village	2021-12-20	3	4	1	4	0.6251
Foot Fetish Fortress VolTitan Vs. The Jundoh Empire Volume 1	2021-12-17	2	4	1	3	0.6251
Tower of Origin 2-Worm's Nest	2021-09-10	10	32	15	25	0.6245
Burn Me Alive	2021-09-01	3	32	15	18	0.6245
崩壊3rd	2021-10-21	1166	155	82	1248	0.6244
Who is the Liar?	2021-07-22	6	30	14	20	0.624
Overture Music Visualization	2021-03-05	5	28	13	18	0.6235
Golf Party	2021-01-29	33	28	13	46	0.6235
Live/Wire	2021-05-14	28	28	13	41	0.6235
Neurodeck	2021-03-18	133	147	78	211	0.6233
Audio Drive Storm	2021-03-24	21	120	63	84	0.6233
King's Bounty II	2021-08-24	5935	2866	1656	7591	0.6232
Truck Driver	2021-05-27	52	69	35	87	0.6232
Beastrun	2021-06-28	50	26	12	62	0.6231
Fake Hostel	2021-09-16	1677	255	139	1816	0.6229
Need for Drive - Open World Multiplayer Racing	2021-02-17	47	1320	754	801	0.6228
No School No Rules	2021-06-17	19	24	11	30	0.6226
Horse Riding Deluxe 2	2021-03-02	7	24	11	18	0.6226
Myastere -Ruins of Deazniff-	2021-04-15	27	24	11	38	0.6226
Megacraft Hentai Apocalipsis	2021-11-27	5	54	27	32	0.6224000000000001
Lisa and the Grimoire	2021-02-27	249	65	33	282	0.6223
Horny Fantasy Girl Hentai	2021-05-28	9	65	33	42	0.6223
Hotel Magnate	2021-10-05	429	233	127	556	0.6222
Mini Crafty	2021-05-13	10	22	10	20	0.6221
Dark Forest	2021-11-04	4	22	10	14	0.6221
SEARCH ALL - ADULT	2021-11-12	3	22	10	13	0.6221
INVITATION To FEAR	2021-11-24	275	183	99	374	0.6217
Guild of Darksteel	2021-07-15	6	20	9	15	0.6215
Girls Guns and Zombies	2021-04-06	5	20	9	14	0.6215
VR Nudity Camping	2021-05-27	3	20	9	12	0.6215
Evdeki Lanet	2021-07-27	4	20	9	13	0.6215
Loverowind	2021-05-19	4	50	25	29	0.6214000000000001
Reverie Knights Tactics: Prologue	2021-07-13	25	50	25	50	0.6214000000000001
Rangok Skies	2021-03-15	4	18	8	12	0.621
NEKO PAPALA	2021-01-28	8	18	8	16	0.621
KNIGHT SLAVE -The Dark Valkyrie of Depravity-	2021-07-01	8	18	8	16	0.621
Death Dream	2021-01-31	5	18	8	13	0.621
Action Commando	2021-05-27	4	18	8	12	0.621
X-Force Genesis	2021-08-30	4	18	8	12	0.621
Apocalich	2021-10-07	11	18	8	19	0.621
Dice Tactics	2021-06-16	6	6	2	8	0.621
OH! MOCHI!	2021-03-31	7	6	2	9	0.621
Sky Mirror · Strolling	2021-06-01	1	6	2	3	0.621
Ghost Opear House 剧院魅影	2021-01-02	4	6	2	6	0.621
My Business 	2021-06-22	2	6	2	4	0.621
Space Station Sprint	2021-08-27	3	6	2	5	0.621
Physics Cake	2021-08-23	2	6	2	4	0.621
The Virus	2021-02-12	2	6	2	4	0.621
Blimps	2021-01-25	3	6	2	5	0.621
The big head of the Jurassic	2021-02-26	5	6	2	7	0.621
Hunt N Cloak	2021-05-14	7	6	2	9	0.621
Deflection (Prologue)	2021-06-23	7	6	2	9	0.621
The Tales of Redbox: An Escape From Desire	2021-05-01	4	6	2	6	0.621
The Dark	2021-04-12	2	6	2	4	0.621
Saphyro	2021-03-19	5	6	2	7	0.621
Castle Of Collapse	2021-04-04	2	6	2	4	0.621
打工人：美香	2021-04-13	3	6	2	5	0.621
Temple of HUE	2021-05-28	2	6	2	4	0.621
A Strange Hotel	2021-06-30	2	6	2	4	0.621
Dice Of Knights	2021-09-03	6	6	2	8	0.621
The Marauder Chronicles - Curse over Valdria	2021-10-07	3	6	2	5	0.621
3D Hentai Puzzle 2	2021-06-05	3	6	2	5	0.621
Spin the World	2021-05-23	1	6	2	3	0.621
Hunger in Paradise	2021-06-10	2	6	2	4	0.621
Beat Defender	2021-07-16	2	6	2	4	0.621
Ningakki XXVI FPS	2021-09-26	3	6	2	5	0.621
Soulfire : Weapon Master	2021-06-23	6	6	2	8	0.621
Really Weird Pool	2021-08-01	7	6	2	9	0.621
Gray Death	2021-06-20	139	6	2	141	0.621
Mighty Chameleon Brothers	2021-06-28	3	6	2	5	0.621
Brickbuilder VR	2021-06-30	2	6	2	4	0.621
山海猎人	2021-11-12	1	6	2	3	0.621
Jaunt	2021-07-07	2	6	2	4	0.621
Mines & Dragons	2021-07-26	23	6	2	25	0.621
Captain Collision	2021-08-16	3	6	2	5	0.621
Ragtag Racing	2021-08-27	3	6	2	5	0.621
Zen: A Gay Sequel	2021-09-02	5	6	2	7	0.621
Dynarog 2	2021-09-12	4	6	2	6	0.621
I Love Finding Pups	2021-10-17	5	6	2	7	0.621
Skattered Dream	2021-09-20	3	6	2	5	0.621
Puzzle Art: Predators	2021-10-26	4	6	2	6	0.621
ThumBeat: Button Basher Edition	2021-12-13	3	6	2	5	0.621
Watermelon Wars	2021-12-27	10	6	2	12	0.621
LawnMower City	2021-12-14	2	6	2	4	0.621
Unstrong	2021-12-20	4	6	2	6	0.621
Prison Tycoon: Under New Management	2021-12-10	105	97	51	156	0.6209
Urban Tale	2021-10-07	59	88	46	105	0.6209
指间堡垒	2021-01-29	16	35	17	33	0.6207
Demon Strikes Back	2021-08-16	48	35	17	65	0.6207
Fortification: tower defence	2021-06-24	6	16	7	13	0.6204999999999999
Siege the Day	2021-11-11	43	16	7	50	0.6204999999999999
Wind Angel	2021-03-11	4	16	7	11	0.6204999999999999
The Killer of Dishonor	2021-05-07	5	16	7	12	0.6204999999999999
Unlock the Block	2021-05-03	4	16	7	11	0.6204999999999999
A Dog Named Mato	2021-07-22	4	16	7	11	0.6204999999999999
Mouse Hunter	2021-06-20	2	16	7	9	0.6204999999999999
Space Tower Defense	2021-09-09	3	16	7	10	0.6204999999999999
ANVIL	2021-12-02	3078	1307	755	3833	0.6204
Toy Tinker Simulator	2021-11-20	78	150	81	159	0.6204
Adeptus Titanicus: Dominus	2021-03-26	80	345	193	273	0.62
FreeRunners	2021-05-28	7	14	6	13	0.62
Stars SLIDE	2021-06-19	3	14	6	9	0.62
Thirty Minute Nightmare	2021-06-17	2	14	6	8	0.62
A wave of enemies	2021-06-29	2	14	6	8	0.62
Shopping Mahjong connect	2021-06-25	4	14	6	10	0.62
LONELY, LUSTFUL, ARROGANT, HATEFUL	2021-10-13	3	14	6	9	0.62
69 Mizuki Love	2021-10-22	5	14	6	11	0.62
Sex Clicker	2021-11-12	3	14	6	9	0.62
Mars Flight VR	2021-06-09	3	8	3	6	0.6197
Blocksplode	2021-04-14	5	8	3	8	0.6197
World War 2 Craft (二战演义)	2021-04-23	6	8	3	9	0.6197
All That Remains: Part 1	2021-04-16	6	8	3	9	0.6197
Kaputte Kranz Chap1	2021-01-29	4	8	3	7	0.6197
NinjaGirlArune	2021-02-05	4	8	3	7	0.6197
HIIS	2021-02-11	5	8	3	8	0.6197
I Am Human!	2021-08-06	11	8	3	14	0.6197
Muffin Fight	2021-02-19	16	8	3	19	0.6197
Retro Classix: Super BurgerTime	2021-03-02	3	8	3	6	0.6197
Space Survival	2021-03-10	5	8	3	8	0.6197
War Of Freedom	2021-03-25	2	8	3	5	0.6197
Tafl Champions: Ancient Chess	2021-10-18	4	8	3	7	0.6197
Tales of the Black Death	2021-10-15	4	8	3	7	0.6197
Olobollo	2021-06-22	2	8	3	5	0.6197
Sacred Cubes 2	2021-05-03	4	8	3	7	0.6197
Out Bike the Tsunami	2021-05-03	3	8	3	6	0.6197
Somniphobia	2021-10-31	3	8	3	6	0.6197
Electron	2021-07-01	3	8	3	6	0.6197
Dungless 2	2021-07-27	6	8	3	9	0.6197
THE ILLUSION	2021-07-30	3	8	3	6	0.6197
Chicken Cannon	2021-09-08	5	8	3	8	0.6197
Witch Stone	2021-08-26	2	8	3	5	0.6197
Andalia	2021-10-08	7	8	3	10	0.6197
The House Where They Dwell	2021-10-29	91	8	3	94	0.6197
Conquest!	2021-10-12	6	8	3	9	0.6197
Adult Puzzles - Pole Dancer	2021-10-23	2	8	3	5	0.6197
Starmancer	2021-08-05	916	525	298	1214	0.6196
Rise of the Slime	2021-05-20	96	73	38	134	0.6196
ANCIENT EVIL	2021-09-11	3	12	5	8	0.6196
GUNBARICH	2021-02-11	5	12	5	10	0.6196
Buyhads	2021-02-05	2	12	5	7	0.6196
琉璃樱	2021-04-19	8	12	5	13	0.6196
Attack Of UNDO Zai	2021-11-30	5	12	5	10	0.6196
Mega Solitaire Collection	2021-03-27	7	12	5	12	0.6196
Gaslamp Cases: The deadly Machine	2021-04-13	5	12	5	10	0.6196
My Sweet Ants!	2021-04-23	2	12	5	7	0.6196
PJ Masks: Heroes of the Night	2021-10-29	9	12	5	14	0.6196
Mononoke Slashdown	2021-08-26	4	12	5	9	0.6196
Follow Your Heart	2021-07-20	2	12	5	7	0.6196
Bikini Girls	2021-09-25	2	12	5	7	0.6196
Pacific General	2021-09-16	18	12	5	23	0.6196
Submarine VR	2021-10-05	4	12	5	9	0.6196
Mr.DomusMundi	2021-12-06	5	12	5	10	0.6196
Grim Tales: Crimson Hollow Collector's Edition	2021-09-24	12	12	5	17	0.6196
Fantasy and Girls	2021-10-21	2	12	5	7	0.6196
Wild Pussies	2021-11-16	4	12	5	9	0.6196
Outpost	2021-12-26	3	12	5	8	0.6196
Party Maker Farm Fest	2021-05-26	45	114	61	106	0.6195
The Disaster	2021-05-22	4	10	4	8	0.6195
Home Designer - Home Sweet Home	2021-02-11	6	10	4	10	0.6195
Symbiotic Love	2021-07-29	7	10	4	11	0.6195
Night Wanderings	2021-04-23	2	10	4	6	0.6195
Phantom sense VR	2021-06-10	2	10	4	6	0.6195
Fast Food Mania 3D	2021-06-08	2	10	4	6	0.6195
Unicorn and Sweets 2	2021-06-09	1	10	4	5	0.6195
Fire and Dungeon	2021-06-25	2	10	4	6	0.6195
StOoPiD Puzzle Game	2021-07-23	4	10	4	8	0.6195
黑帝斗者	2021-08-09	6	10	4	10	0.6195
My Best Nightmare	2021-09-06	5	10	4	9	0.6195
Follow The Cat	2021-09-15	4	10	4	8	0.6195
Lirica	2021-10-20	3	10	4	7	0.6195
Home Designer - Makeover Blast	2021-09-11	4	10	4	8	0.6195
Nosos	2021-10-08	10	10	4	14	0.6195
Hentai Neko Mosaic!	2021-12-03	2	10	4	6	0.6195
Rhentsu	2021-12-22	3	10	4	7	0.6195
Wild Journey	2021-07-26	26	105	56	82	0.6193
Noosphere	2021-07-23	24	62	32	56	0.6191
Unsafe	2021-11-18	85	119	64	149	0.619
Monster Energy Supercross - The Official Videogame 4	2021-03-11	572	370	209	781	0.6186
Days of Heroes: D-Day	2021-03-11	9	29	14	23	0.6186
Sensual Adventures - The Game	2021-02-17	51	67	35	86	0.618
Action Entities	2021-08-06	7	49	25	32	0.618
安魂挽歌	2021-08-26	157	155	85	242	0.6179
Abyss of Neptune	2021-04-26	501	106	57	558	0.6179
Forgotten Journey	2021-07-08	16	58	30	46	0.6179
ATC Infinite	2021-06-10	6	27	13	19	0.6178
NationWar:Annals	2021-04-06	77	74	39	116	0.6176
Dungeon Coup	2021-09-27	24	38	19	43	0.6176
Dropshipping Simulator	2021-12-09	51	63	33	84	0.6168
PEGGO!	2021-07-22	160	54	28	188	0.6165999999999999
Swallow The Blue Remastered	2021-01-18	9	45	23	32	0.6165
CryptoClickers: Crypto Idle Game	2021-06-19	200	112	61	261	0.6162
Dieselpunk Wars	2021-05-13	51	84	45	96	0.6162
Antiprism	2021-06-21	5	23	11	16	0.616
Dice Rollers	2021-01-16	27	23	11	38	0.616
Midnight Submersion Nightmare Horror Story Prologue	2021-12-27	20	23	11	31	0.616
Detective Story	2021-01-22	6	59	31	37	0.6154999999999999
Last Mortem	2021-06-27	21	50	26	47	0.6152000000000001
Ecchi Spirit	2021-05-08	12	32	16	28	0.615
Magical girl Noble Rose	2021-09-24	19	32	16	35	0.615
Kingdom Fall, Dawn of the Druid	2021-10-08	24	32	16	40	0.615
Tank Brawl 2: Armor Fury	2021-03-26	12	21	10	22	0.6149
Dura Vita Online	2021-01-05	8	21	10	18	0.6149
Anachronism	2021-05-04	5	21	10	15	0.6149
A Conversation With Mister Rabbit	2021-03-05	2	21	10	12	0.6149
Signals	2021-11-16	10	21	10	20	0.6149
Stones Keeper: Prologue	2021-09-17	8	21	10	18	0.6149
Idle Wasteland	2021-07-15	428	231	131	559	0.6147
Waifu vs Evil	2021-09-11	5	30	15	20	0.614
The Protagonist: EX-1	2021-07-18	7	19	9	16	0.6138
CityBeat: The Sorority Shuffle	2021-03-25	7	19	9	16	0.6138
The hidden game society	2021-05-28	4	19	9	13	0.6138
ШХД: ЛЕТО (IT'S SUMMER)	2021-06-30	3	19	9	12	0.6138
Sweet Desire 2	2021-08-13	7	19	9	16	0.6138
Whisper Trip	2021-10-07	19	46	24	43	0.6136
Explorers of the Abyss	2021-06-05	352	105	58	410	0.6131000000000001
공포의 임상시험	2021-02-09	23	37	19	42	0.6131000000000001
Bassmaster® Fishing	2021-10-28	98	122	68	166	0.6129
英雄道	2021-10-14	127	79	43	170	0.6129
Anime Sunset Ride	2021-06-15	3	28	14	17	0.6129
Punk Wars	2021-11-11	79	65	35	114	0.6126
Strip Fighter 5: Chimpocon Edition	2021-12-11	23	51	27	50	0.6126
Hindsight 20/20 - Wrath of the Raakshasa	2021-09-09	11	17	8	19	0.6125
The Handler of Dragons	2021-09-27	7	17	8	15	0.6125
Star Pilot	2021-11-24	5	17	8	13	0.6125
中国象棋-残局	2021-05-28	25	17	8	33	0.6125
Time of Piracy	2021-06-04	8	17	8	16	0.6125
Alone on Mars	2021-08-30	6	17	8	14	0.6125
Die After Sunset Prologue	2021-10-27	10	17	8	18	0.6125
Uncharted Waters IV HD Version	2021-05-20	4423	1031	617	5040	0.6121
REINCARNATION ASURA ZARANDARA Journey of carnage and redemption	2021-01-26	11	26	13	24	0.6118
Alien Dawn	2021-10-23	21	61	33	54	0.6111
Orion	2021-01-05	3	15	7	10	0.6111
CLEARWORLD-透明世界-	2021-05-19	6	15	7	13	0.6111
Burning Ball	2021-03-26	3	15	7	10	0.6111
StarScraper	2021-06-10	6	15	7	13	0.6111
通灵神探：杀意	2021-05-21	7	15	7	14	0.6111
The Shape On The Ground (Steam Edition)	2021-06-15	3	15	7	10	0.6111
The Edge Of	2021-10-15	7	15	7	14	0.6111
SOMETHING	2021-11-30	8	15	7	15	0.6111
Childlike(차일드라이크)	2021-12-15	6	15	7	13	0.6111
Arkham Horror: Mother's Embrace	2021-03-23	603	368	216	819	0.611
Tunnel of Doom	2021-11-23	23	33	17	40	0.611
Protoball	2021-09-08	37	66	36	73	0.6106
Wartune Reborn	2021-02-27	134	112	63	197	0.6104999999999999
Hentai Nureta Puzzle Mythica	2021-02-19	3	24	12	15	0.6104999999999999
VR Hiroshima 1945	2021-01-15	4	24	12	16	0.6104999999999999
CARGAME	2021-01-28	4	52	28	32	0.61
Dev Inc	2021-08-08	15	45	24	39	0.6098
Smalles	2021-08-07	37	31	16	53	0.6098
Ravensword: Undaunted	2021-07-09	10	38	20	30	0.6097
Lazy Sweet Tycoon	2021-08-11	18	13	6	24	0.6095
Strip Black Jack - Sex Teacher	2021-02-26	7	13	6	13	0.6095
冒险的路上总在为爱鼓掌	2021-06-01	10	13	6	16	0.6095
Crazy Race	2021-04-23	2	13	6	8	0.6095
Assignment 42 	2021-07-28	19	13	6	25	0.6095
Endorfire Tower Defense	2021-08-13	5	13	6	11	0.6095
Mirror Party	2021-12-03	982	875	529	1511	0.6093000000000001
景安区奇案-Jing 'an District Copstories	2021-01-06	10	22	11	21	0.609
Amazing Superhero Squad	2021-10-22	7	22	11	18	0.609
投资模拟器：打工篇	2021-10-08	1638	596	358	1996	0.6089
I Saw Black Clouds	2021-03-30	70	282	167	237	0.6077
Miners Mettle	2021-11-03	13	41	22	35	0.6077
Red Fox and the Four Seasons	2021-03-09	377	11	5	382	0.6076
Monster Girl Fantasy 2: Exposed	2021-04-20	10	11	5	15	0.6076
THE FATE OF THE BULLY	2021-06-25	2	11	5	7	0.6076
Negligee: Girls Night	2021-06-18	7	11	5	12	0.6076
Hard Block Girls	2021-06-18	3	11	5	8	0.6076
Shillelagh	2021-11-10	4	11	5	9	0.6076
Magic Frame	2021-05-11	13	11	5	18	0.6076
异世界打工人 	2021-06-04	3	11	5	8	0.6076
Lamia's Plan	2021-08-27	2	11	5	7	0.6076
Toadomination	2021-09-30	2	11	5	7	0.6076
Yuzi Lims: Puzzle	2021-09-23	2	11	5	7	0.6076
MOVERS IN THE WAREHOUSE	2021-09-28	5	11	5	10	0.6076
Us Against Aliens	2021-11-05	3	11	5	8	0.6076
Fisti-Fluffs	2021-09-23	17	20	10	27	0.6074
Food Delivery Service	2021-04-17	22	20	10	32	0.6074
OnlyFuck - RuRu's Adventures	2021-06-20	204	150	87	291	0.6073
2020: The Ride	2021-03-02	5	27	14	19	0.6071
Slick Racing Game	2021-06-18	29	27	14	43	0.6071
SaiIn Rhythm	2021-12-23	4	27	14	18	0.6071
Company of Heroes: Back to Basics	2021-07-02	222	113	65	287	0.6065
TrainClicker Idle Evolution	2021-02-13	196	39	21	217	0.6065
Not An Angels	2021-01-08	53	32	17	70	0.6059
Waifu Trainer	2021-11-19	12	32	17	29	0.6059
Gemini Strategy Origin	2021-01-14	63	81	46	109	0.6058
Alchemic Cutie	2021-11-12	51	25	13	64	0.6055
Japanese Drag Racing (JDM) - ジェイディーエム	2021-03-11	6	25	13	19	0.6055
VR Parallel World	2021-03-14	4	18	9	13	0.6055
Spin City	2021-11-25	9	18	9	18	0.6055
Stealing a Monster Girl Harem	2021-11-08	11	18	9	20	0.6055
Gone Upstate	2021-05-25	13	9	4	17	0.6054
Glam	2021-02-18	4	9	4	8	0.6054
Isolationist Nightclub Simulator	2021-03-11	2	9	4	6	0.6054
LineArt Jigsaw Puzzle - Erotica 3	2021-01-30	3	9	4	7	0.6054
Traversing Traveler	2021-05-21	2	9	4	6	0.6054
Diorama Tower Defense: Tiny Kingdom (Prologue)	2021-04-09	3	9	4	7	0.6054
Grim Tales: Trace in Time Collector's Edition	2021-04-02	11	9	4	15	0.6054
Driving Simulator 	2021-08-02	3	9	4	7	0.6054
Drowned Gems	2021-05-28	2	9	4	6	0.6054
Space Porter	2021-05-18	2	9	4	6	0.6054
POG 2	2021-05-27	2	9	4	6	0.6054
BlastFort	2021-07-26	7	9	4	11	0.6054
Rat Prison	2021-07-22	2	9	4	6	0.6054
Neon Nights Pinball	2021-08-18	2	9	4	6	0.6054
Fantasy Sliding Puzzle	2021-09-02	2	9	4	6	0.6054
Love Hentai and Puzzles: Gamer Girls	2021-12-16	6	9	4	10	0.6054
Xenture	2021-11-11	5	9	4	9	0.6054
Maze Art: Pink	2021-12-04	2	9	4	6	0.6054
Mysterious House	2021-12-27	7	9	4	11	0.6054
迟到摄影师 Late photographer	2021-12-10	45	99	57	102	0.6052000000000001
The Plane Effect	2021-09-23	15	42	23	38	0.6047
Warhammer Age of Sigmar: Storm Ground	2021-05-26	1445	582	357	1802	0.6046
VR HOT	2021-05-06	53	411	250	303	0.6045
Therais Book	2021-03-26	16	47	26	42	0.6045
阴缘	2021-09-27	14	23	12	26	0.6037
One Last Memory	2021-11-05	7	23	12	19	0.6037
Find Girl	2021-04-12	14	40	22	36	0.6035
Monster Collector	2021-02-19	5	16	8	13	0.6034
The Great Plague Exodus	2021-02-05	5	16	8	13	0.6034
VR Shooting Range: Multiple Weapons	2021-02-02	4	16	8	12	0.6034
VR Kyoto: Beauty of Japan	2021-02-17	3	16	8	11	0.6034
Wow Dance	2021-03-19	4	16	8	12	0.6034
Warplane inc.	2021-06-08	8	16	8	16	0.6034
Cemetery Warrior V	2021-05-30	3	16	8	11	0.6034
War Of Gold	2021-08-22	3	16	8	11	0.6034
Skotos	2021-09-17	5	16	8	13	0.6034
Park Life	2021-11-06	4	16	8	12	0.6034
Furry Puzzle	2021-08-14	4	45	25	29	0.6033
Saviors of Sapphire Wings / Stranger of Sword City Revisited	2021-03-16	201	93	54	255	0.6032000000000001
Harvest Moon: One World	2021-09-07	39	50	28	67	0.6032000000000001
Virtual Surfing	2021-09-16	10	88	51	61	0.603
Sylphine	2021-05-28	83	174	104	187	0.6028
Naau: The Lost Eye	2021-04-29	8	28	15	23	0.6028
Shoot 'm Up	2021-04-02	4	7	3	7	0.6028
Wolfpack Island	2021-12-03	8	7	3	11	0.6028
Pangman	2021-04-28	5	7	3	8	0.6028
Soulace	2021-06-21	4	7	3	7	0.6028
In the House of Silence	2021-05-10	4	7	3	7	0.6028
Shards of Feyra	2021-01-10	6	7	3	9	0.6028
Isometric Nonogram	2021-02-21	4	7	3	7	0.6028
Happy Valentine's Day	2021-01-18	2	7	3	5	0.6028
Golf With Your Grandmother	2021-05-07	4	7	3	7	0.6028
My Territory Was Witches' Island!?	2021-03-12	11	7	3	14	0.6028
SLASH OF BULLET	2021-04-24	3	7	3	6	0.6028
Spawn Kings	2021-08-19	4	7	3	7	0.6028
80s Volleyball	2021-06-03	2	7	3	5	0.6028
Witchcraft U	2021-12-09	34	7	3	37	0.6028
The Adventures of Mr. Poop	2021-05-14	3	7	3	6	0.6028
Desperation	2021-05-14	6	7	3	9	0.6028
1001 Jigsaw Legends of Mystery 2	2021-07-06	4	7	3	7	0.6028
Super Gobang	2021-06-09	3	7	3	6	0.6028
Vortex Rolling	2021-06-14	2	7	3	5	0.6028
SYDE Rugby League Simulator	2021-07-30	2	7	3	5	0.6028
いの べーしょん! 2007	2021-08-27	2	7	3	5	0.6028
Undead Menace	2021-10-29	2	7	3	5	0.6028
Nakornsampan	2021-12-19	8	7	3	11	0.6028
Bloxi: The Word Game	2021-12-17	2	7	3	5	0.6028
Experiment Of Being	2021-12-14	3	7	3	6	0.6028
Escape Logan Estate	2021-12-07	4	7	3	7	0.6028
Palphone-sama : Curse call	2021-12-09	5	7	3	8	0.6028
Exsanguinate	2021-12-29	3	7	3	6	0.6028
Gentlemen's Club	2021-12-13	236	219	132	368	0.6027
Furry Fetishists	2021-12-19	35	161	96	131	0.6027
Axis Football 2021	2021-08-26	46	81	47	93	0.6021
Andromeda: Rebirth of Humanity	2021-01-22	45	58	33	78	0.6021
INMATE: Survival	2021-04-06	17	43	24	41	0.6020000000000001
Metal Heads	2021-03-27	21	21	11	32	0.6017
Hammerting	2021-11-16	1456	1362	861	2317	0.6016
P3TT	2021-03-25	44	84	49	93	0.6015
Hit n' Rush	2021-02-18	79	56	32	111	0.6011
RainCity	2021-01-21	18	56	32	50	0.6011
Crystal Raiders VR	2021-12-10	9	26	14	23	0.601
Horror Villa 恐怖撤锁	2021-07-20	4	26	14	18	0.601
Starbase	2021-07-29	9969	3732	2398	12367	0.6009000000000001
S.P.A.T.	2021-08-27	13	51	29	42	0.6009000000000001
Mission Z	2021-02-05	8	14	7	15	0.6009000000000001
Snapshot	2021-03-24	3	14	7	10	0.6009000000000001
最涯（さいはて）の列車	2021-06-03	19	14	7	26	0.6009000000000001
Crazy Boom	2021-05-14	2	14	7	9	0.6009000000000001
Adventurer Liz and the Erotic Dungeon	2021-10-29	6	14	7	13	0.6009000000000001
Take Over Body	2021-11-23	7	14	7	14	0.6009000000000001
Pregnant	2021-11-23	4	14	7	11	0.6009000000000001
Magia X	2021-02-25	38	191	116	154	0.6004
Aggressor	2021-07-28	24	98	58	82	0.6002000000000001
Earth Analog	2021-02-11	40	59	34	74	0.6002000000000001
Survival Vacancy	2021-02-19	23	54	31	54	0.5999
Somnium	2021-11-22	2	5	2	4	0.5997
UNHERD	2021-02-15	3	5	2	5	0.5997
I Have Powers!	2021-03-31	3	5	2	5	0.5997
DumbBots	2021-05-19	3	5	2	5	0.5997
Horned Knight	2021-02-26	3	5	2	5	0.5997
Date Night Bowling	2021-11-26	4	5	2	6	0.5997
PlanetariumVR	2021-12-18	2	5	2	4	0.5997
Marbleous Blocks	2021-01-27	2	5	2	4	0.5997
Oath	2021-01-08	4	5	2	6	0.5997
NovaMundi	2021-04-13	4	5	2	6	0.5997
Surprise Party!	2021-01-20	3	5	2	5	0.5997
Aim Academy	2021-01-22	3	5	2	5	0.5997
Niinamigota	2021-05-27	2	5	2	4	0.5997
ZombieWave-UnlimitedChallenges	2021-01-06	2	5	2	4	0.5997
Let's Learn Japanese: Deluxe	2021-01-01	4	5	2	6	0.5997
Subterene	2021-01-07	2	5	2	4	0.5997
Chef's Tail	2021-10-22	4	5	2	6	0.5997
Taekwondo Demonstration Team Simulator	2021-01-19	2	5	2	4	0.5997
Survival Draw	2021-01-14	2	5	2	4	0.5997
Lo-Fi Lounge	2021-05-02	2	5	2	4	0.5997
SHOOTERBALL	2021-03-09	6	5	2	8	0.5997
Fenrir's Prelude	2021-06-30	4	5	2	6	0.5997
NULLORE: beginning	2021-04-30	4	5	2	6	0.5997
Detective Puz	2021-05-14	3	5	2	5	0.5997
Detective Riddles - Sherlock's Heritage	2021-03-15	6	5	2	8	0.5997
Fill and Cross Magic Journey	2021-04-08	4	5	2	6	0.5997
Marooned	2021-03-08	2	5	2	4	0.5997
Problem Here	2021-03-29	10	5	2	12	0.5997
RPG IDLE	2021-03-03	5	5	2	7	0.5997
Jixxaw	2021-03-15	6	5	2	8	0.5997
Dark facets	2021-04-09	2	5	2	4	0.5997
Theofil	2021-04-09	2	5	2	4	0.5997
Defiance & Mr. Good Looking	2021-04-28	3	5	2	5	0.5997
Smoots Golf	2021-11-18	3	5	2	5	0.5997
Robbed Money	2021-05-17	3	5	2	5	0.5997
Naught Bots	2021-05-18	3	5	2	5	0.5997
Zagu Espionage	2021-06-18	2	5	2	4	0.5997
Axiom Alternative II	2021-06-09	1	5	2	3	0.5997
Django	2021-08-27	2	5	2	4	0.5997
Haunted Hotel: A Past Redeemed Collector's Edition	2021-06-18	8	5	2	10	0.5997
Long Tail	2021-10-14	2	5	2	4	0.5997
Pandora : Wild Origins	2021-09-10	3	5	2	5	0.5997
Two Clusters Cold Haven	2021-09-15	13	5	2	15	0.5997
Z Mutants	2021-07-27	2	5	2	4	0.5997
Emergency Crew Volcano Eruption	2021-08-18	6	5	2	8	0.5997
ball.io	2021-11-08	2	5	2	4	0.5997
The Trader	2021-07-30	3	5	2	5	0.5997
THE MADHOUSE | 感染屋敷	2021-11-18	15	5	2	17	0.5997
Singulive	2021-08-17	3	5	2	5	0.5997
Wardwell House VR	2021-07-30	2	5	2	4	0.5997
The Adventures of Dinobot and Tiara!	2021-08-06	2	5	2	4	0.5997
Street Dreams	2021-09-17	3	5	2	5	0.5997
Power Pals	2021-08-27	2	5	2	4	0.5997
Dessert Tank: The Saga of Hansel and Gretel Prologue	2021-10-30	7	5	2	9	0.5997
Lovely Tesserae	2021-10-03	2	5	2	4	0.5997
Tower To Heaven	2021-10-06	2	5	2	4	0.5997
Deformity	2021-10-19	5	5	2	7	0.5997
MyJapaneseTeacher	2021-11-16	2	5	2	4	0.5997
Gaslamp Cases 2	2021-11-11	7	5	2	9	0.5997
There is No Stairs	2021-12-05	4	5	2	6	0.5997
Lemon vs. Teddy	2021-12-10	4	5	2	6	0.5997
Maze Art: Purple	2021-12-04	3	5	2	5	0.5997
PHANTASIA	2021-12-15	4	5	2	6	0.5997
Splash Fly Fire	2021-12-09	1	5	2	3	0.5997
Catherine Ragnor and the Legend of the Flying Dutchman	2021-12-17	3	5	2	5	0.5997
Police Chase	2021-03-12	6	19	10	16	0.5994
Dance Waifu	2021-01-15	2	19	10	12	0.5994
Sweet Desire	2021-05-21	9	19	10	19	0.5994
Darkzone	2021-11-15	115	83	49	164	0.5992000000000001
DPS IDLE	2021-08-21	548	347	216	764	0.5991
Chrono's Arena	2021-06-23	15	24	13	28	0.5989
Accident On the Simple Rd	2021-08-06	16	24	13	29	0.5989
Surviving West	2021-09-24	9	24	13	22	0.5989
Desert Parkour	2021-06-22	6	24	13	19	0.5989
Ruin Raiders	2021-10-14	22	29	16	38	0.5988
Incel Syndrome	2021-08-20	5	29	16	21	0.5988
Office Love Affair	2021-06-17	12	60	35	47	0.5982999999999999
Bubble Bobble 4 Friends: The Baron's Workshop	2021-09-30	21	47	27	48	0.5982999999999999
Nemezis: Mysterious Journey III	2021-07-08	72	68	40	112	0.5981000000000001
Sheriff Rage	2021-04-03	2	12	6	8	0.598
DuelVox: Max Quality	2021-04-16	2	12	6	8	0.598
Sweety Little Witch	2021-05-27	3	12	6	9	0.598
The Mountain Hunting	2021-06-24	3	12	6	9	0.598
Tank Zombie Smasher	2021-07-20	3	12	6	9	0.598
Virus ON	2021-09-03	7	12	6	13	0.598
Kings and Pigs Prequel	2021-10-27	2	12	6	8	0.598
PRIMAFLOOWS	2021-11-30	2	12	6	8	0.598
Mega Zombie Explosion	2021-12-07	2	12	6	8	0.598
Blackberry	2021-02-05	13	84	50	63	0.5979
Legends of Ellaria	2021-04-01	61	480	303	364	0.5978
Warhammer Combat Cards	2021-06-03	111	215	133	244	0.5976
Comanche	2021-08-26	56	182	112	168	0.5976
Blacksmith Legends: Prologue	2021-07-08	65	90	54	119	0.5971000000000001
Derelict Void	2021-03-18	41	32	18	59	0.5971000000000001
Armored Front	2021-11-20	9	27	15	24	0.5968
Nightfall	2021-04-25	24	27	15	39	0.5968
VR Hentai 18+	2021-03-11	3	27	15	18	0.5968
Urban Trial Tricky	2021-07-22	10	17	9	19	0.5968
Japanese Puzzle	2021-06-14	2	17	9	11	0.5968
Drone Showcase	2021-12-14	6	17	9	15	0.5968
Welcome to the Adventurer Inn!	2021-04-03	202	61	36	238	0.5965
87 Aftermath: A Rolling Ball Game	2021-01-23	3	3	1	4	0.596
Solstice	2021-06-01	2	3	1	3	0.596
Side Decide	2021-08-19	4	3	1	5	0.596
Chained	2021-06-04	2	3	1	3	0.596
Rogue Waves	2021-01-15	3	3	1	4	0.596
パトルの軍事博物館３ 超絶無敵究極兵器	2021-07-20	20	3	1	21	0.596
Crisp Cube	2021-11-12	2	3	1	3	0.596
Breath of the Forest	2021-02-20	1	3	1	2	0.596
Mirastell	2021-08-23	3	3	1	4	0.596
Matergari: Below Valesia	2021-11-04	2	3	1	3	0.596
Ash of Legends	2021-06-23	4	3	1	5	0.596
Woodsalt	2021-01-25	2	3	1	3	0.596
Strawberry Chocolate Miner 8AD 4SS	2021-08-27	2	3	1	3	0.596
Welcome to the Polyverse	2021-08-01	2	3	1	3	0.596
Germany at War - Soviet Dawn	2021-01-01	6	3	1	7	0.596
Airplane Racer 2021	2021-11-05	2	3	1	3	0.596
WAVER	2021-08-20	5	3	1	6	0.596
Glorious Tournius	2021-04-30	4	3	1	5	0.596
Boom!VR	2021-03-19	2	3	1	3	0.596
Plan Z	2021-01-20	2	3	1	3	0.596
Gravels of Endless War	2021-01-29	4	3	1	5	0.596
Task Men	2021-03-01	2	3	1	3	0.596
Sexy Match	2021-11-06	3	3	1	4	0.596
宅配勇者	2021-10-20	10	3	1	11	0.596
The Happy Little Virus	2021-01-18	2	3	1	3	0.596
Dominate Square	2021-01-05	1	3	1	2	0.596
Misery Street	2021-08-06	3	3	1	4	0.596
I Am the Captain Now	2021-05-27	5	3	1	6	0.596
Ochitsubaki	2021-12-17	1	3	1	2	0.596
Altarage	2021-03-08	2	3	1	3	0.596
Laser Cup	2021-02-18	4	3	1	5	0.596
Recycle My World	2021-01-03	2	3	1	3	0.596
Aeris&Zack	2021-06-19	2	3	1	3	0.596
Children's Jigsaw Puzzles	2021-01-10	4	3	1	5	0.596
Star Squadron: Student Driver	2021-03-05	2	3	1	3	0.596
Flying Frags World Tour	2021-01-28	1	3	1	2	0.596
The Last From Mars	2021-03-30	2	3	1	3	0.596
Ultimate Bumper Cars	2021-08-19	4	3	1	5	0.596
孙美琪疑案 第四季	2021-02-05	5	3	1	6	0.596
Pixel Game Maker Series REMOTE BOMBER	2021-02-24	2	3	1	3	0.596
Customers From Hell - Game For Retail Workers	2021-08-03	2	3	1	3	0.596
Pixel Game Maker Series Puzzle Pedestrians	2021-03-03	2	3	1	3	0.596
Behold The Dark	2021-03-10	2	3	1	3	0.596
Vacation Adventures: Park Ranger 4	2021-02-15	4	3	1	5	0.596
Analytical World	2021-02-19	3	3	1	4	0.596
Omniblast	2021-03-24	3	3	1	4	0.596
VR Pianist	2021-08-18	2	3	1	3	0.596
Easter Riddles	2021-04-14	4	3	1	5	0.596
Plasma Attack	2021-03-03	2	3	1	3	0.596
Mythic Prelude - Concept Demo	2021-03-10	1	3	1	2	0.596
Gravity Mastery	2021-03-10	1	3	1	2	0.596
Struggling Ball	2021-07-02	4	3	1	5	0.596
Yet Another Hard Game	2021-03-12	2	3	1	3	0.596
Exorcised	2021-04-09	2	3	1	3	0.596
Automatrons	2021-06-09	2	3	1	3	0.596
修仙重生记	2021-04-09	5	3	1	6	0.596
Forza Yang	2021-03-15	2	3	1	3	0.596
Wind of shuriken	2021-07-19	2	3	1	3	0.596
Fluff labs: a colourful life	2021-06-12	3	3	1	4	0.596
Canary in a Crater	2021-05-18	3	3	1	4	0.596
Mission Mars	2021-05-14	2	3	1	3	0.596
Pineapple Island	2021-03-30	1	3	1	2	0.596
SUPER DUPER ISLAND ADVENTURE	2021-04-29	2	3	1	3	0.596
Go home, Go home?	2021-05-19	2	3	1	3	0.596
Avoid The Demons	2021-04-22	1	3	1	2	0.596
Keep Talk Until You Dead	2021-05-04	1	3	1	2	0.596
Elixir of Life	2021-04-26	4	3	1	5	0.596
XCUTE(me)	2021-05-14	2	3	1	3	0.596
HS Galaxy	2021-05-14	2	3	1	3	0.596
You Are Kaiju	2021-05-30	1	3	1	2	0.596
Slime's Revenge	2021-06-10	2	3	1	3	0.596
Soul Survivor	2021-05-13	3	3	1	4	0.596
Kin's Chronicle	2021-07-28	3	3	1	4	0.596
DemonPandemicVR	2021-06-18	1	3	1	2	0.596
Biscuitts 4	2021-11-24	2	3	1	3	0.596
SuperSecret	2021-09-29	2	3	1	3	0.596
1001 Jigsaw. Earth Chronicles 9	2021-11-25	3	3	1	4	0.596
Rabbit Run	2021-05-17	1	3	1	2	0.596
Move the Window	2021-06-01	2	3	1	3	0.596
The Indestructible Moxy Boxy	2021-06-08	1	3	1	2	0.596
The Insignia Project	2021-07-16	2	3	1	3	0.596
爱与命的彼端	2021-05-27	2	3	1	3	0.596
Puzz/LR	2021-07-08	3	3	1	4	0.596
Elfblade	2021-06-17	2	3	1	3	0.596
Haunted Hotel: Phoenix Collector's Edition	2021-06-02	8	3	1	9	0.596
U.F.O. K.O. Tower Defense	2021-08-02	2	3	1	3	0.596
Key: Maze of Illusions	2021-12-15	3	3	1	4	0.596
打怪! Beat the Mons!	2021-06-21	134	3	1	135	0.596
Yellow Ballman	2021-08-05	1	3	1	2	0.596
Waifu Covered 2 : Censored Edition	2021-07-29	2	3	1	3	0.596
First Samurai	2021-07-23	4	3	1	5	0.596
末日航路-The Termination	2021-07-23	5	3	1	6	0.596
Coral Quest	2021-08-16	1	3	1	2	0.596
Cat Attack	2021-08-04	2	3	1	3	0.596
Loop Room	2021-07-22	3	3	1	4	0.596
Mini Jumper	2021-08-13	3	3	1	4	0.596
Absurd Chess	2021-12-01	4	3	1	5	0.596
Escape from the Lockdown: The Demon Fortress	2021-08-27	5	3	1	6	0.596
LowPolyExplorer	2021-08-06	2	3	1	3	0.596
Chetz!	2021-11-27	2	3	1	3	0.596
Mosaic Your Crush!	2021-08-13	2	3	1	3	0.596
Blind Postman	2021-09-24	2	3	1	3	0.596
八尾	2021-09-23	2	3	1	3	0.596
CABOUS	2021-09-09	3	3	1	4	0.596
Jaksaljabi	2021-09-24	2	3	1	3	0.596
Wager	2021-11-11	4	3	1	5	0.596
ARCH STONE vs The Zombie Specters	2021-09-25	2	3	1	3	0.596
Shadow Killer	2021-10-15	2	3	1	3	0.596
Color Guys	2021-10-20	3	3	1	4	0.596
WavePlayer	2021-10-25	4	3	1	5	0.596
Louder Than Words ~The Story of a Field Trip~	2021-10-29	2	3	1	3	0.596
Jump! Fork!	2021-11-07	2	3	1	3	0.596
Love Hentai and Puzzles: Yokai	2021-12-16	2	3	1	3	0.596
Demon Runner - The Forsaken	2021-10-19	1	3	1	2	0.596
Elta7	2021-10-31	2	3	1	3	0.596
Take As Needed	2021-11-19	3	3	1	4	0.596
Magneta Box	2021-11-30	2	3	1	3	0.596
Puzzle Art: Primates	2021-10-26	2	3	1	3	0.596
Squidoku	2021-11-09	1	3	1	2	0.596
True Detective Solitaire 2	2021-11-09	4	3	1	5	0.596
Void Heart	2021-12-25	2	3	1	3	0.596
Punch It Deluxe	2021-11-13	1	3	1	2	0.596
Comixxx Jixxaw	2021-12-01	3	3	1	4	0.596
Yui Tui	2021-12-03	1	3	1	2	0.596
Clocknockers	2021-11-23	2	3	1	3	0.596
Santa Slays Nazis	2021-12-26	2	3	1	3	0.596
CaptMeow	2021-12-13	3	3	1	4	0.596
Roof Genocide	2021-12-10	3	3	1	4	0.596
Breakwaters	2021-12-09	1043	534	342	1385	0.5953
Extreme Soccer	2021-02-04	48	59	35	83	0.5952000000000001
Tiny Space Academy	2021-03-26	26	30	17	43	0.5952000000000001
Doctor Who: The Edge of Reality	2021-10-13	129	153	95	224	0.5947
Baldo: The Guardian Owls	2021-08-27	88	106	65	153	0.5944
The Fabled Woods	2021-03-25	18	84	51	69	0.5944
Nightmare Zone	2021-09-17	3	10	5	8	0.5943
White Rabbit	2021-02-23	3	10	5	8	0.5943
Live Labyrinth	2021-02-24	3	10	5	8	0.5943
VR Girls’ Room in Darkness	2021-01-26	2	10	5	7	0.5943
ChillaxVR	2021-01-28	3	10	5	8	0.5943
Farmer's Co-op:Out of This World	2021-09-01	14	10	5	19	0.5943
Toys & Physics	2021-03-04	2	10	5	7	0.5943
Parallax Tunnel	2021-04-07	2	10	5	7	0.5943
Faerie's Bargain: The Price of Business	2021-12-02	21	10	5	26	0.5943
Operation Body Count	2021-08-06	3	10	5	8	0.5943
Hentai Pleasure	2021-07-17	2	10	5	7	0.5943
Smoots Golf - First Training	2021-11-04	8	10	5	13	0.5943
TheNuWRLD	2021-09-07	4	10	5	9	0.5943
Motorcycle Biker Simulator	2021-09-29	2	10	5	7	0.5943
Chicken Duty	2021-09-15	3	10	5	8	0.5943
幽霊案件	2021-10-30	5	10	5	10	0.5943
Draco Dux	2021-04-30	1	1	0	1	0.5942000000000001
Goblin.Life	2021-04-30	2	1	0	2	0.5942000000000001
Arcsaber VR	2021-01-15	1	1	0	1	0.5942000000000001
Sixteen	2021-11-23	2	1	0	2	0.5942000000000001
Project Ara - Crucible	2021-07-18	2	1	0	2	0.5942000000000001
BallRun 3D Marble Maze Speedrun	2021-12-18	3	1	0	3	0.5942000000000001
Kojou	2021-02-28	9	1	0	9	0.5942000000000001
Hexer	2021-03-01	1	1	0	1	0.5942000000000001
Cyber Puzzle HackRow	2021-11-09	1	1	0	1	0.5942000000000001
Knights of Riddle	2021-02-16	3	1	0	3	0.5942000000000001
Exploding Babies	2021-10-27	4	1	0	4	0.5942000000000001
The Truck Game	2021-11-26	2	1	0	2	0.5942000000000001
Miles of Cubes	2021-01-31	1	1	0	1	0.5942000000000001
Dino Lost	2021-08-25	2	1	0	2	0.5942000000000001
Jade's Ascension	2021-03-10	3	1	0	3	0.5942000000000001
Xenrai	2021-12-23	3	1	0	3	0.5942000000000001
My Very Own Light (MVOL)	2021-11-25	3	1	0	3	0.5942000000000001
Occultus Command	2021-01-13	1	1	0	1	0.5942000000000001
Swiss Knife	2021-11-03	2	1	0	2	0.5942000000000001
Pirate Popper VR	2021-04-29	1	1	0	1	0.5942000000000001
Skeleton vs zombies	2021-08-20	2	1	0	2	0.5942000000000001
Craft The Mapcrafter:Gathering Magic Words	2021-04-22	6	1	0	6	0.5942000000000001
23UL	2021-10-26	1	1	0	1	0.5942000000000001
Unarmed Area	2021-09-28	2	1	0	2	0.5942000000000001
Deserted	2021-03-15	2	1	0	2	0.5942000000000001
Military Base War	2021-04-29	1	1	0	1	0.5942000000000001
Anti-Science Brigade	2021-09-07	1	1	0	1	0.5942000000000001
ENCYCLE	2021-04-19	2	1	0	2	0.5942000000000001
Hidden Histories: The Principality	2021-12-02	1	1	0	1	0.5942000000000001
CHICARO DENTISTRY	2021-06-30	2	1	0	2	0.5942000000000001
Space Haters	2021-04-19	1	1	0	1	0.5942000000000001
Natural Habitat	2021-07-10	2	1	0	2	0.5942000000000001
Heim	2021-12-03	2	1	0	2	0.5942000000000001
Living Art	2021-11-15	2	1	0	2	0.5942000000000001
Rust Raiders	2021-12-20	1	1	0	1	0.5942000000000001
Anicon - Animal Complex - Rabbit's Path	2021-10-28	4	1	0	4	0.5942000000000001
TKO	2021-03-05	1	1	0	1	0.5942000000000001
Aria: Dragon Eater	2021-06-03	1	1	0	1	0.5942000000000001
DICHOTOMY	2021-08-02	8	1	0	8	0.5942000000000001
Paper Shakespeare: Very Naked Hamlet	2021-03-08	2	1	0	2	0.5942000000000001
Swords of Edo	2021-04-18	1	1	0	1	0.5942000000000001
Mind Over Melee Radio	2021-03-06	3	1	0	3	0.5942000000000001
Orb and the Stars	2021-06-30	2	1	0	2	0.5942000000000001
OMG - One more goal!	2021-02-24	1	1	0	1	0.5942000000000001
Down the River	2021-04-15	1	1	0	1	0.5942000000000001
False Dichotomy	2021-08-31	1	1	0	1	0.5942000000000001
Splash King's Tournament	2021-09-08	1	1	0	1	0.5942000000000001
ALPHA CENTAURI SPACE FORCE	2021-04-08	2	1	0	2	0.5942000000000001
FarRock Dodgeball	2021-09-24	1	1	0	1	0.5942000000000001
Hot Tiles	2021-01-18	2	1	0	2	0.5942000000000001
Isle of the Crown	2021-02-10	3	1	0	3	0.5942000000000001
Small Iron	2021-01-06	1	1	0	1	0.5942000000000001
Fight N' Fall	2021-11-26	2	1	0	2	0.5942000000000001
Distant Transmission	2021-02-12	2	1	0	2	0.5942000000000001
Inner Light	2021-12-01	2	1	0	2	0.5942000000000001
Drift Racer	2021-03-11	2	1	0	2	0.5942000000000001
Two by One	2021-07-26	2	1	0	2	0.5942000000000001
Loch Mess	2021-03-04	3	1	0	3	0.5942000000000001
Solar Scion	2021-06-07	1	1	0	1	0.5942000000000001
Dasher	2021-01-25	1	1	0	1	0.5942000000000001
Красный Сокол	2021-01-06	1	1	0	1	0.5942000000000001
The Prabbits: Happy Dogfights !	2021-07-31	3	1	0	3	0.5942000000000001
Smoop Can't Sleep!	2021-10-27	2	1	0	2	0.5942000000000001
Encounter the Light / 邂逅光明	2021-01-02	1	1	0	1	0.5942000000000001
BLIND QUEST - The Frost Demon	2021-03-18	1	1	0	1	0.5942000000000001
Zephyr	2021-02-05	1	1	0	1	0.5942000000000001
Space Plane	2021-03-09	1	1	0	1	0.5942000000000001
Project Mirror	2021-03-31	2	1	0	2	0.5942000000000001
Poster Sticker	2021-03-04	1	1	0	1	0.5942000000000001
TRIPILL	2021-02-26	1	1	0	1	0.5942000000000001
PrePaladin Wars	2021-01-31	1	1	0	1	0.5942000000000001
Lost & Round	2021-05-12	3	1	0	3	0.5942000000000001
Beat Bolt City	2021-02-05	1	1	0	1	0.5942000000000001
Battle Alchemy	2021-05-27	2	1	0	2	0.5942000000000001
Mystic Fate	2021-04-22	2	1	0	2	0.5942000000000001
Trapmania	2021-01-21	1	1	0	1	0.5942000000000001
Silver Vault	2021-04-05	1	1	0	1	0.5942000000000001
Pamir Saga	2021-02-18	2	1	0	2	0.5942000000000001
The Clot Thickens	2021-03-02	5	1	0	5	0.5942000000000001
Plushie Dungeon	2021-10-12	1	1	0	1	0.5942000000000001
Endline	2021-03-29	2	1	0	2	0.5942000000000001
Devil Edge	2021-02-24	1	1	0	1	0.5942000000000001
Bounce	2021-02-06	1	1	0	1	0.5942000000000001
NeoCube	2021-01-22	2	1	0	2	0.5942000000000001
Timothy ティモシー -神秘の森-	2021-12-24	3	1	0	3	0.5942000000000001
Slime Fantasy: the search for the lost sword	2021-03-04	1	1	0	1	0.5942000000000001
Among Stars and Robots	2021-01-28	3	1	0	3	0.5942000000000001
Salyut π	2021-01-05	1	1	0	1	0.5942000000000001
Invincible Fins	2021-01-18	1	1	0	1	0.5942000000000001
Farty Bird	2021-06-29	1	1	0	1	0.5942000000000001
FutureKreate	2021-04-13	2	1	0	2	0.5942000000000001
VR Plant Journey	2021-06-19	2	1	0	2	0.5942000000000001
EPEJSODION Dodgeball Speed	2021-02-01	2	1	0	2	0.5942000000000001
幻想啟示錄	2021-09-24	2	1	0	2	0.5942000000000001
CABARET 4 CARD	2021-01-01	1	1	0	1	0.5942000000000001
Grave Complex	2021-05-17	2	1	0	2	0.5942000000000001
Pesky Humans	2021-03-01	1	1	0	1	0.5942000000000001
The Research Age	2021-09-17	1	1	0	1	0.5942000000000001
Spiky	2021-02-28	1	1	0	1	0.5942000000000001
Cubo ao topo	2021-06-22	2	1	0	2	0.5942000000000001
Fall Balance Ball	2021-01-11	2	1	0	2	0.5942000000000001
Whats Wrong With You?	2021-03-29	2	1	0	2	0.5942000000000001
Cyber Defense 2088	2021-07-09	2	1	0	2	0.5942000000000001
Champoo Club	2021-01-05	1	1	0	1	0.5942000000000001
Tanxy	2021-01-11	1	1	0	1	0.5942000000000001
Paladin's Lance	2021-01-01	2	1	0	2	0.5942000000000001
Fallen Rebellion	2021-01-04	1	1	0	1	0.5942000000000001
Coveneth	2021-01-08	7	1	0	7	0.5942000000000001
MONSTER X	2021-11-13	1	1	0	1	0.5942000000000001
Story of a tiny earth, the symbolic ages	2021-02-22	2	1	0	2	0.5942000000000001
汉字数独	2021-01-18	3	1	0	3	0.5942000000000001
The Demon Rush: Legends Corrupt	2021-01-29	2	1	0	2	0.5942000000000001
Leap of Love - Safe Edition	2021-02-08	2	1	0	2	0.5942000000000001
Box And Ball	2021-07-23	1	1	0	1	0.5942000000000001
Sqr(2)	2021-01-12	1	1	0	1	0.5942000000000001
Pilfered Liberty	2021-05-21	2	1	0	2	0.5942000000000001
UfoPilot : The Phadt Menace - Steam Edition	2021-01-19	2	1	0	2	0.5942000000000001
Furry Shakespeare: Dreamin' of One Lazy Dead Midsummer	2021-08-13	1	1	0	1	0.5942000000000001
Beyond The Waterfalls	2021-02-25	6	1	0	6	0.5942000000000001
Relax It's Aqua	2021-04-17	2	1	0	2	0.5942000000000001
夏日的回忆	2021-01-23	1	1	0	1	0.5942000000000001
Gun Bots	2021-01-25	1	1	0	1	0.5942000000000001
Cannibal Coast	2021-01-19	1	1	0	1	0.5942000000000001
Kazakh 'Jack	2021-03-22	3	1	0	3	0.5942000000000001
SSCS	2021-02-18	2	1	0	2	0.5942000000000001
Tomb Of Pharaohs	2021-05-31	1	1	0	1	0.5942000000000001
HyperShot	2021-02-22	1	1	0	1	0.5942000000000001
The Fun of Asmodius	2021-02-02	3	1	0	3	0.5942000000000001
Theme Park Mystery	2021-03-31	1	1	0	1	0.5942000000000001
The Killing Cloud	2021-03-31	1	1	0	1	0.5942000000000001
Revertia	2021-02-08	2	1	0	2	0.5942000000000001
Travel Fanz	2021-11-11	2	1	0	2	0.5942000000000001
Degradation(ALPHA)	2021-03-15	4	1	0	4	0.5942000000000001
DMN7	2021-07-28	3	1	0	3	0.5942000000000001
Starter Pack	2021-02-08	1	1	0	1	0.5942000000000001
Assault	2021-02-05	1	1	0	1	0.5942000000000001
Blood of the Alchemists	2021-08-05	2	1	0	2	0.5942000000000001
Crystorld	2021-02-11	2	1	0	2	0.5942000000000001
Escape of Pinball	2021-02-14	1	1	0	1	0.5942000000000001
Eternity Protectors	2021-05-14	1	1	0	1	0.5942000000000001
Spacegirl	2021-05-19	1	1	0	1	0.5942000000000001
Rolf	2021-02-21	2	1	0	2	0.5942000000000001
Zahhak	2021-05-07	1	1	0	1	0.5942000000000001
endlessCorona	2021-02-10	1	1	0	1	0.5942000000000001
Match Puzzle	2021-02-21	2	1	0	2	0.5942000000000001
Dots n Lines	2021-02-28	2	1	0	2	0.5942000000000001
The Thief Girl	2021-08-16	2	1	0	2	0.5942000000000001
Plasma Spheres	2021-03-03	3	1	0	3	0.5942000000000001
Horde Slayer	2021-03-19	1	1	0	1	0.5942000000000001
Tower of Portal	2021-02-18	1	1	0	1	0.5942000000000001
RUSH!!!	2021-02-15	1	1	0	1	0.5942000000000001
VoidOut Parkour	2021-02-18	2	1	0	2	0.5942000000000001
Super Crazy Nynja	2021-07-23	1	1	0	1	0.5942000000000001
Assimilation X	2021-03-12	1	1	0	1	0.5942000000000001
Gaggle Brains!	2021-02-25	1	1	0	1	0.5942000000000001
Siege of the Swine	2021-03-01	1	1	0	1	0.5942000000000001
Super Can Cannon	2021-04-22	1	1	0	1	0.5942000000000001
VR Galactic Roller Coaster	2021-02-25	3	1	0	3	0.5942000000000001
Fast Break	2021-03-05	1	1	0	1	0.5942000000000001
The Holy Orange	2021-04-18	1	1	0	1	0.5942000000000001
HighQ Quiz	2021-03-25	1	1	0	1	0.5942000000000001
Island Herders	2021-03-03	1	1	0	1	0.5942000000000001
Christmas Griddlers	2021-03-15	3	1	0	3	0.5942000000000001
Boxoku!	2021-03-05	1	1	0	1	0.5942000000000001
COUNT THE DEAD	2021-03-11	2	1	0	2	0.5942000000000001
TankWar Nexus	2021-03-06	1	1	0	1	0.5942000000000001
No Going Back	2021-03-05	1	1	0	1	0.5942000000000001
Dark Pathways	2021-06-01	2	1	0	2	0.5942000000000001
Omega-Altro	2021-03-01	1	1	0	1	0.5942000000000001
Victor	2021-06-15	1	1	0	1	0.5942000000000001
TheLastHope	2021-08-09	1	1	0	1	0.5942000000000001
OVERSTARS	2021-03-16	1	1	0	1	0.5942000000000001
Dragon Blast - Crazy Action Super Hero Game	2021-03-27	1	1	0	1	0.5942000000000001
Generals. Positional Warfare	2021-04-14	2	1	0	2	0.5942000000000001
Legacy Bites	2021-03-23	1	1	0	1	0.5942000000000001
Zerone 2D	2021-11-08	1	1	0	1	0.5942000000000001
Tower Attack	2021-10-17	1	1	0	1	0.5942000000000001
Maze Workout - Lost Urban Exit Game - Trials1	2021-04-02	2	1	0	2	0.5942000000000001
Cosmic Tank	2021-04-07	2	1	0	2	0.5942000000000001
Vacation Adventures: Park Ranger 11	2021-05-25	5	1	0	5	0.5942000000000001
COMBOHEAD	2021-04-05	1	1	0	1	0.5942000000000001
Sands of Fire	2021-04-02	1	1	0	1	0.5942000000000001
Search for the Titanic	2021-04-02	2	1	0	2	0.5942000000000001
Puzzle Pieces	2021-04-02	2	1	0	2	0.5942000000000001
Automation* of Sorts	2021-10-04	3	1	0	3	0.5942000000000001
Kaboom!	2021-07-30	4	1	0	4	0.5942000000000001
Extreme Peg Solitaire	2021-03-29	1	1	0	1	0.5942000000000001
原体：出逃	2021-06-05	1	1	0	1	0.5942000000000001
Fish Feast	2021-04-09	2	1	0	2	0.5942000000000001
ParticuLights	2021-04-01	1	1	0	1	0.5942000000000001
Tactical Battle Chronicles: Prelude to a War	2021-04-07	2	1	0	2	0.5942000000000001
Pocket Mina	2021-07-12	2	1	0	2	0.5942000000000001
Pearls of the Oceans	2021-10-04	2	1	0	2	0.5942000000000001
Landing Confirmed	2021-04-29	2	1	0	2	0.5942000000000001
Furry Shakespeare: To Date Or Not To Date Spooky Cat Girls?	2021-11-16	1	1	0	1	0.5942000000000001
Furry Shakespeare: Oops! All Dragons!	2021-09-02	1	1	0	1	0.5942000000000001
Pillow Bellow	2021-09-20	1	1	0	1	0.5942000000000001
1 Hop	2021-04-22	2	1	0	2	0.5942000000000001
Tower Alchemy	2021-11-01	2	1	0	2	0.5942000000000001
Laser Droplets	2021-04-15	2	1	0	2	0.5942000000000001
Memorize Cards	2021-04-13	1	1	0	1	0.5942000000000001
MAYBE I CAN	2021-06-17	1	1	0	1	0.5942000000000001
悠悠猴大冒险	2021-04-22	2	1	0	2	0.5942000000000001
Open World Foreva	2021-06-07	2	1	0	2	0.5942000000000001
ScreenSpace	2021-04-23	2	1	0	2	0.5942000000000001
Astral Cube	2021-04-23	1	1	0	1	0.5942000000000001
JumpCubox	2021-05-06	1	1	0	1	0.5942000000000001
EyeRoll	2021-04-23	1	1	0	1	0.5942000000000001
Topsy Turvy	2021-05-13	1	1	0	1	0.5942000000000001
Solitaire Legend of the Pirates 3	2021-05-10	6	1	0	6	0.5942000000000001
Pack of Demons	2021-11-15	2	1	0	2	0.5942000000000001
Alma	2021-12-06	1	1	0	1	0.5942000000000001
Mazeing	2021-06-14	1	1	0	1	0.5942000000000001
Timothy Leary's Mind Mirror	2021-09-02	1	1	0	1	0.5942000000000001
Clouds no more	2021-06-16	1	1	0	1	0.5942000000000001
Kate Kite	2021-05-08	2	1	0	2	0.5942000000000001
MariAlbum	2021-05-03	1	1	0	1	0.5942000000000001
Hack Bomb BOMA-YE	2021-06-06	4	1	0	4	0.5942000000000001
BunnyShot	2021-05-03	1	1	0	1	0.5942000000000001
Comet Crusher	2021-05-31	1	1	0	1	0.5942000000000001
Valley General Hospital NiVR	2021-08-01	1	1	0	1	0.5942000000000001
Cub Gym	2021-05-05	1	1	0	1	0.5942000000000001
Altruism	2021-05-14	1	1	0	1	0.5942000000000001
Asterism Basketball	2021-05-11	2	1	0	2	0.5942000000000001
Dungeonite	2021-06-18	2	1	0	2	0.5942000000000001
Battle Snakes	2021-10-23	4	1	0	4	0.5942000000000001
Path to Heaven	2021-05-17	1	1	0	1	0.5942000000000001
Yokai Taiji	2021-07-01	1	1	0	1	0.5942000000000001
Wolfriders A Sniper Adventure	2021-06-10	1	1	0	1	0.5942000000000001
Santa Soccer	2021-05-21	2	1	0	2	0.5942000000000001
Oversight	2021-06-04	5	1	0	5	0.5942000000000001
Super Swarm Smash	2021-05-14	1	1	0	1	0.5942000000000001
Gustav Vasa: Adventures in the Dales	2021-06-01	1	1	0	1	0.5942000000000001
Endless Heck	2021-05-21	1	1	0	1	0.5942000000000001
Myth of Ethary	2021-06-04	2	1	0	2	0.5942000000000001
Detective Solitaire The Ghost Agency	2021-09-10	5	1	0	5	0.5942000000000001
Anyek	2021-09-10	2	1	0	2	0.5942000000000001
The Chatters Show	2021-06-12	3	1	0	3	0.5942000000000001
Squad Killer	2021-05-20	2	1	0	2	0.5942000000000001
Shadoworlds	2021-06-04	1	1	0	1	0.5942000000000001
Cupcake Remember	2021-10-08	1	1	0	1	0.5942000000000001
Artifacting	2021-06-03	1	1	0	1	0.5942000000000001
School ! Love ☆ Reflex	2021-11-05	2	1	0	2	0.5942000000000001
Universe999999	2021-06-03	2	1	0	2	0.5942000000000001
Ichth.ys	2021-05-25	1	1	0	1	0.5942000000000001
One Hell of a Trip	2021-06-02	2	1	0	2	0.5942000000000001
水果祖玛 | Fruit Zumba	2021-06-15	4	1	0	4	0.5942000000000001
BeatJunkies	2021-07-24	2	1	0	2	0.5942000000000001
Our Beautiful Earth 2	2021-06-02	3	1	0	3	0.5942000000000001
Dinobag's Arcade	2021-08-21	1	1	0	1	0.5942000000000001
SEN.TUR.	2021-09-01	1	1	0	1	0.5942000000000001
I.O.R.C Impact Orbital Rescue Crew	2021-06-07	1	1	0	1	0.5942000000000001
Inside The Line	2021-07-08	1	1	0	1	0.5942000000000001
The Terrible Persistence of Memory	2021-06-15	1	1	0	1	0.5942000000000001
The Loneliest Artist	2021-08-06	2	1	0	2	0.5942000000000001
If You Go Down In The Woods Today	2021-10-14	1	1	0	1	0.5942000000000001
The phenomenon of Edgar Allan Poe 1/2	2021-11-01	1	1	0	1	0.5942000000000001
たたかえ！ハルモニア音楽隊	2021-08-20	2	1	0	2	0.5942000000000001
Church of the Midnight Sailor	2021-06-29	2	1	0	2	0.5942000000000001
Gobot	2021-06-29	1	1	0	1	0.5942000000000001
PEOPLEDOWN	2021-07-21	2	1	0	2	0.5942000000000001
Cold Hill	2021-08-18	1	1	0	1	0.5942000000000001
Black Mansion	2021-06-15	2	1	0	2	0.5942000000000001
Zombie Apocalypse 2021	2021-06-25	1	1	0	1	0.5942000000000001
HABITAT: Race To Mars	2021-10-26	1	1	0	1	0.5942000000000001
MayBlues	2021-07-22	1	1	0	1	0.5942000000000001
Adventures of Human Being	2021-07-28	2	1	0	2	0.5942000000000001
Switch It	2021-06-17	1	1	0	1	0.5942000000000001
Themes of Dark and Light	2021-09-15	3	1	0	3	0.5942000000000001
Super Shield Dash	2021-08-22	1	1	0	1	0.5942000000000001
MyHoriZen	2021-09-15	1	1	0	1	0.5942000000000001
Witty witch	2021-10-29	2	1	0	2	0.5942000000000001
Sprite Sequence Chapter 2	2021-10-15	2	1	0	2	0.5942000000000001
Neon: Eternal	2021-07-26	1	1	0	1	0.5942000000000001
RE:Jump Boy	2021-07-31	2	1	0	2	0.5942000000000001
wav ocs game	2021-08-17	1	1	0	1	0.5942000000000001
Griddlers Beach Season	2021-07-19	4	1	0	4	0.5942000000000001
Virtual Amusement	2021-08-04	1	1	0	1	0.5942000000000001
Ammo 666	2021-07-02	2	1	0	2	0.5942000000000001
Dwarves Craft. Mountain Brothers	2021-09-16	5	1	0	5	0.5942000000000001
Shiba Mekuri 柴めくり	2021-07-15	2	1	0	2	0.5942000000000001
Geisterland	2021-07-31	1	1	0	1	0.5942000000000001
Egg of Empire	2021-07-14	2	1	0	2	0.5942000000000001
DeHexTD	2021-07-08	2	1	0	2	0.5942000000000001
There May Be Ninety-Nine Of Us, But We Have To Win In Ninety-Nine Turns!	2021-07-14	2	1	0	2	0.5942000000000001
White Eyes	2021-07-26	1	1	0	1	0.5942000000000001
MEMORIES	2021-09-14	1	1	0	1	0.5942000000000001
Profectus	2021-07-30	3	1	0	3	0.5942000000000001
Oval Racer Series - Sandbox	2021-11-19	2	1	0	2	0.5942000000000001
Metal Faith	2021-08-02	1	1	0	1	0.5942000000000001
Zombardment	2021-08-31	1	1	0	1	0.5942000000000001
Ayoub Episode 2	2021-09-22	1	1	0	1	0.5942000000000001
VR Eagles of Victorian England	2021-07-26	2	1	0	2	0.5942000000000001
Hinata in Hot Maze	2021-09-02	1	1	0	1	0.5942000000000001
Sneezeman: Escape From Planet Sneeze	2021-10-01	1	1	0	1	0.5942000000000001
Pop's	2021-11-01	2	1	0	2	0.5942000000000001
Simple Sky	2021-09-22	2	1	0	2	0.5942000000000001
Bunny Puzzle	2021-10-15	1	1	0	1	0.5942000000000001
Color by Number - Medieval Portrait	2021-08-03	2	1	0	2	0.5942000000000001
Qualia's Sweets Craft / クオリアのお菓子工房	2021-08-27	2	1	0	2	0.5942000000000001
Tales from Ahrum	2021-10-10	3	1	0	3	0.5942000000000001
HangTogether	2021-09-01	4	1	0	4	0.5942000000000001
Mind Space	2021-11-15	1	1	0	1	0.5942000000000001
Burning Brick Breaker	2021-09-13	2	1	0	2	0.5942000000000001
Chromancy	2021-08-07	2	1	0	2	0.5942000000000001
The other side: My own horror	2021-08-27	1	1	0	1	0.5942000000000001
Unionatic	2021-10-10	3	1	0	3	0.5942000000000001
Adventurers Guild	2021-09-06	2	1	0	2	0.5942000000000001
Find Objects	2021-08-10	2	1	0	2	0.5942000000000001
EscapeThisBigMaze!	2021-08-16	1	1	0	1	0.5942000000000001
Zombie Quest	2021-12-21	2	1	0	2	0.5942000000000001
Star Fisher	2021-11-10	1	1	0	1	0.5942000000000001
Schizm: Mysterious Journey	2021-10-08	2	1	0	2	0.5942000000000001
Delicious Fruitworld	2021-12-11	2	1	0	2	0.5942000000000001
SAVED	2021-10-14	1	1	0	1	0.5942000000000001
Vacation Adventures: Park Ranger 12	2021-10-20	4	1	0	4	0.5942000000000001
Flyland Wars: 1 Mountain Climb	2021-10-04	1	1	0	1	0.5942000000000001
Nikhil Murthy's Syphilisation	2021-08-17	2	1	0	2	0.5942000000000001
Go Emoji Go The Maze	2021-08-19	1	1	0	1	0.5942000000000001
Metal Golem: First Contact	2021-08-23	1	1	0	1	0.5942000000000001
パズルハムスター ～地球冒険記～	2021-08-27	2	1	0	2	0.5942000000000001
Impossible Simplified Cube	2021-08-27	2	1	0	2	0.5942000000000001
Swinario Super Bros. Play	2021-09-20	1	1	0	1	0.5942000000000001
Survival Night	2021-08-27	1	1	0	1	0.5942000000000001
Poly Racing	2021-09-07	1	1	0	1	0.5942000000000001
生化迷城	2021-11-02	2	1	0	2	0.5942000000000001
MannaWars	2021-09-01	2	1	0	2	0.5942000000000001
Remy Raccoon and the Lost Temple	2021-09-24	1	1	0	1	0.5942000000000001
Caves Of Mars	2021-09-29	2	1	0	2	0.5942000000000001
Stationery Frontier	2021-09-08	2	1	0	2	0.5942000000000001
Terrain Defender	2021-10-29	1	1	0	1	0.5942000000000001
Flyland Wars: 2 Not Yours Mine	2021-10-04	1	1	0	1	0.5942000000000001
Star Age: Space Combat	2021-11-26	2	1	0	2	0.5942000000000001
Puzzle Fever	2021-09-09	1	1	0	1	0.5942000000000001
Kirkileons	2021-11-17	2	1	0	2	0.5942000000000001
Detention Club: School's Out	2021-09-07	2	1	0	2	0.5942000000000001
Hyper Bullet	2021-10-06	1	1	0	1	0.5942000000000001
Eyeballs are your ENEMIES!	2021-09-04	2	1	0	2	0.5942000000000001
Colours and Symbols	2021-09-30	2	1	0	2	0.5942000000000001
玄龙山	2021-12-14	1	1	0	1	0.5942000000000001
n2222	2021-11-29	1	1	0	1	0.5942000000000001
The Final Frontier	2021-09-12	1	1	0	1	0.5942000000000001
Galaxy Edge	2021-10-07	1	1	0	1	0.5942000000000001
Kingdom of Heroes	2021-09-21	2	1	0	2	0.5942000000000001
Farmers' Market	2021-10-01	2	1	0	2	0.5942000000000001
Collector Thief	2021-12-20	1	1	0	1	0.5942000000000001
Dalruan: World of Magic	2021-09-14	2	1	0	2	0.5942000000000001
Dreams Of The Elements	2021-10-06	4	1	0	4	0.5942000000000001
Spirit and Katana	2021-10-14	3	1	0	3	0.5942000000000001
Purify	2021-11-07	1	1	0	1	0.5942000000000001
Eternal night	2021-10-21	1	1	0	1	0.5942000000000001
ファントムゾーン　クリプトファシア	2021-11-26	1	1	0	1	0.5942000000000001
Sidequest : the video game	2021-11-22	2	1	0	2	0.5942000000000001
Running Water	2021-09-24	2	1	0	2	0.5942000000000001
Dance of Cubes	2021-09-15	1	1	0	1	0.5942000000000001
Circuit Breaker	2021-10-22	2	1	0	2	0.5942000000000001
Sailing Stone	2021-09-17	1	1	0	1	0.5942000000000001
Crom: Journey of Conquest	2021-09-27	2	1	0	2	0.5942000000000001
Crazy Athletics - Summer Sports & Games	2021-12-03	2	1	0	2	0.5942000000000001
Tile Connect - Onet Match	2021-09-23	5	1	0	5	0.5942000000000001
String Rush	2021-09-29	1	1	0	1	0.5942000000000001
Legends of Murder Collection	2021-10-01	2	1	0	2	0.5942000000000001
Ninja: Rise of a Hero	2021-09-24	2	1	0	2	0.5942000000000001
Last Defenders	2021-10-05	1	1	0	1	0.5942000000000001
Merge Chess	2021-09-26	1	1	0	1	0.5942000000000001
Imoto	2021-09-29	1	1	0	1	0.5942000000000001
Legend of Labot: The Golden Pearl	2021-11-17	1	1	0	1	0.5942000000000001
Lowsy	2021-09-27	1	1	0	1	0.5942000000000001
Sola	2021-09-28	2	1	0	2	0.5942000000000001
The Adventures of Emoji 4 : Fly High Mouse	2021-10-06	1	1	0	1	0.5942000000000001
Stint: Rift Apart	2021-10-22	1	1	0	1	0.5942000000000001
Pong Temple	2021-12-17	2	1	0	2	0.5942000000000001
Little Red Rocket Ship	2021-10-01	1	1	0	1	0.5942000000000001
Dungescape!	2021-10-03	1	1	0	1	0.5942000000000001
Rescue Troopers	2021-10-05	2	1	0	2	0.5942000000000001
是男人就跳一万米	2021-10-08	2	1	0	2	0.5942000000000001
RollingBall	2021-10-06	2	1	0	2	0.5942000000000001
The Tainted	2021-11-02	3	1	0	3	0.5942000000000001
Cards Matching Memory Game	2021-10-06	2	1	0	2	0.5942000000000001
Lack of Water	2021-10-15	2	1	0	2	0.5942000000000001
Facility	2021-11-15	2	1	0	2	0.5942000000000001
Connection	2021-10-25	1	1	0	1	0.5942000000000001
Vacation Adventures: Cruise Director 3	2021-10-13	3	1	0	3	0.5942000000000001
Destroying The Asteroids (Along With Unfair Hurdles)	2021-10-25	1	1	0	1	0.5942000000000001
The Northern Gate	2021-10-13	1	1	0	1	0.5942000000000001
QontoWars	2021-10-16	6	1	0	6	0.5942000000000001
Space Depression	2021-11-12	3	1	0	3	0.5942000000000001
Touhou Adventure	2021-10-20	1	1	0	1	0.5942000000000001
Play Outside Simulator	2021-10-26	1	1	0	1	0.5942000000000001
Anivenge	2021-11-22	1	1	0	1	0.5942000000000001
Das Boot: German U-Boat Simulation	2021-11-05	2	1	0	2	0.5942000000000001
AirPlane	2021-10-27	1	1	0	1	0.5942000000000001
A Frustrating Platformer	2021-10-26	1	1	0	1	0.5942000000000001
CubeLines	2021-10-29	3	1	0	3	0.5942000000000001
Ball Gun Arena	2021-11-26	1	1	0	1	0.5942000000000001
Space Gliders	2021-11-27	2	1	0	2	0.5942000000000001
The Pied Piper of Gamelin	2021-10-30	1	1	0	1	0.5942000000000001
Safari Cannon	2021-10-28	2	1	0	2	0.5942000000000001
A Hot Springs Vacation with my Married Office Lady Superior	2021-11-17	3	1	0	3	0.5942000000000001
Laypo Simulator	2021-11-18	2	1	0	2	0.5942000000000001
Timmy the Tiger's Big Adventure	2021-11-07	1	1	0	1	0.5942000000000001
Memory Lost-Pairs™	2021-11-05	2	1	0	2	0.5942000000000001
Hardcore: The Game	2021-11-04	1	1	0	1	0.5942000000000001
Poly Memory: Furries 2	2021-11-01	2	1	0	2	0.5942000000000001
Jump10000	2021-11-19	2	1	0	2	0.5942000000000001
THE SPRITE TRIALS	2021-11-17	3	1	0	3	0.5942000000000001
Elimination Games	2021-11-04	1	1	0	1	0.5942000000000001
Kill The Monster Z	2021-11-12	1	1	0	1	0.5942000000000001
NanoMachina	2021-12-01	2	1	0	2	0.5942000000000001
Toy Kingdom 3	2021-11-27	1	1	0	1	0.5942000000000001
Jumper	2021-11-20	1	1	0	1	0.5942000000000001
Tale of six	2021-11-12	1	1	0	1	0.5942000000000001
Being Ball	2021-11-23	2	1	0	2	0.5942000000000001
World Tree	2021-11-17	1	1	0	1	0.5942000000000001
TownOfDestruction	2021-11-23	2	1	0	2	0.5942000000000001
Injoku Byoutou	2021-12-21	1	1	0	1	0.5942000000000001
Boomerang Woman	2021-12-21	1	1	0	1	0.5942000000000001
Breakdown	2021-11-21	2	1	0	2	0.5942000000000001
Space Waves	2021-11-16	1	1	0	1	0.5942000000000001
Wuhan Clan	2021-12-01	1	1	0	1	0.5942000000000001
Mech Arena	2021-12-11	3	1	0	3	0.5942000000000001
Race On Ice 2020 Pro	2021-12-03	14	1	0	14	0.5942000000000001
In Shape 2	2021-11-23	1	1	0	1	0.5942000000000001
Sirberia Front	2021-12-16	5	1	0	5	0.5942000000000001
Middle Ages Jigsaw Puzzles	2021-11-24	2	1	0	2	0.5942000000000001
Super Yodelland: Legend of the Katzenbär	2021-12-06	1	1	0	1	0.5942000000000001
Hot Roads	2021-11-26	2	1	0	2	0.5942000000000001
DREAM	2021-12-23	1	1	0	1	0.5942000000000001
Heroes of Egypt - The Curse of Sethos	2021-11-30	4	1	0	4	0.5942000000000001
Sorcerer's Tournament	2021-12-22	1	1	0	1	0.5942000000000001
No Rage Quit Dude	2021-12-02	2	1	0	2	0.5942000000000001
Fast Fruit	2021-12-06	1	1	0	1	0.5942000000000001
Generations Of Destruction	2021-12-13	1	1	0	1	0.5942000000000001
Space Survival	2021-12-17	2	1	0	2	0.5942000000000001
GravityPunk	2021-12-15	2	1	0	2	0.5942000000000001
Mugen Abisu	2021-12-09	2	1	0	2	0.5942000000000001
Christmas Sort Puzzle	2021-12-14	3	1	0	3	0.5942000000000001
Roadworks 2	2021-12-16	2	1	0	2	0.5942000000000001
VARIABLE PICTOGRAM JUMP	2021-12-19	5	1	0	5	0.5942000000000001
BetWin	2021-12-21	2	1	0	2	0.5942000000000001
Fast Delivery	2021-12-30	2	1	0	2	0.5942000000000001
Agent Stilus	2021-12-31	2	1	0	2	0.5942000000000001
Mother Stone	2021-12-29	2	1	0	2	0.5942000000000001
Ultimate Christmas Puzzler 2	2021-12-27	2	1	0	2	0.5942000000000001
FREEZEFRAME	2021-12-27	1	1	0	1	0.5942000000000001
Tomes and Quests: a Word RPG	2021-09-30	10	20	11	21	0.594
Torqued Up	2021-10-08	18	20	11	29	0.594
Horny Alice: Gothic Run	2021-08-27	6	33	19	25	0.5939
Negligee: Spring Clean	2021-08-20	31	15	8	39	0.5937
AstroBike	2021-10-20	6	15	8	14	0.5937
Realtime Mining Simulator	2021-03-28	8	15	8	16	0.5937
Dark Side of Fate	2021-07-23	10	15	8	18	0.5937
18Korea	2021-12-07	9	15	8	17	0.5937
Deep Cave	2021-12-23	3	15	8	11	0.5937
AMaze DOS	2021-12-30	3	15	8	11	0.5937
Brass: Birmingham	2021-12-01	117	227	144	261	0.593
Fallen Knight	2021-07-20	7	28	16	23	0.593
My Married Cousin's Need for Seed	2021-04-02	43	105	65	108	0.5926
Scavengers	2021-05-01	16787	5876	3946	20733	0.5921000000000001
Smoked Gun	2021-01-15	9	23	13	22	0.5921000000000001
The Mighty Vikings	2021-02-17	4	23	13	17	0.5921000000000001
COTTON REBOOT!	2021-11-11	7	23	13	20	0.5921000000000001
HIGHBLAST	2021-11-19	5	23	13	18	0.5921000000000001
Dragon And Home	2021-08-20	667	706	462	1129	0.5920000000000001
Secret Government	2021-04-15	128	160	101	229	0.5919
Starship Inspector	2021-01-07	10	31	18	28	0.5918
Room 54	2021-05-30	6	53	32	38	0.5912
约拍女神3	2021-03-27	6	18	10	16	0.5910000000000001
HEAT REBORN	2021-05-08	546	159	101	647	0.5906
Monkey vs Dino	2021-04-14	4	26	15	19	0.5906
《古斯塔奥：帝国重生》Gustavo Kingdom Rebirth	2021-02-04	3	13	7	10	0.59
Killer Ricky	2021-06-15	4	13	7	11	0.59
リアルタイムバトル将棋オンライン	2021-11-02	29	13	7	36	0.59
Space of Retaliation	2021-01-22	6	13	7	13	0.59
Holy Chick!	2021-03-30	5	13	7	12	0.59
Trap Arena	2021-03-12	2	13	7	9	0.59
Fruit Row	2021-03-31	3	13	7	10	0.59
COME INSIDE MY INNER WORLD	2021-04-20	14	13	7	21	0.59
Survive Isolation	2021-06-01	5	13	7	12	0.59
P.U.R.G.A.T.O.R.Y	2021-10-27	4	13	7	11	0.59
Garda	2021-11-11	6	13	7	13	0.59
Animal Cafe	2021-10-01	5	8	4	9	0.5897
Seena	2021-05-18	2	8	4	6	0.5897
KILLING A SUPERSTAR	2021-01-05	2	8	4	6	0.5897
Nympho wife	2021-01-17	3	8	4	7	0.5897
仙路志异	2021-06-10	3	8	4	7	0.5897
Höll Space 5D6	2021-05-21	4	8	4	8	0.5897
Otaku Club	2021-03-29	3	8	4	7	0.5897
World Racing '95	2021-05-28	2	8	4	6	0.5897
Ouroboros Dungeon	2021-05-05	4	8	4	8	0.5897
GunKour	2021-10-04	9	8	4	13	0.5897
Net VR Theater	2021-07-04	137	8	4	141	0.5897
Circular	2021-05-27	3	8	4	7	0.5897
Game of Love	2021-07-26	4	8	4	8	0.5897
SPACE DANCE	2021-07-20	2	8	4	6	0.5897
Chicken Defender	2021-09-06	3	8	4	7	0.5897
Food Decisions	2021-11-02	16	8	4	20	0.5897
Egg King	2021-12-10	2	8	4	6	0.5897
Base Dune	2021-11-18	2	8	4	6	0.5897
Maze Art: Green	2021-12-02	2	8	4	6	0.5897
Guardians of Hyelore	2021-09-29	31	29	17	48	0.5895
Veneficium	2021-03-18	40	40	24	64	0.5894
Robogal	2021-09-17	22	40	24	46	0.5894
Aeon Must Die!	2021-10-14	30	54	33	63	0.5893
FORECLOSED	2021-08-12	22	54	33	55	0.5893
Christmas Mansion	2021-12-08	17	21	12	29	0.5892000000000001
Guardians: Royal Journey	2021-07-14	48	32	19	67	0.5887
Hentai VR	2021-04-29	4	46	28	32	0.5885
Operator	2021-05-28	91	731	488	579	0.5879
Furry Sex Madness	2021-11-05	3	24	14	17	0.5879
斗罗大陆-王国印记	2021-05-08	102	113	72	174	0.5878
Left to Survive	2021-11-18	187	140	90	277	0.5876
Infinite Gateway	2021-01-03	4	16	9	13	0.5875
Bondage Girl	2021-03-12	7	16	9	16	0.5875
PROPHUNT	2021-07-05	17	16	9	26	0.5875
Dark Threads	2021-08-13	4	16	9	13	0.5875
Big Rumble Boxing: Creed Champions	2021-09-03	36	58	36	72	0.5872999999999999
M.A.R.S.	2021-10-28	3741	530	353	4094	0.5872
Verdict	2021-09-05	143	93	59	202	0.5872
诛天记	2021-07-15	134	102	65	199	0.5871000000000001
Stay in the Light	2021-02-23	8	27	16	24	0.5870000000000001
A Wake Inn	2021-02-25	10	27	16	26	0.5870000000000001
Whitehaven	2021-10-18	10	27	16	26	0.5870000000000001
80's Night	2021-11-05	3	27	16	19	0.5870000000000001
Dungeon No Dungeon	2021-11-20	257	296	195	452	0.5869
Dis The Game	2021-02-18	948	938	632	1580	0.5868
Unlasting Horror	2021-02-05	9	70	44	53	0.5867
Riddle Girl	2021-10-22	3	19	11	14	0.5859000000000001
KOBOLOK	2021-10-20	3	19	11	14	0.5859000000000001
Nira	2021-10-14	17	59	37	54	0.5857
Arc Wizards 3	2021-01-05	4	11	6	10	0.5855
Lazy Postman	2021-01-26	3	11	6	9	0.5855
Flatline	2021-02-20	3	11	6	9	0.5855
DrakulA	2021-02-25	2	11	6	8	0.5855
REFICUL 666	2021-03-30	4	11	6	10	0.5855
Recapture the Castle	2021-06-07	3	11	6	9	0.5855
Z-Company	2021-05-27	5	11	6	11	0.5855
Colorado Cocoa Club	2021-04-23	6	11	6	12	0.5855
Overcoming Obstacles	2021-04-29	4	11	6	10	0.5855
Tank Fantastic	2021-06-16	2	11	6	8	0.5855
Battlemage: Magic by Mail	2021-08-12	38	11	6	44	0.5855
Rolling Car	2021-07-20	2	11	6	8	0.5855
Queen of Honor	2021-09-10	9	11	6	15	0.5855
Lovely Girls Puzzle	2021-08-12	4	11	6	10	0.5855
Honey Milf	2021-10-08	4	11	6	10	0.5855
Empires of the Void II	2021-12-16	5	11	6	11	0.5855
盖世豪侠	2021-11-12	18	11	6	24	0.5855
舔狗模拟器	2021-11-05	32	71	45	77	0.5853
Asterix & Obelix Slap Them All!	2021-12-07	69	86	55	124	0.5852
VirtuaCreature	2021-04-23	14	22	13	27	0.5849000000000001
毛蟹穴	2021-10-20	9	22	13	22	0.5849000000000001
Hunter's Arena: Legends	2021-08-03	1079	780	530	1609	0.5844
North Modding Company: Bergsbruk	2021-02-25	32	51	32	64	0.5843
Challenge Speedball	2021-01-13	136	63	40	176	0.5841
Alien X	2021-01-08	5	31	19	24	0.5833
Bakumatsu Renka SHINSENGUMI	2021-06-16	9	14	8	17	0.5833
堕星之乱	2021-04-02	5	14	8	13	0.5833
At the behest of the Pike: Time To Run	2021-07-12	5	14	8	13	0.5833
江湖行	2021-07-08	25	14	8	33	0.5833
The Luffeltera Renovator	2021-10-05	22	14	8	30	0.5833
School Trip	2021-11-05	2	14	8	10	0.5833
End of this World	2021-11-12	4	14	8	12	0.5833
Speed Mazing	2021-10-21	5	6	3	8	0.5833
Prince Of Wallachia	2021-04-28	2	6	3	5	0.5833
Corpse Mansion	2021-10-29	2	6	3	5	0.5833
Seeds of Friendship	2021-03-16	4	6	3	7	0.5833
Nostalgici Anonimi	2021-01-24	2	6	3	5	0.5833
Pan-Arcade Airlines	2021-01-23	2	6	3	5	0.5833
Plumber	2021-01-21	3	6	3	6	0.5833
Victoria's Body	2021-02-08	8	6	3	11	0.5833
废土黄昏 Dusk of the wasteland age	2021-02-18	4	6	3	7	0.5833
Snow Wars	2021-03-13	2	6	3	5	0.5833
PewPew!	2021-02-23	3	6	3	6	0.5833
MineSweeper 3D 三维扫雷	2021-08-14	2	6	3	5	0.5833
Girls on puzzle 4	2021-03-26	3	6	3	6	0.5833
Hentai Muse	2021-07-17	7	6	3	10	0.5833
Final Pilot	2021-06-21	9	6	3	12	0.5833
The Sorcerer's Curse	2021-11-19	3	6	3	6	0.5833
Detective Rosie Morgan: Murder on the River Thames	2021-06-04	8	6	3	11	0.5833
True Visions	2021-12-30	6	6	3	9	0.5833
Blood for Poppies	2021-08-19	15	6	3	18	0.5833
Pirates of the Sea	2021-08-19	7	6	3	10	0.5833
Hentai beautiful girls 5	2021-09-04	3	6	3	6	0.5833
Suddenly Meow	2021-09-02	5	6	3	8	0.5833
致命游戏-Lethal Gamble 1 Werewolf Puzzle	2021-09-15	6	6	3	9	0.5833
周松转	2021-10-05	5	6	3	8	0.5833
HAJWALA LINE	2021-09-17	4	6	3	7	0.5833
EVAN QUEST	2021-09-17	3	6	3	6	0.5833
Fly Or Die	2021-11-25	2	6	3	5	0.5833
Miasma: Citizens of Free Thought	2021-11-03	2	6	3	5	0.5833
She Hates Unicorns	2021-11-19	2	6	3	5	0.5833
Huntress: The cursed Village	2021-11-27	3	6	3	6	0.5833
Excavator Simulator VR	2021-03-30	7	34	21	28	0.583
Links E6	2021-06-28	30	55	35	65	0.5825
SAD RPG	2021-11-11	10	17	10	20	0.5821000000000001
Draft Day Sports: College Football 2021	2021-02-05	36	17	10	46	0.5821000000000001
Unmetaverse	2021-12-15	14	17	10	24	0.5821000000000001
BALAN WONDERWORLD	2021-03-26	124	210	141	265	0.5815
The Scary Square	2021-01-15	5	20	12	17	0.5814
Citor3 Santa's Elf VR Adult XXX Game	2021-02-07	5	20	12	17	0.5814
The Farmthis Gallery	2021-07-21	8	20	12	20	0.5814
Cladmen	2021-05-23	11	20	12	23	0.5814
Trashyard	2021-08-08	5	20	12	17	0.5814
Shachibato! President, It's Time for Battle! Maju Wars	2021-03-31	59	56	36	95	0.5809000000000001
Claire de Lune	2021-07-12	20	26	16	36	0.5807
Last Standing	2021-05-03	26	47	30	56	0.5806
Tile Miner	2021-11-11	8	38	24	32	0.5805
Dizzy Two	2021-02-01	14	29	18	32	0.5805
Vicewave	2021-11-19	15	117	78	93	0.5796
There Was A Dream	2021-02-11	4	9	5	9	0.5796
Mercenary Skirmish	2021-03-26	6	9	5	11	0.5796
Million on Mars	2021-09-21	8	9	5	13	0.5796
Sheriff Exam	2021-05-17	2	9	5	7	0.5796
Farlight Commanders: Prologue	2021-03-09	8	9	5	13	0.5796
Erotic Jigsaw Puzzle	2021-04-17	3	9	5	8	0.5796
Bouncing Traveler	2021-05-24	6	9	5	11	0.5796
Hustle Game	2021-07-20	2	9	5	7	0.5796
TIERRA - Mystery Point & Click Adventure	2021-07-20	3	9	5	8	0.5796
Escape from DuFo	2021-08-14	2	9	5	7	0.5796
CUBE-e 2	2021-08-26	2	9	5	7	0.5796
Card Game Simulator	2021-11-15	9	9	5	14	0.5796
Memories Of Loneliness	2021-09-27	2	9	5	7	0.5796
Adult Puzzles - Fantasy Ladies	2021-10-16	2	9	5	7	0.5796
Anime Jigsaw Girls - Office	2021-11-05	2	9	5	7	0.5796
Murder by Moonlight 2 - Crimson Night	2021-12-08	3	9	5	8	0.5796
S.O.T.A 2	2021-07-14	69	196	133	202	0.579
Succubus: Hunt For Meal	2021-09-03	38	86	57	95	0.5787
My Step Sisters	2021-02-16	12	64	42	54	0.5784
nightshift	2021-07-30	8	42	27	35	0.5784
Dungeon Limbus	2021-02-14	33	12	7	40	0.5782
Re: Award	2021-05-31	4	12	7	11	0.5782
Tales From Yeoldeburg	2021-01-05	3	12	7	10	0.5782
duck flighting	2021-08-02	2	12	7	9	0.5782
Ritual	2021-03-25	2	12	7	9	0.5782
Ahri and Bear	2021-04-30	5	12	7	12	0.5782
Cardiac Unrest	2021-05-22	4	12	7	11	0.5782
Hentai BDSM	2021-11-06	3	12	7	10	0.5782
Hot Milf	2021-11-09	4	12	7	11	0.5782
Draft Day Sports: Pro Basketball 2022	2021-12-02	29	12	7	36	0.5782
Mars parking simulator	2021-12-02	2	12	7	9	0.5782
Murder of the Bear lake	2021-12-15	2	12	7	9	0.5782
NBA 2K22	2021-09-10	46661	21972	15822	62483	0.578
SEX Prison [18+]	2021-11-20	692	58	38	730	0.5779
Monogon: Echoes	2021-05-14	136	33	21	157	0.5779
Survival Simulator	2021-06-11	18	15	9	27	0.5776
Trump VS Covid: Save The World Clicker	2021-01-05	7	15	9	16	0.5776
VR Walking Simulator	2021-07-13	4	15	9	13	0.5776
Ressifice	2021-09-30	3	15	9	12	0.5776
HELPLESS	2021-06-10	4	15	9	13	0.5776
Transporter Manager Tycoon	2021-04-02	13	21	13	26	0.5773
Interregnum Chronicles: Signal	2021-07-22	17	21	13	30	0.5773
Paradise Trails	2021-09-29	16	21	13	29	0.5773
functional	2021-07-09	6	18	11	17	0.5773
胡莱三国3	2021-09-08	107	46	30	137	0.5768
Journey of Life	2021-02-01	257	431	301	558	0.5766
文字三国	2021-07-15	132	108	73	205	0.5765
Superstar Racing	2021-04-01	60	96	65	125	0.5755
Mighty forest	2021-02-03	7	50	33	40	0.5754
Car Mechanic Simulator VR	2021-06-08	59	161	111	170	0.5749000000000001
The Looking Stone	2021-09-06	313	134	92	405	0.5748
Vantage: Primitive Survival Game	2021-12-02	13	44	29	42	0.5746
Carp Fishing Simulator	2021-10-14	21	121	83	104	0.5744
GunboundM	2021-12-14	155	142	98	253	0.5740999999999999
LuvSic	2021-06-18	253	118	81	334	0.5740999999999999
Sharknado VR: Eye of the Storm (Arcade Edition)	2021-12-09	2	4	2	4	0.5739
Grand Attrition	2021-09-28	3	4	2	5	0.5739
Maze Banquet	2021-08-10	2	4	2	4	0.5739
City Of Thugs	2021-10-02	3	4	2	5	0.5739
Franky the Bumwalker: REBORN	2021-03-03	2	4	2	4	0.5739
Highlaundry	2021-07-13	6	4	2	8	0.5739
Soul Shifter	2021-08-24	2	4	2	4	0.5739
Asdivine Cross	2021-03-05	8	4	2	10	0.5739
Fool's Paradise	2021-09-09	4	4	2	6	0.5739
Move Forward	2021-04-24	2	4	2	4	0.5739
Hamster Logic 3D	2021-06-26	5	4	2	7	0.5739
Scraplers	2021-02-19	2	4	2	4	0.5739
SAW HELL	2021-02-23	2	4	2	4	0.5739
飞花令 春饼	2021-02-12	2	4	2	4	0.5739
孙美琪疑案 第三季	2021-01-22	5	4	2	7	0.5739
Exit Strategy	2021-02-05	5	4	2	7	0.5739
PATHFINDER 08	2021-01-28	2	4	2	4	0.5739
Firescout	2021-03-12	2	4	2	4	0.5739
flaming/million	2021-02-15	2	4	2	4	0.5739
Overpower	2021-07-15	4	4	2	6	0.5739
Survive after hell	2021-03-12	2	4	2	4	0.5739
RoadPunk	2021-02-20	3	4	2	5	0.5739
Dungen	2021-04-06	4	4	2	6	0.5739
Escape From My Turrets	2021-03-10	2	4	2	4	0.5739
Escape The Ordinary: Tales of Romina Manor	2021-02-25	2	4	2	4	0.5739
Great Battles of Karl XII	2021-05-16	3	4	2	5	0.5739
Mystery Tales: Master of Puppets Collector's Edition	2021-03-05	10	4	2	12	0.5739
Hyperspace : Andy's Adventure	2021-03-18	2	4	2	4	0.5739
Contrast Tunnel	2021-03-16	3	4	2	5	0.5739
Desktop AI - Lily	2021-05-05	2	4	2	4	0.5739
Dr Iwan	2021-11-19	3	4	2	5	0.5739
Ultima Adventum	2021-04-15	3	4	2	5	0.5739
Bonegard	2021-04-01	1	4	2	3	0.5739
The Most Boring Life Ever	2021-04-08	3	4	2	5	0.5739
Legend of Azcarth	2021-05-26	4	4	2	6	0.5739
LSDriver 1+2 (Remastered Collection)	2021-04-22	2	4	2	4	0.5739
Jurassic mahjong	2021-05-17	4	4	2	6	0.5739
Jivitam	2021-05-01	1	4	2	3	0.5739
青の镇物语	2021-07-10	3	4	2	5	0.5739
Combat Casino	2021-07-29	3	4	2	5	0.5739
Setup Developer Tool 2021	2021-05-31	5	4	2	7	0.5739
Moxina	2021-05-19	4	4	2	6	0.5739
Halloween Patchwork Trick or Treat	2021-07-16	3	4	2	5	0.5739
Domination	2021-09-02	2	4	2	4	0.5739
50 Waves Hero	2021-07-17	28	4	2	30	0.5739
Oozing Islands	2021-08-22	2	4	2	4	0.5739
Terragon: Symbol Of Magic	2021-09-08	3	4	2	5	0.5739
Ironfell 2	2021-07-29	3	4	2	5	0.5739
The Far Kingdoms: Magic Mosaics	2021-08-17	3	4	2	5	0.5739
The Rescue Squad	2021-08-25	2	4	2	4	0.5739
Heavenly Hammer	2021-10-09	2	4	2	4	0.5739
ButtonMash	2021-09-14	2	4	2	4	0.5739
Shuriken	2021-12-02	2	4	2	4	0.5739
2033: Das Erschwachen der Macht	2021-09-01	3	4	2	5	0.5739
George	2021-10-28	2	4	2	4	0.5739
Apocalyptic Adventure: Episode 1	2021-10-21	2	4	2	4	0.5739
Drowned Helicopter	2021-09-10	1	4	2	3	0.5739
Core Alpha	2021-09-28	3	4	2	5	0.5739
Evil Soul	2021-09-09	3	4	2	5	0.5739
Danplace	2021-09-13	3	4	2	5	0.5739
POWERNAUT 2	2021-09-24	2	4	2	4	0.5739
Mary Knots - Garden Wedding	2021-09-15	4	4	2	6	0.5739
Starry Moon Island	2021-10-28	2	4	2	4	0.5739
Soccer Boss	2021-10-21	4	4	2	6	0.5739
HotGirls Sliding Puzzle	2021-09-09	2	4	2	4	0.5739
Hockey VR	2021-10-14	3	4	2	5	0.5739
Sumy Shelltris - ICEBLOCKS 1	2021-11-03	1	4	2	3	0.5739
Robin Hood: Spring of Life	2021-11-24	14	4	2	16	0.5739
Another Day in Paradise	2021-12-18	2	4	2	4	0.5739
Scripture	2021-12-05	3	4	2	5	0.5739
Jane The Reaper	2021-12-22	2	4	2	4	0.5739
NYKRA: Before	2021-09-27	71	61	41	112	0.5737
Ryte: The Eye Of Atlantis	2021-01-27	13	19	12	25	0.5731
Cross Soul	2021-11-05	33	19	12	45	0.5731
Hentai GIF Puzzle	2021-05-01	3	19	12	15	0.5731
Junkpunk: Arena	2021-08-31	15	19	12	27	0.5731
Arena Tactics	2021-06-18	145	19	12	157	0.5731
Christmas Horror	2021-12-03	6	19	12	18	0.5731
Machinist	2021-04-20	17	16	10	27	0.5726
Bromeliad	2021-01-30	8	16	10	18	0.5726
lightblue	2021-02-28	4	16	10	14	0.5726
Spider-Robots War	2021-04-02	2	16	10	12	0.5726
Farming Engine	2021-04-23	11	16	10	21	0.5726
Neokaiju	2021-07-03	8	16	10	18	0.5726
Rust 'n Dust	2021-09-13	6	16	10	16	0.5726
封灵档案	2021-01-08	961	817	588	1549	0.5723
Car Constructor	2021-05-08	11	52	35	46	0.5723
Ulna Online	2021-03-12	22	13	8	30	0.5721
Undiscovered House	2021-03-24	3	13	8	11	0.5721
7 Years' War	2021-05-31	2	13	8	10	0.5721
Space Ninja Simulator VR	2021-03-25	10	13	8	18	0.5721
BENTO GIRL	2021-03-26	6	13	8	14	0.5721
Pets No More	2021-07-26	5	13	8	13	0.5721
Puppy Adventure	2021-05-23	2	13	8	10	0.5721
Mini Racing World	2021-07-26	5	13	8	13	0.5721
An Odd Tale	2021-07-31	6	13	8	14	0.5721
Winter Warfare: Survival	2021-11-09	8	13	8	16	0.5721
The Quiet Apocalypse	2021-11-11	6	13	8	14	0.5721
Spooky Mahjong	2021-11-09	2	13	8	10	0.5721
Underwater World	2021-12-03	6	13	8	14	0.5721
Sword and Fairy 5	2021-06-17	38	29	19	57	0.5719
RiMS Racing	2021-08-19	680	622	447	1127	0.5718
Minimal Move	2021-03-31	5	7	4	9	0.5718
The Makings of a Lady - Purity Yours to Defile -	2021-05-14	3	7	4	7	0.5718
The Last Kids on Earth and the Staff of Doom!	2021-06-04	6	7	4	10	0.5718
DoHots	2021-04-26	4	7	4	8	0.5718
Delivery Company Clicker	2021-05-25	5	7	4	9	0.5718
Z-Blood Mission	2021-01-15	2	7	4	6	0.5718
Bushfires: Animal Rescue	2021-01-22	5	7	4	9	0.5718
Asian Mahjong	2021-03-16	3	7	4	7	0.5718
Dreams Of Adventure	2021-10-07	4	7	4	8	0.5718
PRISONER 17	2021-04-12	7	7	4	11	0.5718
Retro Tank Party	2021-04-20	6	7	4	10	0.5718
Redaxium	2021-12-27	3	7	4	7	0.5718
Mind Shadows	2021-04-15	2	7	4	6	0.5718
ZeroChance	2021-04-23	2	7	4	6	0.5718
Skeleton Wave	2021-05-04	2	7	4	6	0.5718
Cyborpunk Crisis	2021-05-29	5	7	4	9	0.5718
Armed Emeth	2021-08-06	24	7	4	28	0.5718
Beyond The Gates	2021-07-22	6	7	4	10	0.5718
SnowTunes Island	2021-12-01	2	7	4	6	0.5718
Sapling	2021-07-30	2	7	4	6	0.5718
Splash Jump	2021-08-02	2	7	4	6	0.5718
Valkyrie: Journey To Midgard	2021-08-28	3	7	4	7	0.5718
Destruction Dummies	2021-12-24	3	7	4	7	0.5718
Lawnmower Game: Space Fight	2021-10-26	2	7	4	6	0.5718
TARAKAN	2021-09-18	4	7	4	8	0.5718
PixGirls	2021-10-16	2	7	4	6	0.5718
KSTG	2021-10-19	5	7	4	9	0.5718
A Fishy RPG	2021-11-05	4	7	4	8	0.5718
Jetpack Vacation	2021-11-18	11	10	6	17	0.5717
Push Your Family	2021-09-22	23	10	6	29	0.5717
Capsule Hotel Simulator	2021-01-24	4	10	6	10	0.5717
Crazy Derby Racing	2021-09-11	2	10	6	8	0.5717
The Island of Dr. Yepstein	2021-09-17	3	10	6	9	0.5717
Neon Warrior	2021-03-02	3	10	6	9	0.5717
T. B. P.	2021-02-11	2	10	6	8	0.5717
Velocity Vector	2021-03-11	3	10	6	9	0.5717
Cutie Bear	2021-03-30	3	10	6	9	0.5717
猫头鹰和灯塔	2021-07-12	16	10	6	22	0.5717
Zombie Freaks	2021-05-28	2	10	6	8	0.5717
Alien Planet Explorer	2021-05-11	2	10	6	8	0.5717
Armored	2021-06-02	2	10	6	8	0.5717
Карьера Президента	2021-07-27	7	10	6	13	0.5717
Academy of Magic: Dark Possession	2021-08-12	5	10	6	11	0.5717
Modest Eyes	2021-12-03	3	10	6	9	0.5717
World of Bärn	2021-12-09	2	10	6	8	0.5717
UFO2: Extraterrestrials	2021-06-15	74	80	55	129	0.5715
SQUID GUYS	2021-12-04	82	108	75	157	0.5714
Hello Teacher	2021-06-16	11	26	17	28	0.5712
Bad boy simulator	2021-01-02	14	36	24	38	0.5710000000000001
Surgical Robot Simulator	2021-09-18	9	36	24	33	0.5710000000000001
Kingdom Builders	2021-06-24	104	152	107	211	0.5706
Power & Revolution 2021 Edition	2021-08-04	625	442	318	943	0.5705
Grand Casino Tycoon	2021-05-20	59	30	20	79	0.5694
NERTHUS: EINAR´S FATE	2021-07-15	8	20	13	21	0.5694
DwarfHeim	2021-09-27	410	333	240	650	0.5692
Toy Soldiers HD 	2021-10-21	87	65	45	132	0.5689000000000001
Dinosaurs Prehistoric Survivors	2021-08-13	9	44	30	39	0.5688000000000001
Prank!	2021-08-20	7	27	18	25	0.5684
Girls' civilization 2	2021-06-01	10	17	11	21	0.5683
Red Colony Uncensored	2021-08-13	16	17	11	27	0.5683
UFO Checkers	2021-10-01	6	17	11	17	0.5683
Dude Simulator 4	2021-07-23	23	209	150	173	0.5682
CosmicBreak Universal	2021-04-07	2642	680	498	3140	0.5681
Spacebase Startopia	2021-03-26	726	319	231	957	0.568
Burned Land	2021-08-09	14	48	33	47	0.568
King of Seas	2021-05-25	1138	368	268	1406	0.5674
Drifters Loot the Galaxy	2021-04-15	168	81	57	225	0.5673
Epidemic	2021-03-05	10	14	9	19	0.5669
Dark Podval	2021-02-01	2	14	9	11	0.5669
Old Evil	2021-07-14	3	14	9	12	0.5669
Endless Furry Pinball 2D	2021-03-09	3	14	9	12	0.5669
Who Are You?	2021-05-20	3	14	9	12	0.5669
Nearly Dead	2021-09-10	51	146	105	156	0.5662
Moi Mei 2	2021-02-24	4	21	14	18	0.5660000000000001
CyberSex 2069	2021-06-14	10	21	14	24	0.5660000000000001
Ball Adventure Ball Simulator	2021-05-11	6	28	19	25	0.5659000000000001
The Dive	2021-08-18	3	39	27	30	0.5653
Drive	2021-07-23	4	11	7	11	0.5653
ANIME Street Fight	2021-03-06	2	11	7	9	0.5653
Endless Love	2021-06-22	3	11	7	10	0.5653
Escape from Nowhere	2021-07-17	2	11	7	9	0.5653
Yoshimitsu Hatsumi	2021-07-23	2	11	7	9	0.5653
Robosnow	2021-09-09	2	11	7	9	0.5653
From Paris with Love: Passion with view	2021-09-10	30	61	43	73	0.5652
Crazy Foods	2021-06-25	23	50	35	58	0.5652
Code Zero	2021-08-15	9	25	17	26	0.5645
GrandChase	2021-07-28	79883	11467	8726	88609	0.5644
Evil Inside	2021-03-25	44	115	83	127	0.5644
The Kind Camomille	2021-07-10	9	18	12	21	0.5644
正宗台灣十六張麻將3	2021-02-08	27	18	12	39	0.5644
Happy Halloween	2021-03-13	8	18	12	20	0.5644
Dark Forest: Lost Story VR	2021-04-11	3	18	12	15	0.5644
Secrets of the Lost Tomb	2021-10-06	6	18	12	18	0.5644
仙剑诀网络版	2021-07-16	88	36	25	113	0.5640999999999999
survive the island	2021-12-14	12	36	25	37	0.5640999999999999
WolfTeam: Classic	2021-02-18	3473	568	424	3897	0.5635
Search for Surf	2021-09-03	4	8	5	9	0.5632
LIMINALPHOBIA	2021-10-07	2	8	5	7	0.5632
Simon the Sorcerer 3D	2021-05-11	6	8	5	11	0.5632
Tail Trail	2021-04-29	6	8	5	11	0.5632
Retro Classix: Heavy Barrel	2021-03-02	3	8	5	8	0.5632
Hentai Royale	2021-07-23	3	8	5	8	0.5632
Sol Dorado Heist	2021-04-23	2	8	5	7	0.5632
Last Generation: Survival	2021-06-17	4	8	5	9	0.5632
Bullet Wave	2021-09-24	2	8	5	7	0.5632
Dash Dash Delivery	2021-07-26	4	8	5	9	0.5632
FOOTBALLER	2021-08-11	7	8	5	12	0.5632
Void Grimm	2021-12-10	4	8	5	9	0.5632
SGS Operation Hawaii	2021-12-07	5	8	5	10	0.5632
Futa Battle TD	2021-11-26	3	8	5	8	0.5632
The Collector	2021-11-26	3	8	5	8	0.5632
Maze Art: Orange	2021-12-04	3	8	5	8	0.5632
Slide Furry Boys	2021-12-15	2	8	5	7	0.5632
Mega Man X DiVE	2021-09-15	816	1044	786	1602	0.5631
Ace Campus Club	2021-05-01	18	22	15	33	0.5629
牛头人迷宫	2021-02-01	9	22	15	24	0.5629
Little adventure	2021-04-23	4	22	15	19	0.5629
Aquarist - first job	2021-09-16	32	48	34	66	0.5628000000000001
Zoo Cleaner	2021-02-15	6	33	23	29	0.5628000000000001
41 Hours	2021-05-21	6	15	10	16	0.5625
Wet Waifu	2021-08-25	5	15	10	15	0.5625
Dangerous platform	2021-10-18	2	15	10	12	0.5625
The Third Building 三教	2021-04-26	121	95	69	190	0.5622
Kingdoms In Chaos	2021-01-21	16	26	18	34	0.562
Into The Haze	2021-02-06	56	72	52	108	0.5618
Operation Airsoft	2021-07-30	24	136	100	124	0.5616
Grass Cutters Academy - Idle Game	2021-02-10	17	30	21	38	0.5614
Serene Asylum	2021-10-05	22	34	24	46	0.5609000000000001
Cast VR	2021-02-20	3	5	3	6	0.5605
Space Revenge - Prologue	2021-09-16	3	5	3	6	0.5605
Into the Pyramid	2021-01-01	8	5	3	11	0.5605
Hentai Breakout City	2021-04-30	2	5	3	5	0.5605
1001 Jigsaw: Earth Chronicles 3	2021-02-03	3	5	3	6	0.5605
Hachi Hachi Mystery	2021-01-19	5	5	3	8	0.5605
JAB!	2021-08-13	4	5	3	7	0.5605
Scribble Fight	2021-02-12	2	5	3	5	0.5605
Video Realms	2021-02-15	3	5	3	6	0.5605
LineArt Jigsaw Puzzle - Erotica 4	2021-03-20	3	5	3	6	0.5605
Cave Nightmare	2021-04-01	1	5	3	4	0.5605
Memorize V	2021-04-03	3	5	3	6	0.5605
ChikPack	2021-05-31	4	5	3	7	0.5605
AMID THE LINES	2021-06-10	2	5	3	5	0.5605
Perspective	2021-05-21	3	5	3	6	0.5605
LineArt Jigsaw Puzzle - Erotica 5	2021-05-22	2	5	3	5	0.5605
Super 3D Table Tennis	2021-05-26	2	5	3	5	0.5605
The Bolt Age	2021-08-20	1	5	3	4	0.5605
DEKONSTRUKT	2021-07-13	1	5	3	4	0.5605
Mystery Trackers: Nightsville Horror Collector's Edition	2021-05-21	16	5	3	19	0.5605
SUPER BOT	2021-06-05	2	5	3	5	0.5605
Jixxaw: Party Time	2021-06-15	3	5	3	6	0.5605
Anagraphs: An Anagram Game With a Twist	2021-06-21	4	5	3	7	0.5605
THE LAST DEFENSE!	2021-07-09	2	5	3	5	0.5605
Dodge	2021-06-29	2	5	3	5	0.5605
Erotic Jigsaw Puzzle Summer	2021-06-30	2	5	3	5	0.5605
Cat Jump	2021-08-18	2	5	3	5	0.5605
The Last Spark	2021-08-20	4	5	3	7	0.5605
SIT DOWN, PLEASE	2021-09-17	4	5	3	7	0.5605
Gems of Magic: Father's Day	2021-12-16	3	5	3	6	0.5605
Don't run out of Soda	2021-10-08	3	5	3	6	0.5605
Fossilfuel: Raptor Isolation VR	2021-10-28	3	5	3	6	0.5605
Fantasy Sliding Puzzle 3	2021-09-30	2	5	3	5	0.5605
Four Animals	2021-11-11	37	5	3	40	0.5605
Lights	2021-12-03	2	5	3	5	0.5605
Escape: Forced Overtime	2021-06-22	12	42	30	42	0.5604
Notruf 112 - Die Feuerwehr Simulation 2	2021-03-18	2880	1946	1493	4373	0.5602
Lost Angel	2021-02-11	23	23	16	39	0.5602
LASHEK	2021-03-29	3	12	8	11	0.56
Underwater Life	2021-04-20	3	12	8	11	0.56
Model Railway Easily 2	2021-10-30	3	12	8	11	0.56
Valor	2021-08-03	6	12	8	14	0.56
ヘブンズブレイザーオンライン	2021-07-11	5	12	8	13	0.56
Smoots Summer Games - First Training	2021-07-12	9	12	8	17	0.56
Arcade Galaxy	2021-11-12	2	12	8	10	0.56
拯救大魔王2:逆流 Falsemen2:Upstream	2021-07-30	45	111	82	127	0.5597
LONER	2021-04-03	7	27	19	26	0.5597
Horror Squad	2021-02-26	128	331	250	378	0.5595
Final Hope	2021-12-06	82	35	25	107	0.5592
Natural Instincts	2021-07-22	97	129	96	193	0.559
Isekai Eternal	2021-07-15	12	43	31	43	0.559
Belly Dance Girl	2021-05-05	3	16	11	14	0.5586
TowerMancer	2021-02-25	5	16	11	16	0.5586
Lasagna Boy	2021-06-18	7	16	11	18	0.5586
Viking Vengeance	2021-04-08	33	60	44	77	0.5579999999999999
USSR CHAN: Hentai Puzzle Game	2021-03-19	5	20	14	19	0.5579999999999999
Conquest of Empires	2021-10-29	20	20	14	34	0.5579999999999999
Pleasure Climb	2021-05-17	8	20	14	22	0.5579999999999999
Little adventure 2	2021-08-02	4	20	14	18	0.5579999999999999
Idle Monkeylogy	2021-08-31	232	56	41	273	0.5579
The Corpsmen	2021-04-23	8	24	17	25	0.5577000000000001
Dawnbreaker - Aeon's Reach	2021-11-05	18	24	17	35	0.5577000000000001
Zombie Hunter	2021-10-04	19	44	32	51	0.5576
Blade Walker	2021-11-18	10	28	20	30	0.5575
RhythmSlinger	2021-07-27	1	2	1	2	0.5569
The Perplexing Orb	2021-09-07	1	2	1	2	0.5569
Aether Way	2021-03-27	2	2	1	3	0.5569
Astrodition	2021-06-25	4	2	1	5	0.5569
Sword story	2021-09-27	1	2	1	2	0.5569
VR Summer Sports	2021-09-24	3	2	1	4	0.5569
Qual	2021-06-14	2	2	1	3	0.5569
Race Project	2021-06-26	4	2	1	5	0.5569
Break Robots VR	2021-10-26	1	2	1	2	0.5569
PengoRoyale	2021-12-19	4	2	1	5	0.5569
Sport Shooter	2021-07-25	4	2	1	5	0.5569
Twin Horizons	2021-02-20	4	2	1	5	0.5569
Bird Boxing	2021-08-20	3	2	1	4	0.5569
Lifesigns	2021-02-10	3	2	1	4	0.5569
Cyberwinter	2021-06-23	2	2	1	3	0.5569
The King of Warriors	2021-10-07	2	2	1	3	0.5569
Cave Explorer	2021-10-08	2	2	1	3	0.5569
WirtschaftsWoche Virtual Reality	2021-01-13	2	2	1	3	0.5569
TheDarkWay	2021-10-29	2	2	1	3	0.5569
Archons of Doom	2021-12-01	2	2	1	3	0.5569
枪林弹雨	2021-05-25	2	2	1	3	0.5569
The Last Islands of Man	2021-01-08	2	2	1	3	0.5569
蘑菇的冒险 MoGu's Adventure	2021-02-26	2	2	1	3	0.5569
Chat Millions	2021-01-01	2	2	1	3	0.5569
Aim: Warmup	2021-01-07	2	2	1	3	0.5569
The Alpha 001 | TAZZO	2021-01-18	2	2	1	3	0.5569
Eliminate Drips	2021-01-06	2	2	1	3	0.5569
Minforiga	2021-01-21	2	2	1	3	0.5569
Marble Ball Racing	2021-01-21	2	2	1	3	0.5569
Mars Quest	2021-05-27	2	2	1	3	0.5569
Freed Soft	2021-04-18	3	2	1	4	0.5569
Build Em' Faster	2021-06-07	1	2	1	2	0.5569
Triblock	2021-01-28	3	2	1	4	0.5569
Adventure Field™ 4	2021-02-07	3	2	1	4	0.5569
Dodge Dancer	2021-02-15	1	2	1	2	0.5569
Ruin	2021-10-29	2	2	1	3	0.5569
Boring in paradise	2021-02-08	1	2	1	2	0.5569
孙美琪疑案 第五季	2021-02-19	5	2	1	6	0.5569
Liars Village	2021-04-06	8	2	1	9	0.5569
Play The Fox	2021-04-24	5	2	1	6	0.5569
The Bits That Saved the Galaxy	2021-04-30	4	2	1	5	0.5569
The Immortal	2021-03-30	2	2	1	3	0.5569
Noah's Ark	2021-03-30	2	2	1	3	0.5569
Giant Blobs From Mars	2021-03-31	2	2	1	3	0.5569
Thearchy	2021-02-19	2	2	1	3	0.5569
The Midnight Eater	2021-03-05	1	2	1	2	0.5569
ExZeus: The Complete Collection	2021-09-30	3	2	1	4	0.5569
Jump/Die/Live	2021-06-23	2	2	1	3	0.5569
Tiani	2021-03-06	1	2	1	2	0.5569
回纹集换卡牌TCG	2021-03-03	2	2	1	3	0.5569
Romeo Must Live	2021-03-08	2	2	1	3	0.5569
Destroy the Dummies	2021-04-27	1	2	1	2	0.5569
Occult: The Interrogation. Are you Innocent or Guilty?	2021-03-11	2	2	1	3	0.5569
One Try Tower	2021-06-07	2	2	1	3	0.5569
Godkiller	2021-08-02	1	2	1	2	0.5569
Trapped	2021-03-15	2	2	1	3	0.5569
Crazy Christmas	2021-03-23	1	2	1	2	0.5569
Sea Battle: Annihilation	2021-04-05	2	2	1	3	0.5569
Pilot's Misadventures	2021-03-25	40	2	1	41	0.5569
【IQ3でできるエロRPG】トレジャーハンターアンナ～新米アンナと処女の穴～	2021-05-25	2	2	1	3	0.5569
Triple Dungeon	2021-03-22	1	2	1	2	0.5569
恶搞赛车	2021-08-11	1	2	1	2	0.5569
Unreal Sandbox	2021-08-17	3	2	1	4	0.5569
Paid Trade	2021-03-29	2	2	1	3	0.5569
Rotego	2021-04-01	2	2	1	3	0.5569
Memento Vivere	2021-04-08	6	2	1	7	0.5569
One Escape	2021-12-03	2	2	1	3	0.5569
Cosmica	2021-05-01	3	2	1	4	0.5569
Reconnect	2021-04-05	1	2	1	2	0.5569
Replicators Defence	2021-07-14	2	2	1	3	0.5569
Green Phoenix	2021-08-26	2	2	1	3	0.5569
Fat Fritz 2.0 Steam Edition	2021-07-19	8	2	1	9	0.5569
Small Town Terrors: Galdor's Bluff Collector's Edition	2021-04-22	8	2	1	9	0.5569
Solitaire Game Halloween 2	2021-05-17	4	2	1	5	0.5569
Mahjong Carnaval 2	2021-05-20	3	2	1	4	0.5569
Camelot: Wrath of the Green Knight	2021-10-20	5	2	1	6	0.5569
Ultimate Demolition	2021-04-30	1	2	1	2	0.5569
Project Hacker	2021-05-28	2	2	1	3	0.5569
Empower	2021-06-01	3	2	1	4	0.5569
Soralio: Cooperation mystery solving game	2021-05-07	7	2	1	8	0.5569
The Dawning	2021-11-25	1	2	1	2	0.5569
Flag Color Number - Painting and Coloring	2021-05-12	3	2	1	4	0.5569
Blue Rabbit	2021-06-07	2	2	1	3	0.5569
Restaurant Solitaire Delicious Lunch	2021-12-07	3	2	1	4	0.5569
Orbit-X	2021-07-26	2	2	1	3	0.5569
Surgeball	2021-05-22	7	2	1	8	0.5569
JIGOKU UNKO	2021-06-15	4	2	1	5	0.5569
Luminyte	2021-07-30	2	2	1	3	0.5569
Manual Intervention VR	2021-07-05	2	2	1	3	0.5569
Fog Factory - Game Maker	2021-06-29	2	2	1	3	0.5569
什么找茬	2021-06-22	2	2	1	3	0.5569
Gang of Paws	2021-07-19	4	2	1	5	0.5569
Abandoned Croxon Mansion	2021-07-16	1	2	1	2	0.5569
Historical Jigsaw Puzzle: World War I	2021-07-13	2	2	1	3	0.5569
2048 Royal Cards	2021-12-09	2	2	1	3	0.5569
Rabbit Hole	2021-09-01	3	2	1	4	0.5569
LandCombatRen	2021-12-31	1	2	1	2	0.5569
Iselin Saga	2021-07-14	2	2	1	3	0.5569
Calmed by the Dark Leviathan	2021-11-29	2	2	1	3	0.5569
Blood Labs	2021-07-13	1	2	1	2	0.5569
Hidden Expedition: A King's Line Collector's Edition	2021-06-25	6	2	1	7	0.5569
卡纳！卡呐？一起来学假名吧！	2021-07-31	3	2	1	4	0.5569
Asdivine Saga	2021-09-29	6	2	1	7	0.5569
The Witch Eye	2021-07-21	2	2	1	3	0.5569
Monkey Tantrum	2021-08-13	2	2	1	3	0.5569
Survival Escape Room	2021-07-23	2	2	1	3	0.5569
KILLER	2021-10-04	2	2	1	3	0.5569
Saving Ghost	2021-07-31	2	2	1	3	0.5569
Space Intervention	2021-07-27	1	2	1	2	0.5569
Cats - Classic Onet Connect	2021-08-06	5	2	1	6	0.5569
Conflict in Vietnam	2021-11-30	2	2	1	3	0.5569
Tank Battle Royale	2021-11-17	2	2	1	3	0.5569
Archie	2021-11-24	3	2	1	4	0.5569
Route Me Mail and Delivery Co	2021-08-18	1	2	1	2	0.5569
Fated Blade	2021-09-30	4	2	1	5	0.5569
Holiday Solitaire Easter	2021-10-01	5	2	1	6	0.5569
Gladiator of sparta	2021-10-11	2	2	1	3	0.5569
Space Battle SVF	2021-09-10	1	2	1	2	0.5569
Lake of Shadows	2021-08-25	3	2	1	4	0.5569
深渊	2021-08-25	3	2	1	4	0.5569
Tactical Monsters - Strategy Edition	2021-09-03	4	2	1	5	0.5569
One Fateful Night	2021-09-20	2	2	1	3	0.5569
Among Dots	2021-10-01	1	2	1	2	0.5569
Campfire Tales	2021-10-28	2	2	1	3	0.5569
Sports Betting Simulator	2021-12-06	2	2	1	3	0.5569
Faster Than Possible	2021-11-05	2	2	1	3	0.5569
Eco Park	2021-10-29	2	2	1	3	0.5569
Narco Lolita	2021-12-06	3	2	1	4	0.5569
Love Hentai and Puzzles: Cyberpunk Babes	2021-12-16	3	2	1	4	0.5569
Halloween Trouble 3	2021-10-08	5	2	1	6	0.5569
RedShip	2021-10-13	3	2	1	4	0.5569
Last Genesis	2021-10-08	3	2	1	4	0.5569
Eyes of the Night	2021-09-29	2	2	1	3	0.5569
Dance like a butterfly, Shot like a Bee!	2021-10-08	1	2	1	2	0.5569
Capital Island	2021-10-06	3	2	1	4	0.5569
LineVox 2: Forward to the Past	2021-10-05	1	2	1	2	0.5569
Dracula Is Coming	2021-10-15	2	2	1	3	0.5569
Bomb Sweeper - Mine Finder	2021-10-27	2	2	1	3	0.5569
Sokoramp	2021-10-29	3	2	1	4	0.5569
Goldfish Flap	2021-10-12	1	2	1	2	0.5569
Alan and the kid	2021-12-17	2	2	1	3	0.5569
XPLORASI3D	2021-10-18	1	2	1	2	0.5569
Heroes of Agora	2021-10-25	3	2	1	4	0.5569
Vacation Adventures: Cruise Director 4	2021-11-04	4	2	1	5	0.5569
Megacraft Hotspot Royale	2021-11-13	2	2	1	3	0.5569
Slutty Sluts Panic	2021-11-12	2	2	1	3	0.5569
Dark effigy	2021-11-07	1	2	1	2	0.5569
Christmas Slots - Casino Game	2021-10-19	2	2	1	3	0.5569
Unstrong: Space Calamity	2021-12-07	2	2	1	3	0.5569
Faded Memories: Video Game Edition	2021-11-13	3	2	1	4	0.5569
2021	2021-11-11	1	2	1	2	0.5569
The Thorn of Warldia	2021-12-11	2	2	1	3	0.5569
Mysterious Night	2021-11-14	2	2	1	3	0.5569
Consume Thy Flesh: The Pumpkin Smashing Sim	2021-11-14	1	2	1	2	0.5569
Oppcium	2021-12-05	2	2	1	3	0.5569
Mizu	2021-12-07	2	2	1	3	0.5569
Paradise Beach Girls	2021-11-09	2	2	1	3	0.5569
Polygon Hunter	2021-12-07	2	2	1	3	0.5569
Shootvaders: The Beginning	2021-12-11	2	2	1	3	0.5569
Just Fly	2021-12-09	2	2	1	3	0.5569
Mugen Journey	2021-12-02	1	2	1	2	0.5569
September 28 Pizza	2021-12-20	1	2	1	2	0.5569
Humanities Legend: Hollow Ascending	2021-12-14	1	2	1	2	0.5569
Summer Numbers	2021-12-23	1	2	1	2	0.5569
The Paribneur Combination	2021-12-24	2	2	1	3	0.5569
Present Cannon Rebirth	2021-12-21	2	2	1	3	0.5569
Fisherman Classic	2021-04-23	3	9	6	9	0.5566
Abyss The Forgotten Past	2021-01-29	4	9	6	10	0.5566
循环世界	2021-01-14	6	9	6	12	0.5566
Epic of Inanna	2021-05-08	5	9	6	11	0.5566
Turbo Tempest	2021-07-09	8	9	6	14	0.5566
Ancient Dino Runner	2021-07-20	3	9	6	9	0.5566
Subject 95	2021-07-11	3	9	6	9	0.5566
Gore Prologue	2021-11-04	34	9	6	40	0.5566
Alien Destroyer	2021-07-30	2	9	6	8	0.5566
The Babysitter	2021-09-01	6	9	6	12	0.5566
Gods Will Fall	2021-01-29	27	49	36	63	0.5565
Neptunia Virtual Stars	2021-03-29	218	224	171	389	0.556
bridg	2021-01-04	23	33	24	47	0.5557
The Spirit	2021-06-04	4	13	9	13	0.5555
Narrow Escape	2021-09-11	12	13	9	21	0.5555
ZAR	2021-04-26	2	13	9	11	0.5555
Panda City	2021-09-08	4	13	9	13	0.5555
Neeron: The Blade of Nature	2021-09-22	4	13	9	13	0.5555
Hero Park	2021-05-28	33	25	18	51	0.5553
Astria Ascending	2021-09-30	233	133	101	334	0.5552
We're All Going To Die	2021-02-19	13	17	12	25	0.5552
Ragnarok Chess	2021-05-04	5	17	12	17	0.5552
Pretend	2021-01-06	148	777	609	757	0.5537
Last Resort	2021-06-28	141	69	52	193	0.5537
Copy Editor: A RegEx Puzzle	2021-10-14	16	30	22	38	0.5536
Russian Train Trip	2021-12-28	8	65	49	57	0.5534
Conquer and Breed the Demon Queen	2021-03-05	37	61	46	83	0.5529999999999999
BEAT ARENA	2021-09-10	10	22	16	26	0.5527000000000001
Combat Cycle	2021-03-16	5	18	13	18	0.5522
Savage Lands	2021-12-16	2157	3683	2942	5099	0.552
Golden Force	2021-04-22	5	14	10	15	0.5517000000000001
The Lost King of Avallon	2021-11-03	17	14	10	27	0.5517000000000001
Logistics Simulator	2021-08-09	10	14	10	20	0.5517000000000001
Rift's Cave	2021-09-09	2054	49	37	2091	0.5516
秋田・男鹿ミステリー案内 凍える銀鈴花	2021-01-14	17	6	4	21	0.5514
Rotten Tide	2021-03-04	4	6	4	8	0.5514
農場ダンジョンRPG ファームダンジョンズ	2021-02-25	7	6	4	11	0.5514
flChess 2	2021-02-16	3	6	4	7	0.5514
Vanilla Click	2021-02-22	2	6	4	6	0.5514
Space Ape	2021-04-29	1	6	4	5	0.5514
Hopeless Dregs	2021-04-09	3	6	4	7	0.5514
Mysterious Blocks	2021-03-15	2	6	4	6	0.5514
梦回 Dream back	2021-09-09	3	6	4	7	0.5514
Zoelie - SCAD Games Studio	2021-08-02	3	6	4	7	0.5514
Dirty Blood	2021-04-27	3	6	4	7	0.5514
The Frog Game	2021-05-03	3	6	4	7	0.5514
Stream Skate	2021-05-19	2	6	4	6	0.5514
LineArt Jigsaw Puzzle - Erotica Summer	2021-05-04	2	6	4	6	0.5514
Lovin House	2021-07-12	2	6	4	6	0.5514
Reigning	2021-06-30	3	6	4	7	0.5514
Star Fighter	2021-10-02	2	6	4	6	0.5514
Slime VS. Female Hero Party	2021-07-02	3	6	4	7	0.5514
Vandalhalla	2021-11-04	5	6	4	9	0.5514
Flirtatious: Fallen Angels	2021-07-14	2	6	4	6	0.5514
Bigger Bikes	2021-10-22	2	6	4	6	0.5514
10th Corpse	2021-08-26	3	6	4	7	0.5514
Rogue Planet 1: Golden Hour	2021-10-23	3	6	4	7	0.5514
Non-Euclidean Chess	2021-10-22	4	6	4	8	0.5514
Voxel Farm Island	2021-10-29	6	6	4	10	0.5514
YUME	2021-01-15	1691	807	640	2331	0.5513
Apple Hopper	2021-06-18	4	10	7	11	0.5513
Forest Farm	2021-11-03	3	10	7	10	0.5513
Down and Out	2021-12-14	4	10	7	11	0.5513
Francisca 2	2021-01-07	4	10	7	11	0.5513
The Addams Family: Mansion Mayhem	2021-09-24	4	10	7	11	0.5513
Fruit Juice	2021-04-12	3	10	7	10	0.5513
Babol the Walking Box	2021-06-25	4	10	7	11	0.5513
Water Ball	2021-05-16	3	10	7	10	0.5513
Space Doomer	2021-09-10	4	10	7	11	0.5513
UROS: A TRIP THROUGH SHADOWS	2021-07-13	9	27	20	29	0.5512
SinSeed	2021-02-13	17	36	27	44	0.551
Project MIKHAIL	2021-11-02	1433	354	279	1712	0.5507
Home Sweet Home Survive	2021-03-25	5565	4583	3686	9251	0.5506000000000001
Space Warfare	2021-06-10	15	41	31	46	0.5504
Zombies Ate My Neighbors and Ghoul Patrol	2021-06-29	70	93	72	142	0.55
Adventure War : Battlefield	2021-10-08	5	19	14	19	0.5496
You are a slave!	2021-09-20	3	19	14	17	0.5496
Flannel Amethyst	2021-11-23	5	19	14	19	0.5496
Cyanide & Happiness - Freakpocalypse (Episode 1)	2021-03-11	1286	610	487	1773	0.5492
Aim Lab VR	2021-12-22	21	61	47	68	0.549
The Amazing American Circus	2021-09-16	71	169	133	204	0.5489
Modiverse	2021-02-19	23	33	25	48	0.5488000000000001
Complex Complex	2021-09-13	4	15	11	15	0.5484
Alchemy Emporium	2021-05-26	12	15	11	23	0.5484
Yuoni	2021-08-19	32	15	11	43	0.5484
Rocket Explorer	2021-08-21	12	15	11	23	0.5484
Languish	2021-01-22	5	15	11	16	0.5484
Dreams and Nightmares	2021-06-06	8	15	11	19	0.5484
Metempsychosis	2021-10-01	12	15	11	23	0.5484
CANNON	2021-09-01	5	15	11	16	0.5484
Badlands Racer	2021-09-23	47	15	11	58	0.5484
Codename: TIARAS	2021-10-14	6	15	11	17	0.5484
Wraith: The Oblivion - Afterlife	2021-05-25	24	38	29	53	0.5483
Hike	2021-01-08	10	29	22	32	0.5477000000000001
地牢少女	2021-05-21	8	20	15	23	0.5471
Quick Race	2021-02-20	3	11	8	11	0.5468999999999999
三国演义之蜀汉传奇	2021-04-13	7	11	8	15	0.5468999999999999
Lost Scale: Part One	2021-05-17	2	11	8	10	0.5468999999999999
Barking Puzzle	2021-07-20	3	11	8	11	0.5468999999999999
The Magnificent Trufflepigs	2021-06-03	47	79	62	109	0.5467000000000001
Junkyard Simulator	2021-10-13	1556	632	511	2067	0.5466
BLACKOUT	2021-05-21	8	25	19	27	0.5465
Trashed	2021-02-17	26	75	59	85	0.5461
USA Truck Simulator	2021-03-25	4	35	27	31	0.546
Mido and Di	2021-11-23	388	194	156	544	0.545
AMazing TD	2021-03-30	8	21	16	24	0.545
Sniper Elite VR	2021-07-08	220	364	295	515	0.5449
League of Maidens	2021-02-25	6706	3521	2901	9607	0.5448
Train Travel Simulator	2021-09-18	7	26	20	27	0.5448
Swing & Miss	2021-03-25	4	7	5	9	0.5448
Disc Ninja	2021-12-20	5	7	5	10	0.5448
MechNest	2021-10-23	11	7	5	16	0.5448
Fate of the Storm Gods	2021-01-28	44	7	5	49	0.5448
Outwars	2021-05-11	3	7	5	8	0.5448
Conquest: Medieval Kingdoms	2021-05-14	6	7	5	11	0.5448
Last Hope	2021-09-29	2	7	5	7	0.5448
Shooty	2021-07-07	3	7	5	8	0.5448
Into The Eternal	2021-04-15	5	7	5	10	0.5448
Biotech Samurai	2021-02-05	2	7	5	7	0.5448
Gongo	2021-02-14	2	7	5	7	0.5448
ZenFarm	2021-02-18	5	7	5	10	0.5448
Starvoly	2021-03-14	4	7	5	9	0.5448
Cat Knight	2021-04-19	2	7	5	7	0.5448
Madness Beverage	2021-11-30	31	7	5	36	0.5448
After Shadows	2021-10-22	4	7	5	9	0.5448
功夫足球队长	2021-09-27	3	7	5	8	0.5448
代号608<CODE 608>	2021-08-24	6	7	5	11	0.5448
No Crooks On Christmas	2021-12-03	2	7	5	7	0.5448
Treasure Girl 3D 2	2021-12-22	4	7	5	9	0.5448
Hidden Shelter	2021-01-27	6	31	24	30	0.5447
Survivor	2021-07-12	391	115	92	483	0.5444
Glitchpunk	2021-08-11	96	101	81	177	0.5435
Battle Axe	2021-04-29	17	37	29	46	0.5435
Arcade Redemption	2021-07-09	7	12	9	16	0.5433
小怪物必须死	2021-12-30	23	12	9	32	0.5433
Citor3 Hallucinations VR Adult XXX Game	2021-02-25	8	22	17	25	0.543
VIRO MOVE	2021-10-20	7	17	13	20	0.543
Dawn of the Falkonir	2021-05-05	8	17	13	21	0.543
Dog_Fox_Bunny	2021-05-28	4	17	13	17	0.543
Four Kings One War	2021-07-26	157	94	76	233	0.5417000000000001
Zombie Strike	2021-06-17	70	44	35	105	0.5417000000000001
Succubus With Guns	2021-10-08	16	44	35	51	0.5417000000000001
Spectrum	2021-12-19	4	3	2	6	0.5417000000000001
SOULBOUND	2021-04-15	3	3	2	5	0.5417000000000001
Doomsday Hero	2021-02-24	4	3	2	6	0.5417000000000001
Blaze	2021-01-04	2	3	2	4	0.5417000000000001
Saving Mr. Sparkles	2021-01-29	4	3	2	6	0.5417000000000001
흡혈귀의 연애방법	2021-01-15	3	3	2	5	0.5417000000000001
Chesstle	2021-04-02	5	3	2	7	0.5417000000000001
escape from dinosaur island	2021-02-05	2	3	2	4	0.5417000000000001
SOL Cycling	2021-02-06	5	3	2	7	0.5417000000000001
Resthedex	2021-01-08	5	3	2	7	0.5417000000000001
Monster Seek Ep.1	2021-04-13	2	3	2	4	0.5417000000000001
Cyberpunch	2021-02-15	2	3	2	4	0.5417000000000001
Edifice of Fiends	2021-02-02	2	3	2	4	0.5417000000000001
4096	2021-01-20	1	3	2	3	0.5417000000000001
VR Shark	2021-01-19	4	3	2	6	0.5417000000000001
Unknown Woods	2021-09-20	1	3	2	3	0.5417000000000001
The Clinic of Depravity - A Wife Reveals Her True Nature in Front of Her Husband -	2021-08-06	4	3	2	6	0.5417000000000001
Cavebound	2021-03-01	3	3	2	5	0.5417000000000001
Creas	2021-08-20	1	3	2	3	0.5417000000000001
Distorted world	2021-02-10	1	3	2	3	0.5417000000000001
Project Blue Book: Hidden Mysteries	2021-03-15	3	3	2	5	0.5417000000000001
Endro	2021-03-19	2	3	2	4	0.5417000000000001
Vivian's Kurse	2021-02-25	3	3	2	5	0.5417000000000001
Quest for Cathrinite	2021-04-21	3	3	2	5	0.5417000000000001
Survival RPG Alisa x Desperate City	2021-03-15	5	3	2	7	0.5417000000000001
Little Wolf	2021-10-30	2	3	2	4	0.5417000000000001
Battle In The City	2021-04-06	2	3	2	4	0.5417000000000001
Renova	2021-07-20	2	3	2	4	0.5417000000000001
Sword Princess Amaltea - The Visual Novel	2021-10-21	2	3	2	4	0.5417000000000001
Fast Finger Rule	2021-11-01	2	3	2	4	0.5417000000000001
Labyrinth Hearts	2021-05-02	4	3	2	6	0.5417000000000001
Idle Poker	2021-04-12	10	3	2	12	0.5417000000000001
Idle Roboto	2021-06-19	5	3	2	7	0.5417000000000001
SCP: Undeads Winter's	2021-04-26	2	3	2	4	0.5417000000000001
Monstrous Lovers	2021-06-24	12	3	2	14	0.5417000000000001
此刻探索中	2021-04-30	2	3	2	4	0.5417000000000001
Super Nova Stadium	2021-08-21	5	3	2	7	0.5417000000000001
The Sole Survivor	2021-05-25	1	3	2	3	0.5417000000000001
Sorcerous	2021-07-23	2	3	2	4	0.5417000000000001
1001 Jigsaw. Home Sweet Home. Back from Vacation	2021-10-22	3	3	2	5	0.5417000000000001
Skyward Descent	2021-06-24	1	3	2	3	0.5417000000000001
Walk of Shame	2021-06-29	2	3	2	4	0.5417000000000001
Mageo	2021-09-30	4	3	2	6	0.5417000000000001
No Fear	2021-06-14	2	3	2	4	0.5417000000000001
Violent Witches: the Vindicator	2021-06-28	1	3	2	3	0.5417000000000001
The Tau Ceti Terminus	2021-08-31	2	3	2	4	0.5417000000000001
Kill Them With Cuteness	2021-08-28	2	3	2	4	0.5417000000000001
Card Tower Defence	2021-06-28	5	3	2	7	0.5417000000000001
Black Space	2021-06-20	1	3	2	3	0.5417000000000001
Soulmate	2021-10-14	2	3	2	4	0.5417000000000001
Synth Run	2021-07-30	2	3	2	4	0.5417000000000001
Song of Life	2021-10-05	2	3	2	4	0.5417000000000001
Heartbeat: Regret	2021-08-23	2	3	2	4	0.5417000000000001
Lifing	2021-10-22	3	3	2	5	0.5417000000000001
Hyper Treasure - Macaronic Labyrinth	2021-10-29	3	3	2	5	0.5417000000000001
Pipe Dreamin' VR: The Big Easy	2021-07-26	4	3	2	6	0.5417000000000001
SAVE THE UNICORN	2021-07-24	1	3	2	3	0.5417000000000001
Dirty Beastly Muscles	2021-07-20	8	3	2	10	0.5417000000000001
Football tournament	2021-07-23	2	3	2	4	0.5417000000000001
The Stone of God	2021-08-27	4	3	2	6	0.5417000000000001
Conundrum	2021-07-29	2	3	2	4	0.5417000000000001
epic maze	2021-11-10	2	3	2	4	0.5417000000000001
Hentai Jigsaw Girls 2	2021-08-05	2	3	2	4	0.5417000000000001
Hit Confirmed	2021-08-12	2	3	2	4	0.5417000000000001
Station Commander	2021-08-23	3	3	2	5	0.5417000000000001
Office Strike - Multiplayer Battle Royale	2021-09-02	10	3	2	12	0.5417000000000001
Freon	2021-08-28	2	3	2	4	0.5417000000000001
Bunch of Games	2021-09-13	2	3	2	4	0.5417000000000001
靖之元：东海	2021-12-13	4	3	2	6	0.5417000000000001
Shambled Spiral	2021-09-14	3	3	2	5	0.5417000000000001
Wreckdigger	2021-10-19	2	3	2	4	0.5417000000000001
Robo pocket: 3d fighter with rollback	2021-12-04	4	3	2	6	0.5417000000000001
CADE PRIME	2021-09-30	1	3	2	3	0.5417000000000001
Multris	2021-12-21	2	3	2	4	0.5417000000000001
Everyday Life in Hospital VR	2021-10-23	2	3	2	4	0.5417000000000001
Starry Moon Island 2	2021-11-08	1	3	2	3	0.5417000000000001
Sudden Darkness	2021-10-30	2	3	2	4	0.5417000000000001
Cyber Runner 2048	2021-10-29	1	3	2	3	0.5417000000000001
Kismet Tapestry	2021-10-29	2	3	2	4	0.5417000000000001
Fructus	2021-11-10	2	3	2	4	0.5417000000000001
Daydream Mosaics	2021-11-04	3	3	2	5	0.5417000000000001
Only Mine	2021-11-15	2	3	2	4	0.5417000000000001
Dark City: Paris Collector's Edition	2021-10-29	7	3	2	9	0.5417000000000001
X Virus	2021-12-05	2	3	2	4	0.5417000000000001
Project Unirah	2021-12-03	2	3	2	4	0.5417000000000001
Mondrian Squares	2021-12-06	1	3	2	3	0.5417000000000001
Hentai Memory - Sexy Couples	2021-11-26	2	3	2	4	0.5417000000000001
Bouncy Bunnies	2021-12-31	23	3	2	25	0.5417000000000001
Sweet Candy	2021-08-20	14	28	22	36	0.5416
Big Dick at the Beach	2021-06-04	14	23	18	32	0.5412
AWAY: The Survival Series	2021-09-28	90	130	106	196	0.541
Farmer's Fairy Tale	2021-05-31	32	18	14	46	0.5407000000000001
BURGER MAN	2021-05-06	3	18	14	17	0.5407000000000001
Kings and Pigs	2021-06-18	5	18	14	19	0.5407000000000001
Among the zombies	2021-12-07	5	18	14	19	0.5407000000000001
Healing Spree	2021-10-20	273	57	46	319	0.5402
12 locks and keys	2021-08-11	3	13	10	13	0.5402
三国群英传8 Kingdom Heroes 8	2021-01-12	25160	7472	6301	31461	0.5401
Ghosts of war	2021-10-26	86	253	209	295	0.5401
孙美琪疑案 第二季	2021-01-11	6	8	6	12	0.5398
Magic Ocean - Multiplayer Roguelike	2021-01-28	6	8	6	12	0.5398
Space Runner - Anime	2021-01-06	2	8	6	8	0.5398
NO.L85	2021-03-26	3	8	6	9	0.5398
Dungeon and Gravestone	2021-04-22	32	8	6	38	0.5398
King Hajwala	2021-07-29	3	8	6	9	0.5398
Cyber Hunter: Awakening	2021-05-06	3	8	6	9	0.5398
Nanoscape	2021-06-29	3	8	6	9	0.5398
On Scene - The Story of Fred & Karen	2021-08-12	4	8	6	10	0.5398
Game of Lust	2021-10-12	12	8	6	18	0.5398
Fantasy Jigsaw Puzzle	2021-08-15	2	8	6	8	0.5398
Tales of the Mirror	2021-08-12	288	124	102	390	0.5392
Scrapvival	2021-11-22	52	76	62	114	0.5392
西湖断桥白娘子	2021-08-13	367	168	139	506	0.5388000000000001
Greed: Abandoned Dogs	2021-07-22	24	19	15	39	0.5387
STRIPING FRUITS	2021-05-13	2	19	15	17	0.5387
ELYON	2021-10-20	15541	2419	2050	17591	0.538
Fast & Furious: Spy Racers Rise of SH1FT3R	2021-11-05	6	14	11	17	0.5375
Date With a Girl: Mahjong	2021-12-05	3	14	11	14	0.5375
Paintball	2021-12-23	12	14	11	23	0.5375
Live Empire 2	2021-12-08	67	87	72	139	0.5369
Demon Lord Jill -REVIVAL-	2021-09-17	16	26	21	37	0.5366
Spire of Sorcery	2021-10-21	82	63	52	134	0.5364
Hogvalord	2021-12-28	3	9	7	10	0.5359
Hentai Neon	2021-01-30	4	9	7	11	0.5359
Soup!	2021-08-11	2	9	7	9	0.5359
Treasure Girl 3D	2021-10-11	4	9	7	11	0.5359
Animals Fight	2021-10-13	2	9	7	9	0.5359
Crazy Truck	2021-10-14	3	9	7	10	0.5359
JUMANJI - The Curse Returns	2021-09-01	11	27	22	33	0.5353
Demon's Residence	2021-08-13	13	21	17	30	0.5352
Nature Treks: Together	2021-12-17	14	15	12	26	0.5352
Fantasma	2021-11-12	15	15	12	27	0.5352
Mainly at Rest	2021-08-26	10	15	12	22	0.5352
Draft Day Sports: Pro Football 2022	2021-10-14	20	15	12	32	0.5352
Subverse	2021-03-26	25318	10089	8706	34024	0.5349
R.B.I. Baseball 21	2021-03-16	56	99	83	139	0.5347999999999999
Shelter 3	2021-03-30	176	174	147	323	0.5347
MOON BASE	2021-01-25	18	41	34	52	0.534
Mechajammer	2021-12-02	199	109	92	291	0.5337
Teke Teke - テケテケ	2021-01-21	43	48	40	83	0.5337
Moonlight Princess	2021-09-11	12	22	18	30	0.5337
Just 15 minutes	2021-06-04	2	22	18	20	0.5337
Quatris	2021-01-20	27	4	3	30	0.5332
Weed County	2021-04-26	4	4	3	7	0.5332
破阵图(Grids of World)	2021-04-23	4	4	3	7	0.5332
MachineryWorld	2021-02-13	4	4	3	7	0.5332
Planet Cracker	2021-01-25	2	4	3	5	0.5332
Booom-Slang!	2021-09-17	4	4	3	7	0.5332
Weltreich: Political Strategy Simulator	2021-08-05	4	4	3	7	0.5332
Futuclass Hub	2021-01-23	12	4	3	15	0.5332
CooKing	2021-02-26	3	4	3	6	0.5332
Galaxy X	2021-03-19	3	4	3	6	0.5332
Night Monsters	2021-03-24	2	4	3	5	0.5332
Relics of ancestors	2021-03-31	5	4	3	8	0.5332
Dragon's Bane	2021-04-08	4	4	3	7	0.5332
Capsule	2021-04-08	1	4	3	4	0.5332
Becoming	2021-04-08	3	4	3	6	0.5332
Seductive Tombs	2021-04-19	3	4	3	6	0.5332
The Far Kingdoms: Hidden Magic	2021-04-21	5	4	3	8	0.5332
Zodiac	2021-05-12	3	4	3	6	0.5332
Flyland Wars: 0 Ball Game [Trainer]	2021-10-04	2	4	3	5	0.5332
Towerbots	2021-05-24	4	4	3	7	0.5332
Wild Rat	2021-06-04	2	4	3	5	0.5332
Star Of The Show	2021-11-26	3	4	3	6	0.5332
Fantasy Friends: Under The Sea	2021-09-28	2	4	3	5	0.5332
Pirate King Simulator	2021-06-08	7	4	3	10	0.5332
vi.dange	2021-06-09	2	4	3	5	0.5332
VR Another World	2021-06-11	1	4	3	4	0.5332
Arcade Boy	2021-08-27	4	4	3	7	0.5332
Longphort	2021-11-05	2	4	3	5	0.5332
Orenji-iro no Kumo	2021-08-16	2	4	3	5	0.5332
Old Hunter	2021-08-28	3	4	3	6	0.5332
Chimeras: What Wishes May Come Collector's Edition	2021-08-13	8	4	3	11	0.5332
Super	2021-09-09	5	4	3	8	0.5332
Tap Tap Builder	2021-09-28	6	4	3	9	0.5332
Frog Ball Rerolled	2021-11-09	2	4	3	5	0.5332
Bullet Grinder	2021-10-29	2	4	3	5	0.5332
Animal Match	2021-10-19	2	4	3	5	0.5332
Spirits of Carter Mansion	2021-10-29	3	4	3	6	0.5332
Galaxity : Korea VR	2021-12-20	3	4	3	6	0.5332
OtherSoul	2021-11-18	2	4	3	5	0.5332
Bear Adventures 2	2021-12-21	11	4	3	14	0.5332
Conquer The Universe	2021-03-29	73	16	13	86	0.5331
Detective Story: Reporter	2021-07-16	5	16	13	18	0.5331
Dungeons Of The Deep	2021-01-25	3	10	8	11	0.5327000000000001
Parkour Game	2021-03-04	4	10	8	12	0.5327000000000001
Friendly Fire: Arena	2021-04-25	6	10	8	14	0.5327000000000001
Soul Challenge	2021-04-18	3	10	8	11	0.5327000000000001
4Prot	2021-08-09	41	10	8	49	0.5327000000000001
POG 4	2021-07-17	2	10	8	10	0.5327000000000001
KTGAME	2021-10-18	14	10	8	22	0.5327000000000001
They Сame From Above	2021-12-01	2	10	8	10	0.5327000000000001
They Came From Below	2021-12-10	3	10	8	11	0.5327000000000001
Ultimate ADOM - Caverns of Chaos	2021-08-25	135	221	189	324	0.5326
Platzkart Simulator	2021-02-01	15	64	54	69	0.5323
MADE : Interactive Movie – 01. Run away!	2021-01-12	9	23	19	28	0.5323
Shadownest	2021-06-17	243	270	232	475	0.532
Milkcraft	2021-01-22	127	109	93	220	0.5316
战地指挥官国际版	2021-10-20	20	17	14	34	0.5313
Rugby Challenge 4	2021-02-04	37	52	44	81	0.5312
Seek Girl Ⅷ	2021-04-30	154	286	247	401	0.5311
Pre-Strike	2021-07-02	32	31	26	58	0.5309
Poly Squad	2021-02-13	88	165	142	230	0.5307999999999999
Boppio	2021-12-22	26	46	39	65	0.5304
Monster Harvest	2021-08-31	551	230	199	750	0.5303
KEO	2021-12-09	315	295	256	571	0.5301
Ravenland	2021-07-17	27	11	9	36	0.53
TOP TRUCK DRIVER	2021-02-23	2	11	9	11	0.53
Furious Revenge of Bolo	2021-08-22	3	11	9	12	0.53
Cavegirl Adventures	2021-08-17	6	25	21	27	0.5297999999999999
Reach the Summit	2021-01-18	3	18	15	18	0.5297
Where Wind Becomes Quiet	2021-05-18	4	18	15	19	0.5297
Evolution: Moon Warfare	2021-10-11	9	18	15	24	0.5297
Ajedrez una tarde de Otoño	2021-11-18	3	18	15	18	0.5297
Muse:Night Out	2021-04-14	166	134	116	282	0.5292
41 Hours: Prologue	2021-03-19	8	33	28	36	0.5292
Orange Cast	2021-01-21	26	72	62	88	0.5288
Opus Castle	2021-11-09	7	26	22	29	0.5288
Blood of Titans	2021-10-11	33	34	29	62	0.5283
DelayedSun	2021-12-03	6	19	16	22	0.5283
Super Arcade Soccer 2021	2021-03-02	6	19	16	22	0.5283
Dungeon Clicker	2021-08-25	67	19	16	83	0.5283
Hard Driver 2	2021-06-18	2	12	10	12	0.5278
Destiny Island	2021-01-30	6	12	10	16	0.5278
SCP: Breakout	2021-12-12	17	12	10	27	0.5278
Puzzle & Chess	2021-04-09	2	12	10	12	0.5278
Stories of Submission: eNTeR the cuck	2021-05-05	11	12	10	21	0.5278
Now Testing: 407	2021-05-07	4	12	10	14	0.5278
NIghtmare	2021-11-19	10	12	10	20	0.5278
The Endless Adventure	2021-08-22	6	12	10	16	0.5278
Grind	2021-06-15	2	5	4	6	0.5278
Plasticalypse - TrashSub Adventures	2021-03-04	3	5	4	7	0.5278
Wetware	2021-01-08	3	5	4	7	0.5278
Dating Life: Emily X Miley	2021-02-20	5	5	4	9	0.5278
Decamped	2021-04-29	3	5	4	7	0.5278
Flow	2021-01-25	3	5	4	7	0.5278
Nova Genetics	2021-03-27	3	5	4	7	0.5278
Towards The Stars	2021-03-04	3	5	4	7	0.5278
She Doesn't Walk	2021-01-21	2	5	4	6	0.5278
Desirable: Dream Hotel	2021-01-10	2	5	4	6	0.5278
Lost Robot	2021-02-15	4	5	4	8	0.5278
Kuro Tactics	2021-07-01	4	5	4	8	0.5278
Time Jumper	2021-03-03	4	5	4	8	0.5278
Wanderlust: The Bermuda Secret Collector's Edition	2021-08-31	5	5	4	9	0.5278
Nightmare Survival	2021-03-12	2	5	4	6	0.5278
Cute animals memory card game	2021-06-22	5	5	4	9	0.5278
SpaceTek	2021-10-21	4	5	4	8	0.5278
Space Flex	2021-05-13	3	5	4	7	0.5278
Mello	2021-10-25	6	5	4	10	0.5278
FREEDOM: Hunt Kill Fly	2021-06-01	2	5	4	6	0.5278
Zolaris	2021-06-29	138	5	4	142	0.5278
Cyberflight	2021-08-13	2	5	4	6	0.5278
Paranormal Files: Ghost Chapter Collector's Edition	2021-07-16	8	5	4	12	0.5278
POG 5	2021-08-24	3	5	4	7	0.5278
Dungeon Arena	2021-08-09	2	5	4	6	0.5278
Bow Man	2021-10-09	2	5	4	6	0.5278
Medieval Wars	2021-08-23	2	5	4	6	0.5278
Desert War	2021-09-12	2	5	4	6	0.5278
Fantasy Jigsaw Puzzle 5	2021-09-25	2	5	4	6	0.5278
Eden: New Dawn Free Edition	2021-11-10	2	5	4	6	0.5278
Escape from the Village	2021-11-03	3	5	4	7	0.5278
Winding Road	2021-11-03	6	5	4	10	0.5278
Adult Puzzles - Hentai Halloween	2021-10-26	2	5	4	6	0.5278
Helix	2021-11-22	8	5	4	12	0.5278
Maze Art: Blue	2021-12-02	3	5	4	7	0.5278
The Search for MR Fimple	2021-12-15	2	5	4	6	0.5278
Murder Mystery Machine	2021-08-25	89	51	44	133	0.5275
INDICTED	2021-10-29	6	20	17	23	0.527
How does it work!?	2021-03-04	3	13	11	14	0.5259
Blowjob Simulator	2021-05-24	4	13	11	15	0.5259
Street Striker	2021-08-19	3	13	11	14	0.5259
Dungeon Warriors	2021-09-13	17	13	11	28	0.5259
Madden NFL 22	2021-08-20	5602	3746	3356	8958	0.5256000000000001
Taxer Inc	2021-02-18	15	30	26	41	0.5251
Capcom Arcade Stadium	2021-05-24	488791	1787	1606	490397	0.5244
Ren the Summoner and the Erotic Dungeon	2021-08-27	14	14	12	26	0.5242
Rugon - Unfinished	2021-02-07	10	6	5	15	0.5239
Groupthink	2021-01-01	5	6	5	10	0.5239
Frog Space	2021-01-06	4	6	5	9	0.5239
Bird	2021-01-12	20	6	5	25	0.5239
Halloween Trouble 2	2021-01-31	5	6	5	10	0.5239
Soldier in the darkness	2021-02-01	3	6	5	8	0.5239
Admiral of the Fleet: Carrier Battles in WW2	2021-03-15	5	6	5	10	0.5239
Retro Classix: Wizard Fire	2021-06-24	2	6	5	7	0.5239
Leyline Knights	2021-05-28	4	6	5	9	0.5239
Midnight Stories	2021-04-13	4	6	5	9	0.5239
Pride and Prejudice: Blood Ties	2021-10-26	4	6	5	9	0.5239
Wandering Trails: A Hiking Game	2021-12-09	3	6	5	8	0.5239
POG 3	2021-06-12	52	6	5	57	0.5239
Box Pusher	2021-07-14	2	6	5	7	0.5239
摆地摊	2021-07-12	8	6	5	13	0.5239
Magic Adventures	2021-07-16	2	6	5	7	0.5239
Stolen Eggs	2021-07-30	3	6	5	8	0.5239
Dream Mirror	2021-07-25	2	6	5	7	0.5239
Lucky day	2021-07-28	2	6	5	7	0.5239
Poly Puzzle: Furries	2021-09-15	2	6	5	7	0.5239
Adult Puzzles - Hentai NightClub	2021-10-13	2	6	5	7	0.5239
Maverta	2021-11-09	4	6	5	9	0.5239
NEDEN?	2021-11-22	2	6	5	7	0.5239
Problem Animals	2021-12-30	2	6	5	7	0.5239
Sky Fleet	2021-12-17	23	23	20	43	0.5236999999999999
Countrified	2021-05-23	23	52	46	69	0.5229
THE ORIGIN: Blind Maid	2021-07-22	11	24	21	32	0.5228
PIRATECRAFT	2021-03-12	6	24	21	27	0.5228
Outbreak: Endless Nightmares	2021-05-19	8	16	14	22	0.5215
Dawn of Light	2021-06-01	18	16	14	32	0.5215
放置勇者：远征/idle Heroes: Odyssey	2021-06-11	531	282	255	786	0.5214
汽车帝国	2021-08-13	229	46	41	270	0.5213
7 Girls War	2021-08-28	195	67	60	255	0.5212
Carrier Command 2 VR	2021-08-10	50	67	60	110	0.5212
Riders of Icarus: SEA	2021-08-19	78	26	23	101	0.5212
Star Puzzle	2021-06-17	6	7	6	12	0.5211
Clash Memory Game	2021-09-11	4	7	6	10	0.5211
Ar nosurge: Ode to an Unborn Star Deluxe	2021-03-04	20	7	6	26	0.5211
Zaacar	2021-05-22	5	7	6	11	0.5211
Black Cat	2021-02-24	2	7	6	8	0.5211
BUNKER	2021-03-25	3	7	6	9	0.5211
Hide Seek Survive	2021-09-17	4	7	6	10	0.5211
Swift Elf	2021-06-11	2	7	6	8	0.5211
Erotic Jigsaw Puzzle 2	2021-05-28	2	7	6	8	0.5211
Robot Labs: Remake	2021-10-18	2	7	6	8	0.5211
女神侦探	2021-07-20	3	7	6	9	0.5211
408 - The Forbidden Room	2021-07-23	2	7	6	8	0.5211
POG 6	2021-12-21	2	7	6	8	0.5211
World of Aircraft: Glider Simulator	2021-05-26	27	27	24	51	0.5205
Highrise Mogul	2021-12-02	30	27	24	54	0.5205
Seduction	2021-10-09	33	28	25	58	0.5197999999999999
INFINITE VERSUS: 3D MUGEN	2021-02-26	24	28	25	49	0.5197999999999999
CallMeProducer101	2021-05-19	50	18	16	66	0.5193
Sokpop S10: Bloks	2021-01-07	5	8	7	12	0.5189
Sacred Stones	2021-03-25	3	8	7	10	0.5189
Every day is more incredible than the previous	2021-10-23	3	8	7	10	0.5189
Hot Milf 2	2021-11-16	3	8	7	10	0.5189
Block Line Engineer	2021-12-16	5	8	7	12	0.5189
Bless Unleashed	2021-08-06	76377	15469	14304	90681	0.5186999999999999
Beat 'Em Down	2021-05-26	142	20	18	160	0.5176
Warhammer Quest: Silver Tower	2021-06-02	157	96	88	245	0.5172
Anew: The Distant Light	2021-08-09	7	9	8	15	0.5171
Thugs Law	2021-05-18	2	9	8	10	0.5171
Team-Z	2021-06-17	3	9	8	11	0.5171
The Surfeit: Episode 1	2021-01-31	6	9	8	14	0.5171
Alien AI	2021-02-19	4	9	8	12	0.5171
CLOSER - anagnorisis	2021-01-22	3	9	8	11	0.5171
Jetpack astronaut	2021-03-03	2	9	8	10	0.5171
Dracula VS The Ninja On The Moon	2021-03-08	2	9	8	10	0.5171
Pokitaire	2021-03-23	2	9	8	10	0.5171
FLOW	2021-10-29	3	9	8	11	0.5171
Hentai Jigsaw	2021-07-17	2	9	8	10	0.5171
Horny Goddesses Quiz	2021-10-27	3	9	8	11	0.5171
Kirakira Monstars	2021-11-25	46	169	156	202	0.5165
Smashing time	2021-09-30	7	22	20	27	0.5161
Bulkhead	2021-11-08	4	10	9	13	0.5156000000000001
我要成为铸剑师	2021-04-21	19	10	9	28	0.5156000000000001
The forgotten phobia	2021-09-15	3	10	9	12	0.5156000000000001
Lolita Creator	2021-11-02	3	10	9	12	0.5156000000000001
Toy War - Cannon	2021-12-15	3	10	9	12	0.5156000000000001
Squirrelmageddon!	2021-10-11	144	23	21	165	0.5155
Flåklypa Grand Prix	2021-11-04	1037	153	142	1179	0.5153
Survival In Africa	2021-01-24	6	24	22	28	0.5149
Monstrum 2 Beta	2021-01-23	401	83	77	478	0.5147
Booble Hentai	2021-05-07	5	11	10	15	0.5144
Speedpunk	2021-08-02	7	11	10	17	0.5144
Detective AI	2021-09-28	15	11	10	25	0.5144
Blocktopia	2021-11-18	9	11	10	19	0.5144
Era Of Newborns	2021-09-14	36	40	37	73	0.5142
Crazy indian	2021-04-20	3	12	11	14	0.5134000000000001
Death in the Family	2021-10-13	4	12	11	15	0.5134000000000001
She Will Shoot	2021-10-22	11	60	56	67	0.5131
The Intern	2021-09-16	2	13	12	14	0.5125
Battlescar	2021-02-17	2	13	12	14	0.5125
Recontact London: Cyber Puzzle	2021-10-19	6	13	12	18	0.5125
Sir Christopher	2021-03-22	2	13	12	14	0.5125
Retro Three Kingdoms	2021-11-23	29	13	12	41	0.5125
Artemishea	2021-06-24	89	141	133	222	0.5119
Marrakech	2021-12-02	12	14	13	25	0.5117
United Assault - Normandy '44	2021-10-27	10	32	30	40	0.5115
Ecila	2021-08-15	57	53	50	107	0.511
Bakery Biz Tycoon	2021-11-25	5	15	14	19	0.511
DARK SPHERE	2021-06-18	10	15	14	24	0.511
Terafall	2021-10-29	8	15	14	22	0.511
Hero Zex	2021-12-04	10	15	14	24	0.511
HARD TAPES	2021-02-10	7	34	32	39	0.5109
Click Quest 3D	2021-08-06	6	16	15	21	0.5104
Virt-U-Mate	2021-05-06	6	17	16	22	0.5099
DIRECT shot	2021-06-02	138	17	16	154	0.5099
Fantasy Mahjong connect	2021-07-07	6	17	16	22	0.5099
He Will Shoot	2021-12-18	4	17	16	20	0.5099
Poker Supreme - Las Vegas	2021-10-22	25	19	18	43	0.509
BAND OF BROTHERS	2021-01-15	6	20	19	25	0.5086
鬼谷八荒 Tale of Immortal	2021-01-27	184171	109435	106187	290358	0.5073
Waxworks: Curse of the Ancestors	2021-12-20	10	25	24	34	0.5071
Giants	2021-05-07	71	26	25	96	0.5068
PAW Patrol The Movie: Adventure City Calls	2021-08-13	19	29	28	47	0.5062
Souls of the Wind	2021-05-12	61	33	32	93	0.5055
Voice of Cards: The Isle Dragon Roars Demo	2021-09-24	409	37	36	445	0.505
Future Fortune	2021-03-31	100	40	39	139	0.5046
Land of War - The Beginning	2021-06-10	250	297	291	541	0.5044
Cosmic Cube	2021-10-17	11	46	45	56	0.5041
Stonedeep	2021-10-09	19	47	46	65	0.504
My boss is weird	2021-02-03	696	591	587	1283	0.5015
YUME 2 : Sleepless Night	2021-07-25	1038	617	616	1654	0.5004
House of Sin	2021-10-21	68	54	54	122	0.5
Foglight Online	2021-02-28	78	42	42	120	0.5
Neon Nights	2021-04-02	10	36	36	46	0.5
Tyran	2021-07-12	113	28	28	141	0.5
Ceres	2021-01-22	25	27	27	52	0.5
PBATOUR 23	2021-07-19	16	27	27	43	0.5
INFINITE VERSUS: 3D MUGEN - Open Beta	2021-02-21	27	24	24	51	0.5
Hamster	2021-05-17	3	24	24	27	0.5
Andromeda Zombies Colonies	2021-02-11	4	23	23	27	0.5
Bowsette	2021-09-22	5	22	22	27	0.5
SWAT	2021-09-17	6	19	19	25	0.5
Aquarelle	2021-01-13	3	18	18	21	0.5
Andromeda 2 Zombies	2021-01-13	3	17	17	20	0.5
Alpine - The Simulation Game	2021-11-23	25	16	16	41	0.5
Ecstasy Elf Shotenken -Naruru's Sexy Adventure-	2021-10-22	10	13	13	23	0.5
美足按摩	2021-08-27	8	13	13	21	0.5
One Shell Straight to Hell	2021-02-09	7	12	12	19	0.5
{Undefined}	2021-08-20	13	12	12	25	0.5
Code Dread	2021-10-12	11	12	12	23	0.5
Fantasy Royal VR	2021-02-19	204	11	11	215	0.5
Retro Racer	2021-05-22	3	11	11	14	0.5
Hoples	2021-06-22	5	11	11	16	0.5
Unreal Golf	2021-06-24	9	11	11	20	0.5
Frog story	2021-03-23	7	10	10	17	0.5
In the dark forest	2021-03-28	5	10	10	15	0.5
Magic gems	2021-07-20	2	10	10	12	0.5
Animus: Revenant	2021-07-28	5	10	10	15	0.5
Kenopsia	2021-10-12	4	10	10	14	0.5
Maiden Maze	2021-05-10	3	9	9	12	0.5
Maya Treasures	2021-03-15	3	9	9	12	0.5
Pachi Pachi On A Roll	2021-06-14	4	9	9	13	0.5
Ascent	2021-07-20	2	9	9	11	0.5
Milena's manor house	2021-08-23	16	9	9	25	0.5
Сollision Hero	2021-10-11	4	9	9	13	0.5
Pool Adventure	2021-11-08	4	9	9	13	0.5
ORO	2021-05-22	22	8	8	30	0.5
Azimech	2021-07-13	5	8	8	13	0.5
SALIGIA	2021-08-05	4	8	8	12	0.5
Turtle's Quest	2021-02-08	3	7	7	10	0.5
N1L	2021-10-16	3	7	7	10	0.5
Negligee: Opposites Attract	2021-07-16	6	7	7	13	0.5
Snowboarding	2021-06-21	3	7	7	10	0.5
Fantasy Jigsaw Puzzle 2	2021-08-21	2	7	7	9	0.5
Gladiator: about to die	2021-11-25	3	7	7	10	0.5
Maze Art: Black	2021-12-02	4	7	7	11	0.5
Ground Zero Texas - Nuclear Edition	2021-03-23	6	6	6	12	0.5
Athena Trivia	2021-05-19	2	6	6	8	0.5
Saving Animals	2021-06-18	2	6	6	8	0.5
No Light	2021-01-21	2	6	6	8	0.5
Beam Car Crash Derby	2021-03-17	3	6	6	9	0.5
Island Domination	2021-05-07	1	6	6	7	0.5
Mika and Sadie's Adventure	2021-11-05	5	6	6	11	0.5
Adult Puzzles - Hentai Christmas	2021-11-10	2	6	6	8	0.5
Istanbul Ship Simulator	2021-12-20	3	6	6	9	0.5
Evening Ecchi	2021-12-15	3	6	6	9	0.5
Spire of Sorcery: Prologue	2021-12-23	6	5	5	11	0.5
Outpost Engineer	2021-06-08	17	5	5	22	0.5
Master of Miracles	2021-06-19	7	5	5	12	0.5
Happy New Hentai	2021-01-01	2	5	5	7	0.5
Kosmonavtes: Escape Reality	2021-02-19	5	5	5	10	0.5
Wild Times	2021-03-26	2	5	5	7	0.5
Aviano	2021-05-03	2	5	5	7	0.5
After	2021-04-23	4	5	5	9	0.5
Slime Kingdom - An Unlikely Adventure!	2021-05-01	2	5	5	7	0.5
Hentai Pretty	2021-07-17	3	5	5	8	0.5
Bitten	2021-06-03	11	5	5	16	0.5
Broken Betrayal	2021-11-30	11	5	5	16	0.5
LOVE! TRUTH! PUZZLE!	2021-09-16	2	5	5	7	0.5
Hidden Motives: The Diamond Rush Collector's Edition	2021-11-09	6	5	5	11	0.5
Executive Hockey	2021-11-02	2	4	4	6	0.5
The Detective Chapters: Part One	2021-01-22	3	4	4	7	0.5
Spirit Clash	2021-03-01	4	4	4	8	0.5
Hyforge	2021-04-08	2	4	4	6	0.5
Unity Invaders	2021-09-25	3	4	4	7	0.5
Portal Defect	2021-04-14	2	4	4	6	0.5
Oscillate	2021-02-22	7	4	4	11	0.5
探索梅西爾VR	2021-02-12	2	4	4	6	0.5
Snowy Love	2021-01-14	2	4	4	6	0.5
VR Guardians	2021-02-11	2	4	4	6	0.5
ProtoStone	2021-04-01	2	4	4	6	0.5
Shining Cubes	2021-03-26	2	4	4	6	0.5
Love Notes	2021-12-13	7	4	4	11	0.5
Pure Bowl VR	2021-09-24	3	4	4	7	0.5
Little Party Legends	2021-04-30	4	4	4	8	0.5
Final Stand: Ragnarok	2021-10-28	37	4	4	41	0.5
Mystery Of Camp Enigma	2021-05-14	3	4	4	7	0.5
Walk On Mars	2021-05-19	137	4	4	141	0.5
Rangers In the SanGo	2021-06-01	5	4	4	9	0.5
通天魔塔	2021-07-22	7	4	4	11	0.5
Lost in Terra Mora	2021-06-17	2	4	4	6	0.5
Lost in Red Valley	2021-09-30	4	4	4	8	0.5
Light Fighter	2021-07-20	2	4	4	6	0.5
Erotic Jigsaw Puzzle 5	2021-07-26	2	4	4	6	0.5
Island of Girls Dreams	2021-08-09	4	4	4	8	0.5
Infinite sky	2021-10-02	2	4	4	6	0.5
King of the Raft	2021-10-10	2	4	4	6	0.5
Dirty Fighter: Hollow Point City	2021-12-13	5	4	4	9	0.5
velvet clouds	2021-09-15	1	4	4	5	0.5
Finding Home	2021-10-29	2	4	4	6	0.5
Blade & Ham	2021-10-14	4	4	4	8	0.5
Goddess Husk	2021-12-29	3	4	4	7	0.5
Busty Balls Brick Breaker	2021-10-08	4	4	4	8	0.5
Trails Of Gold Privateers	2021-12-16	2	4	4	6	0.5
A L O N E	2021-12-24	2	4	4	6	0.5
Wall to Wall	2021-12-04	2	4	4	6	0.5
Fantasy Memory - Sexy Mermaids	2021-11-27	2	4	4	6	0.5
A Journey Through Valhalla	2021-09-12	6	3	3	9	0.5
Asylum of the Dead	2021-12-11	3	3	3	6	0.5
Your Quest 2	2021-05-25	3	3	3	6	0.5
SwordBall	2021-01-09	4	3	3	7	0.5
Mystic Isles	2021-08-30	7	3	3	10	0.5
DVR Simulator	2021-12-22	5	3	3	8	0.5
Eden: New Dawn	2021-09-28	6	3	3	9	0.5
Brutal Dinosaur	2021-03-27	1	3	3	4	0.5
Gododo	2021-04-17	2	3	3	5	0.5
Heart of Metal	2021-03-29	2	3	3	5	0.5
What's Left Behind	2021-01-15	3	3	3	6	0.5
Invincible Cleopatra: Caesar's Dreams	2021-05-27	8	3	3	11	0.5
Thread Fred	2021-01-16	2	3	3	5	0.5
During Before And After COVID-19	2021-02-07	2	3	3	5	0.5
Briddle	2021-01-29	7	3	3	10	0.5
The Tower Of TigerQiuQiu 2	2021-03-19	2	3	3	5	0.5
The Daunting House	2021-09-15	4	3	3	7	0.5
Pretty Girls Panic! PLUS	2021-03-10	5	3	3	8	0.5
Bullet Time	2021-02-21	1	3	3	4	0.5
What The Maze	2021-03-10	4	3	3	7	0.5
Elder Puzzle	2021-02-26	2	3	3	5	0.5
Siphonophore	2021-05-05	2	3	3	5	0.5
Archer Master	2021-03-26	2	3	3	5	0.5
The Sand Dunes	2021-09-09	3	3	3	6	0.5
Emerland Solitaire 2 Collector's Edition	2021-03-29	4	3	3	7	0.5
纸上谈兵模拟器	2021-05-14	8	3	3	11	0.5
Earth Guard: Egypt	2021-09-08	2	3	3	5	0.5
Wild Runs [beta]	2021-05-12	2	3	3	5	0.5
The treasure of civilization VR	2021-05-08	5	3	3	8	0.5
Swarming Planet	2021-05-19	2	3	3	5	0.5
Crossy Bridge	2021-04-28	2	3	3	5	0.5
RANGER VS. DRONES	2021-07-05	2	3	3	5	0.5
Hagia Sophia VR Experience	2021-05-21	1	3	3	4	0.5
Thukothea Defender	2021-09-06	2	3	3	5	0.5
Quiet Valley 2	2021-06-24	2	3	3	5	0.5
That Role Playing	2021-10-20	2	3	3	5	0.5
Labyrinths of the World: The Game of Minds Collector's Edition	2021-07-02	7	3	3	10	0.5
Creeping Darkness	2021-07-22	2	3	3	5	0.5
Golden Boy	2021-07-27	1	3	3	4	0.5
Cat from the box	2021-07-16	2	3	3	5	0.5
Meister2	2021-11-29	3	3	3	6	0.5
Dark Forest Project	2021-07-29	1	3	3	4	0.5
Hentai Love	2021-10-17	3	3	3	6	0.5
FamilyWorldRoam	2021-09-10	2	3	3	5	0.5
Fantasy Jigsaw Puzzle 3	2021-08-26	2	3	3	5	0.5
Cosmic Cat	2021-10-05	3	3	3	6	0.5
Live Or Die	2021-10-29	3	3	3	6	0.5
Searching for objects in the forest	2021-10-01	1	3	3	4	0.5
Join Rush Attack	2021-10-07	2	3	3	5	0.5
Hentai Jigsaw Girls 4	2021-09-25	3	3	3	6	0.5
Steps From Above	2021-10-20	2	3	3	5	0.5
Back Alley Inn	2021-11-19	4	3	3	7	0.5
Splash Jumper	2021-11-11	2	3	3	5	0.5
Comixxx Strip	2021-11-18	2	3	3	5	0.5
Arcante: Definitive Edition	2021-12-10	5	3	3	8	0.5
haunt	2021-11-30	3	3	3	6	0.5
Imoto No Yume	2021-12-10	2	3	3	5	0.5
ASTRAL - Dream Or Reality	2021-12-15	1	3	3	4	0.5
ILLUMI-NAUGHTY ;) - Remastered	2021-12-20	3	3	3	6	0.5
Beyond the Board - DTDA Games	2021-12-22	3	3	3	6	0.5
Mystery Trackers: Queen of Hearts Collector's Edition	2021-12-13	9	3	3	12	0.5
Dungeon of Eyden	2021-03-12	3	2	2	5	0.5
Floody	2021-03-02	4	2	2	6	0.5
Typing Fingers - Enemy	2021-01-25	3	2	2	5	0.5
Dangerous Solitaire. Zombie Fever	2021-02-05	4	2	2	6	0.5
Deeply Dark	2021-05-31	2	2	2	4	0.5
Chess Mega Bundle	2021-06-07	4	2	2	6	0.5
Water Girls	2021-09-10	5	2	2	7	0.5
Fox face kills!	2021-02-19	8	2	2	10	0.5
RUNDOM	2021-02-01	1	2	2	3	0.5
The Seasons Collection: Spring	2021-02-12	136	2	2	138	0.5
The Fang	2021-01-05	3	2	2	5	0.5
Wreak The Havoc	2021-04-12	2	2	2	4	0.5
Tap-Tap Adventure	2021-02-02	1	2	2	3	0.5
Don't mess with Nanny	2021-02-21	4	2	2	6	0.5
The SOL Device 2	2021-09-01	2	2	2	4	0.5
Curiosaurios Club. Un viaje espacial	2021-01-28	1	2	2	3	0.5
Collapse	2021-01-26	1	2	2	3	0.5
心灵噩梦	2021-02-04	3	2	2	5	0.5
Karma - Chapter 1	2021-03-17	3	2	2	5	0.5
Table Tennis Pro	2021-03-04	2	2	2	4	0.5
Crystal sword	2021-03-25	1	2	2	3	0.5
小小精灵塔防	2021-02-18	2	2	2	4	0.5
VR New York Story	2021-02-21	4	2	2	6	0.5
The Haunted Tunnel	2021-03-05	2	2	2	4	0.5
火柴人大逃亡	2021-07-14	3	2	2	5	0.5
Christmas Griddlers Journey to Santa	2021-03-15	4	2	2	6	0.5
Twin Mind: Murderous Jealousy Collector's Edition	2021-03-22	5	2	2	7	0.5
Asteroids Maneuvers	2021-03-01	2	2	2	4	0.5
Uncle Ted	2021-03-09	2	2	2	4	0.5
Family	2021-03-10	2	2	2	4	0.5
红鸟	2021-03-13	3	2	2	5	0.5
Brawler	2021-03-18	2	2	2	4	0.5
Pixel Game Maker Series ISEKAI QUARTET Adventure Action Game	2021-06-24	3	2	2	5	0.5
irenehouse	2021-11-18	2	2	2	4	0.5
Unending War: Grand-Strategy Chess	2021-04-22	3	2	2	5	0.5
Riding Shotgun	2021-06-23	4	2	2	6	0.5
METALWORKING	2021-05-24	2	2	2	4	0.5
太空战舰	2021-05-06	3	2	2	5	0.5
Coin Dash	2021-05-29	2	2	2	4	0.5
Undergrowth: VR Maze	2021-09-15	2	2	2	4	0.5
折射大师（Master of refraction）	2021-05-21	2	2	2	4	0.5
Little Big Guy	2021-06-10	2	2	2	4	0.5
BrainTeaser	2021-05-16	3	2	2	5	0.5
Infiltration: Alone in Combat	2021-06-02	2	2	2	4	0.5
Endings	2021-08-25	2	2	2	4	0.5
Anime Cards	2021-06-29	1	2	2	3	0.5
The Chatters Show Free Version	2021-07-03	2	2	2	4	0.5
Spinner Breaker	2021-07-15	1	2	2	3	0.5
Casual Golf	2021-08-16	2	2	2	4	0.5
はじめて点てたお茶がコーヒーの私は、破茶滅茶なお点前で茶道大会優勝を目指す。	2021-08-09	1	2	2	3	0.5
Lostria	2021-08-06	4	2	2	6	0.5
B.Y.O.O.L. - Best Years Of Our Lives	2021-07-23	1	2	2	3	0.5
Synthwaifu: Neon Space Fighter	2021-09-18	2	2	2	4	0.5
Dirty and lascivious awakening RPG by lecher knight Reika	2021-09-22	2	2	2	4	0.5
Decision in the Desert	2021-11-30	1	2	2	3	0.5
Jelly	2021-08-13	3	2	2	5	0.5
Cubic Dweller	2021-11-26	3	2	2	5	0.5
Axial Drift	2021-12-24	12	2	2	14	0.5
Above the Skies	2021-09-03	4	2	2	6	0.5
Fill and Cross Trick or Treat 2	2021-09-08	5	2	2	7	0.5
Fuzor	2021-10-01	2	2	2	4	0.5
Plague Infection	2021-09-20	2	2	2	4	0.5
Tank Golfing	2021-09-02	2	2	2	4	0.5
Hentai Jigsaw Girls 3	2021-08-26	2	2	2	4	0.5
Virtual world-Digital girl	2021-10-25	5	2	2	7	0.5
Howling Village	2021-10-20	4	2	2	6	0.5
Dat Hentai Game	2021-09-24	1	2	2	3	0.5
Lucky Tlhalerwa's Cybernetic Titan	2021-09-25	1	2	2	3	0.5
thEiAoLoGy	2021-10-13	2	2	2	4	0.5
Procedural Soccer	2021-09-28	2	2	2	4	0.5
Mystery Trackers: Train to Hellswich Collector's Edition	2021-09-10	13	2	2	15	0.5
Alien Accident	2021-10-12	2	2	2	4	0.5
Greed Is Bad	2021-11-01	2	2	2	4	0.5
ENOH	2021-10-27	6	2	2	8	0.5
Poly Puzzle: Furries 2	2021-10-01	3	2	2	5	0.5
Rain Puzzle	2021-10-15	2	2	2	4	0.5
The Misty Tale	2021-10-17	2	2	2	4	0.5
Desert Magic Adventures	2021-10-13	1	2	2	3	0.5
Ghost Tokyo	2021-10-12	1	2	2	3	0.5
Fuyu no Tsuma	2021-10-15	2	2	2	4	0.5
Wings of Justice	2021-10-28	2	2	2	4	0.5
Elven Tales - Rise of Darkness	2021-10-29	2	2	2	4	0.5
Acid Trip	2021-12-17	2	2	2	4	0.5
Blue Barbarian Man	2021-11-05	2	2	2	4	0.5
Nekomimi Nikki	2021-11-04	2	2	2	4	0.5
Destiny’s Plan	2021-11-20	2	2	2	4	0.5
Fantasy Sliding Puzzle 5	2021-10-31	1	2	2	3	0.5
Myths or Reality: Fairy Lands Collector's Edition	2021-11-23	7	2	2	9	0.5
CHESS CROWN	2021-12-01	3	2	2	5	0.5
Vampire Combat	2021-12-03	1	2	2	3	0.5
Connectify	2021-12-10	1	2	2	3	0.5
Radiotelegraphist	2021-12-22	2	2	2	4	0.5
Cyber Girls 2022	2021-12-28	2	2	2	4	0.5
Super Dig Man Deluxe	2021-01-29	2	1	1	3	0.5
DoVille	2021-09-01	1	1	1	2	0.5
Condors Vs Ocelots	2021-03-19	2	1	1	3	0.5
Urizen Frosty Plus The New Warriors	2021-03-03	1	1	1	2	0.5
Hell Firefighter	2021-04-03	1	1	1	2	0.5
A Million Conquests	2021-01-19	2	1	1	3	0.5
Dimensions: Story Mode	2021-03-18	3	1	1	4	0.5
Purgatory Overkill	2021-04-26	2	1	1	3	0.5
qubo	2021-06-01	2	1	1	3	0.5
Orbals	2021-08-04	3	1	1	4	0.5
Drive-By Cop	2021-07-26	1	1	1	2	0.5
Sink	2021-01-15	1	1	1	2	0.5
Chibi Wars	2021-04-15	1	1	1	2	0.5
Attic	2021-07-09	1	1	1	2	0.5
Monochrome RPG Episode 1: The Maniacal Morning	2021-11-18	1	1	1	2	0.5
Tears Of Luna	2021-01-06	2	1	1	3	0.5
The Legend Of The Black Wizard	2021-01-06	1	1	1	2	0.5
Ribby Rocket	2021-03-26	442	1	1	443	0.5
赤蛮奇的头头大冒险 ~ Sekibanki Head Adventure	2021-03-27	3	1	1	4	0.5
MadHack	2021-02-21	2	1	1	3	0.5
Ralf's Adventure: Aztec Mystery	2021-01-06	2	1	1	3	0.5
Ladder Box	2021-04-06	1	1	1	2	0.5
ERO Shooter	2021-05-26	1	1	1	2	0.5
Space Revenge	2021-09-30	2	1	1	3	0.5
Boat Warfare	2021-07-01	2	1	1	3	0.5
Sparks - Episode One	2021-07-18	2	1	1	3	0.5
九个世界（Nine worlds）	2021-09-05	1	1	1	2	0.5
Stack Defense	2021-05-21	2	1	1	3	0.5
Elementowers	2021-09-23	4	1	1	5	0.5
Eggineer	2021-02-25	3	1	1	4	0.5
Mediterranean Assault: 1943	2021-02-16	2	1	1	3	0.5
Mad Asylum Escape	2021-08-05	1	1	1	2	0.5
VR Basketball Hoops	2021-08-05	1	1	1	2	0.5
Retailer Tycoon	2021-01-21	2	1	1	3	0.5
ONNANOKO KEEPER 2	2021-02-24	2	1	1	3	0.5
Block Destruction	2021-01-07	2	1	1	3	0.5
Sprint Racer	2021-02-05	2	1	1	3	0.5
Bloomee	2021-01-12	1	1	1	2	0.5
Great Exploration VR: New Colony beyond Viking Raiders	2021-01-12	1	1	1	2	0.5
Buried Under Rocks	2021-02-17	2	1	1	3	0.5
KnockDown	2021-03-03	2	1	1	3	0.5
The Great Chicken Thief	2021-04-16	3	1	1	4	0.5
Maze Escape	2021-01-24	2	1	1	3	0.5
The Legends in Kylamar	2021-06-21	2	1	1	3	0.5
SUKAKKO	2021-01-28	2	1	1	3	0.5
Dig Deep: Race To The Core!	2021-02-16	5	1	1	6	0.5
Spell Beats	2021-05-02	2	1	1	3	0.5
Unconventional Ragdoll Game	2021-04-26	2	1	1	3	0.5
Bomb Escape	2021-04-12	2	1	1	3	0.5
A Sleeper's Quest: A Labyrinth to Thee	2021-04-09	2	1	1	3	0.5
Demon Zombie Outpost	2021-02-19	1	1	1	2	0.5
Path of Insanity	2021-04-15	2	1	1	3	0.5
Grappling Ball	2021-02-28	2	1	1	3	0.5
Hormone Wars	2021-11-10	1	1	1	2	0.5
Cut Them Up	2021-05-03	2	1	1	3	0.5
Planetary Defense	2021-03-06	2	1	1	3	0.5
R.T.O. Tales of the Dark Lands	2021-03-29	1	1	1	2	0.5
Insanium	2021-03-31	2	1	1	3	0.5
Chronicles of Elmyra	2021-03-25	2	1	1	3	0.5
The Survivor After	2021-06-05	1	1	1	2	0.5
Alphadia Genesis 2	2021-06-04	5	1	1	6	0.5
Void's Blight	2021-04-30	3	1	1	4	0.5
Injoku Furin	2021-03-16	2	1	1	3	0.5
DVOREC	2021-04-12	1	1	1	2	0.5
Void Surfer	2021-04-07	1	1	1	2	0.5
POPOP!	2021-04-03	1	1	1	2	0.5
Dragon Hunters	2021-12-04	2	1	1	3	0.5
RATOMON	2021-10-13	2	1	1	3	0.5
Cube Space	2021-04-15	1	1	1	2	0.5
中外名将对决	2021-09-23	1	1	1	2	0.5
Infinity ZigZag	2021-04-21	2	1	1	3	0.5
Asteroid Blasters	2021-04-26	1	1	1	2	0.5
Seafarers	2021-08-02	2	1	1	3	0.5
Freiwillig	2021-04-30	1	1	1	2	0.5
UNIVERSE PRISON	2021-05-07	2	1	1	3	0.5
After School	2021-05-06	6	1	1	7	0.5
Galactic Refugees	2021-06-01	1	1	1	2	0.5
Instrumentalist	2021-05-06	2	1	1	3	0.5
Jigsaw Puzzle VR	2021-06-08	1	1	1	2	0.5
Half Wing	2021-07-14	2	1	1	3	0.5
XANDO: Xtreme & Over the Top	2021-11-21	3	1	1	4	0.5
Forgotten Forest: Eye of the Great One	2021-05-21	2	1	1	3	0.5
VR Game Station	2021-06-14	2	1	1	3	0.5
Scraftion	2021-06-11	3	1	1	4	0.5
Magical Girl Creator	2021-10-15	2	1	1	3	0.5
DangerZone VR	2021-09-04	2	1	1	3	0.5
Ohio John: Get Out!	2021-08-20	2	1	1	3	0.5
Meca Snake	2021-05-18	1	1	1	2	0.5
Tasty Jigsaw Happy Hour 2	2021-05-07	2	1	1	3	0.5
We Are Open	2021-07-15	2	1	1	3	0.5
SHAKESPEARE? More like THIRSTspeare, amirite?	2021-07-08	1	1	1	2	0.5
Last Soul	2021-06-09	2	1	1	3	0.5
Star Pixie	2021-06-29	1	1	1	2	0.5
Raising Torolith	2021-09-21	1	1	1	2	0.5
Visitors: First Contact	2021-07-22	2	1	1	3	0.5
Pugmire: Treasure of the Sea Dogs	2021-07-15	9	1	1	10	0.5
HyperFeat	2021-07-02	2	1	1	3	0.5
Ninja Ken	2021-06-08	2	1	1	3	0.5
ReBall	2021-06-12	1	1	1	2	0.5
Tizahl's Quest	2021-08-16	1	1	1	2	0.5
明明如月	2021-07-02	3	1	1	4	0.5
Vacation Adventures: Park Ranger 6	2021-07-06	4	1	1	5	0.5
Atoll	2021-11-17	2	1	1	3	0.5
Code angel	2021-07-16	2	1	1	3	0.5
Bad Bots Battle Arena	2021-09-17	2	1	1	3	0.5
Hentai Sushi Jigsaw	2021-08-11	1	1	1	2	0.5
Childhood Gone: Shadowed Wand	2021-07-15	1	1	1	2	0.5
The Grass	2021-07-26	2	1	1	3	0.5
Haos	2021-09-23	1	1	1	2	0.5
Starfighter Aces	2021-09-15	1	1	1	2	0.5
Mandacaru	2021-08-06	1	1	1	2	0.5
Historic Fighters	2021-07-30	1	1	1	2	0.5
Fomalhaut Flowers	2021-08-02	2	1	1	3	0.5
Cupid's Palace	2021-07-30	1	1	1	2	0.5
Chain Of Eroticism	2021-08-08	2	1	1	3	0.5
Snooker Loopy Pro	2021-07-30	2	1	1	3	0.5
TCSTRIKERS4	2021-12-22	3	1	1	4	0.5
The Key of Rednow	2021-08-10	2	1	1	3	0.5
WhackAKyouka	2021-08-17	2	1	1	3	0.5
The Magister - The First Two Days	2021-08-25	4	1	1	5	0.5
Perang Laut - Maritime Warfare	2021-10-27	1	1	1	2	0.5
Don't Hate My Music Taste	2021-09-07	2	1	1	3	0.5
iB Cricket Companion	2021-09-23	5	1	1	6	0.5
The Hero of Bangaona	2021-10-01	2	1	1	3	0.5
POWERTRIP	2021-09-08	2	1	1	3	0.5
Confined Space Entry VR Training	2021-12-21	2	1	1	3	0.5
Tales of a Rabbit: The Story of Willie Hop	2021-09-17	1	1	1	2	0.5
Knight&Princess	2021-11-26	5	1	1	6	0.5
break	2021-09-18	1	1	1	2	0.5
Lovely Animal Stories	2021-09-26	1	1	1	2	0.5
Demolition Game	2021-10-08	2	1	1	3	0.5
Don't Hate Me	2021-09-30	2	1	1	3	0.5
Clean Art	2021-11-11	4	1	1	5	0.5
Meet PIP	2021-11-06	1	1	1	2	0.5
Zombie Hunter	2021-10-19	1	1	1	2	0.5
Tiranogg	2021-11-19	3	1	1	4	0.5
Laruaville 10	2021-10-18	5	1	1	6	0.5
Banished Sir	2021-11-10	2	1	1	3	0.5
Head Pain	2021-11-07	2	1	1	3	0.5
Galactic Federation	2021-10-22	1	1	1	2	0.5
I am Your King	2021-11-08	1	1	1	2	0.5
MUNCHIES	2021-10-29	3	1	1	4	0.5
Farlife	2021-12-20	2	1	1	3	0.5
East Trapper	2021-10-26	2	1	1	3	0.5
Bouncy Cube	2021-10-22	1	1	1	2	0.5
Puzzle Art: Horses	2021-10-26	3	1	1	4	0.5
Dragon Kingdom	2021-10-29	3	1	1	4	0.5
labyrinth inf	2021-11-08	3	1	1	4	0.5
Solitaire TED and PET	2021-11-05	3	1	1	4	0.5
The Faded - Chapter 1 - The Perish Forest Demo	2021-11-02	2	1	1	3	0.5
Space Rocks Blaster	2021-11-15	1	1	1	2	0.5
Destruction of planets	2021-11-16	1	1	1	2	0.5
FirePuzzle - Save the House	2021-11-19	2	1	1	3	0.5
The Choice VR (선택VR)	2021-12-30	1	1	1	2	0.5
Throne And Crown	2021-12-07	1	1	1	2	0.5
jingor sudoku	2021-12-04	2	1	1	3	0.5
Helen Giantess	2021-12-15	1	1	1	2	0.5
Ritual Tournament	2021-12-22	3	1	1	4	0.5
Knowledge park - All World	2021-12-26	3	1	1	4	0.5
Dungeons & Dragons: Dark Alliance	2021-06-22	9912	2284	2298	12210	0.4986
DYNASTY WARRIORS 9 Empires	2021-12-23	3104	716	730	3834	0.49570000000000003
Killer: Infected One of Us	2021-02-01	240	105	109	349	0.4925
Sprite Fantasia	2021-10-19	464	132	137	601	0.4924
Spiritwish	2021-04-01	56	21	22	78	0.49210000000000004
东方有顶天梦	2021-07-17	10	20	21	31	0.4918
Infinite Lagrange	2021-10-08	239	197	205	444	0.4917
The Purge Man	2021-01-12	5	19	20	25	0.4914
Monster Girl Dungeon	2021-03-31	7	19	20	27	0.4914
Car Physics Simulator	2021-07-25	7	19	20	27	0.4914
Horny Heart	2021-05-18	19	56	59	78	0.4901
Realpolitiks II	2021-05-12	305	263	276	581	0.48979999999999996
Rogue Explorer	2021-03-12	23	15	16	39	0.48960000000000004
银魂：Silver Soul	2021-04-09	5	15	16	21	0.48960000000000004
Atelier Agnes	2021-12-17	28	15	16	44	0.48960000000000004
Lobster Game	2021-12-22	4	15	16	20	0.48960000000000004
Utopos	2021-03-29	56	49	52	108	0.4888
Beyond Mankind	2021-08-31	69	48	51	120	0.4886
Hood: Outlaws & Legends	2021-05-10	11536	3704	3892	15428	0.48850000000000005
Sheltered 2	2021-09-21	2157	834	881	3038	0.4878
ENF Novels: Dress Code	2021-09-16	13	28	30	43	0.4878
Türkçe Rap Kariyerim	2021-05-05	5	12	13	18	0.4875
完美决策 Perfect Decision	2021-02-03	9	11	12	21	0.4866
Huntfeast	2021-06-21	7	11	12	19	0.4866
票者！小慧的打工大作戰	2021-07-15	24	11	12	36	0.4866
Dark Home	2021-07-14	14	11	12	26	0.4866
Mazing	2021-12-01	17	11	12	29	0.4866
Tax Fugitive	2021-09-10	10	11	12	22	0.4866
Ancient Life	2021-07-12	138	54	58	196	0.4864
Blockchain Tycoon	2021-01-20	10	24	26	36	0.48610000000000003
Waterpark Simulator	2021-02-02	2	10	11	13	0.48560000000000003
Secrets of Egypt	2021-04-07	2	10	11	13	0.48560000000000003
Dice Tourney	2021-08-16	4	10	11	15	0.48560000000000003
Another Dungeon	2021-08-13	3	10	11	14	0.48560000000000003
Car Tuning Simulator	2021-10-29	8	62	67	75	0.4851
RAM Pressure	2021-09-15	242	431	462	704	0.48490000000000005
Barbarian Legend	2021-06-30	9	21	23	32	0.48450000000000004
You Arrive in a Town	2021-01-26	7	9	10	17	0.4844
Kill Demons	2021-01-26	3	9	10	13	0.4844
Dungeon Overseer	2021-12-21	8	19	21	29	0.4832
Room 13	2021-10-04	4	19	21	25	0.4832
Hentai GIF Puzzle X	2021-04-19	2	8	9	11	0.4829
Goblin Dungeoneer	2021-02-04	9	8	9	18	0.4829
Aero Battle	2021-03-31	2	8	9	11	0.4829
Lovely Kitchen	2021-06-30	2	8	9	11	0.4829
Lightout	2021-10-07	2	8	9	11	0.4829
ClickMonster	2021-06-18	4	17	19	23	0.4816
Lost Harem	2021-04-28	9	17	19	28	0.4816
IDLE RAID	2021-11-25	21	17	19	40	0.4816
Lost in Space	2021-09-07	5	17	19	24	0.4816
VirtualCop	2021-11-11	8	37	41	49	0.48119999999999996
策马三国志之霸王大陆	2021-02-08	8	7	8	16	0.4811
Breath of Spirits	2021-06-21	4	7	8	12	0.4811
House Cleaning Survival	2021-05-31	4	7	8	12	0.4811
Starsation	2021-05-25	2	7	8	10	0.4811
Fear Corporation	2021-08-19	3	7	8	11	0.4811
Dungeon Avenger	2021-12-14	2	7	8	10	0.4811
X-17	2021-04-05	1637	42	47	1684	0.4792
Void Eclipse	2021-11-04	3	6	7	10	0.4789
FartPart	2021-01-22	19	6	7	26	0.4789
Playground VR	2021-02-27	5	6	7	12	0.4789
Jin Conception	2021-05-12	5	6	7	12	0.4789
Cat's Menace	2021-02-04	3	6	7	10	0.4789
Researcher	2021-02-18	2	6	7	9	0.4789
Wild world	2021-04-25	2	6	7	9	0.4789
Hot Swap: Cyberlust	2021-09-11	3	6	7	10	0.4789
The Hunt	2021-09-30	6	6	7	13	0.4789
Adult Puzzles - Fantasy Ladies 2	2021-10-28	2	6	7	9	0.4789
Thugs Never Die	2021-12-29	2	6	7	9	0.4789
Arkan Tower	2021-03-31	4	14	16	20	0.47850000000000004
问道仙途2	2021-11-12	21	13	15	36	0.4772
Nemesis: Race Against The Pandemic	2021-04-15	3	20	23	26	0.47630000000000006
Disturbing Forest: Demon's Path	2021-07-22	5	5	6	11	0.4761
Dire Wolf Game Room	2021-07-06	7	5	6	13	0.4761
Poker Pretty Girls Battle : Fantasy World Edition	2021-01-22	7	5	6	13	0.4761
Lazy Chess	2021-03-12	5	5	6	11	0.4761
Mystery Trackers: Forgotten Voices Collector's Edition	2021-04-16	7	5	6	13	0.4761
MISKATONIC	2021-11-19	2	5	6	8	0.4761
Hentai In The Forest	2021-08-13	2	5	6	8	0.4761
Red Adventure	2021-06-05	2	5	6	8	0.4761
Defense Tower Simulator	2021-06-05	4	5	6	10	0.4761
Erotic Jigsaw Puzzle 3	2021-06-04	2	5	6	8	0.4761
Find The Murderer	2021-11-17	3	5	6	9	0.4761
UE5 Shooter Game	2021-12-17	3	5	6	9	0.4761
BATTLESHIP APOLLO	2021-09-06	283	99	112	395	0.4753
轮回修真OL	2021-02-14	71	19	22	93	0.4753
Sexy Airlines	2021-12-20	347	232	262	609	0.4743
Project : Skyscape	2021-12-30	10	11	13	23	0.47409999999999997
Extended Stay	2021-06-15	13	11	13	26	0.47409999999999997
The Fear Island	2021-07-01	15	11	13	28	0.47409999999999997
Polus.gg	2021-08-18	1271	227	257	1528	0.47380000000000005
Misha Adventures	2021-07-25	3	10	12	15	0.4722
Color Crush 2	2021-05-10	6	4	5	11	0.4722
斗魂大陆	2021-03-01	12	4	5	17	0.4722
The hardest game in the universe	2021-02-27	2	4	5	7	0.4722
Voidwalkers - Soul Hunters	2021-09-16	3	4	5	8	0.4722
The Sunken Hero	2021-05-07	2	4	5	7	0.4722
SexStone	2021-06-22	2	4	5	7	0.4722
Cologne 3D	2021-10-01	1	4	5	6	0.4722
Afterworld King	2021-10-25	2	4	5	7	0.4722
The Graffiti Creator	2021-10-19	3	4	5	8	0.4722
SPICESHIFTER	2021-10-19	2	4	5	7	0.4722
Deadly Threat	2021-05-11	3	16	19	22	0.4717
Risk Of Waifus	2021-07-02	3	16	19	22	0.4717
Horny Nurses	2021-12-15	18	35	41	59	0.4712
Summer Seduction VR	2021-10-08	13	22	26	39	0.4712
Nether Nightmare	2021-04-05	8	28	33	41	0.4708
WWR: World of Warfare Robots	2021-03-12	18	47	55	73	0.4705
World Senate	2021-05-09	16	15	18	34	0.4703
Redout: Space Assault	2021-01-22	35	40	47	82	0.47020000000000006
Bongo Quest	2021-12-23	3	21	25	28	0.47020000000000006
XTHRUST	2021-03-12	69	9	11	80	0.47000000000000003
Sex and Morning	2021-05-14	4	9	11	15	0.47000000000000003
Bigger Trucks	2021-10-16	3	9	11	14	0.47000000000000003
Megania Online	2021-08-19	71	20	24	95	0.469
Zombie Gunship Survival	2021-09-22	147	410	475	622	0.46799999999999997
萌娘三国	2021-02-09	12	19	23	35	0.46770000000000006
Survival Horror #8,436	2021-05-12	14	19	23	37	0.46770000000000006
Olympic Games Tokyo 2020 – The Official Video Game™	2021-06-21	4064	1183	1366	5430	0.4675
Infected City	2021-06-24	2	8	10	12	0.4673
充气娃娃	2021-06-24	3	8	10	13	0.4673
Magic Time	2021-09-24	2	8	10	12	0.4673
Naked Porn Battle	2021-12-01	4	8	10	14	0.4673
Clash of Legions	2021-09-09	44	41	49	93	0.467
Infinite Dungeon Crawler	2021-06-11	12	13	16	28	0.4669
Rioters 2025	2021-07-16	23	13	16	39	0.4669
Malicious Payload	2021-02-06	2	3	4	6	0.4668
Toolboy	2021-03-18	3	3	4	7	0.4668
ROBALL	2021-02-03	4	3	4	8	0.4668
Towers Inc.	2021-09-06	4	3	4	8	0.4668
Zombies!	2021-04-30	2	3	4	6	0.4668
Tactical Operations Force	2021-12-29	10	3	4	14	0.4668
Jetpack City Action VR	2021-05-05	2	3	4	6	0.4668
JEI VR	2021-03-05	2	3	4	6	0.4668
Forsaken Universe	2021-01-25	3	3	4	7	0.4668
Endless Furry Blackjack	2021-03-23	2	3	4	6	0.4668
Strip Black Jack - Sex Bunny	2021-04-25	5	3	4	9	0.4668
Space Ship DRIFT	2021-04-07	2	3	4	6	0.4668
The Cryptologist Room	2021-04-09	3	3	4	7	0.4668
My Universe - Interior Designer	2021-12-03	3	3	4	7	0.4668
Fantasy Strip Poker & Blackjack	2021-05-01	4	3	4	8	0.4668
Chasing the wind	2021-06-01	2	3	4	6	0.4668
Hot Swap	2021-05-16	3	3	4	7	0.4668
Hi Poker 3D:Texas Holdem	2021-10-11	12	3	4	16	0.4668
SORALAND	2021-05-25	6	3	4	10	0.4668
Dark Harvest	2021-06-11	3	3	4	7	0.4668
Nanoscape VR	2021-06-17	2	3	4	6	0.4668
Idle Master Hunter Steam Edition	2021-09-14	14	3	4	18	0.4668
Heroines	2021-07-26	2	3	4	6	0.4668
Hard Steel	2021-06-15	2	3	4	6	0.4668
Anime puzzle	2021-06-24	2	3	4	6	0.4668
Camp Enigma 2: Point & Click Puzzle Adventure	2021-06-22	3	3	4	7	0.4668
Runes of Avalon 2	2021-08-03	4	3	4	8	0.4668
Monster Wilds	2021-10-05	3	3	4	7	0.4668
Starveling Way	2021-07-28	1	3	4	5	0.4668
Watashi no Kokoro! 君の事が好きです。	2021-08-05	4	3	4	8	0.4668
Paradise	2021-10-13	4	3	4	8	0.4668
Hentai Girls Sliding Puzzle	2021-09-16	1	3	4	5	0.4668
DKLS	2021-09-23	3	3	4	7	0.4668
Lust Complex	2021-10-09	9	3	4	13	0.4668
Connect the Dots	2021-10-14	2	3	4	6	0.4668
Rorys Restaurant Deluxe	2021-10-22	3	3	4	7	0.4668
In The Line Of My Heart	2021-12-22	3	3	4	7	0.4668
Zombie Crush VR	2021-12-10	2	3	4	6	0.4668
Shankaram: CODE REBORN	2021-12-20	2	3	4	6	0.4668
Alone but strong	2021-12-16	2	3	4	6	0.4668
iblis	2021-04-16	28	201	236	264	0.46640000000000004
The Island	2021-08-10	10	39	47	57	0.4656
Primordials: Battle of Gods	2021-03-03	150	33	40	190	0.46520000000000006
Ragdoll Kanojo	2021-10-04	4	12	15	19	0.4648
Rhythm Knights	2021-09-17	3	12	15	18	0.4648
HardPunch: Sex Plague	2021-01-21	10	22	27	37	0.4647
Destructo	2021-03-31	5	7	9	14	0.46409999999999996
极限求生	2021-02-11	4	7	9	13	0.46409999999999996
Detective VR	2021-08-19	5	7	9	14	0.46409999999999996
Space SEX	2021-01-22	13	31	38	51	0.46340000000000003
Elewder	2021-10-28	50	26	32	82	0.46340000000000003
Don't Cheat On Me	2021-01-21	343	134	161	504	0.4625
Island Raft Survival 2021: Ocean Escape 	2021-02-12	5	15	19	24	0.46130000000000004
Farmer Life Simulator	2021-08-21	58	88	107	165	0.4612
Distant Kingdoms	2021-05-05	496	133	161	657	0.461
Retention: A Love Story	2021-03-01	3	6	8	11	0.46020000000000005
MAGIC POT&TER BATTLEGROUNDS	2021-05-04	3	6	8	11	0.46020000000000005
Food Stranding	2021-01-12	2	6	8	10	0.46020000000000005
Park Walk	2021-03-01	2	6	8	10	0.46020000000000005
Retro Clicker	2021-04-29	30	6	8	38	0.46020000000000005
DawnWander	2021-06-23	6	6	8	14	0.46020000000000005
AFTERLIFE - FPS Horror Shooter	2021-12-20	3	6	8	11	0.46020000000000005
Dangerous Planet	2021-06-11	2	6	8	10	0.46020000000000005
My first Furry	2021-11-24	3	6	8	11	0.46020000000000005
PUSSY 4	2021-10-01	4	6	8	12	0.46020000000000005
Crazy Empress	2021-10-21	2	6	8	10	0.46020000000000005
NEO 2045	2021-06-10	31	10	13	44	0.4598
Tag Royal	2021-09-04	5	10	13	18	0.4598
The Station: Escape Room	2021-04-26	8	10	13	21	0.4598
Red Crucible: Able Archer	2021-11-16	10	10	13	23	0.4598
Buildings Have Feelings Too!	2021-04-22	47	32	40	87	0.4597
Global Aviation Dream	2021-06-24	12	14	18	30	0.4593
Vilset	2021-08-31	22	27	34	56	0.45920000000000005
Charlie | The Legend	2021-10-01	25	44	55	80	0.4583
Incremental Epic Breakers	2021-03-17	285	35	44	329	0.4583
Dishwasher	2021-01-12	1	2	3	4	0.4583
Delphyq	2021-10-19	4	2	3	7	0.4583
Zack 2: Celeste's Map	2021-03-11	2	2	3	5	0.4583
Fire Protection Training Simulator	2021-01-08	2	2	3	5	0.4583
Suez Canal Simulator	2021-04-20	3	2	3	6	0.4583
Gravitational	2021-11-11	2	2	3	5	0.4583
Red Cap Zombie Hunter	2021-12-21	2	2	3	5	0.4583
Sunflower Code	2021-01-01	2	2	3	5	0.4583
Smash Track Drifters	2021-03-06	4	2	3	7	0.4583
No Sushi, No Life	2021-01-08	3	2	3	6	0.4583
Fritz & Chesster - Learn to Play Chess Vol. 1	2021-02-08	2	2	3	5	0.4583
Apostle 3D	2021-08-13	1	2	3	4	0.4583
Hotel Paris	2021-07-15	3	2	3	6	0.4583
ZombieVan Drive	2021-01-26	2	2	3	5	0.4583
Across Killzone	2021-02-15	2	2	3	5	0.4583
MOF	2021-11-10	3	2	3	6	0.4583
Blessings of No-more	2021-03-09	2	2	3	5	0.4583
HardCop 2	2021-03-11	1	2	3	4	0.4583
The test of beauty | 小姐姐的考验	2021-03-19	1	2	3	4	0.4583
诗酒剑江湖	2021-04-09	4	2	3	7	0.4583
Godlike	2021-05-19	2	2	3	5	0.4583
Bus stop in the fog	2021-04-29	2	2	3	5	0.4583
Rescuer	2021-08-06	2	2	3	5	0.4583
Zen Cube	2021-05-27	1	2	3	4	0.4583
Cute Girls Love Books	2021-05-01	2	2	3	5	0.4583
Fairy Godmother Stories: Puss in Boots Collector's Edition	2021-05-28	9	2	3	12	0.4583
Express Simulator	2021-06-18	1	2	3	4	0.4583
Bright girl	2021-07-16	1	2	3	4	0.4583
Hentai Jigsaw Girls	2021-07-20	2	2	3	5	0.4583
BattleGrounds : War, Tanks And Nukes	2021-08-26	2	2	3	5	0.4583
Fox Goes Hunting ™	2021-10-08	4	2	3	7	0.4583
Abandoned	2021-10-05	2	2	3	5	0.4583
Sandfall	2021-10-15	5	2	3	8	0.4583
Confessions at Candlewood Lake	2021-09-24	6	2	3	9	0.4583
because King of Beasts.	2021-10-08	9	2	3	12	0.4583
Moon Defense	2021-10-06	1	2	3	4	0.4583
Moster Dice	2021-10-14	3	2	3	6	0.4583
Master Whip	2021-10-06	2	2	3	5	0.4583
Cry Baby	2021-11-12	1	2	3	4	0.4583
Samurai Crawler	2021-10-28	2	2	3	5	0.4583
Proto Shooter Lychee	2021-10-29	1	2	3	4	0.4583
TrapBot	2021-11-12	3	2	3	6	0.4583
Memory Grove	2021-11-28	2	2	3	5	0.4583
Through the world	2021-12-30	1	2	3	4	0.4583
Five dreams	2021-11-18	2	2	3	5	0.4583
Maverta City	2021-11-17	3	2	3	6	0.4583
Angels Prayer	2021-12-01	2	2	3	5	0.4583
Midnight Stories 4	2021-12-14	3	2	3	6	0.4583
Memory Puzzle - Hentai Angels	2021-12-08	2	2	3	5	0.4583
Memory Puzzle - Mystery Mermaids	2021-12-10	2	2	3	5	0.4583
Mystery of Island	2021-12-26	2	2	3	5	0.4583
Mourning Inc.	2021-12-04	18	30	38	56	0.4576
Costume Party	2021-12-27	23	38	48	71	0.457
Warage	2021-06-16	24	17	22	46	0.457
Galactic Crew II	2021-05-06	12	13	17	29	0.457
Call of Senpai: Waifu Warfare	2021-10-29	5	13	17	22	0.457
Guardians of Greyrock	2021-04-02	5	9	12	17	0.45670000000000005
One Night with CLARA	2021-08-06	10	9	12	22	0.45670000000000005
Cyber Girl	2021-02-22	12	9	12	24	0.45670000000000005
Flesh Eating Geriatric Internet Predator	2021-01-28	2	9	12	14	0.45670000000000005
MoneyFalls Coin Pusher Simulator	2021-06-25	37	9	12	49	0.45670000000000005
ZombiesWaves	2021-02-12	5	29	37	42	0.4565
Lightning Fast	2021-06-18	18	41	52	70	0.4559
Iron Survival	2021-03-08	4	5	7	11	0.45520000000000005
Crawler	2021-04-16	2	5	7	9	0.45520000000000005
最后一搏 The last fight	2021-09-24	3	5	7	10	0.45520000000000005
Defence Your Organism	2021-08-15	2	5	7	9	0.45520000000000005
The Forger	2021-08-27	2	5	7	9	0.45520000000000005
Air Strike	2021-09-13	2	5	7	9	0.45520000000000005
Rorys Restaurant: Winter Rush	2021-11-16	2	5	7	9	0.45520000000000005
武林志2（Wushu Chronicles 2）	2021-08-12	386	343	426	812	0.4533
V.O.D.K.A. Open World Survival Shooter	2021-03-13	7	34	44	51	0.45310000000000006
Callparin 2	2021-08-03	3	8	11	14	0.45310000000000006
Haunted House Escape: A VR Experience 	2021-11-30	7	18	24	31	0.4516
The Lands of Eldyn	2021-11-01	9	11	15	24	0.4516
Overpass™	2021-03-16	17	74	96	113	0.4491
新魔剑（New Magic Sword）	2021-04-19	71	27	36	107	0.449
Crossword City Chronicles	2021-01-25	10	7	10	20	0.4487
Power Washer Hero	2021-04-21	5	7	10	15	0.4487
Kittens' Maze	2021-01-21	4	7	10	14	0.4487
Cold Wind	2021-01-08	4	7	10	14	0.4487
Base Defense VR	2021-08-26	6	7	10	16	0.4487
Alphadeck	2021-09-29	4	7	10	14	0.4487
Bed Survival!	2021-03-30	6	7	10	16	0.4487
CubePuzzle	2021-07-25	2	7	10	12	0.4487
Other Realms	2021-10-25	4	4	6	10	0.4486
Fight with love	2021-08-13	2	4	6	8	0.4486
Zoo World VR	2021-02-13	5	4	6	11	0.4486
Dino Eruption	2021-01-23	4	4	6	10	0.4486
Era of Defense	2021-02-08	2	4	6	8	0.4486
Fill and Cross Pirate Riddles	2021-07-07	4	4	6	10	0.4486
Cold Breath	2021-02-24	2	4	6	8	0.4486
The Last Place	2021-03-03	2	4	6	8	0.4486
村庄-The Village	2021-03-25	8	4	6	14	0.4486
CyberGrid: Tower defense	2021-03-27	2	4	6	8	0.4486
Alone in the Office	2021-04-23	5	4	6	11	0.4486
One Day of an Insurance Agent	2021-04-19	2	4	6	8	0.4486
Fantoccini	2021-08-13	3	4	6	9	0.4486
Crypto Is Dead	2021-07-23	7	4	6	13	0.4486
County Hospital	2021-08-04	3	4	6	9	0.4486
Branches	2021-08-27	2	4	6	8	0.4486
Skeleton Troubles	2021-09-06	2	4	6	8	0.4486
Night Darkness	2021-09-05	2	4	6	8	0.4486
Bossa Presents	2021-12-07	12	10	14	26	0.4483
LeHweng LeHweng	2021-01-20	4	10	14	18	0.4483
Rise Eterna	2021-06-09	69	57	75	144	0.4475
蛋蛋掌门日志	2021-05-20	68	26	35	103	0.4475
Medieval Trader Simulator	2021-12-18	15	46	61	76	0.44700000000000006
Elisa Dragon Hunter	2021-12-03	6	22	30	36	0.4464
R.I.C.O. 2: London	2021-09-09	12	9	13	25	0.44450000000000006
Castle Life	2021-11-05	5	9	13	18	0.44450000000000006
Zombie Watch	2021-09-16	18	33	45	63	0.4437
VERSUS: The Deathscapes	2021-05-27	17	6	9	26	0.4434
Play Me	2021-10-14	4	6	9	13	0.4434
Click Your Crush!	2021-07-02	16	6	9	25	0.4434
Why Not?	2021-06-04	3	6	9	12	0.4434
ASTRO: The Beginning	2021-04-22	2	1	2	4	0.44310000000000005
Last Contingency	2021-12-30	7	1	2	9	0.44310000000000005
伊始之战	2021-12-07	4	1	2	6	0.44310000000000005
Sheltering With You	2021-12-27	4	1	2	6	0.44310000000000005
Elkabo: Selina's Dark Spirit	2021-05-28	3	1	2	5	0.44310000000000005
Behind Closed Doors: A Developer's Tale	2021-10-20	2	1	2	4	0.44310000000000005
Dragon Fury VR	2021-02-01	1	1	2	3	0.44310000000000005
Outcast in Mars	2021-01-15	1	1	2	3	0.44310000000000005
Racing Djani 2	2021-01-02	1	1	2	3	0.44310000000000005
Night Stalkers	2021-10-01	1	1	2	3	0.44310000000000005
Sea of Blood	2021-02-25	3	1	2	5	0.44310000000000005
Revenger	2021-01-14	3	1	2	5	0.44310000000000005
NightClub 69: Bunny Girls	2021-12-15	2	1	2	4	0.44310000000000005
1001 Jigsaw Home Sweet Home Wedding Ceremony	2021-01-27	4	1	2	6	0.44310000000000005
Moon Defence	2021-07-26	2	1	2	4	0.44310000000000005
Cinders Of Hades	2021-01-26	2	1	2	4	0.44310000000000005
Hot Honey	2021-01-23	2	1	2	4	0.44310000000000005
Star Ships	2021-01-14	3	1	2	5	0.44310000000000005
Aliens Adventure	2021-01-04	2	1	2	4	0.44310000000000005
Dragonborne	2021-02-12	2	1	2	4	0.44310000000000005
CyberNEON	2021-04-08	2	1	2	4	0.44310000000000005
VR Wonderland 2：Adventures in a Fruit Boat	2021-01-07	1	1	2	3	0.44310000000000005
Absurbia: A Trashy Satire of Suburban Outcries	2021-02-03	2	1	2	4	0.44310000000000005
Abandoned Life	2021-01-30	1	1	2	3	0.44310000000000005
Dark spot	2021-01-20	2	1	2	4	0.44310000000000005
Power Ball 2021	2021-01-18	2	1	2	4	0.44310000000000005
Witch's Reign	2021-07-13	1	1	2	3	0.44310000000000005
Zombie Drift	2021-01-27	2	1	2	4	0.44310000000000005
Imercyve: Living with Intellectual Disability	2021-05-05	1	1	2	3	0.44310000000000005
POSSESSED BLOODY ASYLUM	2021-02-05	2	1	2	4	0.44310000000000005
Starship Tunnel	2021-02-01	2	1	2	4	0.44310000000000005
Across the demon realm	2021-02-08	1	1	2	3	0.44310000000000005
The Damathos Clan	2021-02-18	4	1	2	6	0.44310000000000005
Temptations X: Darkest Fantasy	2021-02-15	3	1	2	5	0.44310000000000005
Formula Bit Racing	2021-02-18	3	1	2	5	0.44310000000000005
Math Castle	2021-03-18	2	1	2	4	0.44310000000000005
You You N Music	2021-03-21	2	1	2	4	0.44310000000000005
RAZE 2070	2021-06-02	3	1	2	5	0.44310000000000005
Mars Accident	2021-04-05	2	1	2	4	0.44310000000000005
DEADLUCK	2021-04-20	2	1	2	4	0.44310000000000005
In Marte - The First Moon	2021-04-28	1	1	2	3	0.44310000000000005
Solo ReflectioN!	2021-12-11	1	1	2	3	0.44310000000000005
Taoyuan Adventure	2021-04-15	2	1	2	4	0.44310000000000005
Fantasy Dungeon VR	2021-08-02	3	1	2	5	0.44310000000000005
Kaiju Crush	2021-05-17	2	1	2	4	0.44310000000000005
PROVIDER	2021-11-26	2	1	2	4	0.44310000000000005
Heltons Haunted Hotel	2021-05-21	2	1	2	4	0.44310000000000005
Big Quest 2: the Adventure	2021-05-04	2	1	2	4	0.44310000000000005
Unchosen: Forsaken	2021-08-12	1	1	2	3	0.44310000000000005
Dose of Dead	2021-08-10	3	1	2	5	0.44310000000000005
Sabre Team	2021-06-04	2	1	2	4	0.44310000000000005
Wounded	2021-08-05	2	1	2	4	0.44310000000000005
Equestrian Training	2021-06-24	2	1	2	4	0.44310000000000005
Newtonian Inversion	2021-05-28	1	1	2	3	0.44310000000000005
Rhythm Hero	2021-06-05	1	1	2	3	0.44310000000000005
Brick Breaker Heart Collector	2021-07-09	2	1	2	4	0.44310000000000005
Castles & Catapults	2021-07-08	1	1	2	3	0.44310000000000005
Navy Strike	2021-10-07	1	1	2	3	0.44310000000000005
Gos Castle Runner	2021-06-14	2	1	2	4	0.44310000000000005
Theseus - Mythological Hero	2021-07-17	1	1	2	3	0.44310000000000005
Training Leah	2021-06-19	2	1	2	4	0.44310000000000005
World Legends	2021-08-12	1	1	2	3	0.44310000000000005
Hot Pieces	2021-07-06	2	1	2	4	0.44310000000000005
女孩与七匹狼	2021-07-08	1	1	2	3	0.44310000000000005
Fill and Cross Trick or Treat	2021-07-16	3	1	2	5	0.44310000000000005
Midsummer Madness	2021-07-04	2	1	2	4	0.44310000000000005
African Safari	2021-07-07	1	1	2	3	0.44310000000000005
DEX : Speed Run - Level Maker - World Records	2021-09-25	2	1	2	4	0.44310000000000005
Nightron Wars	2021-12-20	2	1	2	4	0.44310000000000005
Altarays	2021-08-02	1	1	2	3	0.44310000000000005
Big Fish	2021-07-29	3	1	2	5	0.44310000000000005
真人恋爱大冒险	2021-10-30	2	1	2	4	0.44310000000000005
Pro Pain Labs	2021-08-18	1	1	2	3	0.44310000000000005
Kick It	2021-09-14	2	1	2	4	0.44310000000000005
Queen of Zarkov	2021-10-04	2	1	2	4	0.44310000000000005
Holiday Jigsaw Thanksgiving Day 2	2021-10-07	1	1	2	3	0.44310000000000005
Spaceship War	2021-09-06	1	1	2	3	0.44310000000000005
Earthquake escape	2021-11-25	2	1	2	4	0.44310000000000005
Hold The Plates	2021-09-14	1	1	2	3	0.44310000000000005
Cubicus	2021-09-23	1	1	2	3	0.44310000000000005
Guardians of Greenheart	2021-10-16	3	1	2	5	0.44310000000000005
Izanami	2021-10-07	1	1	2	3	0.44310000000000005
INQUIR P.T.	2021-10-13	1	1	2	3	0.44310000000000005
The Conjurer's Quest	2021-10-18	4	1	2	6	0.44310000000000005
RoboVanRush	2021-10-28	3	1	2	5	0.44310000000000005
Space Hoarders Inc.	2021-11-26	3	1	2	5	0.44310000000000005
Protect The Treasure	2021-11-04	2	1	2	4	0.44310000000000005
Death Slayer V	2021-11-04	3	1	2	5	0.44310000000000005
Enraged	2021-12-16	1	1	2	3	0.44310000000000005
Drynk	2021-11-05	10	1	2	12	0.44310000000000005
Escape Covid Camp	2021-11-30	2	1	2	4	0.44310000000000005
Reta Tus Habilidades	2021-12-13	4	1	2	6	0.44310000000000005
Sin Bearers Tactics	2021-12-06	1	1	2	3	0.44310000000000005
Saving Sunrise	2021-12-30	2	1	2	4	0.44310000000000005
Future Tanks Area	2021-12-09	1	1	2	3	0.44310000000000005
Mystical Riddles: Snowy Peak Hotel Collector's Edition	2021-12-21	6	1	2	8	0.44310000000000005
Nonograms 22	2021-12-25	3	1	2	5	0.44310000000000005
Deadly Forest	2021-05-30	3	8	12	15	0.44
Welcome to PINEHILLS	2021-08-28	5	8	12	17	0.44
Iraq War	2021-08-27	8	8	12	20	0.44
Megacraft Hentai And Zombies	2021-11-06	3	8	12	15	0.44
Here I Come	2021-05-28	5	3	5	10	0.43950000000000006
NecroLand : Undead Corps	2021-06-30	13	3	5	18	0.43950000000000006
Beyond Enemy Lines - Remastered Edition	2021-09-23	4	3	5	9	0.43950000000000006
Rear of Business	2021-01-21	4	3	5	9	0.43950000000000006
Fairy Glade	2021-10-08	4	3	5	9	0.43950000000000006
Mad Devils	2021-05-10	3	3	5	8	0.43950000000000006
DREMA	2021-03-06	3	3	5	8	0.43950000000000006
Farming Tractor Simulator	2021-04-30	3	3	5	8	0.43950000000000006
Tachyon Wars	2021-04-13	3	3	5	8	0.43950000000000006
Rainy Day Roommate	2021-04-04	2	3	5	7	0.43950000000000006
Gustavo : Kingdom Rebirth	2021-03-25	2	3	5	7	0.43950000000000006
Pro Deer Hunting 2	2021-04-30	4	3	5	9	0.43950000000000006
Fastlane Bowling	2021-09-16	2	3	5	7	0.43950000000000006
Hoverboard Chase	2021-07-02	2	3	5	7	0.43950000000000006
Time Voyeur	2021-09-10	2	3	5	7	0.43950000000000006
Fairy Sister	2021-07-29	2	3	5	7	0.43950000000000006
UnScared	2021-08-13	2	3	5	7	0.43950000000000006
邪神大陆	2021-09-09	3	3	5	8	0.43950000000000006
NAGARE-BOSHI	2021-09-11	2	3	5	7	0.43950000000000006
KOSHMAR	2021-09-20	3	3	5	8	0.43950000000000006
Try to Catch Up	2021-09-27	2	3	5	7	0.43950000000000006
Little Island	2021-11-25	3	3	5	8	0.43950000000000006
Puzzle Art: Birds	2021-10-06	4	3	5	9	0.43950000000000006
Happy Summer Quest	2021-10-29	2	3	5	7	0.43950000000000006
Poly Puzzle: Cats	2021-11-17	3	3	5	8	0.43950000000000006
Cricket 22 - Academy Creation Tools	2021-12-15	6	3	5	11	0.43950000000000006
素敵な彼女の作り方	2021-04-23	538	401	531	1069	0.43920000000000003
Gamer Shop Simulator	2021-11-06	13	66	91	104	0.43770000000000003
末日血战	2021-04-01	14	10	15	29	0.4375
Коты Воители	2021-05-21	3	10	15	18	0.4375
Photo Studio	2021-01-29	4	5	8	12	0.4368
Infected Prison	2021-02-04	2	5	8	10	0.4368
Cassidy	2021-03-25	3	5	8	11	0.4368
Girl Next Door	2021-03-17	5	5	8	13	0.4368
Puzzles with cats	2021-07-26	2	5	8	10	0.4368
Forsaken World: Gods and Demons	2021-09-10	83	78	108	191	0.4361
Space Merchant	2021-10-01	15	12	18	33	0.43560000000000004
Pantyhoes	2021-06-03	11	12	18	29	0.43560000000000004
Demolish & Build VR	2021-10-18	5	12	18	23	0.43560000000000004
修真之路	2021-02-06	14	7	11	25	0.4347
Do Something	2021-12-15	4	7	11	15	0.4347
Frick Frack	2021-03-12	25	19	28	53	0.4341
Ka Mate	2021-06-18	5	14	21	26	0.434
ZEE.END	2021-09-14	8	14	21	29	0.434
Modern Assault Tanks	2021-07-12	22	34	49	71	0.43340000000000006
救赎之路 (Lama Azavtani）	2021-02-19	4	9	14	18	0.43310000000000004
Break Free - Resurgence	2021-12-03	8	11	17	25	0.43170000000000003
Ms. Han's After-School Tutoring	2021-08-19	123	62	89	212	0.4303
P0	2021-10-04	6	6	10	16	0.4283
Covid Chaos	2021-04-01	2	6	10	12	0.4283
浮动女孩	2021-05-14	4	6	10	14	0.4283
Dead Transmission	2021-12-02	9	6	10	19	0.4283
Hero of the day	2021-10-26	2	6	10	12	0.4283
Sunshine & Overcast	2021-10-15	2	4	7	9	0.4282
Citor3 Sex Villa VR Adult XXX Game	2021-03-11	4	4	7	11	0.4282
Best Miner	2021-04-01	2	4	7	9	0.4282
Legend of Heroes : Eternal Arena	2021-06-17	9	4	7	16	0.4282
Hero Sword	2021-04-29	2	4	7	9	0.4282
A Winter Story -- Original Edition and Highly Difficult	2021-11-11	2	4	7	9	0.4282
飞机女孩	2021-12-01	3	4	7	10	0.4282
Taxi Chaos	2021-10-19	5	19	29	34	0.42810000000000004
有翼のフロイライン Wing of Darkness	2021-06-03	175	89	128	303	0.4279
ASPEN: Uncanny Home	2021-04-14	11	8	13	24	0.4279
FPS Tactics	2021-04-05	2	8	13	15	0.4279
Husky's Adventures	2021-06-10	4	8	13	17	0.4279
Vaccine Hunter	2021-03-17	2	12	19	21	0.4269
Crazy Defense Heroes	2021-02-16	24	14	22	46	0.4264
Lost Brothers	2021-01-12	9	25	38	47	0.4263
CODE2040	2021-02-02	897	359	506	1403	0.4261
那些年,我们一起收到的好人卡	2021-04-15	2	2	4	6	0.4261
Survival Maze	2021-12-02	2	2	4	6	0.4261
香山31号	2021-01-24	4	2	4	8	0.4261
Dungeon Island	2021-11-01	3	2	4	7	0.4261
Brutal Wizardry	2021-02-17	3	2	4	7	0.4261
Sleeper Cell	2021-01-25	6	2	4	10	0.4261
Elven Truth	2021-01-18	2	2	4	6	0.4261
Bow & Crystal Tower Defense	2021-02-11	2	2	4	6	0.4261
Football Betting	2021-02-24	3	2	4	7	0.4261
Puzzle Challengers	2021-03-08	2	2	4	6	0.4261
Moonwave Overdrive	2021-07-28	3	2	4	7	0.4261
Teomim Island	2021-03-16	2	2	4	6	0.4261
Expert on Domestication	2021-06-09	6	2	4	10	0.4261
Space Explore	2021-05-04	2	2	4	6	0.4261
Network	2021-05-13	2	2	4	6	0.4261
Escape	2021-05-05	3	2	4	7	0.4261
Grey Lucidity	2021-08-06	2	2	4	6	0.4261
你的初恋女友	2021-07-08	1	2	4	5	0.4261
Hardpunch: Fuck 4Joy	2021-10-04	3	2	4	7	0.4261
Hidden Forest	2021-10-05	2	2	4	6	0.4261
Mr.Knight	2021-08-13	3	2	4	7	0.4261
Balls! Balls!	2021-08-08	2	2	4	6	0.4261
Haunted Shores	2021-10-16	4	2	4	8	0.4261
Midnight Stories 3	2021-09-15	3	2	4	7	0.4261
Game Developer Simulator	2021-09-10	2	2	4	6	0.4261
Extinction	2021-10-06	2	2	4	6	0.4261
忍者快递	2021-10-01	1	2	4	5	0.4261
NORR part II: Will Walker	2021-10-04	3	2	4	7	0.4261
Gold Miner	2021-10-01	3	2	4	7	0.4261
Nanny	2021-12-08	2	2	4	6	0.4261
May God Forgive Us	2021-11-12	4	2	4	8	0.4261
Deranged	2021-11-23	2	2	4	6	0.4261
Motorbike Traffic Splash	2021-11-25	2	2	4	6	0.4261
Unidentified	2021-12-08	2	2	4	6	0.4261
Memory Puzzle - Sexy Fairies	2021-12-25	2	2	4	6	0.4261
Women's Prison	2021-08-09	4	18	28	32	0.4254
The Federal Rescue	2021-05-08	4	11	18	22	0.4227
God Sword	2021-04-29	38	17	27	65	0.4225
The Frost Rebirth	2021-03-15	9	9	15	24	0.42240000000000005
Stranded	2021-01-28	135	7	12	147	0.4218
Monster Evo	2021-07-11	18	7	12	30	0.4218
Solar Cage	2021-12-21	6	7	12	18	0.4218
Highrisers	2021-07-15	27	46	70	97	0.42119999999999996
Metric Racer	2021-02-23	3	5	9	12	0.4204
Actor Tycoon 2	2021-01-06	15	5	9	24	0.4204
Sakura Mochi	2021-01-05	2	5	9	11	0.4204
Plunderers Adventures: Sea of Whores	2021-05-13	3	5	9	12	0.4204
Evil Buster	2021-03-26	2	5	9	11	0.4204
Fallen from the sky	2021-05-06	1	5	9	10	0.4204
Valley of No Roads	2021-06-11	6	5	9	15	0.4204
Auction	2021-12-03	8	5	9	17	0.4204
Poly Memory: Cats	2021-12-02	9	5	9	18	0.4204
100 hidden cups	2021-09-15	8	82	124	132	0.41850000000000004
Survival: Lost Way	2021-02-04	55	75	114	169	0.4181
Base One	2021-05-11	464	170	253	717	0.4178
Sam & Max: This Time It's Virtual!	2021-09-10	23	33	52	75	0.4175
The Lodge	2021-03-09	20	21	34	54	0.41700000000000004
Bonhomme 7 Heures	2021-06-04	16	21	34	50	0.41700000000000004
Fantasy Dungeon	2021-04-13	4	8	14	18	0.4167
Anime Arena: Infinite War	2021-04-03	2	3	6	8	0.4167
Mars Mission	2021-02-01	3	3	6	9	0.4167
Miss You	2021-03-27	5	3	6	11	0.4167
I'm a King	2021-04-23	3	3	6	9	0.4167
HuoChaiRenRPG	2021-05-04	2	3	6	8	0.4167
Invisible	2021-05-17	3	3	6	9	0.4167
Mad Mustache	2021-06-07	2	3	6	8	0.4167
Medieval Arms	2021-11-11	2	3	6	8	0.4167
Battlegrounds : First Blast	2021-07-30	2	3	6	8	0.4167
Life Can Be Amazing	2021-08-06	6	3	6	12	0.4167
Dudu Monkey	2021-08-15	2	3	6	8	0.4167
Archer's Adventure	2021-10-02	2	3	6	8	0.4167
Falling As Lightning	2021-09-06	4	3	6	10	0.4167
Mistrun	2021-11-16	2	3	6	8	0.4167
Paunch 2	2021-12-22	49	100	152	201	0.41630000000000006
Prop Hunt	2021-03-26	27	38	60	87	0.41590000000000005
Human Or Virus	2021-03-28	3	6	11	14	0.41450000000000004
The Lost Valley	2021-03-01	3	6	11	14	0.41450000000000004
Battle for Sea 3D	2021-04-08	2	6	11	13	0.41450000000000004
命运边际	2021-12-31	14	11	19	33	0.41409999999999997
Star Wars™ Pinball VR	2021-04-29	52	63	99	151	0.4129
game about games	2021-08-05	4	12	21	25	0.4108
Desdemona	2021-02-28	7	4	8	15	0.4103
Easter Pairs	2021-09-11	2	4	8	10	0.4103
Orc Scrolls	2021-07-06	2	4	8	10	0.4103
Baseball Adventure	2021-06-30	2	4	8	10	0.4103
Hidden Water	2021-10-16	2	4	8	10	0.4103
Thalassophobia	2021-07-24	3	7	13	16	0.41000000000000003
Zombie Craft	2021-12-01	4	7	13	17	0.41000000000000003
Pornocrates	2021-06-04	21	15	26	47	0.4094
The USB Stick Found in the Grass	2021-01-29	33	56	91	124	0.40740000000000004
NSFW Studio	2021-12-02	113	38	63	176	0.40700000000000003
Zombies Beyond Me	2021-09-20	509	141	223	732	0.40640000000000004
GOLD IS MINE	2021-03-04	4	8	15	19	0.40630000000000005
Factory Manager Simulator	2021-09-11	20	19	33	53	0.4061
Dead Shits	2021-11-06	3	0	1	4	0.4058
VR 10 Pin Bowling	2021-05-28	1	0	1	2	0.4058
Trenchfoot	2021-02-07	4	0	1	5	0.4058
Cherry Island	2021-10-19	2	0	1	3	0.4058
Tet VR	2021-06-02	2	0	1	3	0.4058
Loco Launcher	2021-09-09	1	0	1	2	0.4058
Project Polygun	2021-12-16	4	0	1	5	0.4058
Hyperventila	2021-02-26	3	0	1	4	0.4058
Spacebase19	2021-05-17	1	0	1	2	0.4058
Oh Boy More Cheese	2021-10-23	2	0	1	3	0.4058
Toxastra	2021-12-19	1	0	1	2	0.4058
UNDERZONE	2021-02-03	2	0	1	3	0.4058
EXPLORATION OF UNIVERSE	2021-01-20	1	0	1	2	0.4058
Refreshing Sideways Puzzle Ghost Hammer	2021-07-14	2	0	1	3	0.4058
Finding 21	2021-05-18	2	0	1	3	0.4058
Power of the Ancients	2021-09-28	2	0	1	3	0.4058
FyreXR Festival	2021-06-17	12	0	1	13	0.4058
活体三国	2021-12-30	3	0	1	4	0.4058
Tank Rampage	2021-02-11	5	0	1	6	0.4058
Amusemos	2021-01-12	2	0	1	3	0.4058
Nak Sim: Fallen Warriors	2021-02-12	2	0	1	3	0.4058
Jump Hero: Beginning	2021-08-07	1	0	1	2	0.4058
Florida Man: Hurricane Hijinks	2021-05-22	3	0	1	4	0.4058
Tower of mice	2021-05-30	1	0	1	2	0.4058
Structura	2021-05-06	2	0	1	3	0.4058
EXOTIUM - Episode 1	2021-01-01	1	0	1	2	0.4058
Elusive World	2021-12-24	1	0	1	2	0.4058
Death By FrostByte	2021-03-10	2	0	1	3	0.4058
ShatteredGardens	2021-09-01	1	0	1	2	0.4058
Amazing Joes Journey	2021-01-05	1	0	1	2	0.4058
Welcome To Graystone	2021-07-20	2	0	1	3	0.4058
Rathe: The Beginning	2021-01-12	2	0	1	3	0.4058
Medium: The Psychic Party Game	2021-08-02	9	0	1	10	0.4058
ZooSim	2021-11-19	2	0	1	3	0.4058
In Between	2021-03-26	1	0	1	2	0.4058
The Expanse	2021-11-25	1	0	1	2	0.4058
Retis Tormentum	2021-03-08	1	0	1	2	0.4058
Deep Enigma	2021-01-28	1	0	1	2	0.4058
My Low Poly City	2021-01-11	1	0	1	2	0.4058
Through the Helios	2021-01-20	1	0	1	2	0.4058
Lunar Base Camp 2030+	2021-01-13	1	0	1	2	0.4058
重生战士	2021-02-03	1	0	1	2	0.4058
Decabristov Street	2021-02-16	1	0	1	2	0.4058
BullyBall	2021-08-04	1	0	1	2	0.4058
Super Retro World	2021-01-27	1	0	1	2	0.4058
Crazy Factory	2021-03-23	1	0	1	2	0.4058
Aruna	2021-11-15	1	0	1	2	0.4058
World of Fantasy: Zero	2021-02-07	2	0	1	3	0.4058
Hajji VR	2021-02-03	2	0	1	3	0.4058
Tabbris Yor	2021-03-11	2	0	1	3	0.4058
Lame Defenders	2021-11-09	2	0	1	3	0.4058
The Great Unborn	2021-02-16	1	0	1	2	0.4058
Sword of Hypotenuse	2021-09-21	1	0	1	2	0.4058
Odenavirus Chapter 2	2021-10-30	1	0	1	2	0.4058
Retro Wars	2021-02-26	2	0	1	3	0.4058
HANDMADE CARPROGRAM	2021-03-15	1	0	1	2	0.4058
この学園からスタート(Start From School)	2021-02-27	1	0	1	2	0.4058
Number Game:24 Points	2021-04-07	2	0	1	3	0.4058
Polgar: Magic detective	2021-11-04	1	0	1	2	0.4058
GEAR TuNNEL	2021-03-22	2	0	1	3	0.4058
混沌核心	2021-04-11	2	0	1	3	0.4058
Project Elysium	2021-05-19	2	0	1	3	0.4058
剑与园(Sword and Space)	2021-04-28	1	0	1	2	0.4058
Microgravity	2021-08-13	1	0	1	2	0.4058
ORBTRAIN - Slot Racing	2021-04-30	1	0	1	2	0.4058
Lost Gold	2021-03-11	1	0	1	2	0.4058
Killer 19	2021-05-09	1	0	1	2	0.4058
Prison 69	2021-04-18	2	0	1	3	0.4058
神秘世界 Mysterious world	2021-03-31	1	0	1	2	0.4058
Once Upon a Sea	2021-05-13	1	0	1	2	0.4058
2002XX	2021-07-04	2	0	1	3	0.4058
Thief Shop	2021-07-23	4	0	1	5	0.4058
Alien Wall	2021-05-07	1	0	1	2	0.4058
RescueTeam	2021-04-24	2	0	1	3	0.4058
Death Upon Us	2021-07-12	1	0	1	2	0.4058
Flappy Bat	2021-04-12	1	0	1	2	0.4058
奇迹世界 miracle world	2021-04-23	1	0	1	2	0.4058
PrisonShow	2021-04-27	1	0	1	2	0.4058
Zen Arts: Relaxing Pendulum Paint Simulator	2021-04-23	1	0	1	2	0.4058
Loop Knight	2021-04-27	3	0	1	4	0.4058
SpiderPunks	2021-08-03	1	0	1	2	0.4058
League Space	2021-09-26	1	0	1	2	0.4058
Street Racing: United	2021-10-09	2	0	1	3	0.4058
Project Scav	2021-10-01	1	0	1	2	0.4058
Garden Magic	2021-04-27	2	0	1	3	0.4058
宇宙终极秘密-灵魂The ultimate secret of the universe：Soul	2021-05-06	1	0	1	2	0.4058
vreezy: Pictorial Story Vol.1	2021-05-16	3	0	1	4	0.4058
Survive Avalon	2021-05-31	1	0	1	2	0.4058
Shank the Cop	2021-06-04	2	0	1	3	0.4058
Nemithia - Tale of the Legendary Saviors	2021-07-29	2	0	1	3	0.4058
Dr. Byte	2021-06-21	1	0	1	2	0.4058
ray attack	2021-05-22	2	0	1	3	0.4058
Operation Insanity	2021-07-30	1	0	1	2	0.4058
Lipstick Assassin	2021-05-25	1	0	1	2	0.4058
Chicken!	2021-05-30	1	0	1	2	0.4058
Spacegirl 2038	2021-05-25	1	0	1	2	0.4058
The Invasion	2021-05-27	2	0	1	3	0.4058
Puzzle & Maze	2021-06-05	1	0	1	2	0.4058
Equilibrium	2021-10-22	1	0	1	2	0.4058
890B	2021-11-10	2	0	1	3	0.4058
Bird's Eye	2021-08-23	1	0	1	2	0.4058
Alone	2021-07-30	2	0	1	3	0.4058
Yin Yuh	2021-06-18	1	0	1	2	0.4058
Time Knight Adventures	2021-08-12	1	0	1	2	0.4058
Shoganai	2021-07-12	2	0	1	3	0.4058
Mercenary Operator: Wolves	2021-08-16	2	0	1	3	0.4058
PuzzleCafeVR	2021-10-09	1	0	1	2	0.4058
Fiore I: Daffodil	2021-06-30	1	0	1	2	0.4058
HamsterVeRse	2021-08-13	1	0	1	2	0.4058
Go Rocket	2021-07-07	1	0	1	2	0.4058
Insomnious	2021-10-27	2	0	1	3	0.4058
觉梦：赛博	2021-07-16	1	0	1	2	0.4058
Rainbow Fuego	2021-07-15	1	0	1	2	0.4058
CYBERUSH	2021-07-07	1	0	1	2	0.4058
Cliché Adventure	2021-08-02	2	0	1	3	0.4058
Meteor Genocide	2021-07-05	1	0	1	2	0.4058
战斗俄罗斯方块	2021-07-27	4	0	1	5	0.4058
Vacation Adventures: Park Ranger 7	2021-09-09	4	0	1	5	0.4058
Cyber Girl 1.0: Booting	2021-07-03	1	0	1	2	0.4058
保护蛋蛋	2021-08-03	1	0	1	2	0.4058
Wave Shooter	2021-08-14	1	0	1	2	0.4058
VR Military Reporter in Middle East (with tanks & helicopters)	2021-08-06	1	0	1	2	0.4058
The Hunter's Journals - Tattered Sails	2021-10-31	2	0	1	3	0.4058
VR Pirates of the Caribbean Life Experience	2021-08-26	1	0	1	2	0.4058
Cybermere	2021-10-29	2	0	1	3	0.4058
海底轮回	2021-08-07	1	0	1	2	0.4058
The Last War	2021-12-25	1	0	1	2	0.4058
Chibi Girl vs. Evil Zombie Dead	2021-12-16	2	0	1	3	0.4058
Mithos	2021-08-06	1	0	1	2	0.4058
Ingredienta	2021-10-14	1	0	1	2	0.4058
Penguin Panic	2021-08-10	2	0	1	3	0.4058
Walking into Walls	2021-08-13	1	0	1	2	0.4058
Between Two Cities - Stonemaier Games	2021-08-20	3	0	1	4	0.4058
Star Witch	2021-11-02	1	0	1	2	0.4058
Calculator and monsters	2021-08-25	3	0	1	4	0.4058
Danger Zombies	2021-09-10	1	0	1	2	0.4058
Infinity war	2021-09-08	2	0	1	3	0.4058
Googass	2021-08-26	2	0	1	3	0.4058
13 WOOD ST	2021-10-01	1	0	1	2	0.4058
Evolution of War	2021-10-12	2	0	1	3	0.4058
Neutron and the Tri-Spark	2021-09-15	1	0	1	2	0.4058
Midnight Calling: Valeria Collector's Edition	2021-08-27	7	0	1	8	0.4058
Wings Of WW2	2021-10-04	2	0	1	3	0.4058
Hidden Objects - Cartoon Fantasy	2021-09-18	1	0	1	2	0.4058
Gpi	2021-09-21	7	0	1	8	0.4058
Failling Capsule	2021-10-11	2	0	1	3	0.4058
殖民地往事	2021-10-02	3	0	1	4	0.4058
Midnight Blues	2021-10-01	1	0	1	2	0.4058
City Air Battle	2021-09-30	2	0	1	3	0.4058
The VanMan	2021-10-06	1	0	1	2	0.4058
SOUNDXWORLD	2021-10-16	1	0	1	2	0.4058
高射炮 flak	2021-10-16	1	0	1	2	0.4058
HeroBattle	2021-11-11	1	0	1	2	0.4058
Niiikotopia: Sky Fall	2021-10-14	1	0	1	2	0.4058
Arm Wrestling Reborn	2021-11-28	2	0	1	3	0.4058
Fear in The Modern House - CH3	2021-10-08	2	0	1	3	0.4058
Blood Red Fists	2021-10-13	1	0	1	2	0.4058
Gliont Light	2021-10-27	4	0	1	5	0.4058
Raiders of the Icepeak Mountains	2021-11-12	4	0	1	5	0.4058
Sweet Hero	2021-10-29	2	0	1	3	0.4058
Assembly	2021-10-15	1	0	1	2	0.4058
SnowRocket	2021-10-28	1	0	1	2	0.4058
The Wrath Of The Erlik	2021-10-26	2	0	1	3	0.4058
Slot Factory - Magic Brewery	2021-11-16	1	0	1	2	0.4058
Word of Kitchen	2021-10-22	1	0	1	2	0.4058
Puzzle Art: Artiodactyls	2021-10-26	2	0	1	3	0.4058
Cute Chess	2021-12-31	2	0	1	3	0.4058
RagingFist	2021-11-05	1	0	1	2	0.4058
Alone	2021-11-11	2	0	1	3	0.4058
Artemis	2021-11-11	1	0	1	2	0.4058
Find Her in Dungeon (3D Quest)	2021-12-01	1	0	1	2	0.4058
Key	2021-12-01	2	0	1	3	0.4058
RED OPS ARCADE	2021-12-29	2	0	1	3	0.4058
Together My Headers	2021-12-04	0	0	1	1	0.4058
Immersion	2021-12-05	1	0	1	2	0.4058
ANCIENT SOCCER	2021-12-14	2	0	1	3	0.4058
Candy Maker	2021-11-29	1	0	1	2	0.4058
Dungeons Of Honor	2021-11-30	1	0	1	2	0.4058
Hackers in Battlefield	2021-12-04	1	0	1	2	0.4058
Little Sparks	2021-12-23	1	0	1	2	0.4058
Legend of Egypt - Jewels of the Gods 2	2021-12-03	3	0	1	4	0.4058
LunaQuest	2021-12-10	1	0	1	2	0.4058
OnlySociety: Arena	2021-12-23	1	0	1	2	0.4058
Comixxx Memories	2021-12-29	3	0	1	4	0.4058
Anima	2021-12-30	1	0	1	2	0.4058
Devil Should Die	2021-12-27	1	0	1	2	0.4058
Drone Simulator	2021-12-22	2	0	1	3	0.4058
Commandos Pro Simulator	2021-02-23	4	5	10	14	0.4057
Steel Nations	2021-09-10	2	5	10	12	0.4057
Gravity run	2021-03-26	2	5	10	12	0.4057
卡牌冒险者	2021-05-21	6	5	10	16	0.4057
LineArt Jigsaw Puzzle - Airplanes	2021-04-26	2	5	10	12	0.4057
Jigsaw Frame: Hot Anime	2021-08-13	2	5	10	12	0.4057
DreamScapes Dimensions	2021-01-22	41	25	43	84	0.4046
Wargs	2021-08-27	4	1	3	7	0.40399999999999997
Bunny Count	2021-01-22	6	1	3	9	0.40399999999999997
Asterism	2021-07-22	3	1	3	6	0.40399999999999997
Craftsman story	2021-03-31	2	1	3	5	0.40399999999999997
WORDDING	2021-09-30	1	1	3	4	0.40399999999999997
Wetlands	2021-02-05	1	1	3	4	0.40399999999999997
Super Chopper	2021-04-27	6	1	3	9	0.40399999999999997
その首輪を離さないで ～狼を食べたい赤ずきんと赤ずきんを食べたい猟師～	2021-02-18	3	1	3	6	0.40399999999999997
Boom Dojo	2021-01-29	2	1	3	5	0.40399999999999997
Hell Invades Heaven	2021-10-22	1	1	3	4	0.40399999999999997
Worst nightmare	2021-01-20	2	1	3	5	0.40399999999999997
Zero-G Revolution	2021-02-19	2	1	3	5	0.40399999999999997
Chaos Road	2021-03-12	3	1	3	6	0.40399999999999997
Pizza Shop Manager	2021-08-20	4	1	3	7	0.40399999999999997
Zombie Dungeon	2021-02-12	2	1	3	5	0.40399999999999997
UC KART	2021-03-12	3	1	3	6	0.40399999999999997
Break It Down	2021-02-21	2	1	3	5	0.40399999999999997
Drop Blox	2021-06-20	1	1	3	4	0.40399999999999997
Avoid!	2021-02-15	2	1	3	5	0.40399999999999997
轮回修仙决	2021-02-26	7	1	3	10	0.40399999999999997
Darker : Episode I	2021-04-30	2	1	3	5	0.40399999999999997
BangBangShooting	2021-06-23	2	1	3	5	0.40399999999999997
Wisdom	2021-03-17	1	1	3	4	0.40399999999999997
Nox Terrorem: Lost Souls	2021-05-31	3	1	3	6	0.40399999999999997
Magic Balls	2021-03-20	2	1	3	5	0.40399999999999997
FindDark	2021-05-05	1	1	3	4	0.40399999999999997
Dark frame	2021-04-23	2	1	3	5	0.40399999999999997
Breaking earth	2021-08-21	3	1	3	6	0.40399999999999997
SHADOW STEP	2021-04-27	10	1	3	13	0.40399999999999997
Miracle field	2021-05-04	2	1	3	5	0.40399999999999997
Darkness Arrives	2021-05-05	2	1	3	5	0.40399999999999997
Wizard's Duty	2021-05-07	1	1	3	4	0.40399999999999997
旅途	2021-05-25	2	1	3	5	0.40399999999999997
Eyewitness Hopper	2021-05-10	2	1	3	5	0.40399999999999997
Draw IT!	2021-05-14	1	1	3	4	0.40399999999999997
Project E.V.A. Remake	2021-05-23	3	1	3	6	0.40399999999999997
Horror House	2021-09-15	3	1	3	6	0.40399999999999997
Hentai Match 3	2021-07-08	2	1	3	5	0.40399999999999997
Sweet Dream	2021-05-31	2	1	3	5	0.40399999999999997
Bunny Flush	2021-06-30	2	1	3	5	0.40399999999999997
1001 Jigsaw: Earth Chronicles 5	2021-07-07	3	1	3	6	0.40399999999999997
Street Racer	2021-08-02	2	1	3	5	0.40399999999999997
Kitsune Killer	2021-07-30	1	1	3	4	0.40399999999999997
G-MODEアーカイブス19 マジカルドロップDX	2021-08-24	3	1	3	6	0.40399999999999997
Brick People	2021-08-24	2	1	3	5	0.40399999999999997
FUN Platformer	2021-09-28	1	1	3	4	0.40399999999999997
Jigsaw With Animals	2021-08-15	1	1	3	4	0.40399999999999997
Project Martians	2021-08-22	3	1	3	6	0.40399999999999997
Makber	2021-08-25	2	1	3	5	0.40399999999999997
狂の世界-Crazy World-	2021-09-01	2	1	3	5	0.40399999999999997
Return Alive	2021-11-07	1	1	3	4	0.40399999999999997
Hentai Madness	2021-12-02	2	1	3	5	0.40399999999999997
Valentine's Day Griddlers	2021-11-10	3	1	3	6	0.40399999999999997
Dead Way	2021-11-05	5	1	3	8	0.40399999999999997
Froggerty Arcade 2	2021-12-01	3	1	3	6	0.40399999999999997
Knight Runaway	2021-12-21	1	1	3	4	0.40399999999999997
Maze Art: Yellow	2021-12-04	2	1	3	5	0.40399999999999997
Battle Of The Robots	2021-12-08	2	1	3	5	0.40399999999999997
Lovely Anna	2021-12-29	2	1	3	5	0.40399999999999997
Elise's Peepshow	2021-01-08	5	9	17	22	0.4032
Sexcraft - Sofiya and the Lewd Clan	2021-09-24	9	6	12	21	0.402
江湖乐子人	2021-12-22	3	6	12	15	0.402
Adult Puzzles - CamGirls	2021-10-09	3	6	12	15	0.402
Erzurum	2021-02-10	934	1495	2314	3248	0.40149999999999997
Line Simulator	2021-02-06	3	2	5	8	0.40030000000000004
Voidwalkers - Astora's Darkness	2021-09-16	2	2	5	7	0.40030000000000004
World of Wonder	2021-05-14	2	2	5	7	0.40030000000000004
蓝实战队	2021-01-15	3	2	5	8	0.40030000000000004
Horus IDLE	2021-01-06	4	2	5	9	0.40030000000000004
Vector Race	2021-01-20	1	2	5	6	0.40030000000000004
Pirates of the Asteroid Belt	2021-08-13	2	2	5	7	0.40030000000000004
RAKETENWASCHMACHINE	2021-03-10	1	2	5	6	0.40030000000000004
Coeus Plan	2021-03-27	2	2	5	7	0.40030000000000004
Car Drive	2021-04-16	2	2	5	7	0.40030000000000004
Smoots Summer Games	2021-07-22	4	2	5	9	0.40030000000000004
Coolors	2021-05-25	2	2	5	7	0.40030000000000004
World Pirate Wars	2021-07-31	4	2	5	9	0.40030000000000004
Candy land	2021-06-28	1	2	5	6	0.40030000000000004
Splash Road	2021-07-14	2	2	5	7	0.40030000000000004
TheBlackHouse	2021-11-08	2	2	5	7	0.40030000000000004
Penguin Quest	2021-09-02	2	2	5	7	0.40030000000000004
Modern Game Tycoon	2021-12-21	2	2	5	7	0.40030000000000004
Imitating Zombies	2021-11-15	1	2	5	6	0.40030000000000004
Serious Breakdown	2021-11-15	2	2	5	7	0.40030000000000004
Alien Abduction Experience PC HD	2021-11-18	3	2	5	8	0.40030000000000004
Your Sword Is So Big	2021-10-08	10	31	54	64	0.4001
Astellia Royal	2021-03-11	744	185	301	1045	0.3992
The Warrior War	2021-05-08	5	7	14	19	0.39909999999999995
Open Country	2021-06-10	355	145	238	593	0.39880000000000004
蒼墨龍吟 The Dragon Sword	2021-01-18	7	3	7	14	0.3972
Ｓ〇Ｘしないと出られない部屋ＶＲ	2021-02-08	5	3	7	12	0.3972
Baobabs Mausoleum Grindhouse Edition	2021-02-26	2	3	7	9	0.3972
Darkness Shooter	2021-02-21	2	3	7	9	0.3972
Fantasy Adventure	2021-02-25	2	3	7	9	0.3972
Partless Ron	2021-03-14	2	3	7	9	0.3972
Pandemic Heart	2021-06-04	3	3	7	10	0.3972
Lustful Tribe	2021-11-09	10	3	7	17	0.3972
Airplane Tycoon	2021-09-04	4	3	7	11	0.3972
ellie on the ruins	2021-08-14	3	3	7	10	0.3972
风驰电掣	2021-08-20	2	3	7	9	0.3972
Box Survivors World	2021-10-07	5	3	7	12	0.3972
Infinite Progression	2021-11-19	7	3	7	14	0.3972
SMETANKA	2021-07-13	4	8	16	20	0.39659999999999995
Hidden Town	2021-10-16	2	8	16	18	0.39659999999999995
 Build & Battle	2021-09-02	3	4	9	12	0.3946
我的城市与军队	2021-02-11	10	4	9	19	0.3946
Jumping Over It With Neko Girl	2021-02-13	3	4	9	12	0.3946
Wood Killer	2021-06-23	3	4	9	12	0.3946
Gefragt Gejagt - Das Spiel	2021-10-29	18	4	9	27	0.3946
Seductive Tombs: Beach Love	2021-08-13	2	4	9	11	0.3946
RawElement	2021-03-08	7	9	18	25	0.3945
Skydome	2021-08-18	176	35	63	239	0.39299999999999996
Booty Calls - Men At Work	2021-10-04	21	14	27	48	0.3929
Battle Lust	2021-06-23	31	14	27	58	0.3929
Snow Survival	2021-03-20	7	10	20	27	0.3926
The Island Combat	2021-05-08	5	5	11	16	0.3924
Close Combat: Modern Tactics	2021-04-15	8	5	11	19	0.3924
Speed 3: Grand Prix	2021-12-16	3	5	11	14	0.3924
BLIND	2021-04-30	4	5	11	15	0.3924
Jungle Rumble	2021-05-02	2	5	11	13	0.3924
The Dawn: Sniper's Way	2021-12-01	2	6	13	15	0.39049999999999996
Great Lakes Simulator	2021-12-16	9	6	13	22	0.39049999999999996
The Forgotten	2021-03-05	4	7	15	19	0.3889
Enherjar Synergy	2021-11-16	6	7	15	21	0.3889
Lands Of Peace	2021-01-25	18	35	66	84	0.3847
AFK Summoner	2021-11-02	33	27	53	86	0.38079999999999997
Kingdom of Maverta	2021-11-11	3	4	10	13	0.3805
Scroll Of Life	2021-11-27	1	4	10	11	0.3805
Little Moneybags	2021-04-01	12	5	12	24	0.3804
VR Plane Crash	2021-01-05	2	3	8	10	0.3803
ABERRATION TOWN	2021-02-06	3	3	8	11	0.3803
ADD	2021-04-05	2	3	8	10	0.3803
Escape - The Speedrun Game	2021-07-09	3	3	8	11	0.3803
Island World	2021-04-15	2	3	8	10	0.3803
Bunny Dance	2021-11-12	3	3	8	11	0.3803
Athletics 3: Summer Sports	2021-06-25	8	3	8	16	0.3803
Mini Kart Racing	2021-10-02	3	3	8	11	0.3803
Pug With Bomb	2021-08-24	2	3	8	10	0.3803
Check, please! : Restaurant Simulator	2021-10-07	5	3	8	13	0.3803
Cinnet	2021-10-07	3	3	8	11	0.3803
Alien worm	2021-11-11	2	3	8	10	0.3803
FAUN AIR -フォーンアイル-	2021-01-18	10	7	16	26	0.37950000000000006
Destroy It	2021-02-23	3	7	16	19	0.37950000000000006
Quiet Sleep	2021-02-03	6	8	18	24	0.379
CRAFTSMAN	2021-06-26	5	8	18	23	0.379
Choco Rabbit Revenge	2021-03-26	3	8	18	21	0.379
Girls Pinball	2021-01-30	3	2	6	9	0.379
Extreme racing	2021-04-29	1	2	6	7	0.379
Lost Islands	2021-05-03	6	2	6	12	0.379
Shaped Touches	2021-07-16	2	2	6	8	0.379
Spades	2021-07-13	6	2	6	12	0.379
Iris Covenant –Song of the Forgotten Heroes–	2021-10-02	7	2	6	13	0.379
QUIZxRPG	2021-11-12	3	2	6	9	0.379
Poly Memory: Furries	2021-10-16	2	2	6	8	0.379
Skull Bullets	2021-10-20	2	2	6	8	0.379
Date of death: origin	2021-11-12	3	2	6	9	0.379
"Agoraphobia ""Knock Knock"""	2021-04-06	6	9	20	26	0.3785
KaraDedeler1989	2021-09-09	4	9	20	24	0.3785
审判者	2021-04-29	458	117	215	673	0.37810000000000005
The Expedition	2021-12-22	3	1	4	7	0.3749
Dangerous Plane	2021-03-09	2	1	4	6	0.3749
Slurkum	2021-03-09	10	1	4	14	0.3749
Portals World	2021-02-25	2	1	4	6	0.3749
Ravished Realms	2021-04-07	2	1	4	6	0.3749
You Must Survive	2021-03-26	2	1	4	6	0.3749
Medieval Shop Simulator	2021-08-25	2	1	4	6	0.3749
Pixel Game Maker Series DRAGON PEAK	2021-03-19	3	1	4	7	0.3749
Dangerous sea area	2021-02-28	2	1	4	6	0.3749
WAR FACTORY	2021-06-02	4	1	4	8	0.3749
Jelly Party: Fire	2021-10-16	2	1	4	6	0.3749
VR Nara Park	2021-04-04	4	1	4	8	0.3749
The Hell Hives	2021-04-29	2	1	4	6	0.3749
Atlantis Adventure VR	2021-05-15	2	1	4	6	0.3749
Good Girls	2021-06-02	3	1	4	7	0.3749
Musicle	2021-06-01	2	1	4	6	0.3749
Useful Cat	2021-06-04	2	1	4	6	0.3749
Flying Corps	2021-10-14	2	1	4	6	0.3749
A Week in the Office -Under the Table-	2021-07-09	6	1	4	10	0.3749
CUBE-e	2021-08-01	2	1	4	6	0.3749
Plumber 2	2021-08-03	3	1	4	7	0.3749
Jelly 2	2021-08-13	2	1	4	6	0.3749
Space Adventures	2021-09-07	1	1	4	5	0.3749
War Wind II: Human Onslaught	2021-09-16	4	1	4	8	0.3749
Forbidden place	2021-10-02	2	1	4	6	0.3749
Traffic Command: Reborn	2021-09-13	1	1	4	5	0.3749
Halloween Memory: Reborn	2021-09-15	2	1	4	6	0.3749
Funny puzzle	2021-10-02	2	1	4	6	0.3749
Zombie Maze	2021-11-19	2	1	4	6	0.3749
The Gift	2021-11-26	3	1	4	7	0.3749
BallRoll	2021-12-09	2	1	4	6	0.3749
欲望忍者/Desire Ninja	2021-12-30	2	1	4	6	0.3749
Horny Pixels	2021-12-29	2	1	4	6	0.3749
Loch Ness	2021-12-03	18	39	78	96	0.373
MUSIC ROOM / おんがくしつ	2021-01-16	6	10	23	29	0.3712
Hellgate VR	2021-03-31	3	10	23	26	0.3712
Freelancer Life Simulator	2021-03-05	8	9	21	29	0.3711
猎妖美姬	2021-12-17	11	9	21	32	0.3711
The Sacred Stone: A Story Adventure	2021-04-05	2428	13	29	2457	0.37090000000000006
Nerf Legends	2021-11-19	10	14	31	41	0.37079999999999996
Buried Alive: The Annihilation VR	2021-01-19	9	6	15	24	0.37020000000000003
The Road to Gelendzhik Palace	2021-02-17	2	5	13	15	0.3694
疑義照会ウォーズ	2021-12-03	16	5	13	29	0.3694
Real Farm – Gold Edition	2021-06-24	8	4	11	19	0.3679
KARMA	2021-03-10	3	4	11	14	0.3679
Ninety Days	2021-02-26	3	3	9	12	0.3655
Degenerate Souls	2021-05-07	2	3	9	11	0.3655
Snowboard	2021-02-24	3	8	20	23	0.36350000000000005
Empire IDLE	2021-01-17	16	7	18	34	0.3625
Retro Classix: Night Slashers	2021-06-24	5	7	18	23	0.3625
NEO: Commanders	2021-07-09	2	2	7	9	0.3611
Zombie Alert	2021-01-02	2	2	7	9	0.3611
Wave War One	2021-07-01	4	2	7	11	0.3611
Must Reach	2021-02-21	2	2	7	9	0.3611
Life is sad	2021-03-04	2	2	7	9	0.3611
NOREN	2021-04-23	2	2	7	9	0.3611
Midnight Stories 2	2021-05-07	4	2	7	11	0.3611
梦回三国	2021-07-17	4	2	7	11	0.3611
Hexagon World	2021-08-04	2	2	7	9	0.3611
Human Madness	2021-10-21	4	2	7	11	0.3611
Blocky Snake	2021-12-20	2	2	7	9	0.3611
雨音スイッチ - AmaneSwitch -	2021-08-24	6	5	14	20	0.3593
Spinner Invaders	2021-09-28	1	0	2	3	0.3592
Captains & Dungeons	2021-02-14	1	0	2	3	0.3592
两体 War of the Twins	2021-03-15	2	0	2	4	0.3592
Molecule Builder	2021-02-04	4	0	2	6	0.3592
RItum Bitum	2021-05-11	1	0	2	3	0.3592
SecreD	2021-01-29	1	0	2	3	0.3592
La légende des Diamétis, la quête de Chloé	2021-01-26	1	0	2	3	0.3592
Arboreal	2021-12-01	3	0	2	5	0.3592
Fly The Cloud	2021-01-04	3	0	2	5	0.3592
Galaxy V	2021-01-15	1	0	2	3	0.3592
VR Graffiti World	2021-08-05	1	0	2	3	0.3592
Necrojacks	2021-02-21	1	0	2	3	0.3592
王国的魔法战争	2021-01-26	3	0	2	5	0.3592
Evil Shogun	2021-07-20	1	0	2	3	0.3592
Hollow Ghost	2021-03-13	1	0	2	3	0.3592
Wild Workshop	2021-01-29	2	0	2	4	0.3592
Escape Prison	2021-01-28	2	0	2	4	0.3592
The Build And Race Hotrod Game	2021-02-05	1	0	2	3	0.3592
Ascended	2021-03-19	1	0	2	3	0.3592
Hunter	2021-04-05	3	0	2	5	0.3592
Outsourcing - IT company simulator	2021-03-25	2	0	2	4	0.3592
ISDDS	2021-03-18	5	0	2	7	0.3592
VR BOXING MASTER	2021-03-13	1	0	2	3	0.3592
Potion Meister	2021-11-02	2	0	2	4	0.3592
Faction Wars	2021-03-24	1	0	2	3	0.3592
Zombie Hazard	2021-10-08	2	0	2	4	0.3592
Save The Heart Planet	2021-05-14	2	0	2	4	0.3592
Police Monster Drift	2021-05-11	2	0	2	4	0.3592
МОЙ ПСИХОЛОГ | БОТ-Ассистент	2021-06-08	2	0	2	4	0.3592
Criminal T	2021-04-29	2	0	2	4	0.3592
Ghost of the Seas	2021-06-23	2	0	2	4	0.3592
Keep looking	2021-04-25	3	0	2	5	0.3592
Steel Rain - Dawn of the Machines	2021-10-23	2	0	2	4	0.3592
Hiragana Katakana Ninja	2021-05-24	1	0	2	3	0.3592
Fimbul Winter VR	2021-06-03	2	0	2	4	0.3592
COCKEYED HELICOPTERS	2021-05-31	3	0	2	5	0.3592
BattleDead	2021-06-24	2	0	2	4	0.3592
Zyconix	2021-07-02	1	0	2	3	0.3592
SpellHunter	2021-06-25	2	0	2	4	0.3592
VRAstroSmash	2021-07-15	1	0	2	3	0.3592
Take town	2021-08-27	1	0	2	3	0.3592
Tactical Vanguard Saga	2021-07-20	1	0	2	3	0.3592
Plush Madness	2021-08-27	2	0	2	4	0.3592
Jude	2021-08-10	1	0	2	3	0.3592
DROPTCH	2021-10-15	2	0	2	4	0.3592
Red Brick Hotel	2021-08-10	2	0	2	4	0.3592
Bacteria Wars	2021-08-26	1	0	2	3	0.3592
SpaceSeals	2021-08-11	1	0	2	3	0.3592
Memories of War Undead Decimation	2021-12-01	3	0	2	5	0.3592
Virtual world Primus	2021-08-27	1	0	2	3	0.3592
Kick Ball	2021-09-17	1	0	2	3	0.3592
脱出忍者	2021-09-29	2	0	2	4	0.3592
Space X Collector	2021-09-02	1	0	2	3	0.3592
DEBIE ZONE	2021-09-03	1	0	2	3	0.3592
Augmented Future	2021-11-18	1	0	2	3	0.3592
VR crazy racing	2021-12-10	2	0	2	4	0.3592
游戏：异星	2021-09-27	1	0	2	3	0.3592
Solo Royale	2021-09-27	1	0	2	3	0.3592
The Last Will	2021-10-13	1	0	2	3	0.3592
Task Force 88	2021-11-08	2	0	2	4	0.3592
英雄这边请	2021-11-05	5	0	2	7	0.3592
Puzzlezon	2021-11-12	2	0	2	4	0.3592
Spin Fighter	2021-11-26	2	0	2	4	0.3592
REX	2021-12-08	1	0	2	3	0.3592
TOUGE RACERS	2021-12-03	1	0	2	3	0.3592
Adamanta View	2021-12-01	1	0	2	3	0.3592
Puputan Legend VR	2021-12-08	1	0	2	3	0.3592
Ascendants Rising	2021-06-25	22	9	23	45	0.3576
End of Days	2021-08-27	30	15	36	66	0.3568
Blackstorm	2021-06-01	142	4	12	154	0.3565
Galactic Pick Up Artist	2021-05-04	3	4	12	15	0.3565
VR Prison Escape	2021-05-19	3	4	12	15	0.3565
Underwater	2021-05-21	3	4	12	15	0.3565
甜蜜别墅	2021-10-29	6	4	12	18	0.3565
Battlefield™ 2042	2021-11-19	105397	65753	121198	226595	0.3556
Animal Doctor	2021-03-25	18	7	19	37	0.35479999999999995
Source of Survival	2021-07-24	14	7	19	33	0.35479999999999995
Neighbor Diana	2021-09-02	4	7	19	23	0.35479999999999995
Water Drift	2021-05-02	2	3	10	12	0.35240000000000005
Oh, Dungeon Master	2021-10-02	2	3	10	12	0.35240000000000005
Soter	2021-02-27	6	1	5	11	0.3522
Art Of Air War	2021-01-06	3	1	5	8	0.3522
Soulpath	2021-07-09	2	1	5	7	0.3522
Владимир 2021	2021-02-19	2	1	5	7	0.3522
Moloko	2021-03-09	2	1	5	7	0.3522
X air combat	2021-02-06	3	1	5	8	0.3522
Caveman	2021-04-03	2	1	5	7	0.3522
When I reincarnate, I'm a cube!?	2021-07-01	2	1	5	7	0.3522
Magic defense	2021-05-26	2	1	5	7	0.3522
DRUM'N'BASS MASSACRE	2021-06-01	2	1	5	7	0.3522
The Crows Cry	2021-06-30	2	1	5	7	0.3522
Sin-Cay	2021-08-04	2	1	5	7	0.3522
Wizardess Lintiara	2021-10-08	3	1	5	8	0.3522
Pirates vs monkeys	2021-08-06	2	1	5	7	0.3522
Find Match Icons	2021-09-23	1	1	5	6	0.3522
BrickOut	2021-10-01	2	1	5	7	0.3522
eFootball™ 2023	2021-09-30	14360	17798	33744	48104	0.35119999999999996
Paradise Lost	2021-03-05	2	5	15	17	0.35000000000000003
霸主:没人比我更懂胜利	2021-11-26	32	8	22	54	0.3497
Deep Insanity ASYLUM	2021-10-13	185	4	13	198	0.3462
Play a ball	2021-06-20	3	4	13	16	0.3462
Death Realm	2021-07-07	2	4	13	15	0.3462
Clarity of The Soul	2021-11-12	2	4	13	15	0.3462
Minicraft Shooter	2021-02-27	2	2	8	10	0.3458
MaJiang	2021-02-18	2	2	8	10	0.3458
Village Defender	2021-04-16	2	2	8	10	0.3458
Tentacles of Submission	2021-10-04	3	2	8	11	0.3458
idle tentacles	2021-07-10	9	6	18	27	0.34490000000000004
Nature Park	2021-04-29	2	5	16	18	0.34140000000000004
CS Horizon	2021-07-28	2	5	16	18	0.34140000000000004
Idle Trading Simulator	2021-09-02	10	5	16	26	0.34140000000000004
Street Football	2021-01-07	2	3	11	13	0.3407
Ero Tennis	2021-02-02	2	3	11	13	0.3407
Planets Battle	2021-05-03	2	3	11	13	0.3407
PROPHECY OF THE NUN	2021-08-28	3	3	11	14	0.3407
Violation	2021-12-15	4	3	11	15	0.3407
I Am Robot	2021-01-15	136	8	24	160	0.3373
Happy Day	2021-08-20	2	4	14	16	0.3367
Fimbul Winter	2021-05-06	2	4	14	16	0.3367
审判者 高清重制全章节版	2021-06-10	130	56	136	266	0.3344
Bionite: Origins	2021-08-13	3	1	6	9	0.33380000000000004
Infected Town	2021-01-18	2	1	6	8	0.33380000000000004
After Off War	2021-05-21	2	1	6	8	0.33380000000000004
Duty in the Forest	2021-05-14	2	1	6	8	0.33380000000000004
Hentai Beach Girls	2021-05-28	3	1	6	9	0.33380000000000004
Drunken Samurai	2021-04-28	2	1	6	8	0.33380000000000004
Ascension	2021-06-09	2	1	6	8	0.33380000000000004
Kate Don't Wait	2021-11-03	1	1	6	7	0.33380000000000004
Robo Go	2021-08-28	2	1	6	8	0.33380000000000004
Queen of Succubus	2021-12-20	6	1	6	12	0.33380000000000004
Neon Arena	2021-09-17	2	1	6	8	0.33380000000000004
Violent Agent	2021-10-06	3	1	6	9	0.33380000000000004
Mystery Swords	2021-10-02	2	1	6	8	0.33380000000000004
Anime Fantasy Jigsaw Puzzle 3D	2021-10-27	2	1	6	8	0.33380000000000004
Stopocop	2021-12-07	2	1	6	8	0.33380000000000004
CosmicBreak Gun & Slash	2021-12-23	15	1	6	21	0.33380000000000004
Rescue Helicopter	2021-12-07	1	1	6	7	0.33380000000000004
Castle survival	2021-03-22	3	5	17	20	0.33340000000000003
HIDEAWAY	2021-12-30	15	5	17	32	0.33340000000000003
Disc Golf Adventure 2 VR	2021-03-13	6	2	9	15	0.33240000000000003
battle Tank	2021-02-04	4	2	9	13	0.33240000000000003
Chinese mother in law	2021-02-16	3	2	9	12	0.33240000000000003
Sato Dreams	2021-04-16	1	2	9	10	0.33240000000000003
Pistol Master!	2021-05-20	5	2	9	14	0.33240000000000003
Exodus H	2021-12-01	6	2	9	15	0.33240000000000003
闪客快打7佣兵帝国	2021-01-20	144	170	394	538	0.3309
Find the cubs	2021-07-26	3	3	12	15	0.33020000000000005
Coronaviruses	2021-01-25	1	0	3	4	0.32939999999999997
Crazy World	2021-12-21	2	0	3	5	0.32939999999999997
魔法猫咖与英雄们	2021-01-30	2	0	3	5	0.32939999999999997
OUTSP4CE	2021-01-09	1	0	3	4	0.32939999999999997
OBEN	2021-07-09	2	0	3	5	0.32939999999999997
Dream Escape	2021-02-05	1	0	3	4	0.32939999999999997
VR Spaceship Battle	2021-02-19	2	0	3	5	0.32939999999999997
Domino killer	2021-02-28	2	0	3	5	0.32939999999999997
Physics	2021-06-01	2	0	3	5	0.32939999999999997
BeacHouSeX	2021-04-14	2	0	3	5	0.32939999999999997
World Of Stalkers	2021-09-16	3	0	3	6	0.32939999999999997
TraxWorld	2021-11-27	3	0	3	6	0.32939999999999997
肉牛养殖计划	2021-04-02	3	0	3	6	0.32939999999999997
Haunted House - The Murder	2021-09-21	1	0	3	4	0.32939999999999997
Pincushion	2021-05-05	3	0	3	6	0.32939999999999997
Void Warfare	2021-06-07	2	0	3	5	0.32939999999999997
Detective Bureau Simulator	2021-06-01	1	0	3	4	0.32939999999999997
Zombies Desert and Guns	2021-06-07	1	0	3	4	0.32939999999999997
Abi and the soul	2021-12-02	2	0	3	5	0.32939999999999997
Vampire Revenge	2021-07-28	4	0	3	7	0.32939999999999997
Twin Balls	2021-08-02	3	0	3	6	0.32939999999999997
手手与共	2021-09-22	1	0	3	4	0.32939999999999997
Balloon Azuna	2021-09-10	2	0	3	5	0.32939999999999997
LyokoVR	2021-09-25	2	0	3	5	0.32939999999999997
Sweet Match 3	2021-09-23	2	0	3	5	0.32939999999999997
Cubicus 2	2021-09-25	1	0	3	4	0.32939999999999997
Devil Tears	2021-10-12	2	0	3	5	0.32939999999999997
The Abandoned	2021-10-15	1	0	3	4	0.32939999999999997
Gecky The Deenosaur Stars In! Adventures In SunnyDoodle Swimmingland!	2021-10-22	2	0	3	5	0.32939999999999997
Spidded	2021-10-07	1	0	3	4	0.32939999999999997
Hidden Investigation: Who did it?	2021-10-28	5	0	3	8	0.32939999999999997
Sludge Fighters	2021-12-10	5	0	3	8	0.32939999999999997
Item synthesis and dungeon exploration	2021-12-21	2	0	3	5	0.32939999999999997
Warehouse Tycoon	2021-02-26	5	4	15	20	0.32799999999999996
Cube Island	2021-08-07	5	4	15	20	0.32799999999999996
三国志奇侠传	2021-02-03	21	5	18	39	0.326
Drift Mania	2021-03-23	2	3	13	15	0.3207
CLOCKWORK PUSSY	2021-08-10	7	3	13	20	0.3207
Hentai ヘンタイ - C-GUM VACCINATION	2021-01-14	2	2	10	12	0.3207
DuckMan	2021-04-17	3	2	10	13	0.3207
Freelancer Life Simulator: Prologue	2021-02-04	6	4	16	22	0.32
1/2 Red Riding Hood	2021-10-30	2	4	16	18	0.32
Devil Slayer	2021-02-18	6	1	7	13	0.3185
SkydiveSim	2021-01-05	1	1	7	8	0.3185
Deadlokk	2021-08-17	4	1	7	11	0.3185
Stone River	2021-04-22	2	1	7	9	0.3185
ASTRA	2021-10-12	2	1	7	9	0.3185
ELIOS VR	2021-02-01	137	7	25	162	0.3169
Airport Simulator 3: Day & Night	2021-03-04	24	8	28	52	0.3159
Physics car FOREVER	2021-02-18	4	5	20	24	0.3125
Alien Abduction Experience	2021-04-14	3	2	11	14	0.3103
Home Creator	2021-07-10	3	2	11	14	0.3103
狱中少女	2021-01-23	15	17	55	70	0.3086
Nibiru Voyage	2021-03-24	2	0	4	6	0.308
Piece Of Mind	2021-05-25	1	0	4	5	0.308
Super Robin	2021-05-10	3	0	4	7	0.308
Undercover brother	2021-01-14	1	0	4	5	0.308
Negative: The Way of Shinobi	2021-02-18	1	0	4	5	0.308
Cutthroat Cove	2021-04-18	3	0	4	7	0.308
Train Tycoon	2021-06-04	3	0	4	7	0.308
Elite Fighter	2021-05-25	3	0	4	7	0.308
Titan Nebula	2021-05-14	2	0	4	6	0.308
Hentai Brick Breaker	2021-06-30	2	0	4	6	0.308
Mini ship wars	2021-06-29	2	0	4	6	0.308
100 days	2021-08-18	2	0	4	6	0.308
Candy gun	2021-08-13	1	0	4	5	0.308
Any Fish	2021-08-25	1	0	4	5	0.308
Angels vs Demons	2021-10-03	1	0	4	5	0.308
Fishing Frenzy	2021-10-01	1	0	4	5	0.308
Super Kakuro	2021-10-28	4	0	4	8	0.308
ARTHA	2021-03-02	26	5	21	47	0.3064
MADELA	2021-09-18	2	1	8	10	0.3056
The Devil's Shoes	2021-08-16	5	1	8	13	0.3056
CrazyDoc	2021-02-09	2	1	8	10	0.3056
Infinite Brick Breaker	2021-06-08	2	1	8	10	0.3056
Space puzzle	2021-06-12	2	1	8	10	0.3056
Secrets of the Middle Ages	2021-09-02	2	1	8	10	0.3056
Auto Mechanic	2021-09-10	2	1	8	10	0.3056
Forbidden Z	2021-04-02	8	3	15	23	0.3041
Blackstar	2021-02-19	16	3	15	31	0.3041
Synth Ninja	2021-10-11	2	2	12	14	0.3009
Club Lipstick VR	2021-03-22	4	2	12	16	0.3009
Grundlewhack	2021-06-18	7	4	19	26	0.2992
Dead Hospital	2021-05-27	4	4	19	23	0.2992
Girls Shop	2021-11-24	2	3	16	18	0.2967
MADE VR : Interactive Movie - 01. Run away!	2021-01-20	3	1	9	12	0.2943
Marswar TD	2021-02-28	6	1	9	15	0.2943
Old Quarry	2021-04-15	2	1	9	11	0.2943
Endless Crawler	2021-06-06	2	1	9	11	0.2943
Fruit Basket	2021-12-01	2	1	9	11	0.2943
One Small Favor	2021-06-04	2	0	5	7	0.2916
Deva｜Second-Person Horror	2021-05-04	3	0	5	8	0.2916
TRAVELLERS	2021-08-31	4	0	5	9	0.2916
Deus Lo Veult	2021-08-10	2	0	5	7	0.2916
神启神落	2021-06-26	3	0	5	8	0.2916
Cybernetica: Final	2021-03-02	1	0	5	6	0.2916
Space Cube Tower Defense	2021-03-01	4	0	5	9	0.2916
Awesome Puzzle	2021-08-17	1	0	5	6	0.2916
Magic defense 2: The Return of the Legend	2021-08-25	2	0	5	7	0.2916
Wild West Z	2021-11-12	2	0	5	7	0.2916
Doomsday Defense	2021-10-02	1	0	5	6	0.2916
行尸走肉	2021-10-30	2	0	5	7	0.2916
美少女搜查官	2021-07-23	9	4	21	30	0.28750000000000003
Stonescape	2021-07-26	2	1	10	12	0.2845
Morph Space	2021-02-27	5	3	18	23	0.2837
BattleBeasts	2021-05-10	46	10	43	89	0.2824
Helicopter Simulator 2020	2021-04-23	2	0	6	8	0.2783
Neon Dimension	2021-03-30	2	0	6	8	0.2783
Porter in the Castle	2021-08-24	1	0	6	7	0.2783
Alien Hunt	2021-09-06	1	0	6	7	0.2783
Suber Driver	2021-11-19	2	0	6	8	0.2783
Mega City Void	2021-12-01	2	0	6	8	0.2783
Viking Warrior	2021-01-19	3	3	19	22	0.2779
COINS BATTLE	2021-06-09	2	2	15	17	0.2778
Sisters of Silent Liberty	2021-07-09	7	2	15	22	0.2778
FEAR	2021-07-08	3	4	24	27	0.2725
NASCAR 21: Ignition	2021-10-28	323	169	551	874	0.2713
Bikini Island Challenge	2021-01-05	191	13	59	250	0.2684
Virtual Soldiers	2021-06-13	2	0	7	9	0.26739999999999997
Ero Snooker	2021-01-29	2	0	7	9	0.26739999999999997
飞行棋	2021-11-08	4	0	7	11	0.26739999999999997
Plumber 3	2021-09-10	2	0	7	9	0.26739999999999997
Hidden Lands	2021-10-06	2	2	17	19	0.2655
Temple with traps	2021-09-06	2	0	8	10	0.2581
Any Candy	2021-08-25	1	0	8	9	0.2581
Wavy Trip	2021-09-07	2	0	8	10	0.2581
White Flower	2021-10-29	2	0	8	10	0.2581
上班摸鱼模拟器 - Lazy at work	2021-12-24	4	0	8	12	0.2581
Crystal Rider	2021-04-30	2	0	9	11	0.25
Hidden Caves	2021-10-06	2	1	15	17	0.249
Ragdoll Knight	2021-06-04	3	0	10	13	0.2429
The Con Simulator	2021-12-31	7	2	22	29	0.2414
便利商店‪6	2021-06-15	7	0	11	18	0.2366
Endless Zombie Weekend	2021-12-21	2	0	11	13	0.2366
Hidden Flowers	2021-09-23	2	1	19	21	0.23
Click and Relax	2021-02-11	3	0	13	16	0.2259
Yellow Brick Road	2021-02-20	3	0	14	17	0.2213
Flykt	2021-03-12	6	1	22	28	0.2189
崩坏3	2021-11-04	1644	1971	8199	9843	0.21280000000000002
LURE: FREE	2021-01-20	35	6	59	94	0.2078
Model Building Restoration	2021-05-31	3	0	18	21	0.2061
三国杀	2021-12-17	1085	3401	19768	20853	0.16390000000000002
Hades	2020-09-17	37749	219790	3274	41023	0.9734
Half-Life: Alyx	2020-03-23	42858	78299	1262	44120	0.9679000000000001
The Henry Stickmin Collection	2020-08-07	2812	36097	488	3300	0.9661000000000001
ULTRAKILL	2020-09-03	16354	56614	939	17293	0.9658
Helltaker	2020-05-11	6509	108781	2306	8815	0.9647
Senren＊Banka	2020-02-14	1450	13051	109	1559	0.9634
OMORI	2020-12-25	3166	53558	1120	4286	0.9615000000000001
tModLoader	2020-05-16	38058	170246	5022	43080	0.9589
ATRI -My Dear Moments-	2020-06-18	724	11177	132	856	0.9589
Phasmophobia	2020-09-18	112717	527419	17778	130495	0.9586
Deep Rock Galactic	2020-05-13	46687	195003	5986	52673	0.9583
Our Life: Beginnings & Always	2020-11-16	1760	8811	90	1850	0.9581999999999999
Satisfactory	2020-06-08	34238	123852	3680	37918	0.9575
There Is No Game: Wrong Dimension	2020-08-06	1348	18513	386	1734	0.9548000000000001
Persona 4 Golden	2020-06-13	29984	60216	1796	31780	0.9540000000000001
Factorio	2020-08-14	34700	158659	5939	40639	0.9514
Ori and the Will of the Wisps	2020-03-11	34807	103886	3708	38515	0.9512999999999999
VTOL VR	2020-08-03	1413	11105	225	1638	0.9512
Risk of Rain 2	2020-08-11	71548	223263	8801	80349	0.9509000000000001
The Test	2020-02-24	407	17816	492	899	0.9485
Riddle Joker	2020-12-18	724	3399	36	760	0.9473
Virtual Cottage	2020-10-07	1801	7554	160	1961	0.9469
Cube Escape Collection	2020-10-14	985	4434	66	1051	0.9468000000000001
Milk inside a bag of milk inside a bag of milk	2020-08-26	79	16448	476	555	0.9467
The Test: Final Revelation	2020-10-12	131	4800	87	218	0.9448000000000001
The Test: Hypothesis Rising	2020-04-27	184	5325	108	292	0.9440999999999999
NEKOPARA Vol. 4	2020-11-26	2529	7655	197	2726	0.943
The Supper	2020-01-28	53	3157	46	99	0.9429000000000001
Maitetsu:Last Run!!	2020-10-30	438	2810	36	474	0.9429000000000001
Wobbly Life	2020-07-08	3161	11750	362	3523	0.9424
Post Void	2020-08-06	133	7711	209	342	0.9419
Samsara Room	2020-04-29	1514	7104	187	1701	0.9417
Marco & The Galaxy Dragon	2020-02-28	287	4621	102	389	0.9409000000000001
Summer Pockets	2020-02-06	206	2154	25	231	0.9401999999999999
Black Mesa	2020-03-06	7158	89946	4283	11441	0.9401
Desperados III	2020-06-16	6057	10991	364	6421	0.9398000000000001
Monster Prom 2: Monster Camp	2020-10-23	2252	4969	121	2373	0.9398000000000001
Alba: A Wildlife Adventure	2020-12-11	198	3915	84	282	0.9395
Star Fetchers	2020-01-17	122	6165	169	291	0.9394
Cats Organized Neatly	2020-10-12	292	2815	48	340	0.9392
Being a DIK	2020-02-14	5709	9155	297	6006	0.9388
shapez	2020-06-07	2622	9002	297	2919	0.9381999999999999
Vampires' Melody	2020-10-03	174	3361	70	244	0.9381999999999999
Carto	2020-10-27	929	5793	163	1092	0.9381
Monster Train	2020-05-21	14073	17409	687	14760	0.9379000000000001
There is no game: Jam Edition 2015	2020-03-18	197	5406	150	347	0.9377
Besiege	2020-02-18	11206	43187	2009	13215	0.9375
Epiphyllum in Love	2020-03-17	97	1766	20	117	0.9375
Spiritfarer®: Farewell Edition	2020-08-18	5603	28627	1258	6861	0.9373
Outer Wilds	2020-06-18	7936	45428	2172	10108	0.9366
Noita	2020-10-15	5239	50116	2473	7712	0.9358
5D Chess With Multiverse Time Travel	2020-07-22	649	5691	177	826	0.9354000000000001
Titanfall® 2	2020-06-18	27631	151610	8428	36059	0.9352
Door Kickers 2	2020-11-03	913	6205	202	1115	0.935
Yakuza: Like a Dragon	2020-11-10	9535	19593	866	10401	0.9346
The Room VR: A Dark Matter	2020-03-26	139	3000	74	213	0.9335
The Pedestrian	2020-01-29	170	3324	91	261	0.9325
Tukoni	2020-11-19	93	3045	80	173	0.9323
The Walking Dead: The Telltale Definitive Series	2020-10-29	1492	9898	409	1901	0.9318000000000001
Untitled Goose Game	2020-09-23	1951	13502	603	2554	0.9315000000000001
Zup! Z	2020-12-21	1288	3706	112	1400	0.9314
Sakuya Izayoi Gives You Advice And Dabs	2020-02-10	293	1838	36	329	0.9311
千面 Melancholy Love	2020-01-03	87	1623	28	115	0.9311
The Jackbox Party Pack 7	2020-10-15	10599	3712	120	10719	0.9296
Fireworks Mania	2020-12-17	797	3986	137	934	0.9287000000000001
Coloring Game 2	2020-01-10	502	3077	95	597	0.9285
ARMORED HEAD	2020-07-31	24	880	7	31	0.9284
It Steals	2020-07-22	46	856	7	53	0.9276000000000001
像素女友	2020-08-20	212	1221	20	232	0.9272
Leaf Blower Revolution - Idle Game	2020-12-04	8125	18184	953	9078	0.9270999999999999
A Space For The Unbound - Prologue	2020-01-22	19	1229	21	40	0.9267000000000001
Detroit: Become Human	2020-06-18	7218	75380	4704	11922	0.9265000000000001
Aokana - EXTRA1	2020-11-06	199	970	13	212	0.9256000000000001
Journey	2020-06-11	1757	23292	1309	3066	0.9255
Superliminal	2020-11-05	1439	20678	1158	2597	0.9248999999999999
Manifold Garden	2020-10-20	326	4302	174	500	0.9244
Vecter	2020-10-14	270	2745	96	366	0.9237000000000001
Coffee Talk	2020-01-29	673	7290	352	1025	0.9231999999999999
Tiny Bunny: Prologue	2020-03-19	142	1835	53	195	0.9231999999999999
Hylics 2	2020-06-22	186	1844	54	240	0.923
Poly Bridge 2	2020-05-28	1924	6000	279	2203	0.9228000000000001
Songs of Syx	2020-09-21	592	2408	82	674	0.9227
YOU and ME and HER: A Love Story	2020-05-25	156	2461	85	241	0.9226000000000001
東方風神録 〜 Mountain of Faith.	2020-06-06	98	729	8	106	0.9220999999999999
CARRION	2020-07-23	6347	18105	1059	7406	0.9218999999999999
SpongeBob SquarePants: Battle for Bikini Bottom - Rehydrated	2020-06-23	15419	12970	725	16144	0.9216
Chronicon	2020-08-21	4868	7820	398	5266	0.9216
Some Some Convenience Store	2020-01-15	783	2808	109	892	0.9207
Baldi's Basics Plus	2020-06-12	228	2332	84	312	0.9206000000000001
Kingdom Rush Vengeance	2020-10-15	3206	6135	307	3513	0.9201
The Riftbreaker: Prologue	2020-08-05	1139	3906	177	1316	0.9193000000000001
Flowers -Le volume sur automne-	2020-07-31	102	552	4	106	0.9193000000000001
House	2020-10-30	202	1383	40	242	0.9189
Christmas Tina -泡沫冬景-	2020-01-03	399	4064	189	588	0.9187000000000001
坦率的小红帽和爱说谎的狼	2020-01-14	20	914	19	39	0.9184000000000001
The Life and Suffering of Sir Brante — Chapter 1&2	2020-12-01	246	1949	70	316	0.9183
Project Wingman	2020-12-01	2113	12326	735	2848	0.9181
Creeper World 4	2020-12-03	3828	3187	140	3968	0.9181
Return to Shironagasu Island	2020-03-03	258	2273	89	347	0.9177
a new life.	2020-05-15	43	1716	59	102	0.9177
F1 2020	2020-07-09	24010	37278	2570	26580	0.9176000000000001
LEWDAPOCALYPSE	2020-04-30	389	6184	329	718	0.9175
恋爱绮谭 不存在的夏天	2020-10-31	139	2283	91	230	0.9172
The Procession to Calvary	2020-04-09	73	736	13	86	0.9169
Micro Platformer	2020-04-21	79	1361	43	122	0.9164
Island Saver	2020-05-13	755	2582	112	867	0.9159
Murder House	2020-10-23	119	1593	56	175	0.9159
TROUBLESHOOTER: Abandoned Children	2020-04-23	1012	7124	405	1417	0.9158
When The Past Was Around	2020-09-22	171	2731	123	294	0.9153
The Coma 2: Vicious Sisters	2020-01-28	261	2223	93	354	0.9152
Roman's Christmas / 罗曼圣诞探案集	2020-02-20	348	1337	44	392	0.9151
ShellShock Live	2020-05-22	7455	29911	2111	9566	0.915
NOeSIS-诉说谎言的记忆之物语	2020-03-19	155	997	27	182	0.9148999999999999
A Summer's End - Hong Kong 1986	2020-04-23	101	1382	47	148	0.9147
Mini Healer	2020-04-24	735	1743	67	802	0.9146
I Wanna Maker	2020-02-13	514	3165	153	667	0.9143000000000001
DRAGON BALL Z: KAKAROT	2020-01-16	25852	37559	2747	28599	0.9141
Making Lovers	2020-04-03	211	563	8	219	0.9141
WORLD OF HORROR	2020-02-20	704	5223	291	995	0.9138
Dictators:No Peace Countryballs	2020-01-01	263	4905	272	535	0.9134000000000001
Football Manager 2021	2020-11-24	93865	22135	1559	95424	0.9133
Mosaique Neko Waifus 2	2020-06-05	722	2351	107	829	0.9129
Propagation VR	2020-09-25	162	4365	240	402	0.9125
Roboquest	2020-08-20	821	5514	320	1141	0.9124
Utawarerumono: Mask of Truth	2020-01-23	250	1073	34	284	0.9124
DRAGON QUEST XI S: Echoes of an Elusive Age – Definitive Edition	2020-12-04	4813	6314	383	5196	0.9116
Shotgun Witch	2020-10-24	32	842	23	55	0.9116
Soda Dungeon 2	2020-07-09	13385	4481	254	13639	0.9114
Wingspan	2020-09-17	1470	6397	392	1862	0.9112
Maiden & Spell	2020-02-25	130	580	11	141	0.9109
DDraceNetwork	2020-08-17	3054	10676	720	3774	0.9106000000000001
Children of Silentown: Prologue	2020-11-25	134	1011	33	167	0.9106000000000001
Penko Park	2020-10-23	40	384	3	43	0.9104000000000001
CBT With Yuuka Kazami	2020-10-19	90	816	23	113	0.9103
Tales From Off-Peak City Vol. 1	2020-05-15	27	453	6	33	0.91
Florence	2020-02-13	141	8894	592	733	0.9098
Loop-Loop DX	2020-04-20	35	401	4	39	0.9098
Friendship with Benefits	2020-11-04	272	1324	52	324	0.9097
Spelunky 2	2020-09-29	9702	15657	1131	10833	0.9095000000000001
Boomerang Fu	2020-08-13	171	1452	60	231	0.9095000000000001
Summer Memories	2020-06-15	5036	9915	679	5715	0.9091
Unrailed!	2020-09-23	9852	14780	1069	10921	0.909
Into the Radius VR	2020-07-20	496	7004	456	952	0.9089
Path of Giants	2020-02-14	43	766	22	65	0.9087000000000001
DOOM 64	2020-03-20	1257	5514	347	1604	0.9084000000000001
Space Bear	2020-03-05	21	409	5	26	0.9084000000000001
The Battle of Polytopia	2020-08-04	966	3082	171	1137	0.9081999999999999
Crusader Kings III	2020-09-01	98872	81599	6927	105799	0.9081
One Step From Eden	2020-03-26	2360	6233	406	2766	0.9078
STORY OF SEASONS: Friends of Mineral Town	2020-07-15	3706	4124	248	3954	0.9077
Scarlet Hollow — Episode 1	2020-09-25	35	590	14	49	0.9075
Creaks	2020-07-22	286	2739	150	436	0.9074
Coloring Game 3	2020-04-17	504	1309	55	559	0.9074
徒花異譚 / Adabana Odd Tales	2020-06-18	70	648	17	87	0.9074
Cyber Hook	2020-09-24	123	2079	105	228	0.9073000000000001
Littlewood	2020-08-04	1678	5614	363	2041	0.9072
Chicken Police	2020-11-05	164	1596	74	238	0.9069
Slap City	2020-09-17	781	2652	146	927	0.9068
My Vow to My Liege	2020-09-22	684	3300	194	878	0.9064
Kukoro: Stream chat games	2020-11-06	101	574	14	115	0.9064
喵可莉的兔玩偶	2020-02-03	95	936	34	129	0.9063
Progressbar95	2020-09-08	51	1484	68	119	0.9062000000000001
UNREAL LIFE	2020-11-19	79	811	27	106	0.9061
Amairo Chocolate	2020-03-19	66	507	11	77	0.9059
Perfect Vermin	2020-11-06	181	2671	151	332	0.9057
Until You Fall	2020-10-27	146	2779	159	305	0.9056000000000001
The White Door	2020-01-09	1144	4483	287	1431	0.9055
Frog Fractions: Game of the Decade Edition	2020-08-02	321	2077	111	432	0.9048999999999999
Horizon's Gate	2020-03-09	133	702	22	155	0.9048999999999999
Vibrant Venture	2020-07-24	103	552	14	117	0.9048
Last Evil	2020-06-24	734	2894	173	907	0.904
Parkasaurus	2020-08-13	953	2474	142	1095	0.904
Mushroom Cats 2	2020-04-24	9	441	9	18	0.9037000000000001
Stormworks: Build and Rescue	2020-09-17	6820	32447	2790	9610	0.9028
秘封旅行 ~Secret Sealing Travel	2020-10-17	138	229	0	138	0.9027
Mosaique Neko Waifus 3	2020-08-27	380	1679	89	469	0.9023000000000001
Cross Princess	2020-09-09	70	747	27	97	0.9023000000000001
The Confession	2020-05-18	12	922	38	50	0.9022
Ninja Kiwi Archive	2020-07-08	758	3973	265	1023	0.9020999999999999
Destroy All Humans!	2020-07-28	12423	8560	649	13072	0.902
Streets of Rage 4	2020-04-30	6438	14268	1157	7595	0.9017000000000001
三国群英传2	2020-11-13	1026	1212	58	1084	0.9015000000000001
A Monster's Expedition	2020-09-10	254	952	41	295	0.9013
MetaWare High School (Demo)	2020-04-02	43	562	17	60	0.9013
TheDawn	2020-12-11	221	7552	570	791	0.9012000000000001
Ghostrunner	2020-10-27	11294	43892	3963	15257	0.9009
Master of Magic Classic	2020-02-25	156	539	16	172	0.9009
Ostriv	2020-03-19	1252	3437	228	1480	0.9008
Kill It With Fire	2020-08-13	472	3111	202	674	0.9008
Freedom Fighters	2020-09-21	157	1191	58	215	0.9006000000000001
One Dreamer: Prologue	2020-05-07	45	767	30	75	0.9005
Spice&Wolf VR2	2020-12-10	34	457	12	46	0.9
Elasto Mania	2020-05-25	43	207	0	43	0.8997
RealRTCW	2020-10-15	106	957	44	150	0.8991
High Entropy: Challenges	2020-09-01	156	926	42	198	0.899
art of rally	2020-09-23	477	3791	266	743	0.8987999999999999
Mr.Mine	2020-10-01	5093	11864	988	6081	0.8986000000000001
Soldat	2020-03-31	622	1532	86	708	0.8985
Neighbours back From Hell	2020-10-08	553	2959	199	752	0.8983
FOOTSIES	2020-09-30	99	367	8	107	0.8983
狐の旅路	2020-01-28	161	1430	79	240	0.8982
PLAYNE	2020-05-01	38	1012	49	87	0.8981
来自边境 - From Frontier	2020-07-25	35	243	2	37	0.8981
Full Service	2020-03-16	173	454	13	186	0.898
东方祈华梦～Elegant Impermanence of Sakura	2020-04-16	313	437	12	325	0.898
Paradise Killer	2020-09-04	291	2790	187	478	0.8978
Timelie	2020-05-21	215	1925	118	333	0.8976999999999999
Zniw Adventure	2020-11-06	29	217	1	30	0.8976000000000001
WHAT THE GOLF?	2020-10-22	636	2649	178	814	0.8971
Aground	2020-04-17	389	1364	76	465	0.8971
DOOM Eternal	2020-03-20	104891	154338	15655	120546	0.897
Bright Memory	2020-03-25	1907	29096	2702	4609	0.8967
Unbound: Worlds Apart Prologue	2020-03-26	280	844	39	319	0.8967
Poker Master	2020-09-24	52	2031	129	181	0.8966
他人世界末	2020-07-10	233	2128	138	371	0.8962000000000001
Red Planet Farming	2020-05-25	135	658	27	162	0.8961
夜永 Eternal Love	2020-11-19	304	746	33	337	0.8959999999999999
ONE PIECE: PIRATE WARRIORS 4	2020-03-26	9219	12211	1062	10281	0.8959
Suzerain	2020-12-04	1090	4464	340	1430	0.8958
THE CORRIDOR	2020-12-04	67	1602	97	164	0.8956999999999999
剑为君舞	2020-03-25	346	812	38	384	0.8955
UnderMine	2020-08-06	3245	7339	608	3853	0.8951000000000001
Hidden Through Time	2020-03-12	229	1983	129	358	0.8951000000000001
Crystal Caves HD	2020-10-15	55	244	3	58	0.8951000000000001
Sakuna: Of Rice and Ruin	2020-11-10	7043	4009	304	7347	0.8948999999999999
Shady Part of Me	2020-12-10	134	1235	70	204	0.8948999999999999
Third Crisis	2020-04-24	219	841	41	260	0.8947
Monster Sanctuary	2020-12-08	1397	7554	636	2033	0.8943000000000001
東方地霊殿 〜 Subterranean Animism.	2020-06-06	48	385	11	59	0.8943000000000001
Liquidators	2020-09-30	53	722	33	86	0.8942
Pretty Neko	2020-02-21	245	2769	201	446	0.8934000000000001
Omno: Prologue	2020-09-11	29	272	5	34	0.8934000000000001
Sea of Thieves	2020-06-03	66906	248816	26856	93762	0.8933
Novena Diabolos	2020-04-26	540	1353	82	622	0.8932
At Dead Of Night	2020-11-19	197	1774	117	314	0.8929
Trials of Mana	2020-04-24	11998	4411	353	12351	0.8926000000000001
Sheepo	2020-08-26	14	228	3	17	0.8925000000000001
MARDEK	2020-06-03	52	208	2	54	0.8925000000000001
Spirits Abyss	2020-08-27	46	334	9	55	0.8921
Nocturne: Prelude	2020-03-03	33	380	12	45	0.8917
Golf Around!	2020-12-04	214	914	50	264	0.8915000000000001
Clam Man 2 - Open Mic	2020-06-19	32	361	11	43	0.8913
Gladiator Guild Manager: Prologue	2020-08-27	482	1404	90	572	0.8911
Pumpkin Jack	2020-10-23	401	4518	374	775	0.8906999999999999
BEAR, VODKA, STALINGRAD! 🐻	2020-03-02	676	811	43	719	0.8906999999999999
Half-Life: Alyx - Final Hours	2020-07-09	955	768	40	995	0.8905
Black Book: Prologue	2020-05-05	123	1206	75	198	0.8902
Petal Crash	2020-10-12	41	252	5	46	0.8902
東方催狐譚 ～ Servants of Harvest Wish	2020-08-03	50	319	9	59	0.89
Lakeview Cabin 2	2020-10-30	42	318	9	51	0.8898999999999999
My Name is Mayo 2	2020-11-17	13	285	7	20	0.8898999999999999
:THE LONGING:	2020-03-05	1063	4595	387	1450	0.8898
Friendly Fire	2020-07-05	46	913	52	98	0.8898
Wayhaven Chronicles: Book Two	2020-05-07	444	193	2	446	0.8898
Ato	2020-05-08	19	266	6	25	0.8896
Puppy Cross	2020-02-11	75	230	4	79	0.8896
Card Hog	2020-06-23	34	394	14	48	0.8895000000000001
Mixolumia	2020-11-30	12	190	2	14	0.8892
Atomicrops	2020-09-17	625	3405	276	901	0.8891
Hex of Steel	2020-08-31	57	280	7	64	0.8891
The Horrorscope	2020-03-09	18	1003	61	79	0.8884000000000001
A Shopping Trip to Eklan Tor	2020-09-18	136	186	2	138	0.8884000000000001
Paper Beast	2020-07-24	36	486	21	57	0.8883
Tonight We Riot	2020-05-08	84	485	21	105	0.8882
BROK the InvestiGator - Prologue	2020-12-02	20	274	7	27	0.8882
Cat in the Box	2020-05-01	45	925	55	100	0.8881
House of Detention	2020-05-29	2515	8465	791	3306	0.888
Jet Lancer	2020-05-12	139	685	36	175	0.888
BPM: BULLETS PER MINUTE	2020-09-15	1874	8711	819	2693	0.8878
Bloons Monkey City	2020-04-10	1198	4226	365	1563	0.8873000000000001
黑色花与红山羊 / Black Datura & Red Goat	2020-08-21	41	420	17	58	0.8872
Trap Legend	2020-07-17	97	516	24	121	0.887
Dread X Collection 2	2020-08-21	107	460	20	127	0.8869
CATch the Stars	2020-11-18	15	314	10	25	0.8869
Command & Conquer™ Remastered Collection	2020-06-05	42587	25233	2637	45224	0.8868
Survive or Thrive	2020-09-07	6	215	4	10	0.8867
Togainu no Chi ~Lost Blood~	2020-02-25	38	281	8	46	0.8865999999999999
Fights in Tight Spaces (Prologue)	2020-12-14	232	752	43	275	0.8862000000000001
tomorrow won't come for those without ██████	2020-07-04	23	600	31	54	0.8862000000000001
The Spike	2020-06-05	243	1430	103	346	0.8852
Levelhead	2020-04-30	367	823	50	417	0.8851000000000001
Exo One: Prologue	2020-08-21	90	671	38	128	0.8845000000000001
Nohra	2020-06-18	17	284	9	26	0.8845000000000001
Super Bit Blaster XL	2020-03-16	490	657	37	527	0.8844
WhiteLily 2：梦醒少女	2020-11-06	65	168	2	67	0.8844
THE NORMAL THING	2020-12-11	39	411	18	57	0.8842
Sword Rogue	2020-08-05	25	396	17	42	0.8840000000000001
Them's Fightin' Herds	2020-04-30	1436	3434	302	1738	0.8839
鶴鄉戀旅	2020-02-27	27	166	2	29	0.8839
STAR WARS™: The Old Republic™	2020-07-21	34210	45534	5107	39317	0.8837999999999999
Max Gentlemen Sexy Business!	2020-02-25	1084	1333	97	1181	0.8837
Intergalactic Fishing	2020-04-21	33	217	5	38	0.8837
Travellers Rest	2020-07-28	2264	4674	432	2696	0.8836
Knock Harder	2020-04-27	36	307	11	47	0.8834000000000001
Cook, Serve, Delicious! 3?!	2020-10-14	491	1678	130	621	0.8833
Breakpoint	2020-09-24	42	198	4	46	0.8832
ParanormalHK	2020-01-06	1221	12453	1290	2511	0.8831
Nexomon: Extinction	2020-08-28	1182	2221	185	1367	0.8825000000000001
Holdfast: Nations At War	2020-03-05	3419	19790	2147	5566	0.8823000000000001
Assemble with Care	2020-03-26	308	3354	301	609	0.8823000000000001
Metel - Horror Escape	2020-09-01	64	598	34	98	0.8822
像素男友 语音完整版	2020-12-24	47	241	7	54	0.8822
Summer Paws	2020-05-26	26	328	13	39	0.8821
Flicker of Hope	2020-08-03	301	794	51	352	0.8819
Disc Room	2020-10-22	181	642	38	219	0.8818000000000001
Lair of the Clockwork God	2020-02-21	41	653	39	80	0.8817
東方星蓮船 〜 Undefined Fantastic Object.	2020-06-06	21	223	6	27	0.8815999999999999
Puddle Knights	2020-03-03	23	138	1	24	0.8815000000000001
邻居大叔/UncleNeighbor	2020-06-19	310	730	46	356	0.8813
The Escaper	2020-03-09	186	624	37	223	0.8812000000000001
Rogue	2020-10-22	74	322	13	87	0.8811
INMOST	2020-08-21	489	3816	357	846	0.8808
Swords 'n Magic and Stuff	2020-09-08	547	871	59	606	0.8808
Hentai Mosaique Neko Waifus	2020-01-27	1070	2393	208	1278	0.8806999999999999
Boris and the Dark Survival	2020-02-10	686	2469	216	902	0.8806
Haven	2020-12-03	593	3664	342	935	0.8805
Aimbeast	2020-05-13	201	1491	118	319	0.8805
Midnight Castle Succubus	2020-09-19	236	878	60	296	0.8805
Whiteboyz Wit Attitude: The Pursuit of Money	2020-10-09	9	436	22	31	0.8805
The Horror Of Salazar House	2020-10-15	14	233	7	21	0.8805
*NEW* EPIC SCUFFED BHOP SIMULATOR 2023 (POG CHAMP)	2020-11-28	552	4615	445	997	0.8804000000000001
The Legend of Heroes: Trails of Cold Steel III	2020-03-23	1922	2290	199	2121	0.8802
Welcome to Elk	2020-09-17	18	185	4	22	0.8802
Rising Star 2	2020-08-12	123	392	19	142	0.8797
Avorion	2020-03-09	4533	10344	1101	5634	0.8795999999999999
Ring of Pain	2020-10-15	1280	3467	326	1606	0.8794
Corruption of Champions II	2020-08-14	423	1245	96	519	0.8794
Heroines of Swords & Spells	2020-03-17	63	500	28	91	0.8793000000000001
Fatum Betula	2020-06-20	11	350	16	27	0.8792
Going Under	2020-09-24	568	2697	245	813	0.8791
VenusBlood FRONTIER International	2020-02-08	757	706	46	803	0.8791
BattleGroupVR	2020-07-31	40	693	45	85	0.8789
She Will Punish Them	2020-04-30	15711	15718	1747	17458	0.8788
Ethereal Enigma	2020-08-22	155	435	23	178	0.8787
Chair F*cking Simulator	2020-07-07	15	576	35	50	0.8786
Cute Honey	2020-07-22	1160	4494	447	1607	0.8779000000000001
Panoptic	2020-10-08	29	277	11	40	0.8779000000000001
The House of Da Vinci 2	2020-05-29	191	1277	102	293	0.8776999999999999
Rainy Season	2020-08-19	57	415	22	79	0.8776
Metro Exodus	2020-02-15	15375	77642	9584	24959	0.8774
The Last Spell: Prologue	2020-10-29	127	246	9	136	0.8772
I accidentally restarted the USSR	2020-06-30	3	203	6	9	0.8771
Vertigo Remastered	2020-07-21	54	803	57	111	0.877
Golf With Your Friends	2020-05-19	20750	50298	6127	26877	0.8769
First Snow	2020-08-19	57	516	31	88	0.8769
妖語り/Yokai's Secret	2020-02-06	1015	5962	622	1637	0.8768000000000001
LOEK	2020-02-10	32	904	67	99	0.8767
New Super Lucky's Tale	2020-08-21	35	256	10	45	0.8764000000000001
Kingdoms Reborn	2020-11-03	2014	4766	490	2504	0.8759
Ruins Seeker	2020-05-29	260	564	36	296	0.8759
Receiver 2	2020-04-14	1150	2093	191	1341	0.8758
Quickscoper Doge: The Dank Illuminati Memes	2020-06-06	9	198	6	15	0.8758
Interstate Drifter 1999	2020-09-16	27	265	11	38	0.8755
Kill It With Fire: HEATWAVE	2020-07-17	279	1839	165	444	0.8753000000000001
Retrograde Arena	2020-05-28	137	400	22	159	0.8753000000000001
Handy Dandy	2020-05-12	334	210	7	341	0.8753000000000001
CHANGE: A Homeless Survival Experience	2020-05-01	320	1845	166	486	0.8752
Utawarerumono: Mask of Deception	2020-01-23	370	997	78	448	0.8752
Umurangi Generation	2020-05-19	47	762	55	102	0.8752
Offroad Mania	2020-02-10	17	434	25	42	0.8752
KukkoroDays	2020-05-14	137	411	23	160	0.8752
The Citadel	2020-08-05	79	676	47	126	0.8751000000000001
100 hidden birds	2020-12-02	9	410	23	32	0.8751000000000001
Bug Academy	2020-01-14	26	236	9	35	0.8749
三国群英传	2020-11-13	1582	970	76	1658	0.8747
Janosik	2020-09-25	49	476	29	78	0.8747
Lightmatter	2020-01-15	396	2146	200	596	0.8745999999999999
Pixel Ripped 1995	2020-04-23	15	149	3	18	0.8745999999999999
Dragon Spirits : Prologue	2020-08-27	17	116	1	18	0.8745999999999999
Automobilista 2	2020-06-30	1306	5414	577	1883	0.8743000000000001
Unravel	2020-06-04	327	3359	337	664	0.8743000000000001
The Book of Distance	2020-10-08	14	148	3	17	0.8743000000000001
Circle of Sumo: Online Rumble!	2020-10-17	259	884	68	327	0.8742000000000001
Wide Ocean Big Jacket	2020-02-04	5	219	8	13	0.8741
ICBM	2020-11-17	700	1197	100	800	0.8740000000000001
Angry Video Game Nerd I & II Deluxe	2020-10-30	101	482	30	131	0.8740000000000001
Without A Voice	2020-03-20	31	232	9	40	0.8740000000000001
Root	2020-09-24	496	2449	236	732	0.8738
Rival Stars Horse Racing	2020-06-24	489	2188	207	696	0.8738
From The Depths	2020-11-06	1700	8761	988	2688	0.8734999999999999
Röki	2020-07-23	270	2014	189	459	0.8734000000000001
Out of the Park Baseball 21	2020-03-20	2047	1533	137	2184	0.8732
Aurora	2020-11-20	43	793	61	104	0.8724
Sagrada	2020-03-31	39	225	9	48	0.8723000000000001
Raindrops	2020-04-24	27	156	4	31	0.8721
Colorful Colore	2020-10-24	13	141	3	16	0.8721
Legend creatures	2020-06-19	2105	3335	346	2451	0.8717
Arise: A Simple Story	2020-12-03	78	864	69	147	0.8717
QT	2020-01-23	11	209	8	19	0.8715999999999999
SKYE	2020-06-18	139	1110	95	234	0.8714000000000001
Wanba Warriors	2020-03-26	374	2026	196	570	0.8713
Kandidatos	2020-09-01	2453	2967	305	2758	0.8712000000000001
One Way: The Elevator	2020-08-13	161	294	15	176	0.8712000000000001
West of Dead Beta	2020-03-31	160	767	60	220	0.8709
Love & Sex: Second Base	2020-03-27	211	585	42	253	0.8708
LUNA The Shadow Dust	2020-02-13	245	1295	116	361	0.8706999999999999
Schwarzerblitz	2020-05-31	17	137	3	20	0.8706999999999999
Atelier Ayesha: The Alchemist of Dusk DX	2020-01-14	223	303	16	239	0.8706
Touhou Gensokyo Visitor	2020-10-30	8	192	7	15	0.8704999999999999
Resident Evil 3: Raccoon City Demo 	2020-03-19	19716	9049	1063	20779	0.8703000000000001
Prodigal	2020-10-16	24	178	6	30	0.8703000000000001
Teenage Blob	2020-08-13	5	136	3	8	0.8703000000000001
My Friend is a Raven	2020-01-04	23	1065	92	115	0.8702
Fight Crab	2020-07-29	263	740	58	321	0.8702
Knock Harder: Useless	2020-01-13	38	356	21	59	0.8699
Depanneur Nocturne	2020-05-26	14	190	7	21	0.8699
Mýrdalssandur, Iceland	2020-03-06	119	1441	134	253	0.8697
City of Broken Dreamers: Book One	2020-08-07	386	1252	113	499	0.8697
My Koi	2020-07-15	148	576	42	190	0.8695999999999999
Space Court	2020-06-25	16	134	3	19	0.8695999999999999
Kill It With Fire: IGNITION	2020-04-28	964	1483	139	1103	0.8695
Spirit Island	2020-07-29	174	614	46	220	0.8694
Apple Slash	2020-02-05	9	188	7	16	0.8694
Yolo Space Hacker - Mission Bikini	2020-12-24	29	175	6	35	0.8694
Sam & Max Save the World	2020-12-02	359	1143	102	461	0.8692000000000001
Succubus Affection	2020-10-23	287	884	74	361	0.8692000000000001
Khimera: Puzzle Island	2020-11-30	21	161	5	26	0.8692000000000001
The Hand of Glory	2020-06-09	21	147	4	25	0.8692000000000001
Wish	2020-05-01	270	2768	290	560	0.8690000000000001
Hero of the Kingdom: The Lost Tales 1	2020-04-17	164	867	73	237	0.8686
My Exercise	2020-08-27	35	360	22	57	0.8686
Shrine	2020-04-03	17	665	52	69	0.8684000000000001
Zen Trails	2020-09-28	32	83	0	32	0.8683
LAST EMBRYO -EITHER OF BRAVE TO STORY-	2020-11-28	74	452	31	105	0.868
The Lost Art of Innkeeping	2020-07-29	10	82	0	10	0.8678
Down The Rabbit Hole	2020-03-26	22	355	22	44	0.8677
Beyond: Two Souls	2020-06-18	1346	14519	1823	3169	0.8675
Monster Girl Club Bifrost	2020-03-23	216	396	26	242	0.8674
Anthophobia	2020-02-28	18	142	4	22	0.8674
Swaying Girl	2020-11-20	1447	3929	440	1887	0.8673000000000001
Super Mega Baseball 3	2020-05-13	814	1669	165	979	0.8673000000000001
Sisterly Lust	2020-03-02	272	664	53	325	0.8672
Chess Sudoku	2020-03-02	74	155	5	79	0.8672
HYPERCHARGE: Unboxed	2020-04-27	1641	3110	339	1980	0.8671
Ghostbusters: The Video Game Remastered	2020-11-17	213	1113	102	315	0.867
Tanuki Sunset	2020-12-04	75	414	28	103	0.8669
Gachi run: Running of the slaves	2020-11-06	11	228	11	22	0.8668000000000001
Summerland	2020-12-02	107	1433	139	246	0.8667
dogpet	2020-12-28	6	126	3	9	0.8666
Witch It	2020-10-22	4971	14867	1893	6864	0.8663
Kofi Quest: Alpha MOD	2020-01-28	100	190	8	108	0.8662000000000001
Jets'n'Guns 2	2020-07-24	182	1029	94	276	0.8661
Sokpop S08: helionaut	2020-07-06	9	164	6	15	0.8659
Paperball	2020-03-27	30	176	7	37	0.8656999999999999
Unspottable	2020-10-22	105	323	20	125	0.8656
亭上满月映西枝~The Forever Moon	2020-06-13	18	123	3	21	0.8654000000000001
Kingdom Under Fire: The Crusaders 	2020-02-28	363	823	72	435	0.8653000000000001
Higurashi When They Cry Hou - Ch.8 Matsuribayashi	2020-05-14	79	374	25	104	0.8653000000000001
Dear Devere	2020-05-29	12	199	9	21	0.8653000000000001
Super Crush KO	2020-01-16	11	175	7	18	0.8653000000000001
Devolverland Expo	2020-07-11	6394	5081	600	6994	0.8652
Toasterball	2020-01-15	12	136	4	16	0.8652
Cloudpunk	2020-04-23	932	10703	1352	2284	0.8649
SUPER ROBOT WARS X	2020-01-09	852	1429	142	994	0.8649
Shrine II	2020-09-22	61	624	51	112	0.8648
A Way Out	2020-06-18	2374	38986	5330	7704	0.8645999999999999
Mists of Aiden	2020-11-10	45	940	86	131	0.8645999999999999
Mission Zigloton	2020-02-14	42	220	11	53	0.8645999999999999
Lockheart Indigo	2020-07-31	5	92	1	6	0.8645999999999999
Haydee 2	2020-11-23	326	1069	101	427	0.8644
Cyber-doge 2077: Meme runner	2020-09-01	8	172	7	15	0.8644
Caravaneer 2	2020-12-30	71	317	20	91	0.8643000000000001
TrymenT ―献给渴望改变的你―	2020-02-20	182	534	42	224	0.8641
The Conquest of Go	2020-12-07	91	377	26	117	0.8640000000000001
Angel Legion - Idle RPG	2020-08-14	893	4007	468	1361	0.8639
Lucid Dream	2020-05-05	73	816	73	146	0.8638
Flying Red Barrel - The Diary of a Little Aviator	2020-06-19	36	90	1	37	0.8637
CosmoDreamer	2020-10-02	8	90	1	9	0.8637
Madrun	2020-04-11	131	404	29	160	0.8634000000000001
Control Ultimate Edition	2020-08-27	9193	31949	4381	13574	0.8633
Cosmic Flow: A Relaxing VR Experience	2020-03-30	9	169	7	16	0.8633
Drunken Wrestlers	2020-01-10	46	506	40	86	0.8628
Baldur's Gate 3	2020-10-06	73980	51843	7304	81284	0.8627
LIT: Bend the Light	2020-05-15	69	235	13	82	0.8626
ISOLAND3: Dust of the Universe	2020-03-16	108	167	7	115	0.8626
Echoes of Nocturnal Chords 夜弦之音	2020-04-11	10	72	0	10	0.8626
Call of the Sea	2020-12-08	213	3025	348	561	0.8623999999999999
Amazing Cultivation Simulator	2020-11-25	18349	18074	2430	20779	0.8623000000000001
Stilt Fella	2020-02-26	307	748	67	374	0.8623000000000001
Blaston	2020-12-15	28	463	36	64	0.8620000000000001
Everland (Stress Test)	2020-05-16	1441	264	16	1457	0.8617
Arcana: Heat and Cold. Season 1	2020-10-07	40	176	8	48	0.8617
Neon Abyss	2020-07-14	6278	17921	2428	8706	0.8615
Shieldwall	2020-03-23	1018	4313	522	1540	0.8615
Understand	2020-10-31	113	479	38	151	0.8615
Horizon Zero Dawn	2020-08-07	56557	82022	11896	68453	0.8614
Azure Striker Gunvolt 2	2020-06-22	96	393	29	125	0.8614
Oppai Muse	2020-05-18	29	477	38	67	0.8612000000000001
ANNIE:Last Hope	2020-04-07	76	550	46	122	0.8611
The Horrorscope: Fatal Awakening	2020-08-24	10	362	26	36	0.8611
Meteorfall: Krumit's Tale	2020-07-23	174	684	61	235	0.861
Turn on the light	2020-07-07	6	138	5	11	0.8609
Alien Scumbags	2020-06-17	3	112	3	6	0.8606
SantaCraft	2020-12-15	13	84	1	14	0.8605
Rubber Bandits: Christmas Prologue	2020-12-01	1496	1045	104	1600	0.8604
Gadgeteer	2020-08-27	11	111	3	14	0.8601000000000001
Perky Little Things	2020-02-14	221	605	53	274	0.86
Half Past Fate	2020-03-12	16	226	13	29	0.86
XIII - Classic	2020-06-11	261	1698	186	447	0.8598
Lair Land Story	2020-04-22	13	110	3	16	0.8597
DAEMON X MACHINA	2020-02-13	9251	5078	639	9890	0.8595
TroubleDays	2020-02-13	256	807	77	333	0.8593999999999999
Wintermoor Tactics Club	2020-05-05	66	437	35	101	0.8592000000000001
Keen	2020-06-25	17	134	5	22	0.8592000000000001
Ratropolis	2020-12-22	1470	4318	537	2007	0.8591
Blazing Sails	2020-09-09	1680	6126	789	2469	0.8589
Tiny Toy Tanks	2020-11-21	30	361	27	57	0.8589
Rags to Dishes	2020-11-11	12	121	4	16	0.8589
Witches x Warlocks	2020-10-31	56	453	37	93	0.8588
The Sims™ 4	2020-06-18	96328	82106	12232	108560	0.8586
STAR WARS™ Battlefront™ II	2020-06-11	10489	40973	5954	16443	0.8584999999999999
The Walking Dead: Saints & Sinners	2020-01-23	1436	7433	978	2414	0.8584999999999999
BLEACH Brave Souls - 3D Action	2020-08-18	8003	6916	904	8907	0.8584999999999999
Royal Alchemist	2020-04-30	102	221	13	115	0.8584999999999999
If Found	2020-05-19	43	1311	140	183	0.8584
Calico	2020-12-15	399	3457	424	823	0.8583
绿洲计划	2020-03-31	57	155	7	64	0.8582
Tank Mechanic Simulator	2020-02-20	5022	6244	813	5835	0.8581000000000001
Eye of the Temple: First Steps	2020-08-27	20	260	17	37	0.858
Evergate	2020-09-01	17	119	4	21	0.8579000000000001
Venge	2020-07-28	18	278	19	37	0.8576
Eternal Hope: Prologue	2020-06-25	73	258	17	90	0.8575
Fury Unleashed	2020-05-08	521	1812	207	728	0.8573000000000001
What Comes After	2020-11-05	17	678	64	81	0.8572
looK INside	2020-01-22	145	296	21	166	0.8572
The HeartBeat	2020-10-05	5	92	2	7	0.8572
The Floor Is Still Really Cheap Lava	2020-11-25	24	185	10	34	0.8571
Agrou	2020-07-25	1273	2139	251	1524	0.8570000000000001
Diorama Builder	2020-11-20	31	266	18	49	0.8570000000000001
The Fairy's Song	2020-08-07	15	117	4	19	0.8570000000000001
末路调色板	2020-10-15	9	78	1	10	0.8570000000000001
Ikenfell	2020-10-08	240	850	85	325	0.8569
Drug Dealer Simulator: Free Sample	2020-04-03	1237	2325	277	1514	0.8567
Praetorians - HD Remaster	2020-01-24	153	690	66	219	0.8566
DJMAX RESPECT V	2020-03-12	3983	18910	2702	6685	0.8564
Isolomus	2020-12-04	5	204	12	17	0.8564
墨心	2020-11-12	314	1225	133	447	0.8562000000000001
Dreamscaper: Prologue	2020-04-08	737	1774	205	942	0.8561
Hydroneer	2020-05-08	8996	14300	2021	11017	0.8559000000000001
112 Operator	2020-04-23	1805	4011	513	2318	0.8559000000000001
Kill or Love	2020-02-07	155	1861	217	372	0.8559000000000001
Brave Alchemist Colette	2020-04-28	651	767	76	727	0.8559000000000001
StopGate	2020-09-01	175	523	47	222	0.8558
Battlefield 4™ 	2020-06-11	12425	45615	6831	19256	0.8556999999999999
Don't Be Afraid - The First Toy	2020-07-02	153	683	66	219	0.8556999999999999
The Dungeon Of Naheulbeuk: The Amulet Of Chaos	2020-09-17	4878	5489	726	5604	0.8556
Pixross	2020-12-15	96	126	5	101	0.8556
Radical Rabbit Stew	2020-07-16	11	114	4	15	0.8555
BORIS THE ROCKET	2020-10-14	40	89	2	42	0.8555
Mega Hasan	2020-01-13	40	326	25	65	0.8554
Amalgam	2020-11-10	28	817	83	111	0.8552
Lotion samurai	2020-06-03	21	75	1	22	0.8552
Death and Taxes	2020-02-20	763	3440	437	1200	0.8551000000000001
100 hidden snails	2020-11-06	5	306	23	28	0.855
The Wind and Wilting Blossom	2020-12-11	35	158	8	43	0.855
Thermo Sudoku	2020-05-25	103	136	6	109	0.855
Chaos	2020-04-28	141	3296	419	560	0.8545999999999999
Mafia: Definitive Edition	2020-09-24	36679	47383	7192	43871	0.8544
ScourgeBringer	2020-10-21	380	1989	239	619	0.8542000000000001
Escape Room - The Sick Colleague	2020-09-05	935	7729	1067	2002	0.8541
Shapik: The Moon Quest	2020-04-22	12	197	12	24	0.8541
Karen: An Outrage Simulator	2020-08-27	14	187	11	25	0.8541
9-nine-:Episode 3	2020-08-31	51	435	38	89	0.8540000000000001
Zooma	2020-08-14	28	216	14	42	0.8538
Circle Empires Rivals	2020-04-15	621	1328	151	772	0.8537
Hentai Beach	2020-11-13	40	552	52	92	0.8537
Mythic Ocean	2020-01-09	14	86	2	16	0.8537
Warzone 2100	2020-02-18	528	1052	115	643	0.8536
Santa Claus in Trouble (HD)	2020-12-21	38	133	6	44	0.8536
Walking Simulator 2020	2020-03-05	473	7733	1075	1548	0.8534
BEAR, VODKA, FALL OF BERLIN! 🐻	2020-05-18	734	371	31	765	0.8534
Bunny Park	2020-01-14	36	541	51	87	0.8533
RuneScape	2020-10-14	12569	17805	2615	15184	0.8532
BarnFinders: The Pilot	2020-04-28	228	455	41	269	0.853
ROBOTICS;NOTES ELITE	2020-10-14	140	325	26	166	0.853
Fox! Hen! Bag!	2020-07-13	6	163	9	15	0.8528
ISEKAI QUEST	2020-09-16	495	2850	364	859	0.8527
100 hidden eternals	2020-12-10	1578	341	28	1606	0.8526
Moose Life	2020-08-13	16	84	2	18	0.8525
AshenForest	2020-06-05	25	162	9	34	0.8523999999999999
Blush Blush	2020-04-22	2581	5099	694	3275	0.8522
The Light Remake	2020-06-04	58	1005	111	169	0.8521
Brain Meltdown - Into Despair	2020-12-01	24	191	12	36	0.8520000000000001
Sable's Grimoire: A Dragon's Treasure	2020-07-31	61	56	0	61	0.8520000000000001
Slide Stories: Neko's Journey	2020-09-28	8	56	0	8	0.8520000000000001
十天的溫度	2020-05-15	10	107	4	14	0.8519
Space Raiders in Space	2020-12-08	11	107	4	15	0.8519
メモリーズオフ-Innocent Fille-	2020-04-02	276	840	90	366	0.8517
Inertial Drift	2020-09-11	131	628	63	194	0.8517
Heaven Dust	2020-02-26	195	448	41	236	0.8517
Battlefield 1 ™	2020-06-11	53714	98009	15629	69343	0.8516
Hentai Vs Furries	2020-01-10	33	3124	408	441	0.8516
MotoGP™20	2020-04-23	1660	2434	309	1969	0.8516
BloodRayne: Terminal Cut	2020-11-20	383	945	104	487	0.8515
五五午时书	2020-08-21	22	274	21	43	0.8515
Starstruck: Prologue	2020-05-12	33	180	11	44	0.8515
Drug Dealer Simulator	2020-04-16	7574	13075	1919	9493	0.8514
Cat and Ghostly Road	2020-02-27	9	139	7	16	0.8514
Super Cable Boy	2020-11-20	17	82	2	19	0.8512000000000001
Vessels	2020-12-08	4	82	2	6	0.8512000000000001
Squad	2020-09-23	26104	114282	18470	44574	0.8505
Swarm	2020-06-12	29	225	16	45	0.8505
Project Starship X	2020-06-18	13	81	2	15	0.8505
Dread X Collection 3	2020-10-23	103	261	20	123	0.8504
Victory Road	2020-03-10	151	167	10	161	0.8503000000000001
Shantae and the Seven Sirens	2020-05-28	795	1185	138	933	0.8502
The Solitaire Conspiracy	2020-10-06	189	617	63	252	0.8502
MY HERO ONE'S JUSTICE 2	2020-03-12	784	2537	329	1113	0.8501000000000001
牛顿与苹果树	2020-08-07	45	251	19	64	0.8501000000000001
Moe Era	2020-02-04	401	4149	567	968	0.85
Museum of Other Realities	2020-02-26	153	338	29	182	0.8499
Midnight Scenes Episode 2 (Special Edition)	2020-09-08	5	92	3	8	0.8499
Happy's Humble Burger Farm Alpha	2020-10-29	49	527	52	101	0.8498000000000001
The Hayseed Knight	2020-12-08	13	103	4	17	0.8495999999999999
10mg: You are such a Soft and Round Kitten.	2020-10-15	3	67	1	4	0.8495999999999999
Methods: The Detective Competition	2020-06-01	60	336	29	89	0.8494
Progress Game	2020-08-14	92	284	23	115	0.8493
Landlord's Super	2020-04-30	430	885	99	529	0.8492000000000001
RollingSky2	2020-04-01	13	91	3	16	0.8492000000000001
PANZER BALL	2020-08-15	354	1113	130	484	0.8491
Biped	2020-03-27	1853	5223	737	2590	0.8489
3dSen	2020-06-19	106	350	31	137	0.8487
Labyrinthine	2020-10-28	1458	8269	1213	2671	0.8484
Ascent	2020-11-20	16	101	4	20	0.8484
Liz ~The Tower and the Grimoire~	2020-02-14	312	388	36	348	0.848
Lust Epidemic	2020-01-09	528	1055	124	652	0.8479000000000001
Burger Joint	2020-10-14	7	51	0	7	0.8478
Sokpop S09: fishy 3D	2020-10-21	8	51	0	8	0.8478
Futa Fix Dick Dine and Dash	2020-12-22	399	2096	273	672	0.8477
BANG! BANG! Totally Accurate Redneck Simulator	2020-05-04	28	225	17	45	0.8475
メモリーズオフ-Innocent Fille- for Dearest	2020-04-30	93	225	17	110	0.8475
Active Neurons - Wonders Of The World	2020-10-13	12	110	5	17	0.8473999999999999
GemCraft - Frostborn Wrath	2020-01-10	2063	2041	266	2329	0.8473
Space Haven	2020-05-21	5687	5862	849	6536	0.8472
Wet steps	2020-12-02	14	224	17	31	0.8472
Retrocycles	2020-07-22	26	120	6	32	0.8471
Sono	2020-03-06	25	383	36	61	0.8469
Pluviophile	2020-06-11	5	232	18	23	0.8469
Lost Potato	2020-08-14	18	109	5	23	0.8468000000000001
Dark Bestiary	2020-07-12	228	430	42	270	0.8467
Godless Tactics	2020-05-15	49	98	4	53	0.8466
Yupitergrad	2020-08-27	5	98	4	9	0.8466
Nexomon	2020-07-10	208	1131	137	345	0.8464
Petals of the Star Curtain	2020-12-24	81	75	2	83	0.8462999999999999
No one lives under the lighthouse	2020-04-21	238	1170	143	381	0.8461
Spirit of the North	2020-05-07	431	2518	341	772	0.846
BATTLE BEARS -1	2020-12-23	10	86	3	13	0.846
iB Cricket	2020-10-25	19	107	5	24	0.8456
STRIKERS 1945 II	2020-05-29	28	74	2	30	0.8456
Dungeon Slime	2020-12-15	8	74	2	10	0.8456
Snowdome	2020-07-23	28	218	17	45	0.8451000000000001
Sable's Grimoire: Man And Elf	2020-06-19	29	48	0	29	0.8451000000000001
TWWWR	2020-11-24	7	48	0	7	0.8451000000000001
Survivalist: Invisible Strain	2020-06-01	728	2329	316	1044	0.845
Tentacle Girl	2020-02-15	185	1051	128	313	0.8449
Helheim Hassle	2020-08-18	43	191	14	57	0.8449
10mg :)	2020-10-15	5	61	1	6	0.8449
Mizuchi 白蛇心傳	2020-04-17	23	73	2	25	0.8448000000000001
Dashing Fire	2020-11-12	17	73	2	19	0.8448000000000001
Dab on Darkness!	2020-06-16	7	73	2	9	0.8448000000000001
SpellForce 3: Fallen God	2020-11-03	1696	1070	131	1827	0.8447
Puzzle Together	2020-12-09	1055	3032	426	1481	0.8444
Let's Cook Together	2020-11-26	26	105	5	31	0.8444
Mainframe Defenders	2020-02-25	663	502	53	716	0.8442000000000001
Meridian 157: Chapter 1	2020-12-09	27	153	10	37	0.8442000000000001
Scrutinized	2020-08-05	276	788	92	368	0.8441
Beyond Eden: Dear Edward	2020-12-30	72	47	0	72	0.8441
Seiga Kaku uses her amazing Taoist arts and gives you a life lesson	2020-11-13	3	47	0	3	0.8441
Britannic: Patroness of the Mediterranean	2020-06-19	396	620	69	465	0.8440000000000001
LunarLux Chapter 1	2020-03-23	16	94	4	20	0.8440000000000001
My Holiday 2	2020-10-05	90	94	4	94	0.8440000000000001
Lumote: The Mastermote Chronicles	2020-02-20	10	72	2	12	0.8440000000000001
GUNBIRD	2020-05-11	31	72	2	33	0.8440000000000001
Skater XL	2020-07-28	5741	15620	2482	8223	0.8439
Love of Magic	2020-12-11	86	354	34	120	0.8439
Flipon	2020-10-08	15	83	3	18	0.8439
Tsuro - The Game of The Path	2020-10-20	30	104	5	35	0.8438
Love's Sweet Garnish 2	2020-10-02	20	104	5	25	0.8438
Unfortunate Spacemen	2020-06-13	11823	6193	932	12755	0.8436
日日夜夜	2020-10-24	39	264	23	62	0.8434999999999999
The Last Show of Mr. Chardish	2020-11-05	16	93	4	20	0.8434
Hargrave	2020-10-12	37	213	17	54	0.8433
Spellbound Spire	2020-06-23	11	178	13	24	0.8432
ESC	2020-05-15	9	71	2	11	0.8432
Ginkgo	2020-06-26	11	246	21	32	0.8431000000000001
Make Me LAG	2020-03-14	15	204	16	31	0.8431000000000001
Kairos'Light	2020-05-29	42	82	3	45	0.8431000000000001
-SPROUT-	2020-07-30	7	82	3	10	0.8431000000000001
Five Dates	2020-11-17	257	1839	248	505	0.843
Disgaea 4 Complete+	2020-09-10	604	599	67	671	0.843
Vampire: The Masquerade — Night Road	2020-09-24	308	473	50	358	0.843
I'm on Observation Duty 2	2020-03-23	41	254	22	63	0.843
Rum & Gun	2020-05-01	10	141	9	19	0.8428
GLASS	2020-11-22	97	1131	143	240	0.8427
Suits: Absolute Power	2020-10-16	25	150	10	35	0.8427
Ancient Enemy	2020-04-09	177	380	38	215	0.8426
Don't Crash - The Political Game	2020-08-27	5	112	6	11	0.8426
Meridian 157: Chapter 2	2020-12-09	18	112	6	24	0.8426
Mission: It's Complicated	2020-02-14	14	167	12	26	0.8423
Quiplash 2 InterLASHional	2020-04-08	375	268	24	399	0.8422000000000001
Grapple Tournament	2020-11-05	32	235	20	52	0.8422000000000001
Memory note	2020-12-25	4	58	1	5	0.8422000000000001
OshiRabu: Waifus Over Husbandos	2020-02-28	1126	3210	464	1590	0.8421
Iris and the giant	2020-02-27	242	953	118	360	0.8421
Way To Yaatra	2020-05-25	46	130	8	54	0.8420000000000001
Alwa's Legacy	2020-06-17	56	291	27	83	0.8419
The Infected	2020-08-07	1941	4472	668	2609	0.8418000000000001
DEEMO -Reborn-	2020-09-04	1403	2643	376	1779	0.8418000000000001
Quantum Protocol	2020-11-04	94	414	43	137	0.8417
The Dawn of Art	2020-02-24	11	120	7	18	0.8416
Vigil: The Longest Night	2020-10-14	1448	2537	361	1809	0.8414
Fly Punch Boom: First Impact!	2020-04-15	133	479	52	185	0.8412999999999999
Tree Simulator 2021	2020-05-22	11	100	5	16	0.8412999999999999
Need for Speed™ Payback	2020-06-18	12152	16018	2611	14763	0.8412000000000001
Mokoko	2020-02-17	25	155	11	36	0.8408
Blankspace	2020-07-23	16	68	2	18	0.8408
Chicken Bomb	2020-07-30	5	68	2	7	0.8408
MMORPG Tycoon 2	2020-01-06	792	2050	287	1079	0.8407
Giraffe and Annika	2020-02-18	66	263	24	90	0.8407
Night Reverie: Prologue	2020-11-25	26	255	23	49	0.8407
Neglected	2020-05-13	34	310	30	64	0.8406
Crumble	2020-12-04	68	540	61	129	0.8405
Wunderling	2020-03-05	16	118	7	23	0.8405
The Button Witch	2020-12-27	7	43	0	7	0.84
The Wizard and The Slug	2020-11-02	12	43	0	12	0.84
Star Seeker in: the Secret of the Sorcerous Standoff	2020-11-04	6	43	0	6	0.84
Gazillionaire	2020-01-14	66	153	11	77	0.8398000000000001
3D Math - Ultra	2020-06-16	23	153	11	34	0.8398000000000001
Spellbreak	2020-12-15	5504	11814	1922	7426	0.8395999999999999
川建国同志想连任	2020-09-11	274	1036	134	408	0.8395
Booth: A Dystopian Adventure	2020-07-22	53	283	27	80	0.8395
Beyond a Steel Sky	2020-07-16	353	948	121	474	0.8394
Tear and the Library of Labyrinths	2020-11-07	465	259	24	489	0.8394
Pode	2020-04-03	31	211	18	49	0.8394
Juiced!	2020-04-23	38	125	8	46	0.8392000000000001
Beneath a Steel Sky	2020-07-27	44	312	31	75	0.8390000000000001
Skatemasta Tcheco	2020-01-31	201	106	6	207	0.8389
Hard Bullet	2020-10-22	166	2702	397	563	0.8388
Magical Diary: Wolf Hall	2020-02-17	143	168	13	156	0.8388
Jiangshi x Daoshi	2020-07-16	11	151	11	22	0.8388
Vetrix	2020-05-21	5	42	0	5	0.8388
ROBO OH	2020-10-17	7	42	0	7	0.8388
Visage	2020-10-30	1178	6487	1026	2204	0.8387000000000001
Evan's Remains	2020-06-11	66	1107	146	212	0.8387000000000001
STRIKERS 1945	2020-04-30	36	115	7	43	0.8387000000000001
Gutwhale	2020-04-06	15	124	8	23	0.8386
Gachi Revenge	2020-06-05	10	264	25	35	0.8384999999999999
Over the Alps	2020-03-31	19	192	16	35	0.8384
Adore	2020-02-18	68	294	29	97	0.8382
In Other Waters	2020-04-03	166	1373	188	354	0.8381000000000001
My Hole is a Mouth of Dirt	2020-04-13	14	158	12	26	0.8381000000000001
Cubism	2020-09-17	5	41	0	5	0.8377
Kidnapped Girl	2020-06-15	148	4947	776	924	0.8375
Colony Siege	2020-09-07	69	198	17	86	0.8375
Sensorium	2020-08-28	23	131	9	32	0.8375
A Case of the Crabs: Rehash	2020-09-21	3	53	1	4	0.8373999999999999
Neko Neko	2020-02-07	25	245	23	48	0.8373
Goblin Summer Camp	2020-04-30	57	156	12	69	0.8371
Observer: System Redux	2020-11-10	253	1409	196	449	0.8369
Escape from Tatris	2020-09-18	26	274	27	53	0.8368000000000001
Approaching Infinity	2020-08-05	42	204	18	60	0.8367
Borderlands 3	2020-03-13	93820	98299	17768	111588	0.8366
Escape from Kyoto House	2020-06-11	16	138	10	26	0.8366
Miracle Sudoku	2020-08-13	87	138	10	97	0.8366
Merchant of the Skies	2020-04-17	625	1167	159	784	0.8365
Cloak and Dasher	2020-02-25	7	40	0	7	0.8365
Trusty Brothers	2020-04-04	9	40	0	9	0.8365
大千世界	2020-07-18	1437	2002	292	1729	0.8364
The Adventures of Looppy	2020-03-04	10	63	2	12	0.8362999999999999
My Jigsaw Adventures - Roads of Life	2020-04-01	12	63	2	14	0.8362999999999999
Let's Learn Korean! Hangul	2020-03-09	5	52	1	6	0.8362999999999999
Roll for the Galaxy	2020-08-25	45	102	6	51	0.8362
Minesweeper Classy	2020-12-17	16	102	6	22	0.8362
Ultra Foodmess	2020-02-20	17	83	4	21	0.8361000000000001
The Peresmeshnik	2020-07-07	5	83	4	9	0.8361000000000001
Iratus: Lord of the Dead	2020-04-23	4258	5685	916	5174	0.8357
Crown Trick	2020-10-16	6594	4186	659	7253	0.8357
Talvisota - Winter War	2020-04-02	59	940	125	184	0.8357
Sweet F. Cake	2020-05-30	260	451	52	312	0.8357
The Grounding	2020-09-16	40	629	78	118	0.8356
Gun Witch	2020-12-31	142	217	20	162	0.8356
Cooking Companions: Appetizer Edition	2020-10-06	65	321	34	99	0.8353
Embracelet	2020-09-24	14	82	4	18	0.8353
Mortal Decay	2020-10-28	2	62	2	4	0.8353
Pitcher and the Whale	2020-07-24	4	51	1	5	0.8353
Fantastic Contraption Classic 1 & 2	2020-08-10	13	51	1	14	0.8353
Berserker's Descent	2020-09-19	6	39	0	6	0.8353
Get-A-Grip Chip	2020-10-16	9	39	0	9	0.8353
Fallstreak: Requiem for my Homeland	2020-11-20	3	39	0	3	0.8353
Goddess of Hentai	2020-02-26	18	364	40	58	0.8351999999999999
Dark Fall: Ghost Vigil	2020-01-10	40	152	12	52	0.8351000000000001
Unicorn Tails	2020-06-22	18	72	3	21	0.8351000000000001
ANIME STANDING	2020-07-14	38	1730	252	290	0.8349
Doomsday Hunters	2020-05-22	72	468	55	127	0.8349
Wire Lips	2020-01-17	9	126	9	18	0.8346
Fantasy Tavern Sextet -Vol.1 New World Days-	2020-12-14	51	267	27	78	0.8345
Rhome	2020-02-21	33	581	72	105	0.8344
Scribble It!	2020-10-20	1661	5758	941	2602	0.8342
ВЗЛОМ ЖОПЫ	2020-02-07	18	1987	296	314	0.8342
Monster Energy Supercross - The Official Videogame 3	2020-02-04	464	978	133	597	0.8342
Shakedown: Hawaii	2020-10-20	68	310	33	101	0.8342
冷血症骰子	2020-10-01	16	198	18	34	0.8342
Teenage Blob: Paperperson - The First Single	2020-09-17	3	50	1	4	0.8342
Chinatris	2020-01-03	219	855	114	333	0.8341
Football Manager 2021 Touch	2020-12-01	1971	599	75	2046	0.8340000000000001
1980	2020-08-31	61	532	65	126	0.8340000000000001
Gubble	2020-06-09	5	38	0	5	0.8340000000000001
Hnefatafl	2020-04-30	8	38	0	8	0.8340000000000001
Streamer Daily	2020-03-04	317	903	122	439	0.8337000000000001
Estranged: The Departure	2020-05-22	7399	1831	272	7671	0.8336
PHOGS!	2020-12-03	153	523	64	217	0.8336
Nine Witches: Family Disruption	2020-12-04	17	189	17	34	0.8336
Alien Cat 2	2020-06-15	13	107	7	20	0.8334999999999999
How Buddy’s parents met - jigsaw puzzle	2020-02-14	13	157	13	26	0.8334
Nick Bounty: The Dame with the Blue Chewed Shoe.	2020-04-01	7	60	2	9	0.8334
Legendary Knight	2020-02-28	25	70	3	28	0.8333
The Case Book of Arne	2020-10-29	30	248	25	55	0.833
Duck Life	2020-11-26	24	140	11	35	0.833
Hell Wedding 夜嫁	2020-06-02	113	990	137	250	0.8328
Box Cats Puzzle	2020-12-02	96	79	4	100	0.8328
Cave Quest	2020-01-12	11	79	4	15	0.8328
Knight's Retreat	2020-08-06	16	79	4	20	0.8328
Zom Nom	2020-01-02	20	123	9	29	0.8327
Picross for a Cause	2020-09-07	16	37	0	16	0.8327
Adventure Llama	2020-12-10	4	37	0	4	0.8327
Plebby Quest: The Crusades	2020-04-09	3533	2172	332	3865	0.8326000000000001
Ruff Night At The Gallery	2020-12-01	13	179	16	29	0.8326000000000001
Ho-Ho-Home Invasion	2020-12-15	20	97	6	26	0.8326000000000001
前進吧！高捷少女Initiating Station PLUS	2020-03-27	23	88	5	28	0.8326000000000001
Cybershock: Future Parkour	2020-07-28	6	88	5	11	0.8326000000000001
Lithium City	2020-06-15	10	209	20	30	0.8323999999999999
Ignis Universia	2020-12-07	13	163	14	27	0.8323999999999999
SLAYERS FOR HIRE	2020-03-20	28	114	8	36	0.8323999999999999
Crysis® 3 	2020-06-04	1387	4414	720	2107	0.8323
Handy Harry's Haunted House Services	2020-07-31	65	521	65	130	0.8320000000000001
Tex-Mechs	2020-02-21	17	170	15	32	0.8320000000000001
Time Break Chronicles	2020-09-01	37	138	11	48	0.8319
SIMULACRA 2	2020-01-30	318	1173	168	486	0.8318000000000001
Bloodstained: Curse of the Moon 2	2020-07-10	688	1040	147	835	0.8315000000000001
Cold Call	2020-12-24	5	68	3	8	0.8314
Rivals	2020-09-21	5	36	0	5	0.8314
Happy Numbers	2020-10-15	133	363	42	175	0.8312999999999999
Red Dead Online	2020-12-04	19921	45515	8407	28328	0.8311000000000001
Skater Frog	2020-01-24	9	168	15	24	0.8311000000000001
Hello Neighbor 2 Alpha 1.5	2020-07-23	1091	4570	756	1847	0.831
Ultimate Zombie Defense	2020-12-08	1111	1200	174	1285	0.831
HENTAI SNIPER: Middle East	2020-01-16	2258	1023	145	2403	0.831
Siege Survival: Gloria Victis Prologue	2020-08-19	348	810	111	459	0.8309000000000001
Bloody Rally Show	2020-02-20	27	220	22	49	0.8308
My Cute Fuhrer	2020-04-16	299	1032	147	446	0.8307
Filament	2020-04-23	279	501	63	342	0.8307
Power of Ten - Demo	2020-09-24	12	47	1	13	0.8307
Diggles: The Myth of Fenris	2020-12-14	395	421	51	446	0.8306
Bad Guys at School	2020-06-15	83	1207	176	259	0.8305
Fetish Locator Week One - Extended Edition	2020-07-27	634	1744	266	900	0.8304
六阶谜题	2020-04-24	179	526	67	246	0.8304
Duck Life: Adventure	2020-06-22	79	255	27	106	0.8304
Sakura Succubus 2	2020-07-20	36	248	26	62	0.8304
Angels of Death Episode.Eddie	2020-05-21	24	297	33	57	0.8303
Heart Star	2020-03-06	5	57	2	7	0.8301999999999999
Beyond Blue	2020-06-11	303	934	132	435	0.8301000000000001
Lucky and a life worth living	2020-05-21	16	76	4	20	0.8301000000000001
Dezatopia	2020-01-23	6	35	0	6	0.8300000000000001
Yes, Your Grace	2020-03-06	3337	6069	1035	4372	0.8298000000000001
Synergia	2020-07-27	64	503	64	128	0.8298000000000001
Raji: An Ancient Epic Prologue	2020-10-05	238	490	62	300	0.8298000000000001
风中之烛	2020-05-18	28	195	19	47	0.8296
TAISHO x ALICE episode 2	2020-09-18	58	329	38	96	0.8295
Fifo's Night	2020-10-29	23	134	11	34	0.8295
Creepy Tale	2020-02-21	100	1693	260	360	0.8294
ELDERBORN	2020-01-30	391	1843	286	677	0.8293
Arena	2020-05-20	23	187	18	41	0.8293
DANMAKAI: Red Forbidden Fruit	2020-10-12	24	84	5	29	0.8293
Kotel Ne Gori: A Friend of Lena Boots	2020-09-01	4	75	4	8	0.8292
Neon Girls	2020-06-13	4	75	4	8	0.8292
H-SNIPER: World War II	2020-09-07	23	812	114	137	0.8287000000000001
Across the Grooves	2020-06-17	30	92	6	36	0.8287000000000001
Soldat 2	2020-09-22	156	319	37	193	0.8286
One Circle	2020-12-11	9	34	0	9	0.8285
Outpost	2020-05-01	266	566	75	341	0.8283
Wait! Life is Beautiful! Prologue	2020-08-06	21	398	49	70	0.8281999999999999
IxSHE Tell	2020-08-28	149	116	9	158	0.8281999999999999
Dragon Audit	2020-12-08	4	45	1	5	0.8281999999999999
Nine Witches: Family Disruption - Prologue	2020-07-20	6	45	1	7	0.8281999999999999
GUNBIRD 2	2020-06-10	19	45	1	20	0.8281999999999999
Wiggly Boy	2020-09-23	4	45	1	5	0.8281999999999999
Spartan Firefight	2020-12-28	9	45	1	10	0.8281999999999999
Operation: Tango - Demo	2020-08-28	866	1258	189	1055	0.8281000000000001
Colt Canyon	2020-06-16	113	750	105	218	0.8278
Deathtrap Dungeon: The Interactive Video Adventure	2020-04-30	26	154	14	40	0.8277
Huuma Mina: The Secret of Immortality	2020-06-05	275	275	31	306	0.8276000000000001
Trivia Tricks	2020-10-27	43	123	10	53	0.8276000000000001
Tomai	2020-08-23	11	82	5	16	0.8276000000000001
36 apples	2020-01-31	5	115	9	14	0.8275
SUPERHOT: MIND CONTROL DELETE	2020-07-16	3746	8586	1526	5272	0.8273
Virtual Exhibition	2020-05-28	7	73	4	11	0.8273
Endless Bounty	2020-07-28	25	73	4	29	0.8273
Delores: A Thimbleweed Park Mini-Adventure	2020-05-09	931	484	63	994	0.8272
Idle Slayer	2020-12-22	1492	3529	593	2085	0.8271
ITTA	2020-04-22	82	232	25	107	0.8270000000000001
Summer in Mara Prologue	2020-05-29	205	919	134	339	0.8269
Forgotten Ways	2020-05-27	13	98	7	20	0.8269
OUTTA GAS	2020-03-26	14	44	1	15	0.8269
Hanoi Puzzles: Solid Match	2020-12-16	6	44	1	7	0.8269
Slapshot: Rebound	2020-12-07	1544	5747	1002	2546	0.8268000000000001
Love Spell: Written In The Stars	2020-07-24	46	114	9	55	0.8268000000000001
MannaRites	2020-10-24	44	238	26	70	0.8267
Hot Shot Burn	2020-01-17	22	167	16	38	0.8267
Willy Jetman: Astromonkey's Revenge	2020-01-31	8	81	5	13	0.8267
Is It Wrong to Try to Shoot 'em Up Girls in a Dungeon?	2020-11-25	16	188	19	35	0.8264
Dingletopia: Nation Under Siege (by Orcs)	2020-07-15	26	144	13	39	0.8262999999999999
Rekt!	2020-11-06	12	89	6	18	0.8262999999999999
HIVESWAP: ACT 2	2020-11-25	1837	805	116	1953	0.8261000000000001
TANKNAROK	2020-06-23	26	97	7	33	0.8261000000000001
Scrapnaut: Prologue	2020-09-09	223	646	90	313	0.826
Greyhat - A Digital Detective Adventure	2020-08-31	15	151	14	29	0.826
Project Heartbeat	2020-03-26	21	229	25	46	0.8258
Theyest Thou	2020-02-26	5	80	5	10	0.8258
Pixel Puzzle Makeout League	2020-10-30	14	53	2	16	0.8256
Othello Let's Go	2020-08-20	8	32	0	8	0.8255
We Went Back	2020-04-03	303	3630	621	924	0.8253
Desktop Kanojo	2020-04-24	600	1360	212	812	0.8253
Demon Turf: Trials	2020-11-27	23	104	8	31	0.8253
Tell Me Why	2020-08-27	2784	7803	1407	4191	0.8250000000000001
Alien Cat	2020-02-25	6	340	42	48	0.8250000000000001
The Outer Worlds	2020-10-23	20349	19117	3601	23950	0.8248000000000001
Choice of Life: Middle Ages	2020-11-06	96	639	90	186	0.8248000000000001
Dream Date	2020-05-09	1570	1844	299	1869	0.8247
Tower and Sword of Succubus	2020-10-31	313	626	88	401	0.8247
Kine	2020-10-19	13	87	6	19	0.8246
9th Dawn III	2020-10-06	437	377	48	485	0.8245
Leisure Suit Larry - Wet Dreams Dry Twice	2020-10-23	618	587	82	700	0.8242
Cake Bash	2020-10-14	49	225	25	74	0.8242
Cauldrons of War - Barbarossa	2020-09-25	21	118	10	31	0.8242
Backworlds	2020-02-20	9	42	1	10	0.8240999999999999
Gothic Murder: Adventure That Changes Destiny	2020-09-24	6	42	1	7	0.8240999999999999
BioCrisis	2020-11-09	4	42	1	5	0.8240999999999999
Kandidatos Kart	2020-10-20	20	525	72	92	0.8240000000000001
逝去的回忆3外传：逝3滞销帮帮我们	2020-04-06	149	400	52	201	0.8239000000000001
SNIKS	2020-08-12	5	31	0	5	0.8239000000000001
Super Forklift 3000	2020-04-17	4	31	0	4	0.8239000000000001
Core Awaken ~Jilelen and LittleSnow~	2020-06-19	5	31	0	5	0.8239000000000001
Azalea	2020-11-09	2	31	0	2	0.8239000000000001
BasCatball Mars	2020-11-06	6	31	0	6	0.8239000000000001
Mythgard	2020-09-18	490	1114	172	662	0.8238
Time Loader Prologue	2020-11-11	27	86	6	33	0.8237000000000001
Tower Tag	2020-05-28	64	257	30	94	0.8236
Neversong	2020-05-20	163	708	103	266	0.8234
Stirring Abyss	2020-10-29	98	302	37	135	0.8233
Last Regiment	2020-06-15	19	69	4	23	0.8233
Wasteland 3	2020-08-28	24555	14490	2736	27291	0.8231
The Wonderful 101: Remastered	2020-05-19	294	664	96	390	0.823
Zamboni Simulator 2019	2020-05-26	19	215	24	43	0.8228
Wolf's Gang	2020-08-20	13	116	10	23	0.8228
BOT.vinnik Chess: Combination Lessons	2020-06-18	9	93	7	16	0.8228
Mortal Glory	2020-01-29	331	445	60	391	0.8227
Her Lie I Tried To Believe - Extended Edition	2020-08-03	6	41	1	7	0.8227
Peace Data	2020-01-28	73	194	21	94	0.8226000000000001
Miner: Dig Deep	2020-11-28	67	166	17	84	0.8224
Nimbatus - Drone Creator	2020-04-30	41	200	22	63	0.8222
HITOTSU NO MORI	2020-01-10	15	100	8	23	0.8222
Astral Gunners	2020-10-02	6	30	0	6	0.8222
The Cherry Orchard	2020-11-20	5	30	0	5	0.8222
Infini	2020-03-04	7	30	0	7	0.8222
Mole Game	2020-01-31	6	30	0	6	0.8222
Syzygy	2020-11-20	7	30	0	7	0.8222
Waronoi	2020-12-21	10	30	0	10	0.8222
b 2	2020-05-15	9	193	21	30	0.8220999999999999
Fly Punch Boom!	2020-05-28	34	115	10	44	0.8220999999999999
Salthe	2020-09-15	15	115	10	25	0.8220999999999999
Kiara And My Ara Ara Adventure	2020-08-07	11	84	6	17	0.8219
Zompiercer	2020-04-03	116	986	153	269	0.8217
BER Bausimulator Remastered	2020-09-17	90	199	22	112	0.8217
My Cute Commissar	2020-10-21	50	297	37	87	0.8216
Isle of Ewe	2020-03-02	491	553	79	570	0.8212
Touhou : Shooting Star | 東方流星譚	2020-06-16	54	67	4	58	0.8212
PEE WAR!!	2020-08-03	6	67	4	10	0.8212
Dragon Blaze	2020-08-03	10	40	1	11	0.8212
Star Island	2020-09-01	12	40	1	13	0.8212
Train Station Renovation - First Job	2020-04-21	311	717	107	418	0.8211
Dandelions in the Sky	2020-07-21	18	191	21	39	0.8211
Apex Legends	2020-11-05	624473	522218	109307	733780	0.821
The Dungeon Beneath	2020-10-23	280	480	67	347	0.821
Under Party	2020-04-03	58	569	82	140	0.8209000000000001
Action Taimanin	2020-10-06	2894	12808	2454	5348	0.8205
Everslash	2020-07-03	14	49	2	16	0.8205
World of Art - learn with Jigsaw Puzzles	2020-06-18	11	49	2	13	0.8205
Ghost Dimension	2020-01-17	2	29	0	2	0.8204000000000001
NOMAD	2020-07-29	5	29	0	5	0.8204000000000001
Bloody Service	2020-12-22	3	29	0	3	0.8204000000000001
三国群英传3	2020-11-13	362	483	68	430	0.8203
Love Breakout	2020-03-13	629	548	79	708	0.8201999999999999
Pro Cycling Manager 2020	2020-06-04	2884	768	117	3001	0.8201
Knight Club +	2020-10-09	139	235	28	167	0.8201
Philophobia: The Fear of Love	2020-02-10	21	66	4	25	0.8201
Scoot	2020-12-28	71	511	73	144	0.8199
CHRONOSHOT	2020-08-08	95	366	49	144	0.8198000000000001
Shadow Empire	2020-12-03	608	867	135	743	0.8197
Oniria Crimes	2020-12-03	5	39	1	6	0.8197
Apotheker	2020-11-20	9	39	1	10	0.8197
Super Buckyball Tournament Preseason	2020-11-19	950	1100	177	1127	0.8194
Furry Shades of Gay	2020-12-18	59	779	120	179	0.8192
My Village Life	2020-08-27	41	167	18	59	0.8192
Stilstand	2020-08-27	13	48	2	15	0.8192
TOUHOU SKY ARENA MATSURI CLIMAX	2020-09-02	51	153	16	67	0.8190000000000001
Lawless Lands	2020-08-14	54	81	6	60	0.8190000000000001
Space Elite Force II	2020-02-03	4	81	6	10	0.8190000000000001
Industrial Petting	2020-03-17	24	65	4	28	0.8190000000000001
Aeon on Mosaic: Anemone 时间碎片：奇迹	2020-07-31	9	65	4	13	0.8190000000000001
Super XYX	2020-08-11	12	73	5	17	0.8189000000000001
Alpaca Ball	2020-10-15	17	73	5	22	0.8189000000000001
Need for Speed™ Heat 	2020-06-04	86196	70751	14546	100742	0.8187000000000001
Seek Girl:Fog Ⅰ	2020-08-28	870	3819	695	1565	0.8186
Sumerians	2020-12-02	158	199	23	181	0.8186
Hazumi and the Pregnation	2020-02-21	80	166	18	98	0.8186
SLI-FI: 2D Planet Platformer	2020-09-21	6	28	0	6	0.8186
Deity Driving	2020-01-21	3	28	0	3	0.8186
Rescue Team: Danger from Outer Space!	2020-06-25	20	28	0	20	0.8186
Let It Go - How to realize your dreams	2020-11-05	3	28	0	3	0.8186
Cloud Meadow	2020-03-03	527	2455	432	959	0.8185
FUSER	2020-11-10	855	1183	194	1049	0.8184
Roller Riot	2020-04-29	32	138	14	46	0.8181999999999999
Bankrupt Heroines	2020-10-15	12	138	14	26	0.8181999999999999
Dino Hazard: Chronos Blackout	2020-11-16	5	56	3	8	0.8181999999999999
A Lozenge	2020-08-26	3	38	1	4	0.8181
Jolly Good: Cakes and Ale	2020-11-12	55	38	1	56	0.8181
Dark Deception: Monsters & Mortals	2020-11-02	254	1887	326	580	0.818
Desktop Agents - Cov1d-999	2020-04-16	4	47	2	6	0.8178000000000001
Destructivator 2	2020-04-02	4	47	2	6	0.8178000000000001
Room No. 9	2020-08-06	39	197	23	62	0.8176000000000001
Lock 'n Load Tactical Digital: Core Game	2020-04-03	101	382	53	154	0.8175
Gordian Rooms 1: A curious heritage	2020-09-23	32	328	44	76	0.8175
Lawnmower Game: Next Generation	2020-07-14	10	137	14	24	0.8175
Chess Brain	2020-09-08	7	109	10	17	0.8175
Stars Die	2020-12-04	7	87	7	14	0.8175
Oppaidius Tropical Cruise!	2020-01-16	17	116	11	28	0.8174
Endless Furry Killer 2020	2020-09-23	9	196	23	32	0.8170999999999999
Cartomante	2020-09-01	5	79	6	11	0.8170999999999999
9 Monkeys of Shaolin	2020-10-16	160	589	89	249	0.8169
Chess'Extra	2020-11-04	17	136	14	31	0.8169
Ginga Force	2020-09-24	23	71	5	28	0.8168000000000001
RaidLand	2020-05-27	216	622	95	311	0.8167
Flower in the Snow - Resurrection	2020-12-19	6	63	4	10	0.8167
Oasis VR	2020-10-26	564	1614	278	842	0.8166
Willy Morgan	2020-08-11	74	313	42	116	0.8166
Thunder Rally	2020-04-07	12	27	0	12	0.8166
Robot Island	2020-06-16	2	27	0	2	0.8166
Beautycopter	2020-06-08	2	27	0	2	0.8166
Square Game	2020-09-25	6	27	0	6	0.8166
Paralyzed	2020-12-18	4	27	0	4	0.8166
Slide Stories: Bonds & Memories	2020-12-15	3	27	0	3	0.8166
BeatBeat	2020-08-25	5	37	1	6	0.8165000000000001
Scrapping Simulator	2020-12-31	14	37	1	15	0.8165000000000001
THE IMPOSSIBLE	2020-07-24	13	245	31	44	0.8164
NEOVERSE	2020-02-19	917	3083	563	1480	0.8163
I Walk Among Zombies Vol. 3	2020-12-15	44	188	22	66	0.8163
Lancelot's Hangover : The Quest for the Holy Booze	2020-10-01	9	46	2	11	0.8163
DethKarz	2020-08-21	7	46	2	9	0.8163
Papa's Quiz	2020-12-29	21	78	6	27	0.8161
World Seed Classic	2020-02-28	57	100	9	66	0.816
Piczle Cross Adventure	2020-04-16	10	70	5	15	0.8157
Helix Slider	2020-09-25	12	85	7	19	0.8156
TUBELIVE	2020-05-12	8	54	3	11	0.8156
Mirror's Edge™ Catalyst	2020-06-04	1446	9183	1803	3249	0.8155
Halo Beats!	2020-01-31	4	62	4	8	0.8155
Gemini	2020-09-23	13	120	12	25	0.8151999999999999
Dungeon Crusher Kiritan	2020-08-13	31	45	2	33	0.8148000000000001
Blastboard	2020-02-28	26	45	2	28	0.8148000000000001
DriftOn	2020-02-06	6	45	2	8	0.8148000000000001
LOVE - A Puzzle Box Filled with Stories	2020-10-21	8	45	2	10	0.8148000000000001
PGA TOUR 2K21	2020-08-21	5473	6003	1160	6633	0.8147
House Sitter	2020-05-27	8	36	1	9	0.8147
Bob Help Them	2020-11-25	6	36	1	7	0.8147
命运九重奏	2020-05-27	71	126	13	84	0.8146
Our Hero! First	2020-07-30	3	26	0	3	0.8146
Linklight	2020-11-19	6	26	0	6	0.8146
Happy Oshare Time	2020-06-17	20	26	0	20	0.8146
Salad Fields	2020-07-10	5	26	0	5	0.8146
Void Breach	2020-02-14	2	26	0	2	0.8146
Bouncy Cat	2020-11-23	10	26	0	10	0.8146
Fae Tactics	2020-07-31	576	1060	178	754	0.8145
Sokpop S09: pyramida	2020-08-14	96	475	71	167	0.8145
Armillo	2020-07-03	819	178	21	840	0.8144
1976	2020-12-10	11	112	11	22	0.8144
Samurai Jack: Battle Through Time	2020-08-21	665	989	165	830	0.8143000000000001
Castle Rock Beach, West Australia	2020-09-26	35	324	45	80	0.8143000000000001
Cardpocalypse	2020-10-12	59	165	19	78	0.8143000000000001
The Walking Fish 2: Final Frontier	2020-06-01	34	252	33	67	0.8142
Falcon City	2020-06-04	18	53	3	21	0.8142
SpermDash	2020-09-09	16	76	6	22	0.8140000000000001
Pianistic	2020-09-01	12	220	28	40	0.8136
The Blind Prophet	2020-02-05	35	262	35	70	0.8134
Home and Dungeon	2020-10-02	173	238	31	204	0.8134
Paper Dolls 2	2020-07-03	1307	1868	336	1643	0.8133
Wormskull	2020-04-03	6	44	2	8	0.8133
STATIONflow	2020-04-15	306	384	56	362	0.8131
Monolight	2020-06-29	35	297	41	76	0.8131
Funbag Fantasy: Sideboob Story 2	2020-03-12	37	35	1	38	0.813
The Adventures of Ten and Till	2020-05-06	6	35	1	7	0.813
∀kashicverse-Malicious Wake-	2020-11-30	10	35	1	11	0.813
Betelgeuse	2020-05-31	4	35	1	5	0.813
Serious Sam 4	2020-09-24	8522	10739	2166	10688	0.8129000000000001
Ever Forward Prologue	2020-05-28	182	366	53	235	0.8129000000000001
Arc Apellago	2020-11-09	87	302	42	129	0.8128000000000001
Paint Girl	2020-09-25	132	611	97	229	0.8127
Hotel R'n'R	2020-05-28	19	143	16	35	0.8127
Vidiot Game	2020-08-14	13	162	19	32	0.8126000000000001
毛笔模拟器 / Chinese Brush Simulator	2020-01-29	10	89	8	18	0.8125
Monster Jaunt	2020-02-20	9	25	0	9	0.8125
The Convenience Store | 夜勤事件	2020-02-18	131	1747	315	446	0.8123
Shoujo City	2020-05-16	29	205	26	55	0.8123
Star Renegades	2020-09-08	1785	1913	348	2133	0.8122
Midnight Scenes: The Highway	2020-07-15	4	155	18	22	0.8122
Yumeutsutsu Re:After	2020-04-23	16	67	5	21	0.8122
Missile Command: Recharged	2020-05-27	9	161	19	28	0.812
Witcheye	2020-08-27	13	129	14	27	0.812
Picklock	2020-05-07	109	305	43	152	0.8118000000000001
Epicinium	2020-10-12	44	252	34	78	0.8118000000000001
Love with Kadyrov	2020-03-11	7	148	17	24	0.8118000000000001
Master Magistrate	2020-06-12	58	122	13	71	0.8117000000000001
Moonlight Basket	2020-06-19	19	43	2	21	0.8117000000000001
Snaliens	2020-02-27	14	43	2	16	0.8117000000000001
Our Secret Below	2020-07-10	21	95	9	30	0.8116
How Stories Die	2020-11-05	26	95	9	35	0.8116
Cat Warfare	2020-02-26	20	81	7	27	0.8116
Assembly Planter	2020-08-04	29	154	18	47	0.8115000000000001
Killer Sudoku	2020-12-14	89	88	8	97	0.8115000000000001
Karnage Chronicles	2020-07-31	85	1049	181	266	0.8114
projet BLARI	2020-10-20	50	141	16	66	0.8114
Sokpop S07: Chatventures	2020-04-09	72	115	12	84	0.8114
MECHBLAZE	2020-11-07	11	51	3	14	0.8114
Slasher's Keep	2020-11-19	1269	1610	291	1560	0.8112
Roundguard	2020-03-13	244	343	50	294	0.8111
Code Romantic	2020-04-30	6	34	1	7	0.8111
About Love, Hate And The Other Ones 2	2020-05-08	5	34	1	6	0.8111
Art of Deception	2020-01-03	4	34	1	5	0.8111
Green: An Orc's Life	2020-03-17	8	34	1	9	0.8111
Orders of Magnitude	2020-03-30	3	34	1	4	0.8111
Elliot	2020-07-20	4	34	1	5	0.8111
Arcus	2020-12-31	3	34	1	4	0.8111
Bakery Magnate: Beginning	2020-08-23	48	762	127	175	0.8109000000000001
Atelier Escha & Logy: Alchemists of the Dusk Sky DX	2020-01-14	98	190	24	122	0.8108
Shady Lewd Kart	2020-03-03	27	159	19	46	0.8107
THE MONSTER OF MEMORY:DESTINY	2020-11-27	40	140	16	56	0.8107
PAGO FOREST: TOWER DEFENSE	2020-10-13	4	73	6	10	0.8107
RollerCoaster Tycoon® 3: Complete Edition	2020-09-24	447	1191	210	657	0.8106
Hypergalactic Psychic Table Tennis 3000	2020-03-03	19	114	12	31	0.8106
Relow	2020-02-26	14	80	7	21	0.8105
Murder by Numbers	2020-03-06	664	1102	193	857	0.8104000000000001
Hello Guest: Hello Neighbor 2 pre-alpha	2020-12-22	112	335	49	161	0.8104000000000001
スペースチャンネル5VR あらかた★ダンシングショー	2020-12-09	12	58	4	16	0.8104000000000001
A Place, Forbidden	2020-06-25	17	266	37	54	0.8103
Ultra Hat Dimension	2020-07-16	3	24	0	3	0.8103
Terraforming Earth	2020-08-28	4	24	0	4	0.8103
Viking Heroes	2020-04-16	15	24	0	15	0.8103
ISOLAND: The Amusement Park	2020-10-15	24	42	2	26	0.81
Pummel Paladins	2020-09-18	15	42	2	17	0.81
Mrs. Santa's Gift Hunt	2020-11-30	9	42	2	11	0.81
Dark Fracture: Prologue	2020-08-25	149	974	169	318	0.8099
Epic Conquest 2	2020-04-20	25	288	41	66	0.8099
MazM: Jekyll and Hyde	2020-04-02	11	86	8	19	0.8096
The Unfinished Swan	2020-09-10	121	992	173	294	0.8095
MOTHER	2020-08-27	14	264	37	51	0.8095
A Hand With Many Fingers	2020-06-09	15	205	27	42	0.8093000000000001
Intrepid Izzy	2020-07-26	4	33	1	5	0.8092
Midsummer Night	2020-05-05	4	33	1	5	0.8092
Welcome to Elk: The first stories	2020-07-10	12	33	1	13	0.8092
The Last Bug	2020-09-09	14	33	1	15	0.8092
Brimstone Brawlers	2020-05-20	35	144	17	52	0.8090999999999999
My Harem	2020-03-11	7	99	10	17	0.8090999999999999
State of Decay 2	2020-03-13	22728	35116	7606	30334	0.809
Rushdown Revolt	2020-09-10	378	1164	208	586	0.8088
Estigma [Steam Edition]	2020-12-23	9	131	15	24	0.8088
Chionophile	2020-10-23	7	137	16	23	0.8086
Before I Forget	2020-07-16	10	105	11	21	0.8086
Happy New Year, Zeliria!	2020-12-25	7	85	8	15	0.8085
Freddy Spaghetti	2020-04-01	6	49	3	9	0.8084
Faefever	2020-07-24	25	340	51	76	0.8083
General Horse and the Package of Doom	2020-06-23	6	41	2	8	0.8083
I dream of you and ice cream	2020-06-24	5	41	2	7	0.8083
Poop On 2020 Simulator	2020-11-25	3	41	2	5	0.8083
Mars Horizon	2020-11-17	2525	2096	398	2923	0.8081
Struggling	2020-08-27	142	508	82	224	0.8081
Lapso: Nimbo	2020-08-01	13	111	12	25	0.8081
Furry Love	2020-07-10	2444	5127	1035	3479	0.8079999999999999
きりたんvsカニたん -ずんだもちを防衛せよ！-	2020-02-13	13	23	0	13	0.8079000000000001
Try again!	2020-01-03	2	23	0	2	0.8079000000000001
BitVault	2020-03-25	4	23	0	4	0.8079000000000001
Xenogunner	2020-04-01	5	23	0	5	0.8079000000000001
Xoo: Xeno Xafari	2020-08-07	4	23	0	4	0.8079000000000001
Neon Cyborg Cat Club	2020-09-10	3	23	0	3	0.8079000000000001
UpWakeNing	2020-11-12	3	23	0	3	0.8079000000000001
Gloomy Eyes	2020-03-11	5	142	17	22	0.8078000000000001
Shieldmaiden	2020-03-13	58	148	18	76	0.8077
RISK: Global Domination	2020-02-19	11716	25236	5474	17190	0.8074
POPULATION: ONE	2020-10-22	545	1986	378	923	0.8073
Ballistic Craft	2020-02-13	134	63	5	139	0.8073
Towaga: Among Shadows	2020-07-14	8	70	6	14	0.8072
Battle Engine Aquila	2020-09-04	8	70	6	14	0.8072
Horror Globes	2020-10-31	6	70	6	12	0.8072
Super Hiking League	2020-02-18	4	32	1	5	0.8072
View From Below	2020-05-22	4	32	1	5	0.8072
180 Files: The Aegis Project	2020-07-09	34	32	1	35	0.8072
Hi-Score Boi	2020-07-14	4	32	1	5	0.8072
Lost Remnant: The End Tides	2020-08-24	8	32	1	9	0.8072
东方幻灵录~Touhou Hakanai Cards	2020-05-21	245	598	100	345	0.8070999999999999
RITE	2020-07-06	21	235	33	54	0.8069
Hayfever	2020-02-25	9	48	3	12	0.8069
Shadow Walls	2020-10-22	11	48	3	14	0.8069
谁说奶妈不能拯救世界！	2020-09-25	13	48	3	16	0.8069
Fight of Animals: Arena	2020-12-17	16	48	3	19	0.8069
Kosmokrats	2020-11-05	19	90	9	28	0.8068000000000001
Fall Guys	2020-08-04	172213	385526	88757	260970	0.8067000000000001
Partisans 1941	2020-10-14	3061	5336	1091	4152	0.8067000000000001
Black Skylands: Origins	2020-04-30	188	486	79	267	0.8067000000000001
Metamorphosis	2020-08-12	79	405	64	143	0.8065000000000001
Arrog	2020-07-28	8	134	16	24	0.8065000000000001
The Witch & The 66 Mushrooms	2020-11-07	20	146	18	38	0.8063
Atelier Shallie: Alchemists of the Dusk Sea DX	2020-01-14	51	146	18	69	0.8063
Drill Deal: Borehole Alpha	2020-08-10	148	317	48	196	0.8062
Soulcaster	2020-09-01	15	55	4	19	0.8062
Submarine Titans	2020-03-18	18	216	30	48	0.8061
JEF	2020-02-28	5	69	6	11	0.8059999999999999
Heavy Rain	2020-06-18	747	7568	1585	2332	0.8059000000000001
A Gay Love Story About Gay Love	2020-09-14	17	403	64	81	0.8059000000000001
Wicked Willow	2020-06-02	15	62	5	20	0.8059000000000001
Bloody Rally Show: Prologue	2020-10-13	18	62	5	23	0.8059000000000001
Enamored Risks	2020-04-27	46	133	16	62	0.8057
Fates of Ort	2020-03-31	26	108	12	38	0.8056000000000001
Quest 4 Papa	2020-06-03	11	82	8	19	0.8054000000000001
Wibbly Witches	2020-10-20	7	22	0	7	0.8054000000000001
Knight Bewitched 2	2020-08-10	9	22	0	9	0.8054000000000001
Charge Kid	2020-06-30	5	22	0	5	0.8054000000000001
宵闇ノ影	2020-08-26	3	22	0	3	0.8054000000000001
Arcanbreak	2020-10-30	50	22	0	50	0.8054000000000001
NYANCO MINE	2020-10-15	3	22	0	3	0.8054000000000001
ILY	2020-07-16	5	47	3	8	0.8053
Hentai vs Virus: I Am Waifu	2020-05-14	1072	276	41	1113	0.8052
Sea of Solitude	2020-06-04	81	1394	262	343	0.8051
剑为君舞 百夜缀	2020-12-16	81	126	15	96	0.8051
The Tale of Doris and the Dragon - Episode 2	2020-02-07	8	31	1	9	0.8051
TaniNani	2020-01-23	7	31	1	8	0.8051
Kirakira stars project Nagisa	2020-06-19	6	31	1	7	0.8051
狂潮-Staggering Through The Dark	2020-11-19	4	31	1	5	0.8051
Unravel Two	2020-06-04	951	3760	763	1714	0.805
Prophecy	2020-06-03	559	357	56	615	0.805
Another Brick in The Mall	2020-04-30	631	1777	342	973	0.8048000000000001
进击的哥布林	2020-06-15	13	39	2	15	0.8048000000000001
THE ART - Metamorphosis	2020-01-04	5	68	6	11	0.8047
Raji: An Ancient Epic	2020-10-15	219	1592	304	523	0.8046
Missing Children | 行方不明	2020-06-13	81	318	49	130	0.8046
Darkanoid	2020-11-30	490	61	5	495	0.8046
Autumn and Girls	2020-10-20	5	61	5	10	0.8046
Age of Empires III: Definitive Edition	2020-10-15	20146	26756	5936	26082	0.8045
Almost My Floor: Prologue	2020-10-05	14	113	13	27	0.8045
Blackwake	2020-02-19	6159	19815	4357	10516	0.8044
Starship EVO	2020-06-19	193	711	125	318	0.8043000000000001
Anime Feet	2020-09-04	18	481	80	98	0.8043000000000001
Drink More Glurp	2020-08-06	59	143	18	77	0.8043000000000001
Tony Stewart's Sprint Car Racing	2020-02-21	115	178	24	139	0.8042
ZomDay	2020-03-27	56	690	121	177	0.8041
BarnFinders	2020-06-15	3069	2929	591	3660	0.8037000000000001
Sakura Succubus 3	2020-11-02	37	177	24	61	0.8036
Signs of the Sojourner	2020-05-14	29	142	18	47	0.8036
Raiders Of The Lost Island	2020-09-02	18	46	3	21	0.8036
Endless Knight	2020-01-01	7	46	3	10	0.8036
Forest Guardian	2020-03-30	8	46	3	11	0.8036
Cursed Gem	2020-08-03	9	46	3	12	0.8036
Mr. Prepper: Prologue	2020-08-27	1089	2005	394	1483	0.8035
Hello Neighbor 2 Alpha 1	2020-12-29	143	410	67	210	0.8034
Sword of the Necromancer - Prologue	2020-11-03	75	244	36	111	0.8034
Oik Reloaded	2020-06-25	5	67	6	11	0.8034
Azure	2020-05-25	7	53	4	11	0.8031999999999999
Crazy Kung Fu	2020-09-25	4	53	4	8	0.8031999999999999
iVIBRATE Ultimate Edition	2020-12-11	15	53	4	19	0.8031999999999999
ABYSS OF THE SACRIFICE	2020-12-16	62	176	24	86	0.8029999999999999
10mg: Always Down	2020-10-16	2	30	1	3	0.8029999999999999
BalloonBoyBob	2020-02-09	7	30	1	8	0.8029999999999999
HoneyLand	2020-10-19	4	30	1	5	0.8029999999999999
Monster Girls and the Mysterious Adventure	2020-03-20	136	105	12	148	0.8029000000000001
Tidal Shock	2020-05-04	20	38	2	22	0.8029000000000001
Lenna's Inception	2020-01-17	96	170	23	119	0.8028000000000001
Find the Letter H	2020-08-11	3	21	0	3	0.8028000000000001
The Pale City	2020-03-20	3	21	0	3	0.8028000000000001
BustaShip	2020-06-18	4	21	0	4	0.8028000000000001
Minimalist Space War	2020-04-21	3	21	0	3	0.8028000000000001
The Adventures of Crackhead Jack: Overdose Edition	2020-10-22	5	21	0	5	0.8028000000000001
Gurobu	2020-08-14	4	21	0	4	0.8028000000000001
Game Of Puzzles: Slavic Mythology	2020-08-27	2	21	0	2	0.8028000000000001
dstnce.	2020-12-15	3	21	0	3	0.8028000000000001
Output Pasture	2020-03-25	21	73	7	28	0.8026000000000001
Through The Darkest of Times	2020-01-30	344	780	141	485	0.8025
Island Saga	2020-05-19	174	242	36	210	0.8025
GWENT: The Witcher Card Game	2020-05-19	7504	21542	4818	12322	0.8024
Kinoko	2020-07-24	40	838	153	193	0.8023
Panzer Corps 2	2020-03-19	3480	2475	500	3980	0.8020999999999999
IIslands of War	2020-03-13	57	104	12	69	0.802
Granblue Fantasy: Versus	2020-03-13	5287	5364	1138	6425	0.8019
100 hidden aliens	2020-12-20	6	257	39	45	0.8019
Carrier Battles 4 Guadalcanal	2020-06-05	35	191	27	62	0.8019
Mask of the Plague Doctor	2020-04-23	44	45	3	47	0.8019
Bikes and Girls	2020-10-26	7	45	3	10	0.8019
Teacher Lady	2020-02-21	5	59	5	10	0.8018000000000001
Crimson Spires	2020-10-27	24	59	5	29	0.8018000000000001
KARDS - The WWII Card Game	2020-04-15	2918	21385	4805	7723	0.8017000000000001
TechnoTsunami	2020-10-29	9	52	4	13	0.8017000000000001
Lighton	2020-06-18	4	52	4	8	0.8017000000000001
PowerBeatsVR	2020-11-18	35	383	63	98	0.8016
Shiro	2020-11-06	11	251	38	49	0.8016
Airborn	2020-07-24	16	85	9	25	0.8016
Pro Gymnast	2020-09-04	28	85	9	37	0.8016
Time Warpers	2020-01-16	280	434	73	353	0.8014
Paper Ghost Stories: 7PM	2020-09-02	38	72	7	45	0.8014
Gordian Rooms: A curious heritage Prologue	2020-09-18	18	91	10	28	0.8013
Fantasy Grounds Unity	2020-11-05	474	504	87	561	0.8012
Mister Versatile: A Gay Superhero Visual Novel	2020-10-16	73	109	13	86	0.8009999999999999
Order Of The Gatekeepers	2020-02-06	11	37	2	13	0.8009000000000001
Sixth Night	2020-02-20	3	37	2	5	0.8009000000000001
Amy's Greenmart	2020-05-11	25	37	2	27	0.8009000000000001
Eye, caramba!	2020-12-23	13	37	2	15	0.8009000000000001
Crypt Stalker	2020-10-30	8	65	6	14	0.8008
非常魔王(Beelzebub)	2020-09-18	10	65	6	16	0.8008
#AkiRobots	2020-12-04	6	29	1	7	0.8007
Fires At Midnight	2020-07-09	4	29	1	5	0.8007
Slimes	2020-06-12	3	29	1	4	0.8007
Golf On Mars	2020-07-03	10	29	1	11	0.8007
Fingers: Mini Games	2020-07-04	4	29	1	5	0.8007
Elephantasy	2020-12-07	3	29	1	4	0.8007
客栈传说	2020-08-14	136	216	32	168	0.8005
SUCCUBUS: Prologue	2020-07-24	643	4304	912	1555	0.8004000000000001
Don't Be Afraid	2020-12-17	74	374	62	136	0.8004000000000001
Bunny Hill	2020-10-23	14	58	5	19	0.8004000000000001
Adventures of Chris	2020-10-08	12	120	15	27	0.8003
The Shattering	2020-04-21	52	199	29	81	0.8002
Puzzle - LINES AND KNOTS	2020-03-05	45	199	29	74	0.8002
她3 : 复乐园之曦 Her3 : The Light of Paradise Regained	2020-04-25	7	44	3	10	0.8002
Runaway Demon Bride	2020-03-27	9	44	3	12	0.8002
Dark Stone: The Lightseeker	2020-10-09	8	44	3	11	0.8002
ココロクローバー パート１/Kokoro Clover Part1	2020-07-04	9	71	7	16	0.8001
Cymatically Muffed	2020-06-03	7	20	0	7	0.8
Mini Island: Night	2020-01-01	3	20	0	3	0.8
xDasher	2020-10-14	6	20	0	6	0.8
Hunting Unlimited 3	2020-11-06	5	20	0	5	0.8
Moirs	2020-06-30	6	20	0	6	0.8
Demonic Blade	2020-06-17	3	20	0	3	0.8
Flying Slime	2020-08-20	8	20	0	8	0.8
Jumpala: Tryouts Edition	2020-09-03	8	20	0	8	0.8
Bunny Hop	2020-12-30	3	20	0	3	0.8
Uranus	2020-12-07	2	20	0	2	0.8
The Under Presents	2020-04-16	15	77	8	23	0.7997
Nino Maze LOFI	2020-06-23	5	77	8	13	0.7997
Mini Motor Racing X	2020-06-23	18	225	34	52	0.7996
Knock on the Coffin Lid	2020-04-08	68	507	89	157	0.7995000000000001
The Morrigan	2020-03-31	12	214	32	44	0.7995000000000001
Geisha World	2020-04-25	3	64	6	9	0.7995000000000001
Shaolin vs Wutang 2	2020-03-09	14	293	47	61	0.7992
Ashina: The Red Witch: Prologue	2020-07-17	380	153	21	401	0.7992
Cubiscape 2	2020-11-02	44	101	12	56	0.7992
Necrobarista	2020-07-22	290	988	189	479	0.799
Core Defense: Prelude	2020-03-20	27	186	27	54	0.799
Antarctica 88	2020-08-12	8	130	17	25	0.799
Radio General	2020-04-09	190	354	59	249	0.7989
Strategic Mind: Blitzkrieg	2020-05-22	182	354	59	241	0.7989
RaidTitans	2020-02-06	37	70	7	44	0.7989
My Little Prince - a jigsaw puzzle tale	2020-09-16	13	57	5	18	0.7989
Viktor Crysworth	2020-05-20	9	36	2	11	0.7989
Lufulus' Creatures	2020-05-04	4	36	2	6	0.7989
Werewolves 2: Pack Mentality	2020-07-23	48	36	2	50	0.7989
Jumping Joe	2020-05-08	18	36	2	20	0.7989
Kelipot / 形骸骑士	2020-11-04	442	635	116	558	0.7985
Vectromirror 0	2020-07-02	30	373	63	93	0.7985
Russia RogueLike	2020-06-17	7	76	8	15	0.7985
Pirates Outlaws	2020-04-14	255	478	84	339	0.7984
Prison Princess	2020-04-02	165	228	35	200	0.7984
Kozue's Strange Journey	2020-08-07	226	163	23	249	0.7984
HyperBrawl Tournament	2020-10-20	69	135	18	87	0.7984
SOK PRO	2020-10-13	7	50	4	11	0.7984
画师	2020-11-26	64	233	36	100	0.7983
Project:Pong	2020-08-28	5	43	3	8	0.7983
Sisters Royale: Five Sisters Under Fire	2020-11-26	8	28	1	9	0.7983
Seduce Me: The Complete Story	2020-03-27	9	28	1	10	0.7983
Fill all	2020-05-01	4	28	1	5	0.7983
Portable Farm	2020-11-02	5	28	1	6	0.7983
Eggnog Incorporated	2020-12-29	4	28	1	5	0.7983
VirtuaVerse	2020-05-12	264	797	150	414	0.7981999999999999
Gatewalkers (Alpha)	2020-06-25	254	672	124	378	0.7981999999999999
Escape to Moscow	2020-12-15	10	316	52	62	0.7981999999999999
Founders' Fortune	2020-12-18	863	1486	298	1161	0.798
Green Project	2020-05-16	407	952	183	590	0.798
Ball at Work	2020-11-24	146	351	59	205	0.7979
Destropolis	2020-08-19	14	140	19	33	0.7979
KingSim	2020-05-28	121	151	21	142	0.7978000000000001
Space Simulation Toolkit	2020-06-05	13	69	7	20	0.7976000000000001
Colossus Down	2020-12-16	12	69	7	19	0.7976000000000001
Lombardi's World	2020-12-07	68	69	7	75	0.7976000000000001
Space Gladiators: The Hole	2020-11-12	17	75	8	25	0.7973
Into A Dream	2020-07-30	11	56	5	16	0.7973
Paper Pirates	2020-02-28	28	87	10	38	0.7970999999999999
OPERATION SERPENS	2020-07-22	6	87	10	16	0.7970999999999999
Insurgence - Second Assault	2020-02-27	5	19	0	5	0.7970999999999999
Chuusotsu! 1.5th Graduation: The Moving Castle	2020-01-17	4	19	0	4	0.7970999999999999
Pussy Puzzle	2020-06-09	4	19	0	4	0.7970999999999999
Shmup Arena	2020-05-17	2	19	0	2	0.7970999999999999
Elemental Abyss	2020-05-27	5	19	0	5	0.7970999999999999
Captain Disaster in: Death Has A Million Stomping Boots	2020-05-29	4	19	0	4	0.7970999999999999
Wanderlust: Bangkok Prelude	2020-05-28	4	19	0	4	0.7970999999999999
Neko Ghost, Jump! Prologue	2020-07-14	8	19	0	8	0.7970999999999999
Speedgunner Ultra	2020-08-14	5	19	0	5	0.7970999999999999
Rad Rocket	2020-09-12	2	19	0	2	0.7970999999999999
Hermes: Sibyls' Prophecy	2020-09-10	14	19	0	14	0.7970999999999999
Bunny's Trail	2020-11-18	5	19	0	5	0.7970999999999999
8 Bit Space	2020-11-07	3	19	0	3	0.7970999999999999
Eternal Hope	2020-08-20	24	204	31	55	0.797
Verdant Village	2020-08-04	12	49	4	16	0.7968000000000001
Black Chapter	2020-10-24	7	49	4	11	0.7968000000000001
Nullum	2020-05-08	4	35	2	6	0.7968000000000001
Sokpop S06: fishy	2020-01-17	176	240	38	214	0.7966
Werewolf: The Apocalypse - Heart of the Forest	2020-10-13	304	668	125	429	0.7965000000000001
Bamerang: Warm-Up Duel	2020-08-12	9	42	3	12	0.7965000000000001
三国群英传5	2020-11-13	176	138	19	195	0.7964
Darwin Project	2020-01-14	12513	15052	3473	15986	0.7963
Othercide	2020-07-27	1696	3109	667	2363	0.7963
Public Defense Corp	2020-12-05	354	234	37	391	0.7962
Democratic Socialism Simulator	2020-03-19	8	68	7	15	0.7962
Flying Sword	2020-02-12	6	92	11	17	0.7961
Ghosts'n DJs	2020-02-06	19	115	15	34	0.7959999999999999
Train Station Renovation	2020-10-01	1921	1952	407	2328	0.7959
Tennis Fighters	2020-01-02	3	27	1	4	0.7958
Bombing Quest	2020-03-04	5	27	1	6	0.7958
There Was the Moon	2020-07-24	4	27	1	5	0.7958
Shooting Arena VR	2020-07-21	10	27	1	11	0.7958
Cellular Harvest	2020-08-25	2	27	1	3	0.7958
Spare Parts: Episode 1	2020-12-17	3	27	1	4	0.7958
Mahou Arms	2020-04-28	103	394	69	172	0.7957
Mad Tracks	2020-03-10	20	137	19	39	0.7957
Related	2020-05-14	12	126	17	29	0.7957
Rekt: Crash Test 	2020-12-03	92	472	85	177	0.7956000000000001
Metaphobia	2020-02-10	51	344	59	110	0.7955
OctoFurry	2020-01-31	10	120	16	26	0.7954000000000001
Bomb Bots Arena	2020-06-01	111	519	95	206	0.7953
Hentai Police	2020-01-17	2175	1715	356	2531	0.7952
Colormeleons	2020-05-11	107	61	6	113	0.7952
BOT.vinnik Chess: Winning Patterns	2020-09-30	14	61	6	20	0.7952
Mars Power Industries: First Job	2020-06-09	6	48	4	10	0.795
Tombo Survivor	2020-12-25	6	48	4	10	0.795
Hero Allstars: Void Invasion	2020-11-13	10	67	7	17	0.7948999999999999
Empyrion - Galactic Survival	2020-08-05	8829	23845	5641	14470	0.7948000000000001
Solitaire Forever II	2020-05-06	77	163	24	101	0.7948000000000001
Savage Halloween	2020-10-26	10	85	10	20	0.7948000000000001
Shine's Adventures 5(World Of Box)	2020-07-10	7	34	2	9	0.7946
The Crimson Diamond: Chapter 1	2020-02-24	4	34	2	6	0.7946
System Invaders	2020-03-27	4	34	2	6	0.7946
Warlock Bentspine	2020-10-28	5	34	2	7	0.7946
Wizards and Warlords	2020-09-25	83	189	29	112	0.7945000000000001
Run Dude	2020-01-24	8	41	3	11	0.7945000000000001
Cyber Lady	2020-03-17	9	113	15	24	0.7942
Lockdown Lewd UP!	2020-09-25	23	54	5	28	0.7942
Train Sim World® 2	2020-08-20	3086	6279	1421	4507	0.7941
Spark & Sparkle	2020-04-16	5	18	0	5	0.7939
ScribbleDude	2020-01-31	7	18	0	7	0.7939
Pair-a-Site	2020-02-06	2	18	0	2	0.7939
Inside The Computer	2020-03-04	3	18	0	3	0.7939
LightBall	2020-04-30	2	18	0	2	0.7939
The Spectre Files: Deathstalker	2020-10-27	6	18	0	6	0.7939
ギセイヒーロー	2020-09-30	4	18	0	4	0.7939
Barry the Bunny	2020-10-15	2	18	0	2	0.7939
Ekstase	2020-10-01	3	18	0	3	0.7939
Hoards of Glory	2020-11-05	7	18	0	7	0.7939
Ruby Heart	2020-11-19	2	18	0	2	0.7939
Yu-Gi-Oh! Legacy of the Duelist : Link Evolution	2020-03-24	1237	2860	622	1859	0.7938
Combat Mission Shock Force 2	2020-08-31	242	545	102	344	0.7936
SUPER DRINK BROS	2020-11-13	108	177	27	135	0.7936
The Night Fisherman	2020-06-29	26	662	127	153	0.7935
Anime Artist 2: Lovely Danya	2020-02-24	108	72	8	116	0.7935
Rock and Girls	2020-04-22	4	72	8	12	0.7935
Hard Times	2020-03-30	35	66	7	42	0.7935
Fuhrer in LA - Special Edition	2020-08-26	3	66	7	10	0.7935
Succumate	2020-11-21	446	619	118	564	0.7933
Jerking Off In Class Simulator	2020-02-27	8	112	15	23	0.7933
STAYHOMER	2020-06-30	4	47	4	8	0.7931999999999999
SMUSH.TV - Competitive VR x PC Action	2020-02-27	9	26	1	10	0.7931999999999999
Pillars of Dust	2020-03-17	10	26	1	11	0.7931999999999999
Scraper: Gauntlet	2020-02-20	6	26	1	7	0.7931999999999999
ExtraGalactica	2020-02-28	5	26	1	6	0.7931999999999999
Daedaluz	2020-07-12	9	26	1	10	0.7931999999999999
Iwate Mountain Dance	2020-05-01	4	26	1	5	0.7931999999999999
Dude, Where Is My Beer?	2020-11-04	29	95	12	41	0.7931
Peaceful Days	2020-02-03	17	155	23	40	0.793
Self-Isolation	2020-12-02	23	390	70	93	0.7929
Duck Life: Retro Pack	2020-10-26	11	128	18	29	0.7928000000000001
Guilt Free	2020-10-02	22	191	30	52	0.7926000000000001
Beam	2020-09-29	9	53	5	14	0.7925
Boxman's Struggle	2020-02-27	64	211	34	98	0.7924
Barbarous: Tavern Of Emyr	2020-02-27	12	33	2	14	0.7923
Canvas Hockey	2020-08-05	4	33	2	6	0.7923
I Am Dead	2020-10-08	44	241	40	84	0.7922
Overcrowd: A Commute 'Em Up	2020-10-06	808	1236	256	1064	0.792
DungeonTop	2020-06-21	270	425	78	348	0.7919
Unferat	2020-06-01	8	116	16	24	0.7919
Lisa's Memory - 丽莎的记忆	2020-06-26	122	255	43	165	0.7918000000000001
Startup Company	2020-04-10	1984	4648	1055	3039	0.7917000000000001
Monster Girl Incursion	2020-12-19	9	46	4	13	0.7914
三国群英传7	2020-11-13	2214	1863	401	2615	0.7913
Sakura Succubus	2020-03-31	47	469	88	135	0.7911
Chupa Chupa VR	2020-08-15	16	93	12	28	0.7909999999999999
Life with Mary	2020-11-10	15	76	9	24	0.7909999999999999
Vaporum: Lockdown	2020-09-15	100	198	32	132	0.7908
Montezuma's Revenge	2020-10-13	5	52	5	10	0.7908
Sword x Hime	2020-09-28	442	1425	302	744	0.7907
OBEY	2020-05-12	106	364	66	172	0.7907
GrowRilla	2020-07-09	8	64	7	15	0.7906000000000001
Absolute Alchemical Potion	2020-09-28	15	64	7	22	0.7906000000000001
NEAR DEADline	2020-08-12	12	64	7	19	0.7906000000000001
Disc Space	2020-11-13	194	439	82	276	0.7905
TARS	2020-08-05	3	17	0	3	0.7905
Chapeau	2020-03-31	4	17	0	4	0.7905
Pentasma	2020-01-31	3	17	0	3	0.7905
Proyecto Flamingo X1	2020-05-26	4	17	0	4	0.7905
Tobari 2: Dream Ocean	2020-07-17	6	17	0	6	0.7905
String Tyrant	2020-06-04	3	17	0	3	0.7905
Shatris: Infinite Puzzles	2020-12-18	3	17	0	3	0.7905
Arabel	2020-08-17	3	17	0	3	0.7905
My Jigsaw Adventures - The Source of Power	2020-09-16	5	17	0	5	0.7905
Jetscout: Mystery of the Valunians	2020-12-16	3	17	0	3	0.7905
Minimum Wage	2020-09-24	3	17	0	3	0.7905
Coloree	2020-12-18	3	17	0	3	0.7905
Re-Nullum	2020-12-16	3	17	0	3	0.7905
MeyRescuer	2020-12-25	4	17	0	4	0.7905
Anno 1404 - History Edition	2020-06-25	1177	1540	329	1506	0.7904000000000001
Imperiums: Greek Wars	2020-07-30	155	344	62	217	0.7904000000000001
ExoCorps	2020-10-09	10	39	3	13	0.7904000000000001
Planet Stronghold 2	2020-03-31	31	39	3	34	0.7904000000000001
Impossible Soaring	2020-01-29	15	25	1	16	0.7904000000000001
Sokpop S04: Penguin Park 3D	2020-01-17	3	25	1	4	0.7904000000000001
Lab 7: Cold Nights	2020-05-06	20	25	1	21	0.7904000000000001
Game Of Puzzles: Dinosaurs	2020-05-07	2	25	1	3	0.7904000000000001
School of Magic Prologue	2020-08-31	30	25	1	31	0.7904000000000001
Earth Attack	2020-09-15	3	25	1	4	0.7904000000000001
Reimu's Weird little advanture	2020-12-29	2	25	1	3	0.7904000000000001
Magic Potion Millionaire	2020-12-29	16	25	1	17	0.7904000000000001
Lost Astronaut	2020-12-11	4	25	1	5	0.7904000000000001
Batbarian: Testament of the Primordials	2020-10-15	36	182	29	65	0.7903
Soviet Jump Game	2020-07-16	1910	1184	248	2158	0.7902
A Town Uncovered	2020-10-16	75	187	30	105	0.7902
Muv-Luv photonmelodies♮	2020-07-30	86	151	23	109	0.7901
RIDE 4	2020-10-08	2898	6831	1598	4496	0.79
PocketCars	2020-01-10	10	92	12	22	0.7898999999999999
Wavey The Rocket	2020-05-07	13	32	2	15	0.7898999999999999
Flinger Tactics	2020-01-03	7	32	2	9	0.7898999999999999
The Golem	2020-09-10	7	32	2	9	0.7898999999999999
Jigsaw Puzzle Animals	2020-08-01	7	32	2	9	0.7898999999999999
Children of Belgrade Metro	2020-09-11	23	32	2	25	0.7898999999999999
Wattam	2020-12-18	57	328	59	116	0.7898000000000001
Adventure Escape Mysteries	2020-05-05	145	342	62	207	0.7897
Sword of Destiny	2020-11-20	14	124	18	32	0.7895000000000001
Evergreen Blues	2020-02-20	4	45	4	8	0.7895000000000001
Viking Chess: Hnefatafl	2020-03-05	11	45	4	15	0.7895000000000001
Oneteam Soccer	2020-07-23	11	45	4	15	0.7895000000000001
Nightmare Puppeteer	2020-09-22	6	45	4	10	0.7895000000000001
Valgrave: Immortal Plains	2020-02-07	168	767	155	323	0.7894
Inertial Drift Sunset Prologue	2020-06-23	52	393	73	125	0.7894
TENGAI	2020-06-22	19	69	8	27	0.7894
Chinatown Detective Agency: Day One	2020-10-02	32	155	24	56	0.7893000000000001
Craftopia	2020-09-04	27246	13316	3216	30462	0.7891
Interrogation Files: Port Landsend	2020-06-19	7	63	7	14	0.7891
Steampunk Genius	2020-03-03	15	57	6	21	0.789
Hentai Fantasy	2020-05-21	4	57	6	10	0.789
Firefighting Simulator - The Squad	2020-11-17	2606	3370	768	3374	0.7888
Covid Tale: Ignorance	2020-06-01	13	118	17	30	0.7888
Zero Hour	2020-08-12	4288	20041	4917	9205	0.7886
Wildfire	2020-05-26	193	587	116	309	0.7885
The Librarian	2020-08-13	4	74	9	13	0.7884000000000001
听见我的心	2020-06-20	9	38	3	12	0.7883
Spooky Chase	2020-10-23	6	38	3	9	0.7883
Stream Arenas	2020-09-01	15	38	3	18	0.7883
ANIME WAR — Modern Campaign	2020-05-28	12	370	69	81	0.788
Frog Bath	2020-06-09	30	188	31	61	0.7878000000000001
Heal	2020-04-10	26	360	67	93	0.7877
The Cassir Simulator	2020-09-28	5	62	7	12	0.7876000000000001
Edge of Dreams	2020-06-08	4	24	1	5	0.7875
Ballsy! World Cup 2020	2020-10-28	5	24	1	6	0.7875
Self-Checkout Unlimited	2020-10-01	7	56	6	13	0.7874
Weapon Hacker	2020-06-08	5	31	2	7	0.7874
Super Lobster Run	2020-04-30	5	31	2	7	0.7874
Magic of Autumn	2020-02-17	4	31	2	6	0.7874
Dustoff Z	2020-10-15	5	31	2	7	0.7874
Jumping Jax	2020-11-16	8	31	2	10	0.7874
Wings Of Bluestar	2020-10-13	7	50	5	12	0.7873000000000001
Forkdrift	2020-07-31	48	523	103	151	0.7872
Yu Escape / Monday	2020-05-01	86	386	73	159	0.7870999999999999
The MoneyMakers Rallye	2020-12-04	21	73	9	30	0.7870999999999999
Ministry of Broadcast	2020-01-30	49	325	60	109	0.7869
Toon Shooters 2: The Freelancers	2020-12-14	7	16	0	7	0.7869
PaymoneyWubby: The Game	2020-11-10	6	16	0	6	0.7869
Outpost On Syrinx	2020-04-30	5	16	0	5	0.7869
Sneak In	2020-10-15	5	16	0	5	0.7869
The Tawashi	2020-01-21	4	16	0	4	0.7869
Cattle Admission Challenge	2020-01-06	3	16	0	3	0.7869
A.R.M.: Absolutely Reliable Machine	2020-12-03	4	16	0	4	0.7869
Geezer Gus: The Meteorite Motel	2020-04-07	2	16	0	2	0.7869
Up until the end	2020-05-22	3	16	0	3	0.7869
Deadly Way	2020-07-30	2	16	0	2	0.7869
Fake Illusions	2020-08-20	3	16	0	3	0.7869
Rogue Aces Deluxe	2020-10-16	4	16	0	4	0.7869
The Adventures of Wolf and Hood - A Jigsaw Tale	2020-12-12	3	16	0	3	0.7869
Ghosty	2020-10-30	26	16	0	26	0.7869
Slime Pandemic TD	2020-10-07	5	16	0	5	0.7869
10mg: SNAAAK	2020-10-20	3	16	0	3	0.7869
Eternal Dungeon	2020-10-24	4	16	0	4	0.7869
Lust from Beyond: Scarlet	2020-10-15	341	1072	229	570	0.7866
Hentai vs Evil: Back 4 Waifus	2020-10-06	12	89	12	24	0.7865000000000001
Air Attack	2020-10-01	12	67	8	20	0.7865000000000001
Dragon Age II	2020-06-04	814	2795	641	1455	0.7864
SiN Gold	2020-03-18	51	258	46	97	0.7864
Sector's Edge	2020-10-31	1645	2498	570	2215	0.7862
Unsung Kingdom	2020-07-04	38	61	7	45	0.7861
墲人之境：探索	2020-04-24	1399	1365	299	1698	0.7859999999999999
G String	2020-10-16	112	607	123	235	0.7859999999999999
Defense of the Oasis	2020-08-26	8	37	3	11	0.7859999999999999
Flatland: Prologue	2020-03-31	9	37	3	12	0.7859999999999999
Rogue Party 2	2020-06-15	7	37	3	10	0.7859999999999999
LA FORET DE PAGO : LA VENGEANCE DU DRAGON	2020-09-24	4	37	3	7	0.7859999999999999
Marble Age: Remastered	2020-11-03	87	214	37	124	0.7859
SPACE / MECH / PILOT	2020-10-13	162	313	58	220	0.7858
Terra Randoma	2020-12-17	36	83	11	47	0.7857
RoboSkate	2020-10-15	18	83	11	29	0.7857
SHUT IN	2020-10-30	14	72	9	23	0.7857
The Hunger: Games Ensemble	2020-11-03	5	55	6	11	0.7857
Yukikoi Melt	2020-04-30	34	55	6	40	0.7857
Eternower	2020-03-29	11	43	4	15	0.7855
RaiOhGar: Asuka and the King of Steel	2020-05-15	129	218	38	167	0.7854000000000001
Holodance	2020-02-28	18	184	31	49	0.7853
WHO IS AWESOME	2020-02-12	9	88	12	21	0.7853
MisBits	2020-03-05	323	412	80	403	0.7852
Sex with Stalin	2020-10-26	1898	1866	421	2319	0.7851
Minesweeper: Collector	2020-09-15	12	66	8	20	0.7851
Happy Quest	2020-11-06	355	651	134	489	0.785
Void's Calling ep. 1	2020-05-29	299	523	105	404	0.785
Eternal Radiance	2020-12-15	130	375	72	202	0.785
Primal Light	2020-07-09	21	297	55	76	0.785
Kandagawa Jet Girls	2020-08-25	84	241	43	127	0.785
Left on Read	2020-05-19	337	4074	964	1301	0.7848999999999999
The Almost Gone	2020-06-25	150	746	156	306	0.7848999999999999
Tallowmere 2: Curse of the Kittens	2020-12-04	197	264	48	245	0.7848
Whateverland: Prologue	2020-06-10	11	139	22	33	0.7848
Glitch's Trip	2020-08-26	5	30	2	7	0.7848
Plastris	2020-03-27	9	30	2	11	0.7848
Axe Girl	2020-09-25	9	30	2	11	0.7848
Nebula Within	2020-10-20	2	30	2	4	0.7848
Obsolete	2020-08-17	3	30	2	5	0.7848
10mg: Cover Me In Leaves	2020-10-15	2	30	2	4	0.7848
Life of Fly	2020-12-18	13	30	2	15	0.7848
Clay Game	2020-07-02	27	98	14	41	0.7846
Barro F	2020-02-28	1611	1077	234	1845	0.7845000000000001
Princesses Never Lose!	2020-03-20	428	319	60	488	0.7845000000000001
Adonis	2020-11-13	4	23	1	5	0.7844
The Equinox Hunt	2020-10-22	7	23	1	8	0.7844
Northern Tale 5: Revival	2020-04-07	18	23	1	19	0.7844
Fury Unleashed: Prologue	2020-03-30	36	23	1	37	0.7844
Yorna: Monster Girl's Secret	2020-09-18	24	23	1	25	0.7844
Cyber Protocol	2020-09-17	5	23	1	6	0.7844
100 vacas	2020-08-17	3	23	1	4	0.7844
Girabox	2020-08-28	5	23	1	6	0.7844
Chasing Tail	2020-11-07	8	23	1	9	0.7844
宥蘿的奇幻冒險 YURO'S FANTASY ADVENTURE	2020-11-11	3	23	1	4	0.7844
東方幻夢箋 ~ Touhou Phantasm Dream	2020-01-12	22	71	9	31	0.7843000000000001
Kill Yourself	2020-03-30	9	71	9	18	0.7843000000000001
Drop In - VR F2P	2020-05-27	33	458	91	124	0.7842
Resident Evil 3	2020-04-03	60293	53733	13903	74196	0.7841
Lawgivers	2020-04-02	43	295	55	98	0.7841
Grim Clicker	2020-01-09	1490	1748	396	1886	0.784
CAR TUNE: Project	2020-02-21	67	354	68	135	0.784
Chasing Light	2020-05-05	16	206	36	52	0.784
Pancake Sailor	2020-04-01	26	143	23	49	0.784
Тёмное отражение (Dark Reflection)	2020-01-13	5	54	6	11	0.784
Axegend VR	2020-03-09	9	54	6	15	0.784
ANIME - World War II	2020-01-13	1589	1119	245	1834	0.7839
The Political Machine 2020	2020-03-03	266	606	125	391	0.7837999999999999
Mommy	2020-01-27	5	92	13	18	0.7837999999999999
Puzzle - STONE BLOCKS	2020-12-22	19	92	13	32	0.7837999999999999
Grisaia Phantom Trigger Vol.7	2020-07-22	183	92	13	196	0.7837999999999999
Shadow Gangs	2020-04-10	7	36	3	10	0.7837000000000001
Gizmos: Steampunk Nonograms	2020-01-17	19	36	3	22	0.7837000000000001
Abracadabrew	2020-10-14	5	36	3	8	0.7837000000000001
Sokpop S01: dino game	2020-01-17	5	48	5	10	0.7836
Bullet Roulette VR	2020-09-10	38	384	75	113	0.7834000000000001
King of the Cul-De-Sac	2020-09-24	6	42	4	10	0.7834000000000001
Cruel Bands Career	2020-08-06	13	42	4	17	0.7834000000000001
Sly Slime	2020-09-22	5	42	4	9	0.7834000000000001
Rebirth:Mr Wang	2020-10-03	1812	2465	575	2387	0.7831
Bullet Girls Phantasia	2020-01-17	138	550	113	251	0.783
Powerslide	2020-07-03	3	15	0	3	0.783
Push Blox 2	2020-05-27	4	15	0	4	0.783
Bizarre Barber	2020-02-26	2	15	0	2	0.783
幸存者 星星之火	2020-05-15	2	15	0	2	0.783
Space Mouse 2	2020-07-23	6	15	0	6	0.783
The Harrowed	2020-05-15	6	15	0	6	0.783
Epicure	2020-05-17	4	15	0	4	0.783
Move 'n' Bloom	2020-10-12	2	15	0	2	0.783
Black Smith2	2020-08-14	8	15	0	8	0.783
Living the Nightmare	2020-09-08	3	15	0	3	0.783
On Pixels: A lights out game	2020-09-02	3	15	0	3	0.783
Medulla	2020-10-16	4	15	0	4	0.783
Save The Astronaut	2020-09-30	3	15	0	3	0.783
PAGO FOREST: DRAGON'S REVENGE	2020-10-27	1	15	0	1	0.783
Pandemos	2020-12-20	3	15	0	3	0.783
Routine Racers	2020-11-29	2	15	0	2	0.783
Puzzling Peaks EXE	2020-12-02	3	15	0	3	0.783
Christmas Stories: The Christmas Tree Forest Collector's Edition	2020-12-15	13	15	0	13	0.783
MiniMap Kingdom	2020-07-15	7	70	9	16	0.7829
Venineth	2020-04-16	28	156	26	54	0.7827
Die Again	2020-09-17	245	121	19	264	0.7822
Noda	2020-10-22	44	29	2	46	0.7820999999999999
Stealthscape	2020-10-20	8	29	2	10	0.7820999999999999
SPORTCON	2020-08-14	13	29	2	15	0.7820999999999999
Obey Me	2020-04-20	20	64	8	28	0.782
Garrison: Archangel	2020-05-15	129	193	34	163	0.7819
Need for Speed™ Hot Pursuit Remastered	2020-11-06	1228	5073	1240	2468	0.7818
Seeds of Chaos	2020-01-31	149	493	101	250	0.7817000000000001
Samozbor ID:HEAVEN	2020-03-20	3	47	5	8	0.7816
Kohate	2020-10-15	11	47	5	16	0.7816
그 어느 여름날의 이야기	2020-09-03	4	47	5	9	0.7816
Simple FPS Aim Trainer	2020-10-05	9	47	5	14	0.7816
BOT.vinnik Chess: Opening Traps	2020-12-22	8	47	5	13	0.7816
The Last of Waifus	2020-09-25	1135	1158	259	1394	0.7815000000000001
Iwaihime	2020-10-23	128	409	82	210	0.7815000000000001
Zoria: Age of Shattering Prologue	2020-04-30	112	356	70	182	0.7815000000000001
Cepheus Protocol	2020-05-15	393	1563	358	751	0.7814
Metallic Metronome	2020-03-20	4	69	9	13	0.7814
Winter War 1939	2020-07-17	6	95	14	20	0.7813
HOUSE OF GOD	2020-12-02	6	41	4	10	0.7813
The Wake: Mourning Father, Mourning Mother	2020-07-10	40	154	26	66	0.7812000000000001
LOGistICAL: Earth	2020-07-23	111	105	16	127	0.7812000000000001
Ever Forward	2020-08-13	66	201	36	102	0.7811
PiraCrash!	2020-04-29	4	22	1	5	0.7811
Gunbrick	2020-04-09	9	22	1	10	0.7811
encrypt.	2020-06-01	8	22	1	9	0.7811
Void Destroyer 2	2020-02-06	264	477	98	362	0.7809
Hentai Furry 2	2020-11-15	3572	464	95	3667	0.7809
Master Bladesmith	2020-02-03	30	301	58	88	0.7809
From the Shadows	2020-11-27	465	196	35	500	0.7809
ClickCells: CPU girls	2020-05-19	7	74	10	17	0.7809
Farmer And Tree	2020-10-29	18	74	10	28	0.7809
Zombo Buster Advance	2020-08-07	27	139	23	50	0.7808
Simp Simulator	2020-07-31	10	214	39	49	0.7805
Something Ate My Alien	2020-06-18	21	52	6	27	0.7803
The Heiress of Sorcery	2020-08-14	32	99	15	47	0.7801
Chex Quest HD	2020-05-18	320	1490	344	664	0.7798999999999999
Reversion - The Return	2020-02-28	28	68	9	37	0.7798999999999999
Later Daters	2020-04-16	17	68	9	26	0.7798999999999999
Wardwell House	2020-01-14	25	588	125	150	0.7798
Wienne	2020-01-06	4	46	5	9	0.7796
holedown	2020-04-09	74	46	5	79	0.7796
Election Year Knockout	2020-07-02	9	57	7	16	0.7794
I am an Air Traffic Controller 4	2020-10-15	114	284	55	169	0.7793000000000001
Crew 167: The Grand Block Odyssey	2020-04-08	6	28	2	8	0.7792
Project AETHER: First Contact	2020-02-24	4	28	2	6	0.7792
Demonheart: Hunters	2020-01-29	182	193	35	217	0.779
Snapshot VR	2020-09-01	29	88	13	42	0.779
Caterpillarnoid	2020-07-17	47	88	13	60	0.779
Darkness Maze Cube - Hardcore Puzzle Game	2020-01-29	6	34	3	9	0.7787999999999999
My Jigsaw Adventures - A Lost Story	2020-05-22	8	34	3	11	0.7787999999999999
Neon Aileron	2020-01-01	3	14	0	3	0.7787000000000001
Vandozer	2020-07-03	6	14	0	6	0.7787000000000001
Dark Forest	2020-06-12	3	14	0	3	0.7787000000000001
Hero Hours Contract	2020-08-26	4	14	0	4	0.7787000000000001
Ducks' Wrath	2020-10-15	5	14	0	5	0.7787000000000001
Hard2Fly	2020-08-07	4	14	0	4	0.7787000000000001
Nyanco Space	2020-03-12	3	14	0	3	0.7787000000000001
The Chronicles of Robin Hood - The King of Thieves	2020-04-12	6	14	0	6	0.7787000000000001
Cards & Crystals	2020-05-26	7	14	0	7	0.7787000000000001
Call of Corona: Micro Warfare	2020-05-15	3	14	0	3	0.7787000000000001
VRSpace	2020-11-27	4	14	0	4	0.7787000000000001
RoboPhobik	2020-09-25	3	14	0	3	0.7787000000000001
Level 20	2020-10-21	3	14	0	3	0.7787000000000001
The Beardless Wizard	2020-11-26	5	14	0	5	0.7787000000000001
Without my arms	2020-12-31	4	14	0	4	0.7787000000000001
Teslapunk	2020-12-30	3	14	0	3	0.7787000000000001
KarmaKnight	2020-05-21	5	51	6	11	0.7785
Mask of Mists	2020-04-09	18	117	19	37	0.7784000000000001
Winter Resort Simulator 2	2020-11-26	839	871	195	1034	0.7782
BlackJack Math	2020-08-20	7	72	10	17	0.7781
Bright Paw	2020-09-01	10	102	16	26	0.778
Eternal Return	2020-10-14	52853	35659	9512	62365	0.7779
Doctor Who: The Runaway	2020-01-20	7	126	21	28	0.7778
Harthorn	2020-10-27	8	126	21	29	0.7778
Melody	2020-12-18	9	126	21	30	0.7778
Lovingly Evil	2020-08-19	40	87	13	53	0.7778
The Signifier Director's Cut	2020-10-15	34	200	37	71	0.7777
Bone Appetit	2020-05-08	4	56	7	11	0.7777
Chess Knights: Viking Lands	2020-08-13	10	56	7	17	0.7777
Blast Brawl 2	2020-12-04	6	21	1	7	0.7777
ViKubb	2020-02-27	8	21	1	9	0.7777
Kana Quest	2020-03-12	6	21	1	7	0.7777
迷雾空城	2020-05-12	4	21	1	5	0.7777
Storm Chasers: Tornado Islands	2020-01-30	7	21	1	8	0.7777
Choco Pixel 2	2020-02-03	3	21	1	4	0.7777
Alt254	2020-09-04	5	21	1	6	0.7777
10mg: SLASHER, Interrupted	2020-10-15	3	21	1	4	0.7777
Rescue Team Planet Savers	2020-11-12	19	21	1	20	0.7777
I Want to Fly	2020-12-24	4	21	1	5	0.7777
Guiding Light	2020-01-20	20	130	22	42	0.7770999999999999
KillSteel	2020-04-17	74	239	46	120	0.7769
A Night In Berlin	2020-08-07	39	352	72	111	0.7768
STARS ERA:LOST STARS	2020-05-14	15	66	9	24	0.7768
Potion Commotion	2020-04-16	32	96	15	47	0.7767000000000001
Unit 404	2020-08-20	5	39	4	9	0.7767000000000001
Zof	2020-10-05	7	39	4	11	0.7767000000000001
Beyond Crimson Stars	2020-02-27	6	71	10	16	0.7766
Samurai Aces	2020-05-20	19	33	3	22	0.7762000000000001
Bunny's Maze	2020-07-25	3	33	3	6	0.7762000000000001
Top Run	2020-02-10	3	27	2	5	0.7762000000000001
失落之白 Eternal Liiivie EP1, 與世隔絕的白族	2020-09-06	4	27	2	6	0.7762000000000001
The Line	2020-07-09	4	27	2	6	0.7762000000000001
Ur Game	2020-06-22	10	27	2	12	0.7762000000000001
wonShot	2020-12-02	3	27	2	5	0.7762000000000001
Cinema Simulator	2020-11-18	6	27	2	8	0.7762000000000001
Jerez's Arena	2020-07-17	215	414	87	302	0.7761
Oneiros	2020-03-27	20	193	36	56	0.7761
Sporadic Spire	2020-07-03	42	55	7	49	0.7759
Cyberpunk 2077	2020-12-10	1054388	472567	132706	1187094	0.7756000000000001
TT Isle of Man: Ride on the Edge 2	2020-03-19	244	939	216	460	0.7755
Alice in Wonderland - a jigsaw puzzle tale	2020-11-18	10	60	8	18	0.7755
Barro Racing	2020-09-11	1335	466	100	1435	0.7754000000000001
DragonRide VR	2020-08-01	6	44	5	11	0.7754000000000001
Spooky Speakeasy	2020-12-21	7	44	5	12	0.7754000000000001
Hentai Cosplay USSR	2020-01-27	7	128	22	29	0.7753
Strategic Mind: Spectre of Communism	2020-11-13	97	151	27	124	0.7752
Mayhem in Single Valley: Confessions	2020-04-30	23	80	12	35	0.7751000000000001
Cute Lady	2020-05-22	8	80	12	20	0.7751000000000001
HyperParasite	2020-04-03	33	123	21	54	0.775
Ben 10: Power Trip	2020-10-09	38	155	28	66	0.7748
Night of the Dead	2020-08-28	4434	6769	1759	6193	0.7745000000000001
Palindrome Syndrome: Escape Room	2020-10-14	30	329	68	98	0.7745000000000001
Stan Lee's Verticus	2020-12-24	13	49	6	19	0.7745000000000001
Magic Lessons in Wand Valley	2020-07-09	10	49	6	16	0.7745000000000001
Taur	2020-02-20	666	1275	303	969	0.7744
KUNAI	2020-02-06	98	396	84	182	0.7744
Toast Defense	2020-11-23	12	159	29	41	0.7744
Touhou Block Fall ~ Yukari	2020-11-20	3	38	4	7	0.7743000000000001
Pieces of my Heart	2020-12-21	142	307	63	205	0.7742
ZHED	2020-04-16	5	13	0	5	0.7741
Melordandek	2020-03-13	4	13	0	4	0.7741
Day of vaccination	2020-11-30	8	13	0	8	0.7741
Baron: Fur Is Gonna Fly	2020-03-04	7	13	0	7	0.7741
Blue Boy: Bleeding Out	2020-06-18	2	13	0	2	0.7741
Monochrome World	2020-05-07	4	13	0	4	0.7741
Cosmos	2020-01-01	3	13	0	3	0.7741
Breakneck City	2020-05-27	2	13	0	2	0.7741
space vanguard	2020-04-17	2	13	0	2	0.7741
TRF - The Race Factory	2020-10-26	5	13	0	5	0.7741
Worm Jazz	2020-09-21	4	13	0	4	0.7741
Dark Romance: Ashville Collector's Edition	2020-03-28	6	13	0	6	0.7741
Inside The Mirror	2020-04-27	7	13	0	7	0.7741
Maneuver Warfare	2020-05-25	4	13	0	4	0.7741
Spacefighter Rukia	2020-04-27	2	13	0	2	0.7741
Pure Soul: The Journey of the Witch Emily	2020-05-06	2	13	0	2	0.7741
The Lost Marble	2020-05-28	3	13	0	3	0.7741
Automata Break	2020-09-18	4	13	0	4	0.7741
Dungeons & Bombs	2020-09-23	2	13	0	2	0.7741
The Neon Mate	2020-08-05	4	13	0	4	0.7741
Labyrinth of the Chaka King	2020-07-16	9	13	0	9	0.7741
Super Psy Penguin	2020-07-31	2	13	0	2	0.7741
Ragnar's Chinese Memory Game	2020-08-14	3	13	0	3	0.7741
KIRO	2020-10-16	2	13	0	2	0.7741
Happy Marriage Project - Starting from 9 years old -	2020-08-20	5	13	0	5	0.7741
Delta Light	2020-11-09	2	13	0	2	0.7741
Couch Installation Service	2020-10-01	15	13	0	15	0.7741
Clutter Evolution: Beyond Xtreme	2020-10-15	12	13	0	12	0.7741
Behind the Horizon	2020-11-11	5	13	0	5	0.7741
Demon heart	2020-12-01	7	13	0	7	0.7741
Koma	2020-12-15	2	13	0	2	0.7741
Blackshift	2020-09-22	5	20	1	6	0.774
Lems	2020-03-13	2	20	1	3	0.774
Vengeful Heart	2020-08-27	4	20	1	5	0.774
Geometry Hero	2020-06-22	4	20	1	5	0.774
Impact	2020-05-04	5	20	1	6	0.774
Drifter King Online	2020-05-15	5	20	1	6	0.774
Simple Machines	2020-05-19	6	20	1	7	0.774
Karting Grand Prix Minigame	2020-07-08	3	20	1	4	0.774
Legendary Journeys	2020-09-07	8	20	1	9	0.774
High Strategy: Urukon	2020-05-22	9	84	13	22	0.7739
Stream Racer	2020-06-19	234	207	40	274	0.7737999999999999
Dread X Collection	2020-05-26	45	352	74	119	0.7736000000000001
Frontline: Panzer Blitzkrieg!	2020-03-06	20	69	10	30	0.7736000000000001
Legion Gold	2020-07-09	20	69	10	30	0.7736000000000001
FadeZone	2020-03-02	22	32	3	25	0.7734000000000001
Sokpop S08: Yardlings	2020-05-04	13	32	3	16	0.7734000000000001
最后的大法师 光明之旅(Last Archmage Journey of Light)	2020-07-16	12	32	3	15	0.7734000000000001
Pink Gum	2020-07-29	2	32	3	5	0.7734000000000001
Victoria Clair and the Mystery Express	2020-12-11	4	32	3	7	0.7734000000000001
The Dream of Shadowlands	2020-12-28	3	32	3	6	0.7734000000000001
Nimbatus - The Space Drone Constructor	2020-05-14	1349	1544	375	1724	0.7733
Maid Mansion	2020-11-14	253	330	69	322	0.7732
Promesa	2020-10-15	8	121	21	29	0.7731
Defeated Girl	2020-10-01	16	300	62	78	0.773
Tenderfoot Tactics	2020-10-21	64	175	33	97	0.773
Rhythmy	2020-03-24	12	26	2	14	0.773
DEDstress	2020-08-20	4	26	2	6	0.773
De:Void	2020-07-16	5	26	2	7	0.773
Shitty Cactus	2020-02-24	3	26	2	5	0.773
Hexplore	2020-06-25	6	26	2	8	0.773
Viewergames Racing	2020-11-13	12	26	2	14	0.773
Fantasy of Expedition	2020-09-14	992	539	120	1112	0.7729
King of Crabs	2020-07-03	1876	6244	1635	3511	0.7728
Burn Me Twice	2020-05-29	37	201	39	76	0.7728
Casual Desktop Game	2020-02-14	21	148	27	48	0.7728
NASCAR Heat 5	2020-07-10	423	1821	449	872	0.7726999999999999
PictoQuest	2020-02-04	196	257	52	248	0.7726999999999999
Snowballs	2020-11-09	29	116	20	49	0.7726999999999999
Bingfa：Warring States	2020-12-07	64	116	20	84	0.7726999999999999
Idle Champions of the Forgotten Realms	2020-03-25	18578	9539	2541	21119	0.7726000000000001
Sierra Ops	2020-01-16	12559	192	37	12596	0.7726000000000001
Sokpop S06: bobo robot	2020-01-17	8	48	6	14	0.7725
WAR DUST	2020-05-06	196	1230	296	492	0.7724
Mr. Fast	2020-04-01	7	143	26	33	0.7724
Furry Nya	2020-06-25	5	78	12	17	0.7724
Tales Of Glory	2020-05-30	47	709	163	210	0.7723000000000001
CROSSBOW: Bloodnight	2020-09-24	33	294	61	94	0.7722
Shining Song Starnova: Idol Empire	2020-02-20	48	73	11	59	0.7722
Bartlow's Dread Machine	2020-09-29	7	53	7	14	0.7721
Lynn , The Girl Drawn On Puzzles	2020-11-19	7	68	10	17	0.772
Mystic Pillars	2020-03-04	6	58	8	14	0.772
Guilty Hell: White Goddess and the City of Zombies	2020-09-30	36	106	18	54	0.7719
Pro Strategy Football 2021	2020-09-07	40	92	15	55	0.7719
Coronavirus Evolution	2020-05-19	6	37	4	10	0.7718
Glare fall	2020-04-20	7	37	4	11	0.7718
Escape until friday	2020-10-01	14	151	28	42	0.7716
Love wish	2020-01-13	161	1280	311	472	0.7714
Help Will Come Tomorrow	2020-04-21	365	601	137	502	0.7713
I Walk Among Zombies Vol. 0	2020-12-15	9	82	13	22	0.7712000000000001
LUNA	2020-11-20	16	207	41	57	0.7711
Q - A Neon Platformer	2020-06-18	15	42	5	20	0.7709
Ronister Adventure	2020-11-30	5	42	5	10	0.7709
Trump Loves Waifu	2020-10-21	5	105	18	23	0.7708
1 Screen Platformer: Prologue	2020-07-16	25	123	22	47	0.7706000000000001
Shank n' Bake	2020-04-29	10	31	3	13	0.7706000000000001
Retrace	2020-01-20	3	31	3	6	0.7706000000000001
Demonizer	2020-10-30	4	31	3	7	0.7706000000000001
Deadly Dozen: Pacific Theater	2020-12-04	4	31	3	7	0.7706000000000001
Verdungo	2020-08-31	6	31	3	9	0.7706000000000001
The Parenting Simulator	2020-05-07	16	47	6	22	0.7704000000000001
BloodRayne 2: Terminal Cut	2020-11-20	642	577	132	774	0.7703
Two Weeks in Painland	2020-02-03	6	52	7	13	0.7702
A Day Without Me	2020-06-27	7	52	7	14	0.7702
No one lives in heaven	2020-06-11	6	57	8	14	0.7701000000000001
AbsentedAge:アブセンテッドエイジ ～亡霊少女のローグライクアクションSRPG -幽玄の章-	2020-10-22	129	57	8	137	0.7701000000000001
Alpha Version.0	2020-03-13	9	19	1	10	0.77
COSMOS	2020-07-22	4	19	1	5	0.77
ReThink | Evolved 4	2020-04-06	4	19	1	5	0.77
Tornado Driver	2020-06-07	3	19	1	4	0.77
Simply Puzzles: Junctions	2020-07-16	5	19	1	6	0.77
Crystal Chasers League	2020-10-21	8	19	1	9	0.77
缄默星空	2020-09-29	5	19	1	6	0.77
Staff Only	2020-12-30	3	19	1	4	0.77
TERMINUS	2020-11-14	4	19	1	5	0.77
Mini Moves: Among Stars	2020-12-22	3	19	1	4	0.77
Electro Ride	2020-07-11	8	81	13	21	0.7698999999999999
GridIron	2020-07-23	792	1616	404	1196	0.7697
Beyond Extinct	2020-02-26	6	25	2	8	0.7697
Biba`s Adventures	2020-01-31	4	25	2	6	0.7697
Yumeutsutsu Re:Idol	2020-04-02	5	25	2	7	0.7697
10mg: HANDMADEDEATHLABYRINTH issue 0	2020-10-15	5	25	2	7	0.7697
PP Puncher	2020-10-07	3	25	2	5	0.7697
Recruit One	2020-10-20	3	25	2	5	0.7697
Wind Peaks	2020-07-29	13	230	47	60	0.7696
Observation	2020-05-21	1034	3130	813	1847	0.7695000000000001
Mech Merc Company	2020-05-01	12	76	12	24	0.7695000000000001
Rising Hell - Prologue	2020-05-13	14	90	15	29	0.7694
Morkredd	2020-12-10	68	304	65	133	0.7692
Learn Game Development, Unity Code Monkey	2020-08-09	65	99	17	82	0.7692
Amoeba Battle	2020-03-03	11	36	4	15	0.7692
Microsoft Flight Simulator	2020-08-18	61829	36058	10161	71990	0.7691
Streamer Life Simulator	2020-08-21	741	4549	1205	1946	0.7691
Red Bow	2020-01-18	8	161	31	39	0.7691
Stacks On Stacks (On Stacks)	2020-04-01	4	12	0	4	0.7690000000000001
Here Come the Mystery Teens!	2020-01-15	2	12	0	2	0.7690000000000001
Kooring VR Wonderland : Mecadino's Attack	2020-10-10	6	12	0	6	0.7690000000000001
Rodent Warriors	2020-01-17	8	12	0	8	0.7690000000000001
Cornflake Crisis	2020-09-02	3	12	0	3	0.7690000000000001
Damaged In Transit	2020-03-24	3	12	0	3	0.7690000000000001
VECTORLORD	2020-05-18	7	12	0	7	0.7690000000000001
Grace	2020-02-22	5	12	0	5	0.7690000000000001
Nakadashi Banzai	2020-02-21	3	12	0	3	0.7690000000000001
Spermula 1	2020-12-04	4	12	0	4	0.7690000000000001
The Manse on Soracca	2020-01-27	2	12	0	2	0.7690000000000001
Sliptime Sleuth	2020-06-22	7	12	0	7	0.7690000000000001
Cat President 2: Purrlitical Revolution	2020-10-13	4	12	0	4	0.7690000000000001
Oh Frog	2020-04-20	7	12	0	7	0.7690000000000001
Epic Dumpster Bear 2	2020-06-15	4	12	0	4	0.7690000000000001
Mushroom Savior	2020-09-04	4	12	0	4	0.7690000000000001
ヤドカリサバイブ	2020-05-11	3	12	0	3	0.7690000000000001
Couple in Trouble	2020-06-23	2	12	0	2	0.7690000000000001
PERFECT MATTER	2020-09-29	2	12	0	2	0.7690000000000001
Super Indie Square - Fight Against Time	2020-07-20	2	12	0	2	0.7690000000000001
Button Soccer League	2020-07-11	3	12	0	3	0.7690000000000001
Stellaren II	2020-07-23	4	12	0	4	0.7690000000000001
Rave Heart	2020-08-28	6	12	0	6	0.7690000000000001
Magical Girl	2020-10-02	4	12	0	4	0.7690000000000001
10mg: Stroke	2020-10-15	2	12	0	2	0.7690000000000001
Delta0	2020-12-01	2	12	0	2	0.7690000000000001
Luminous Plume	2020-11-05	5	12	0	5	0.7690000000000001
BO020880	2020-11-04	2	12	0	2	0.7690000000000001
Stacker Puzzle	2020-10-19	4	12	0	4	0.7690000000000001
Grow Big (or Go Home)	2020-12-18	4	12	0	4	0.7690000000000001
Pixel Game Maker Series Werewolf Princess Kaguya	2020-12-21	2	12	0	2	0.7690000000000001
Don Flatus: Poop Hunter	2020-11-27	5	66	10	15	0.7687999999999999
Double Kick Heroes	2020-08-13	43	182	36	79	0.7687
MiniLAW: Ministry of Law	2020-01-01	54	143	27	81	0.7686000000000001
东方梦零魂 ~ TouHou Nil Soul	2020-02-28	44	143	27	71	0.7686000000000001
Asura Girls	2020-04-22	4	80	13	17	0.7685
The Sorrowvirus: A Faceless Short Story	2020-05-31	8	41	5	13	0.7685
DCL - The Game	2020-02-18	220	581	135	355	0.7684000000000001
Sokpop S07: sok-worlds	2020-03-11	23	56	8	31	0.7683
Among Ass	2020-12-04	98	326	71	169	0.7682
VELVETIST prototype	2020-05-18	31	125	23	54	0.7682
Jetboard Joust	2020-10-23	7	51	7	14	0.7682
Succubus Throne	2020-05-13	9	51	7	16	0.7682
SUPERCHICOS	2020-11-24	5	51	7	12	0.7682
Mace and Grace	2020-05-08	12	46	6	18	0.7682
Hadr	2020-10-06	6	46	6	12	0.7682
Howdy, Jacob!	2020-12-17	4	46	6	10	0.7682
Hentai hentai	2020-02-12	7	248	52	59	0.7681
Understanding, The Game	2020-12-23	23	244	51	74	0.7681
Boiling Steel	2020-03-05	10	289	62	72	0.768
Palais de Reine	2020-06-18	36	98	17	53	0.768
Shop Titans	2020-05-05	7990	10632	2928	10918	0.7679
The Swine	2020-06-18	8	206	42	50	0.7678
Sense - 不祥的预感: A Cyberpunk Ghost Story	2020-08-25	79	405	91	170	0.7676999999999999
Sokpop S04: capy hoky	2020-01-17	5	30	3	8	0.7676000000000001
Mine Dungeon	2020-03-08	5	30	3	8	0.7676000000000001
NAMCO MUSEUM ARCHIVES Vol 2	2020-06-17	18	70	11	29	0.7675000000000001
FPS Infinite	2020-03-16	11	79	13	24	0.767
Deadside	2020-04-14	9581	22872	6472	16053	0.7668
Escape Dungeon	2020-11-16	214	481	111	325	0.7668
梦乡 The Dreamcatcher	2020-08-21	48	97	17	65	0.7668
Ego In A Coma (自我、状態、昏睡。)	2020-06-30	1606	274	59	1665	0.7667
节奏快打/Rhythm Fighter	2020-05-28	323	358	80	403	0.7665000000000001
Consternation II	2020-05-19	8	55	8	16	0.7664
Rude Racers	2020-09-24	18	83	14	32	0.7662000000000001
Attack of the Giant Mutant Lizard	2020-06-21	7	24	2	9	0.7662000000000001
HORIZON VANGUARD	2020-06-26	3	24	2	5	0.7662000000000001
Mad Cat's World	2020-03-31	7	24	2	9	0.7662000000000001
All Over	2020-04-06	137	24	2	139	0.7662000000000001
Eira: Echoes of Adventure	2020-05-08	9	24	2	11	0.7662000000000001
So May It Be: A Witch Dating Simulator	2020-05-07	5	24	2	7	0.7662000000000001
Path to Prosperity	2020-09-18	8	24	2	10	0.7662000000000001
Midnight Bike	2020-09-17	6	24	2	8	0.7662000000000001
Moki	2020-11-17	3	24	2	5	0.7662000000000001
18 Wheels of Steel: Pedal to the Metal	2020-06-05	8	50	7	15	0.7661
Cars and Girls	2020-11-07	4	50	7	11	0.7661
Atelier Tia	2020-11-25	10	50	7	17	0.7661
Sky Sanctuary	2020-07-31	5	40	5	10	0.7661
Beats Of Fury	2020-04-22	5	45	6	11	0.766
Neon City Riders	2020-03-12	10	45	6	16	0.766
Chaos Galaxy	2020-06-16	61	211	44	105	0.7658
Summit of the Wolf	2020-04-21	6	18	1	7	0.7658
Blaze Revolutions	2020-07-15	5	18	1	6	0.7658
DanielX.net Paint Composer	2020-01-30	6	18	1	7	0.7658
The Revenge of Johnny Bonasera: Episode 4	2020-03-23	5	18	1	6	0.7658
Survival Denied	2020-04-21	5	18	1	6	0.7658
Em-A-Zurvival	2020-04-07	2	18	1	3	0.7658
Virus Blast	2020-06-05	4	18	1	5	0.7658
Mealmates	2020-08-10	6	18	1	7	0.7658
The Square Key	2020-10-08	6	18	1	7	0.7658
Kirakira stars idol project Reika	2020-10-29	6	18	1	7	0.7658
Yuligans: Christmas is Coming!	2020-11-24	8	18	1	9	0.7658
GraviFire	2020-11-25	3	18	1	4	0.7658
Hello Puppets!	2020-10-22	12	190	39	51	0.7655
Sokpop S09: King Pins	2020-10-30	13	64	10	23	0.7654000000000001
侠道游歌 / Songs Of Wuxia	2020-09-21	178	476	111	289	0.7653
Milky Way Prince – The Vampire Star	2020-08-13	239	251	54	293	0.7653
Hidden Memory - Nature	2020-11-18	7	73	12	19	0.765
Dungeon Cards	2020-01-27	40	59	9	49	0.7648999999999999
2MD: VR Football Evolution	2020-04-01	16	59	9	25	0.7648999999999999
Extreme Escape	2020-06-30	5	59	9	14	0.7648999999999999
SimAirport	2020-02-29	1071	2817	751	1822	0.7648
Love Wish 2	2020-06-20	390	1188	301	691	0.7648
Edgar - Bokbok in Boulzac	2020-02-26	6	82	14	20	0.7648
Bad Lady	2020-03-10	7	147	29	36	0.7647
Hello From Darkness	2020-11-30	16	104	19	35	0.7646
Hentai Furry	2020-03-17	20153	1398	359	20512	0.7645000000000001
Concept Destruction	2020-05-22	12	117	22	34	0.7645000000000001
Puzzle Pelago - A Drag & Drop Economy	2020-04-30	9	29	3	12	0.7645000000000001
Action Ball 2	2020-02-07	5	29	3	8	0.7645000000000001
One Line Coloring	2020-08-21	4	29	3	7	0.7645000000000001
ASMR Journey - Animated Jigsaw Puzzle	2020-11-11	4	29	3	7	0.7645000000000001
Half-Life: Restored	2020-07-01	150	656	159	309	0.7644
Meme Run 2	2020-07-23	7	54	8	15	0.7644
Gravity	2020-06-17	15	54	8	23	0.7644
Air Bounce - The Jump 'n' Run Challenge	2020-12-21	8	54	8	16	0.7644
Seals of the Bygone	2020-03-13	18	68	11	29	0.7643000000000001
Cirno's Perfect Summer Vacation	2020-02-10	5	68	11	16	0.7643000000000001
Facility 47	2020-09-14	5	49	7	12	0.7640000000000001
Mega Man Zero/ZX Legacy Collection	2020-02-25	808	1250	320	1128	0.7639
Panzer Dragoon: Remake	2020-09-25	99	494	117	216	0.7637999999999999
SAMURAI SHODOWN NEOGEO COLLECTION	2020-06-18	55	171	35	90	0.7637999999999999
~在魔界当女仆~恶魔天使与勇者的秘密喫茶店	2020-11-21	105	256	56	161	0.7637
SGS Winter War	2020-07-15	7	44	6	13	0.7637
Headbangers in Holiday Hell	2020-12-07	6	44	6	12	0.7637
Move Code Lines	2020-08-29	8	44	6	14	0.7637
Shoot. Push. Repeat.	2020-06-08	8	44	6	14	0.7637
Сreeps Сreeps? Creeps!	2020-01-31	6	34	4	10	0.7637
Four Rendezvous	2020-10-02	11	34	4	15	0.7637
Flatland Vol.2	2020-08-26	10	34	4	14	0.7637
Idle Armada	2020-09-23	58	34	4	62	0.7637
Remnants	2020-11-03	22	90	16	38	0.7636000000000001
In Her Eyes / 彼女之瞳	2020-04-02	15	63	10	25	0.7636000000000001
Close Combat: Cross of Iron	2020-07-23	58	81	14	72	0.7634000000000001
DreamDasher	2020-09-05	18	81	14	32	0.7634000000000001
Hollow Island	2020-01-30	40	72	12	52	0.7634000000000001
dancing chair	2020-02-16	6	72	12	18	0.7634000000000001
Monster Logic	2020-07-06	6	11	0	6	0.7634000000000001
Beat Champion	2020-03-06	5	11	0	5	0.7634000000000001
Ufflegrim	2020-04-06	4	11	0	4	0.7634000000000001
Azurebreak Heroes	2020-11-19	9	11	0	9	0.7634000000000001
Sokpop S02: Hoco Poco	2020-01-17	4	11	0	4	0.7634000000000001
VolticPistol	2020-03-26	2	11	0	2	0.7634000000000001
Dogs of Wall Street	2020-04-17	4	11	0	4	0.7634000000000001
闪避大师 Master Of Dodging	2020-04-11	3	11	0	3	0.7634000000000001
StretchBot	2020-02-05	4	11	0	4	0.7634000000000001
JORRY	2020-02-02	4	11	0	4	0.7634000000000001
Spaß Taxi	2020-01-13	2	11	0	2	0.7634000000000001
Puzzle Frame	2020-02-11	3	11	0	3	0.7634000000000001
La Historia De	2020-02-26	10	11	0	10	0.7634000000000001
Harolds Harem: The Neckoning	2020-02-13	2	11	0	2	0.7634000000000001
Living Legends: The Crystal Tear Collector's Edition	2020-01-31	6	11	0	6	0.7634000000000001
Glitchy Apocalypse Simulator	2020-11-25	3	11	0	3	0.7634000000000001
カモネギ号が魔法剣でいっぱいになる	2020-12-24	7	11	0	7	0.7634000000000001
Bragger's Run	2020-11-26	2	11	0	2	0.7634000000000001
Forking Hell	2020-07-01	3	11	0	3	0.7634000000000001
Order from Caos	2020-06-17	5	11	0	5	0.7634000000000001
Solitaire 3D	2020-07-01	12	11	0	12	0.7634000000000001
Secrets of Magic 3: Happy Halloween	2020-10-26	9	11	0	9	0.7634000000000001
Аlien cat 4	2020-07-13	2	11	0	2	0.7634000000000001
Pumpkin Farmer	2020-07-12	1	11	0	1	0.7634000000000001
Train Train Train	2020-08-07	3	11	0	3	0.7634000000000001
ドトコイ	2020-08-26	4	11	0	4	0.7634000000000001
A Dark Ice Saga: The Rescue	2020-12-04	1	11	0	1	0.7634000000000001
Death Drives A Bus	2020-09-18	2	11	0	2	0.7634000000000001
Ironseed 25th Anniversary Edition	2020-09-21	5	11	0	5	0.7634000000000001
Fishing Together	2020-10-30	4	11	0	4	0.7634000000000001
Gizmos: Spooky Adventures	2020-10-26	10	11	0	10	0.7634000000000001
Disquiet Fields	2020-10-30	2	11	0	2	0.7634000000000001
OverTime	2020-10-22	5	11	0	5	0.7634000000000001
Fishticuffs	2020-12-21	3	11	0	3	0.7634000000000001
Battle Bugs	2020-11-23	3	11	0	3	0.7634000000000001
The OrangeRice	2020-12-04	2	11	0	2	0.7634000000000001
The Wormaid	2020-12-18	1	11	0	1	0.7634000000000001
Vampire's Fall: Origins	2020-01-31	662	545	131	793	0.7632
Project Exhibited	2020-06-16	50	120	23	73	0.7632
TramSim Vienna	2020-10-29	713	1302	336	1049	0.7631
Kirakira stars idol project Ai	2020-02-17	11	58	9	20	0.763
Venture Seas	2020-01-30	335	694	171	506	0.7629000000000001
我来自江湖	2020-07-24	1965	1610	422	2387	0.7628
Geometric Sniper	2020-12-17	46	286	64	110	0.7628
Ninja Hanrei	2020-11-29	20	182	38	58	0.7628
Family Man: Prologue	2020-05-01	25	85	15	40	0.7628
Occupy Mars: Prologue	2020-08-20	244	1135	291	535	0.7626999999999999
Euphoria: Supreme Mechanics	2020-10-18	395	67	11	406	0.7626000000000001
NAIRI: Rising Tide - Prologue	2020-05-21	6	23	2	8	0.7625000000000001
Mahjong Nagomi	2020-08-07	30	169	35	65	0.7623000000000001
Hentai Balloons	2020-12-12	4	80	14	18	0.7619
Bird Missions	2020-05-03	8	48	7	15	0.7618
Total Tank Simulator	2020-05-20	1707	4997	1397	3104	0.7614000000000001
Maid of Sker	2020-07-28	332	1164	302	634	0.7613
Dunk Lords	2020-03-18	33	43	6	39	0.7613
Rabbit Simulator	2020-03-20	5	43	6	11	0.7613
Knockback: The Awakening	2020-05-01	7	17	1	8	0.7613
Reek	2020-01-31	3	17	1	4	0.7613
Briefcase Inc.	2020-05-01	7	17	1	8	0.7613
Hyzer Sky	2020-08-10	5	17	1	6	0.7613
Marcella Moon: Secret on the Hill	2020-06-15	4	17	1	5	0.7613
Balacera Brothers	2020-07-10	2	17	1	3	0.7613
Dungeons & Guns	2020-07-24	4	17	1	5	0.7613
Lost Remnant: Roaches to Riches	2020-11-05	5	17	1	6	0.7613
Deathroids	2020-10-12	2	17	1	3	0.7613
Pray in VR Medieval Christian Churches	2020-11-25	2	17	1	3	0.7613
Blocks Stacking	2020-11-01	4	17	1	5	0.7613
Unknown Planet	2020-11-05	3	17	1	4	0.7613
Myth Bearer	2020-11-10	4	17	1	5	0.7613
迷雾之夏	2020-07-17	479	782	197	676	0.7612000000000001
Daily Wife	2020-08-07	259	564	138	397	0.7612000000000001
Quanero 2 - System Release	2020-06-25	5	28	3	8	0.7612000000000001
Goofballs	2020-02-21	10	28	3	13	0.7612000000000001
Sokpop S04: Featherfall	2020-01-17	15	118	23	38	0.7611
Crisis Wing	2020-09-18	12	57	9	21	0.7611
Astonia Remastered	2020-02-18	16	101	19	35	0.761
THE GAME OF LIFE 2	2020-12-11	433	1966	528	961	0.7609
2ECONDS TO STΔRLIVHT: Forever My Diamond	2020-09-02	4	66	11	15	0.7609
Astral Towers	2020-09-29	7	38	5	12	0.7609
RB: Axolotl	2020-08-07	5	38	5	10	0.7609
Pre-Shave	2020-08-21	7	38	5	12	0.7609
Warriors of the Nile 	2020-08-07	3034	1961	527	3561	0.7608
Spitlings	2020-08-04	11	33	4	15	0.7608
Ironheart	2020-02-27	34	33	4	38	0.7608
Labyrinth Legend	2020-07-21	17	33	4	21	0.7608
The Last Show of Mr. Chardish: Act I	2020-09-03	5	33	4	9	0.7608
三国群英传6	2020-11-13	115	105	20	135	0.7606999999999999
Mr. DRILLER DrillLand	2020-06-24	62	195	42	104	0.7606
Incremental Adventures	2020-08-11	1042	519	127	1169	0.7602
Adam - Lost Memories	2020-07-04	9	146	30	39	0.7602
BDSM: Big Drunk Satanic Massacre Demo	2020-03-23	35	142	29	64	0.7602
Paper Beast - Folded Edition	2020-10-20	17	96	18	35	0.7601000000000001
Need for Speed™ Most Wanted	2020-06-18	1964	10245	2960	4924	0.76
Super Bernie World	2020-03-09	200	2378	649	849	0.76
Don't Fall	2020-10-13	15	61	10	25	0.76
GOHOME	2020-06-16	36	186	40	76	0.7599
Pirates Girls	2020-06-13	28	83	15	43	0.7599
HordeCore Prologue	2020-10-14	101	83	15	116	0.7599
Ruinarch	2020-08-25	1075	800	204	1279	0.7598
パラディンリアス	2020-07-21	81	295	68	149	0.7597
Out of Space	2020-02-26	331	1739	468	799	0.7595999999999999
BomjMan	2020-12-15	169	498	122	291	0.7595000000000001
Tree Trunk Brook	2020-10-23	9	74	13	22	0.7595000000000001
Zeon 25	2020-02-14	5	47	7	12	0.7595000000000001
RUN! GRANDPA! RUN!	2020-06-22	4	47	7	11	0.7595000000000001
ARIA CHRONICLE	2020-07-12	1389	888	229	1618	0.7593000000000001
The Ghost Train | 幽霊列車	2020-07-24	139	320	75	214	0.7589
Forklift Load	2020-10-23	10	95	18	28	0.7587999999999999
No King No Kingdom	2020-02-16	21	99	19	40	0.7586
Wooden Ocean	2020-06-10	4	22	2	6	0.7586
Faith of Fate	2020-04-19	4	22	2	6	0.7586
The City of Time	2020-06-17	2	22	2	4	0.7586
Nyanco Channel	2020-02-28	3	22	2	5	0.7586
Shoo, Box!	2020-07-20	10	22	2	12	0.7586
Minimal Maze	2020-07-17	2	22	2	4	0.7586
NENA	2020-10-05	5	22	2	7	0.7586
Ignatius	2020-11-19	3	22	2	5	0.7586
Sweet and Hot	2020-08-20	5	69	12	17	0.7585
Vengeance	2020-04-29	8732	300	70	8802	0.7584000000000001
Sokpop S02: Llama Villa	2020-01-17	4	37	5	9	0.7582
Mandew vs the Colorless Curse	2020-10-28	7	37	5	12	0.7582
Fragsurf	2020-06-07	26	111	22	48	0.758
STAR WARS™ Battlefront™	2020-06-11	623	2987	836	1459	0.7578
Dog Duty	2020-09-17	19	90	17	36	0.7578
MEGAJUMP	2020-10-19	206	90	17	223	0.7578
Shadow Puppets & Beijing opera	2020-04-08	6	32	4	10	0.7576999999999999
Speedway Challenge 20	2020-09-08	37	32	4	41	0.7576999999999999
It's Not About The End	2020-11-10	4	32	4	8	0.7576999999999999
Caffeine: Victoria's Legacy	2020-03-20	6	27	3	9	0.7576999999999999
Musashi vs Cthulhu	2020-01-14	4	27	3	7	0.7576999999999999
Pets Sniper Shooting	2020-02-11	24	27	3	27	0.7576999999999999
Summer Flowers	2020-06-19	3	27	3	6	0.7576999999999999
Pilots Of Darsalon	2020-05-28	8	27	3	11	0.7576999999999999
Let's Journey: Dragon Hunter	2020-10-08	23	27	3	26	0.7576999999999999
MXGP 2020 - The Official Motocross Videogame	2020-12-16	233	528	132	365	0.7575000000000001
Alchemy Story	2020-04-15	45	139	29	74	0.7575000000000001
莉莉娜的奇幻之旅	2020-11-06	29	64	11	40	0.7574
Locked Up	2020-04-24	42	751	194	236	0.7572
Dinosaur Fossil Hunter: Prologue	2020-08-06	243	516	129	372	0.7572
Infernal Radiation	2020-12-28	6	46	7	13	0.7572
Elizabeth	2020-02-25	10	46	7	17	0.7572
ClickCells: Winter Lady	2020-01-27	4	46	7	11	0.7572
One More Step	2020-11-06	46	46	7	53	0.7572
Eden's Ritter: Paladins of Ecstasy	2020-07-31	14	55	9	23	0.7571
Fishy2	2020-01-28	12	55	9	21	0.7571
Zodiac Girls	2020-08-07	4	55	9	13	0.7571
B.O.T.S. and the Robofriends	2020-03-16	4	10	0	4	0.7571
Whiskey & Zombies	2020-11-25	4	10	0	4	0.7571
Munchie Match	2020-06-23	2	10	0	2	0.7571
Rage Among The Stars	2020-02-15	2	10	0	2	0.7571
Tiamat's Drink	2020-06-05	2	10	0	2	0.7571
Smart Moves	2020-02-25	3	10	0	3	0.7571
Hell's Pharma	2020-01-18	3	10	0	3	0.7571
Orum's Death Run	2020-03-09	34	10	0	34	0.7571
Endurium	2020-11-11	2	10	0	2	0.7571
Mossen Seikkailut	2020-05-24	2	10	0	2	0.7571
Frak!	2020-12-15	3	10	0	3	0.7571
Saranity	2020-05-21	3	10	0	3	0.7571
Hand Cannon Virtuoso	2020-09-30	3	10	0	3	0.7571
Faircroft Antiques: Treasures of Treffenburg	2020-11-25	7	10	0	7	0.7571
Easy puzzle: Streets	2020-04-08	3	10	0	3	0.7571
3D Jigsaw Puzzle Simulator	2020-04-17	2	10	0	2	0.7571
Express Thru	2020-05-06	5	10	0	5	0.7571
Nofrills Klondike Solitaire	2020-06-24	4	10	0	4	0.7571
A-Star Theft	2020-08-28	3	10	0	3	0.7571
Shape	2020-09-18	4	10	0	4	0.7571
Easy puzzle: Animals 2	2020-08-22	2	10	0	2	0.7571
Swing Lord	2020-11-20	3	10	0	3	0.7571
Notebook Artillery	2020-11-05	4	10	0	4	0.7571
Peg Adventure	2020-11-13	3	10	0	3	0.7571
CrossKrush	2020-10-23	3	10	0	3	0.7571
Good puzzle: Music	2020-10-24	2	10	0	2	0.7571
Stupid Stories	2020-12-04	2	10	0	2	0.7571
Close Call	2020-12-21	4	10	0	4	0.7571
Breath	2020-12-21	2	10	0	2	0.7571
Faircroft’s Antiques: Home for Christmas	2020-12-31	7	10	0	7	0.7571
Biomass	2020-10-12	19	81	15	34	0.757
The Alliance Alive HD Remastered	2020-01-16	71	162	35	106	0.7567
Shoot Them 2	2020-04-03	16	85	16	32	0.7567
Lightless: The 21st Sacrifice (Episode 1)	2020-06-19	19	130	27	46	0.7565999999999999
SPACERIFT: Arcanum System	2020-12-17	39	292	69	108	0.7564000000000001
Nuclear Wipeout	2020-05-25	4	16	1	5	0.7564000000000001
Guntastic	2020-12-04	4	16	1	5	0.7564000000000001
BH Trials	2020-04-10	10	16	1	11	0.7564000000000001
Re Painter	2020-01-12	5	16	1	6	0.7564000000000001
Crown of the Empire	2020-09-07	7	16	1	8	0.7564000000000001
Revenant March	2020-01-17	2	16	1	3	0.7564000000000001
Tower Of God: One Wish	2020-01-18	7	16	1	8	0.7564000000000001
The Last Archwing	2020-03-27	4	16	1	5	0.7564000000000001
Shattered Hourglass	2020-04-29	5	16	1	6	0.7564000000000001
Sokpop S08: disc party	2020-05-12	21	16	1	22	0.7564000000000001
Wave Rider	2020-12-22	3	16	1	4	0.7564000000000001
The Last Survey	2020-08-07	2	16	1	3	0.7564000000000001
Tyrannis	2020-07-08	7	16	1	8	0.7564000000000001
Space Travel Jigsaw Puzzles	2020-10-07	8	16	1	9	0.7564000000000001
EmptyBottle	2020-11-12	6	16	1	7	0.7564000000000001
Subway Train Simulator 2D	2020-12-01	3	16	1	4	0.7564000000000001
Kagura's Dreamland	2020-12-24	4	16	1	5	0.7564000000000001
Critical Damage	2020-12-08	3	16	1	4	0.7564000000000001
Big Tiddy Goth GF Simulator	2020-05-19	9	223	51	60	0.756
Coloring Book	2020-11-05	55	196	44	99	0.7559
The Secret Order 8: Return to the Buried Kingdom	2020-01-30	23	101	20	43	0.7559
The Deed II	2020-05-29	205	76	14	219	0.7559
Putin kills: Coronavirus	2020-06-15	4	125	26	30	0.7556
Tony Stewart's All-American Racing	2020-09-04	101	125	26	127	0.7556
Aurora	2020-11-18	77	401	99	176	0.7555
Zoo 2: Animal Park	2020-08-24	343	756	198	541	0.7554000000000001
Core Defense	2020-07-31	152	271	64	216	0.7553000000000001
X-Fitness	2020-12-03	6	84	16	22	0.7553000000000001
SRC: Sprint Robot Championship	2020-03-02	15	36	5	20	0.7553000000000001
Cryptofall: Investor simulator	2020-04-21	7	36	5	12	0.7553000000000001
Rev	2020-10-01	5	36	5	10	0.7553000000000001
Fort Triumph	2020-04-16	556	695	181	737	0.7552
Mess Adventures	2020-09-30	167	378	93	260	0.7551000000000001
Tomato Way 3	2020-09-15	7	54	9	16	0.755
Raiders! Forsaken Earth	2020-11-10	168	183	41	209	0.7549
WKSP RUMBLE	2020-10-15	44	92	18	62	0.7549
WATCH	2020-12-03	12	45	7	19	0.7548
Nyanco Card	2020-06-25	6	45	7	13	0.7548
My hidden things	2020-06-04	6	45	7	13	0.7548
Ace In Space	2020-02-14	5	31	4	9	0.7545999999999999
Project Crimson	2020-08-21	9	31	4	13	0.7545999999999999
Cubic Currency	2020-08-31	6	31	4	10	0.7545999999999999
Seek Girl Ⅵ	2020-09-30	432	909	243	675	0.7544
Legends of Ethernal	2020-10-30	6	21	2	8	0.7544
The End of an Actress	2020-02-21	6	21	2	8	0.7544
Hornet Virus: Steel Alcimus II	2020-05-29	3	21	2	5	0.7544
Retro Vaders: Reloaded	2020-04-14	3	21	2	5	0.7544
Buck Bradley: Comic Adventure	2020-05-12	5	21	2	7	0.7544
The Metamorphosis	2020-10-19	3	21	2	5	0.7544
Roundabout 3	2020-07-13	6	21	2	8	0.7544
Magirune	2020-06-17	4	21	2	6	0.7544
Line Dots	2020-08-27	4	21	2	6	0.7544
Wave of Time	2020-09-16	7	21	2	9	0.7544
Throw Me in the River	2020-10-05	2	21	2	4	0.7544
Awesome Pea 2	2020-01-31	12	26	3	15	0.7541
An Interesting Journey of Monsieur PAF	2020-07-29	6	26	3	9	0.7541
Dawn of the Mexica	2020-11-26	7	26	3	10	0.7541
Fe	2020-06-04	47	544	140	187	0.7540000000000001
Mass Effect™: Andromeda	2020-06-11	3591	8975	2686	6277	0.7536
Naked Story (Sports Festival Ver)	2020-02-28	17	40	6	23	0.7536
Pizza Bike Rider	2020-08-03	201	40	6	207	0.7536
Broken Lines	2020-02-25	261	489	125	386	0.7535
Drake Hollow	2020-10-01	781	1172	321	1102	0.7534000000000001
The Indifferent Wonder of an Edible Place	2020-02-27	9	111	23	32	0.7534000000000001
UPPERS	2020-10-21	65	103	21	86	0.7534000000000001
Project Genesis	2020-05-22	45	99	20	65	0.7534000000000001
The Witch in the Forest	2020-10-01	7	66	12	19	0.7533
Ancestors: The Humankind Odyssey 	2020-08-27	3334	5810	1720	5054	0.7531
NationWar2	2020-09-30	53	270	65	118	0.7529000000000001
Astria	2020-11-15	24	70	13	37	0.7529000000000001
Spectro	2020-06-11	6	53	9	15	0.7529000000000001
The Call of Karen	2020-07-16	92	861	232	324	0.7526999999999999
EA SPORTS™ FIFA 21 	2020-10-09	44388	43574	13606	57994	0.7524
Nickelodeon Kart Racers 2: Grand Prix	2020-12-01	129	432	110	239	0.7524
The Long Gate	2020-09-22	12	35	5	17	0.7524
Killer Inside Us	2020-10-30	12	35	5	17	0.7524
ClickCells: Summer	2020-12-22	4	35	5	9	0.7524
Exit the Gungeon	2020-03-17	923	2302	661	1584	0.752
FOS	2020-05-16	44	272	66	110	0.752
eFootball PES 2021 SEASON UPDATE	2020-09-15	20674	28072	8719	29393	0.7519
Lucifer Within Us	2020-10-15	90	330	82	172	0.7519
Yogurt!	2020-10-15	225	2213	635	860	0.7518000000000001
Overgrown: Genesis	2020-05-22	45	129	28	73	0.7515999999999999
The Complex	2020-03-31	382	2013	576	958	0.7515000000000001
みんなで空気読み。	2020-03-30	96	340	85	181	0.7515000000000001
Sockventure: Prologue	2020-05-26	21	65	12	33	0.7514000000000001
ROCKETRON	2020-02-08	6	48	8	14	0.7514000000000001
Waves of Rotting Flesh	2020-07-08	4	48	8	12	0.7514000000000001
The Sea Hotel☆Umineko Tei	2020-09-30	43	48	8	51	0.7514000000000001
Deleveled	2020-09-10	150	267	65	215	0.7513
Project DeepWeb	2020-04-15	10	69	13	23	0.7512000000000001
ARISEN: Prologue	2020-07-18	8	69	13	21	0.7512000000000001
Drawkanoid	2020-01-21	10	30	4	14	0.7512000000000001
Warden of the Isles	2020-02-14	5	30	4	9	0.7512000000000001
Sokpop S05: sok-stories	2020-01-17	6	30	4	10	0.7512000000000001
HopBound	2020-06-09	5	30	4	9	0.7512000000000001
Crappy Climber	2020-10-22	14	30	4	18	0.7512000000000001
Himeko Maid	2020-10-12	9	30	4	13	0.7512000000000001
El Hijo	2020-12-03	26	140	31	57	0.751
Emergence	2020-08-07	9	73	14	23	0.751
Super Mega Space Blaster Special Turbo	2020-01-14	2	15	1	3	0.751
Call of VII	2020-02-05	4	15	1	5	0.751
Dawn at my Neighbourhood	2020-09-25	4	15	1	5	0.751
Undead Darlings ~no cure for love~	2020-09-28	9	15	1	10	0.751
Moonfall	2020-05-20	4	15	1	5	0.751
Escape Game Fort Boyard	2020-06-25	8	15	1	9	0.751
We Surround You	2020-06-15	2	15	1	3	0.751
Shivering Hearts	2020-07-22	2	15	1	3	0.751
Illness in the East	2020-10-30	2	15	1	3	0.751
Missing Features: 2D	2020-12-18	3	15	1	4	0.751
River Attack	2020-10-23	3	15	1	4	0.751
MOAI 7: Mystery Coast	2020-11-05	11	15	1	12	0.751
Harvest Green	2020-12-31	8	15	1	9	0.751
Lumber Party	2020-12-22	10	15	1	11	0.751
Cube Paradox	2020-12-15	4	15	1	5	0.751
Fast Cubes	2020-12-25	4	15	1	5	0.751
Persian Nights 2: The Moonlight Veil	2020-06-10	16	77	15	31	0.7509
One Dollar Simulator	2020-02-16	5	39	6	11	0.7509
reky	2020-05-27	10	39	6	16	0.7509
My Diggy Dog 2	2020-08-11	15	39	6	21	0.7509
Florida Simulator 1986	2020-07-14	6	39	6	12	0.7509
The Unexpected Quest	2020-11-27	59	132	29	88	0.7506999999999999
Taimanin Yukikaze 1: Trial／対魔忍ユキカゼ・体験版	2020-07-09	80	85	17	97	0.7506999999999999
SWEET MILF	2020-05-08	32	52	9	41	0.7506999999999999
Space Crew: Legendary Edition	2020-10-15	1546	1222	342	1888	0.7506
WarriOrb	2020-04-28	26	128	28	54	0.7506
Fate Arena (Alpha)	2020-04-08	228	327	82	310	0.7505
Busty Hentai Mosaic	2020-01-29	5	25	3	8	0.7503000000000001
Tabletop Playground Beta	2020-04-20	61	25	3	64	0.7503000000000001
Fox Spirit: A Two-Tailed Adventure	2020-10-15	37	25	3	40	0.7503000000000001
Domino House	2020-10-28	6	25	3	9	0.7503000000000001
Tokyo Re:Connect Prologue	2020-09-10	6	25	3	9	0.7503000000000001
Takorita Meets Fries	2020-09-30	6	25	3	9	0.7503000000000001
Binaural Odyssey	2020-10-15	3	25	3	6	0.7503000000000001
Panmorphia	2020-11-06	5	25	3	8	0.7503000000000001
Mini Car Money Chase	2020-12-21	3	25	3	6	0.7503000000000001
StarCrossed	2020-02-11	19	56	10	29	0.7502
Perfect Round Disc Golf	2020-03-12	15	56	10	25	0.7502
Undungeon Arena	2020-10-29	18	56	10	28	0.7502
apartment: a separated place	2020-02-14	3	9	0	3	0.75
Cryogear	2020-04-17	4	9	0	4	0.75
Déjà Vu	2020-08-12	3	9	0	3	0.75
Spear Master	2020-05-15	4	9	0	4	0.75
Iridium	2020-08-27	4	9	0	4	0.75
Iridion 3D	2020-04-08	2	9	0	2	0.75
In - Sight	2020-01-05	2	9	0	2	0.75
First Contact	2020-02-21	4	9	0	4	0.75
Sokpop S05: Pilfer	2020-01-17	2	9	0	2	0.75
Der Geisterturm / The Ghost Tower	2020-01-23	3	9	0	3	0.75
Maze Burrow	2020-03-31	2	9	0	2	0.75
Protective Clothing	2020-03-28	4	9	0	4	0.75
Speed Sweeper	2020-03-06	2	9	0	2	0.75
Fusion SHIFT	2020-05-15	3	9	0	3	0.75
Astro-g	2020-06-04	2	9	0	2	0.75
9 Till Void	2020-05-19	6	9	0	6	0.75
Defenders: Survival and Tower Defense	2020-06-30	5	9	0	5	0.75
Pandemic Crisis	2020-05-15	6	9	0	6	0.75
Stozle - Solve the Mystery	2020-05-16	3	9	0	3	0.75
Fantasy Lands	2020-06-23	3	9	0	3	0.75
Whispers from Within: Moving On	2020-07-23	1	9	0	1	0.75
Extortion	2020-10-30	4	9	0	4	0.75
Not Their WIll	2020-05-25	4	9	0	4	0.75
Block Motion	2020-12-01	4	9	0	4	0.75
Takelshin	2020-06-19	2	9	0	2	0.75
Jonas Willy Online	2020-07-09	3	9	0	3	0.75
Day Island	2020-07-14	3	9	0	3	0.75
Slimesphere	2020-08-06	3	9	0	3	0.75
Sea Legends	2020-10-02	3	9	0	3	0.75
Captain Frogger	2020-08-17	3	9	0	3	0.75
Dark Tales: Edgar Allan Poe's The Devil in the Belfry Collector's Edition	2020-08-07	6	9	0	6	0.75
Spark The Battle Dog	2020-11-24	2	9	0	2	0.75
Rock'n Cow	2020-08-31	2	9	0	2	0.75
Union	2020-10-01	5	9	0	5	0.75
NUI	2020-09-17	4	9	0	4	0.75
The Count of Monte Carlo	2020-10-26	3	9	0	3	0.75
Breathing Fear	2020-11-12	2	9	0	2	0.75
FISTS OF FIRE 美鈴伝説	2020-12-03	2	9	0	2	0.75
Cat's Cradle	2020-12-13	3	9	0	3	0.75
Sep's Diner	2020-12-15	7	9	0	7	0.75
Puzzle Party	2020-06-15	11	20	2	13	0.7499
Hidden Protector : ROADTRIP (Preface)	2020-09-14	3	20	2	5	0.7499
Gundy	2020-03-10	4	20	2	6	0.7499
Supermarket Shriek	2020-10-23	5	20	2	7	0.7499
红魔事件簿 The Note of Red Evil	2020-02-09	5	20	2	7	0.7499
Sunset Shapes	2020-09-08	5	20	2	7	0.7499
KITT.IO	2020-05-24	5	20	2	7	0.7499
Mini War - Three Kingdoms	2020-11-30	6	20	2	8	0.7499
The Sperminator: Rescuing Tzar Vlad	2020-03-03	5	43	7	12	0.7498
Winds Rhapsody	2020-08-24	6	43	7	13	0.7498
All For Nought - Tic Tac Toe	2020-09-03	7	43	7	14	0.7498
Inland	2020-11-20	9	43	7	16	0.7498
Split or Steal	2020-01-31	1076	980	272	1348	0.7497
Bridge Constructor: The Walking Dead	2020-11-19	70	150	34	104	0.7497
Flying Hero VR	2020-11-06	15	64	12	27	0.7495999999999999
Moving Out	2020-04-28	652	1360	386	1038	0.7494
Strip 'Em	2020-04-17	18	92	19	37	0.7494
Linda & Joan Prologue: “Four Months Earlier”	2020-07-14	4	34	5	9	0.7493000000000001
Marble Maid	2020-11-04	8	34	5	13	0.7493000000000001
Rolls and Girls	2020-11-07	3	34	5	8	0.7493000000000001
Visitations	2020-12-18	11	34	5	16	0.7493000000000001
Phi	2020-12-16	13	80	16	29	0.7492000000000001
Blood of Steel	2020-10-20	2203	4822	1454	3657	0.7490000000000001
Cherry Kisses	2020-04-23	12	47	8	20	0.7490000000000001
Speed Stars	2020-12-16	44	47	8	52	0.7490000000000001
Amnesia: Rebirth	2020-10-20	6486	5389	1633	8119	0.7489
BEAUTIFUL DESOLATION	2020-02-26	175	432	113	288	0.7488
I Am Your President: Prologue	2020-12-02	217	435	114	331	0.7486
ANIME REDEMPTION	2020-02-10	1575	421	110	1685	0.7486
Escape from GULAG	2020-07-21	3	51	9	12	0.7484999999999999
Tinker Racers	2020-08-12	16	167	39	55	0.7483
Work And Girls	2020-05-29	5	38	6	11	0.748
I hope she's ok	2020-11-13	3	38	6	9	0.748
Wordle 2	2020-08-31	2056	133	30	2086	0.7479000000000001
Sokpop S07: Pupper park	2020-01-17	4	29	4	8	0.7478
Daemonic Runner	2020-01-03	4	29	4	8	0.7478
Encore Classic Card Games	2020-09-16	31	29	4	35	0.7478
Hopebringers	2020-05-25	9	29	4	13	0.7478
Viking Butcher	2020-07-21	6	29	4	10	0.7478
Captain Sabertooth & the Magic Diamond	2020-11-20	14	29	4	18	0.7478
NEON STRUCT: Carrion Carrier	2020-10-20	3	29	4	7	0.7478
Billion Road	2020-04-16	96	144	33	129	0.7477
Hentai Thigh	2020-03-03	12	83	17	29	0.7477
Operencia: The Stolen Sun	2020-03-31	277	362	94	371	0.7474
中世纪君主 Medieval Monarch	2020-01-02	47	231	57	104	0.7472
Trial of the Gods: Siralim CCG	2020-03-13	21	42	7	28	0.7471
URUZ Return of The Er Kishi	2020-10-02	18	389	102	120	0.747
The Amazing Shrinking Giraffe	2020-02-17	10	98	21	31	0.747
Neuronaut	2020-04-10	17	158	37	54	0.7469
Shoot Shoot My Waifu	2020-10-12	44	117	26	70	0.7469
Sport Girls	2020-08-08	4	46	8	12	0.7465
ReRoad	2020-11-17	27	86	18	45	0.7464000000000001
Ties	2020-07-22	34	86	18	52	0.7464000000000001
Dead Space™ 3	2020-06-18	1105	6975	2164	3269	0.7463
Soccering	2020-08-06	5	24	3	8	0.7463
Kill The Santa	2020-01-14	7	24	3	10	0.7463
Krystopia: Nova´s Journey	2020-07-21	7	24	3	10	0.7463
Sunset Mall	2020-09-23	4	24	3	7	0.7463
Gone Golfing	2020-11-04	12	82	17	29	0.7462000000000001
Virus Popper	2020-04-10	14	50	9	23	0.7462000000000001
Aimi	2020-10-20	20	78	16	36	0.7461
Bird path	2020-08-21	3	33	5	8	0.7461
Shiren the Wanderer: The Tower of Fortune and the Dice of Fate	2020-12-02	2671	506	137	2808	0.746
みんなで空気読み。2 ～令和～	2020-09-30	26	74	15	41	0.7459
Stoneshard	2020-02-06	10738	17800	5673	16411	0.7458
Transcender	2020-09-30	10	66	13	23	0.7458
Collective Card Game	2020-03-27	227	160	38	265	0.7454999999999999
Tubetastic World Splashfest	2020-04-02	4	14	1	5	0.7453000000000001
Obversion	2020-01-28	3	14	1	4	0.7453000000000001
Bhavacakra Maco	2020-09-25	4	14	1	5	0.7453000000000001
Sorbetta: Gravely in Debt	2020-02-20	8	14	1	9	0.7453000000000001
Active Neurons 2	2020-04-15	3	14	1	4	0.7453000000000001
Pay Me In Colors	2020-06-04	3	14	1	4	0.7453000000000001
Escape Initiative	2020-06-12	17	14	1	18	0.7453000000000001
Beyond Dawn	2020-06-15	4	14	1	5	0.7453000000000001
Space Probes	2020-08-15	4	14	1	5	0.7453000000000001
Lurkers	2020-11-03	3	14	1	4	0.7453000000000001
August of August	2020-08-18	1	14	1	2	0.7453000000000001
Head Bumper: Editcraft	2020-09-19	4	14	1	5	0.7453000000000001
Mages and Treasures	2020-10-27	4	14	1	5	0.7453000000000001
New Yankee 9: The Evil Spellbook	2020-10-01	17	14	1	18	0.7453000000000001
Trials of Argolis	2020-12-02	2	14	1	3	0.7453000000000001
The Cat Banny	2020-12-19	2	14	1	3	0.7453000000000001
Pushy and Pully in Blockland	2020-05-04	6	37	6	12	0.7451000000000001
Baby Dino Adventures	2020-07-01	5	37	6	11	0.7451000000000001
B67	2020-08-31	3	37	6	9	0.7451000000000001
PARANOIHELL	2020-01-17	5	19	2	7	0.7451000000000001
トトのおもちゃばこ	2020-02-07	4	19	2	6	0.7451000000000001
Dark Judgement	2020-02-22	4	19	2	6	0.7451000000000001
Thomas Scott	2020-06-13	4	19	2	6	0.7451000000000001
SMIB: Mission Cure	2020-11-20	7	19	2	9	0.7451000000000001
VALKYRIE CONNECT	2020-04-03	1438	690	193	1631	0.7449
Loot Grind Simulator	2020-10-14	49	266	68	117	0.7449
GetMeBro!	2020-04-29	85	104	23	108	0.7449
WarPlan	2020-03-26	45	130	30	75	0.7448
Skautfold: Moonless Knight	2020-03-04	9	41	7	16	0.7444
BISQUE DOLL	2020-10-10	8	41	7	15	0.7444
Ayahuasca	2020-01-15	11	258	66	77	0.7443000000000001
The Emperor's Own	2020-11-05	35	409	110	145	0.7442000000000001
be you 2	2020-07-18	10	73	15	25	0.7442000000000001
Real Life Plus Ver. Kaname Komatsuzaki	2020-05-08	11	28	4	15	0.7441
Angry Bunny 3: Virus	2020-05-04	7	28	4	11	0.7441
The Dark Method	2020-11-20	3	28	4	7	0.7441
Thousand Threads	2020-07-30	24	65	13	37	0.7439
随风而逝/Story About Times	2020-02-26	7	61	12	19	0.7438
First Person Shooter Kit Showcase	2020-07-28	7	49	9	16	0.7438
Starena	2020-05-21	45	57	11	56	0.7437
Chess Knights: Shinobi	2020-11-18	13	53	10	23	0.7437
Lessons with Chii-chan	2020-03-13	44	103	23	67	0.7436
Apex Aim Trainer	2020-01-29	287	514	142	429	0.7433
Kazakh Drive	2020-10-18	42	168	41	83	0.7431
A Fold Apart	2020-04-17	13	80	17	30	0.7431
SELF	2020-01-15	38	196	49	87	0.7428
FlowState	2020-02-28	198	76	16	214	0.7428
Outburst	2020-03-07	87	32	5	92	0.7428
Lootbox Lyfe	2020-02-28	10	32	5	15	0.7428
Deathbloom: Chapter 2	2020-03-03	4	32	5	9	0.7428
The Flower Collectors	2020-04-21	16	117	27	43	0.7426
Wordle 3	2020-10-06	2414	178	44	2458	0.7425
Broll	2020-11-27	10	72	15	25	0.7425
Birth ME Code	2020-04-22	29	68	14	43	0.7422
Peaky Blinders: Mastermind	2020-08-20	252	632	179	431	0.7421
Stela	2020-03-13	49	553	155	204	0.7421
Dead Ground Arcade	2020-04-02	10	36	6	16	0.742
Test Of Courage	2020-10-27	6	36	6	12	0.742
Sweet and Cute	2020-08-11	3	36	6	9	0.742
Joyfess Ep1: Martin's Secret Recipe	2020-03-26	8	23	3	11	0.742
末日临晓	2020-03-20	7	23	3	10	0.742
Mason: Building Bricks	2020-11-09	5	23	3	8	0.742
Super Neat Cat	2020-12-16	5	23	3	8	0.742
Dwarrows	2020-02-28	122	98	22	144	0.7419
Claws & Feathers 3	2020-12-03	7	8	0	7	0.7419
Solos	2020-12-17	2	8	0	2	0.7419
Rum Ram	2020-10-14	4	8	0	4	0.7419
Star99	2020-10-28	11	8	0	11	0.7419
Burnt Rubber	2020-03-12	3	8	0	3	0.7419
PLAY DOG PLAY TAG	2020-03-05	5	8	0	5	0.7419
Human Factory	2020-11-02	4	8	0	4	0.7419
Celestial	2020-01-11	5	8	0	5	0.7419
Firefight!	2020-01-16	2	8	0	2	0.7419
赤红2028-WeAreEscape-	2020-01-18	2	8	0	2	0.7419
Box Kid Adventures	2020-01-28	4	8	0	4	0.7419
BoyandBox	2020-02-14	5	8	0	5	0.7419
Gotcha	2020-04-29	5	8	0	5	0.7419
Martial Arts Brutality Premium	2020-06-09	5	8	0	5	0.7419
How To Make A Killing	2020-07-31	3	8	0	3	0.7419
FPS Robot Attack Minigame	2020-05-09	3	8	0	3	0.7419
Zeph	2020-06-04	7	8	0	7	0.7419
Reflections of Life: Utopia Collector's Edition	2020-04-03	5	8	0	5	0.7419
MaryPark St.	2020-08-24	2	8	0	2	0.7419
TP Royale	2020-10-31	5	8	0	5	0.7419
Hentai Girls 2	2020-04-30	2	8	0	2	0.7419
TraptionBakery	2020-10-01	5	8	0	5	0.7419
F29 Retaliator	2020-07-03	2	8	0	2	0.7419
We Die	2020-05-27	2	8	0	2	0.7419
Yuri Ogibalov's Bizarre Adventure	2020-06-25	2	8	0	2	0.7419
Sword Slinger	2020-10-20	3	8	0	3	0.7419
Snake	2020-06-22	2	8	0	2	0.7419
Pop-It! Or Don't..	2020-07-11	3	8	0	3	0.7419
Astronomia	2020-07-08	3	8	0	3	0.7419
Soccer Adventures	2020-10-20	3	8	0	3	0.7419
Nonsense Soccer	2020-10-16	5	8	0	5	0.7419
Urban Survival	2020-09-25	3	8	0	3	0.7419
The Grand Lord	2020-09-04	2	8	0	2	0.7419
My Nuclear Octopus	2020-08-05	1	8	0	1	0.7419
CROSSFIRE II	2020-08-27	2	8	0	2	0.7419
epsilon wars	2020-11-12	3	8	0	3	0.7419
Mimicry	2020-09-04	3	8	0	3	0.7419
Pumpkin Dog Xtreme	2020-09-02	3	8	0	3	0.7419
Gravitaze: One	2020-08-24	2	8	0	2	0.7419
Way in the Stars	2020-09-24	2	8	0	2	0.7419
Good puzzle: Animals	2020-10-06	2	8	0	2	0.7419
Social Distancing	2020-11-27	2	8	0	2	0.7419
Pocket Penguin ( ポケットペンギン)	2020-11-16	3	8	0	3	0.7419
Silver Cats	2020-12-18	3	8	0	3	0.7419
Go! Birdie	2020-12-23	2	8	0	2	0.7419
NEOMORPH	2020-01-15	118	499	139	257	0.7418000000000001
Saint Emiliana	2020-09-17	252	205	52	304	0.7417
Sokpop S07: deer hunter II	2020-01-17	14	40	7	21	0.7415999999999999
A Ton Of Feathers	2020-04-17	3	40	7	10	0.7415999999999999
The Chess Variants Club	2020-12-16	8	40	7	15	0.7415999999999999
Conflict Area	2020-07-01	9	40	7	16	0.7415999999999999
Dragon Age™ Inquisition	2020-06-04	4121	9297	2992	7113	0.7415
HUNGRY TEA PARTY	2020-02-21	6	56	11	17	0.7415
Dragon Marked For Death	2020-04-21	1364	678	194	1558	0.7414000000000001
Zombie Derby: Pixel Survival	2020-11-19	7	48	9	16	0.7413
One Try, One Kill	2020-04-28	5	48	9	14	0.7413
Apollon 88	2020-06-05	9	48	9	18	0.7413
The Survivalists	2020-10-09	3563	4109	1292	4855	0.7412000000000001
Hentai Honeys Jigsaw	2020-02-14	29	123	29	58	0.7412000000000001
Death Come True	2020-07-17	125	595	169	294	0.741
Manor of Mystic Courtesans	2020-04-17	60	333	90	150	0.7406999999999999
Aeolis Tournament	2020-07-16	38	71	15	53	0.7406999999999999
Spacebourne	2020-07-18	192	528	149	341	0.7406
I'm on Observation Duty 3	2020-11-13	17	151	37	54	0.7406
Gothic Girls	2020-09-22	5	67	14	19	0.7403000000000001
愛神餐館MAX	2020-03-09	17	27	4	21	0.7403000000000001
Claire's Cruisin' Cafe	2020-10-29	12	27	4	16	0.7403000000000001
Lens Life	2020-08-11	81	175	44	125	0.7401000000000001
Rose Seed Replica	2020-09-09	5	18	2	7	0.74
Cardboard Ground	2020-01-28	8	18	2	10	0.74
FLS	2020-01-01	4	18	2	6	0.74
Slaughter 3: The Rebels	2020-02-05	4	18	2	6	0.74
Last Week	2020-02-07	2	18	2	4	0.74
Warmth	2020-02-27	5	18	2	7	0.74
LAST CHICK - 最後のひよこ	2020-03-19	7	18	2	9	0.74
SWORDSHOT	2020-05-26	3	18	2	5	0.74
Probe	2020-04-14	4	18	2	6	0.74
妙语连珠	2020-06-25	4	18	2	6	0.74
Action SuperCross	2020-06-17	6	18	2	8	0.74
Seeker 2	2020-07-04	2	18	2	4	0.74
VRWorkout	2020-07-05	4	18	2	6	0.74
The Mutineer	2020-10-26	5	18	2	7	0.74
Get Out! Snakes!	2020-10-02	5	18	2	7	0.74
SmFly: Gravity Adventure	2020-10-02	5	18	2	7	0.74
Frisbee For Fun	2020-11-22	2	18	2	4	0.74
Sokpop S09: Grey Scout	2020-10-22	3	18	2	5	0.74
Cute Honey 2	2020-09-30	489	1114	333	822	0.7397
Pincremental	2020-08-10	419	367	101	520	0.7395999999999999
SoundSelf: A Technodelic	2020-04-22	21	118	28	49	0.7395999999999999
Hot And Lovely 3	2020-05-25	795	350	96	891	0.7394
AFL Evolution 2	2020-09-11	61	132	32	93	0.7393000000000001
告死天使的审判 Death Angel Trial	2020-08-03	12	74	16	28	0.7393000000000001
Moon Raider	2020-09-10	7	31	5	12	0.7393000000000001
Dwarves & Dungeons	2020-11-20	8	31	5	13	0.7393000000000001
Ostrich Runner	2020-12-10	8	31	5	13	0.7393000000000001
The Wizards - Dark Times	2020-06-04	47	323	88	135	0.7392000000000001
Wizard Lady	2020-04-23	6	51	10	16	0.7390000000000001
Boyfriend's Rescue - Gay Platform Game	2020-08-21	10	35	6	16	0.7389
Dances and Girls	2020-10-31	3	35	6	9	0.7389
Bleeding Moons	2020-09-03	8	13	1	9	0.7389
Ninja Turdle	2020-02-14	4	13	1	5	0.7389
Tamiku	2020-09-18	2	13	1	3	0.7389
Iridion II	2020-04-08	5	13	1	6	0.7389
Sloth Quest	2020-06-19	2	13	1	3	0.7389
大禹治水 Pipeline Of Emperor Yu	2020-01-03	4	13	1	5	0.7389
Night Of The Living Dead VR	2020-01-21	3	13	1	4	0.7389
Mini Golf Club	2020-05-29	8	13	1	9	0.7389
Hyper Treasure - The Legend of Macaron	2020-04-17	7	13	1	8	0.7389
Only One Rectangle	2020-07-23	3	13	1	4	0.7389
GraFi Easter	2020-04-16	3	13	1	4	0.7389
Return of the Phantom	2020-08-07	4	13	1	5	0.7389
THE KNIGHT OF QUEEN	2020-05-29	3	13	1	4	0.7389
Corners	2020-11-26	3	13	1	4	0.7389
The Machine's Garden	2020-08-07	4	13	1	5	0.7389
BRDG	2020-06-19	2	13	1	3	0.7389
Maze: Sinister Play Collector's Edition	2020-06-21	5	13	1	6	0.7389
Trenchlore	2020-08-07	2	13	1	3	0.7389
STARS ERA:THE FINAL DEFENCE	2020-08-21	4	13	1	5	0.7389
Mystika 4 : Dark Omens	2020-08-08	11	13	1	12	0.7389
Kristallijn	2020-10-02	2	13	1	3	0.7389
Monkey King vs Transformers	2020-12-10	2	13	1	3	0.7389
法利恩戰記 Ⅱ (Furion Chronicles Ⅱ)	2020-12-18	9	13	1	10	0.7389
Return of the Heir	2020-12-16	2	13	1	3	0.7389
VR World War II battlefield experience	2020-12-31	3	13	1	4	0.7389
Golazo! Soccer League	2020-11-03	19	149	37	56	0.7387
HENTAI SAVES AUSTRALIA	2020-02-12	5	92	21	26	0.7387
GEESE vs CTHULHU	2020-06-29	4	43	8	12	0.7387
Stocksynd House	2020-03-20	8	43	8	16	0.7387
Project RTD: Random Tower Defense VR	2020-05-19	7	43	8	15	0.7387
Furry Woof and Nya	2020-08-08	5	43	8	13	0.7387
Anime Artist 3: Harem	2020-11-19	7	43	8	15	0.7387
Terrordrome - Reign of the Legends	2020-07-24	19	81	18	37	0.7386
Loop	2020-11-24	4	81	18	22	0.7386
Gears Tactics	2020-04-28	7351	4717	1517	8868	0.7382
Mad Tower Tycoon	2020-01-14	215	310	85	300	0.7378
Make Your Kingdom: Prologue	2020-04-30	108	336	93	201	0.7376
SUPER CIRCUIT BREAKERS	2020-05-19	134	73	16	150	0.7376
Calturin and Clone	2020-09-23	12	73	16	28	0.7376
Jendo	2020-11-04	25	243	65	90	0.7375
DEAD	2020-07-30	6	22	3	9	0.7375
Harem Girl: Isabella	2020-04-12	5	22	3	8	0.7375
Bryce's Movement Engine¹	2020-01-17	5	22	3	8	0.7375
Dungeon of Rikka	2020-12-07	3	22	3	6	0.7375
PIVO	2020-04-10	5	22	3	8	0.7375
RUN OR FIGHT	2020-05-23	3	22	3	6	0.7375
Elli	2020-07-13	6	22	3	9	0.7375
Die drei ??? - Fluch des Flaschenteufels	2020-07-30	18	22	3	21	0.7375
Agent Klutz	2020-11-11	3	22	3	6	0.7375
AI＊Shoujo/AI＊少女	2020-03-17	599	1581	489	1088	0.7373000000000001
Mini Words: Top Games	2020-11-05	12	54	11	23	0.7371
ColdSide	2020-11-07	46	305	84	130	0.7369
Summer in Mara	2020-06-16	1003	1285	395	1398	0.7366
7 дней лета: Youth Sky	2020-07-30	11	87	20	31	0.7366
Rune Knights	2020-10-28	30	218	58	88	0.7365
Swords of Gurrah	2020-04-21	124	632	186	310	0.7364
Heart's Medicine - Season One	2020-05-14	19	76	17	36	0.7364
Solar Panic: Utter Distress	2020-01-28	5	26	4	9	0.7363
S H R i M P	2020-11-16	7	26	4	11	0.7363
Supfly Delivery Simulator	2020-10-17	5	26	4	9	0.7363
AftLife -少女と猫と、失われた世界-	2020-03-25	5	46	9	14	0.7362000000000001
Drive 4 Survival	2020-10-15	42	204	54	96	0.7361
Adorable Crush	2020-10-15	395	465	134	529	0.736
RealFlight Trainer Edition	2020-08-13	55	83	19	74	0.736
SpellForce 3: Versus Edition	2020-11-03	1296	890	269	1565	0.7359
Nordic Warriors	2020-06-19	7	42	8	15	0.7359
Ruvato: Original Complex	2020-11-20	8	42	8	16	0.7359
MechDefender	2020-03-03	9849	180	47	9896	0.7358
Mechanica	2020-02-29	129	387	110	239	0.7356999999999999
Husbandry	2020-09-01	33	90	21	54	0.7356999999999999
Hentai: Memory leak II	2020-02-27	3	38	7	10	0.7356999999999999
The Narrator is a DICK : Longer, Harder, and Uncut	2020-04-20	8	38	7	15	0.7356999999999999
映夢	2020-10-15	16	38	7	23	0.7356999999999999
Sasel RPG	2020-10-08	9	38	7	16	0.7356999999999999
からかい上手の高木さんVR	2020-05-21	20	132	33	53	0.7356
Sexual Void	2020-09-10	207	1175	362	569	0.7354
Fleshcult	2020-10-22	53	111	27	80	0.7354
Pixel Strike 3D	2020-05-29	895	7805	2597	3492	0.7349
Mass Effect 3 (2012)	2020-06-11	673	1566	492	1165	0.7347
Wakamarina Valley, New Zealand	2020-05-12	6	75	17	23	0.7347
Ergastulum	2020-11-05	8	53	11	19	0.7347
Areia	2020-01-16	9	53	11	20	0.7347
Path of Redemption	2020-01-23	6	53	11	17	0.7347
LIBERATED	2020-07-30	55	502	147	202	0.7345999999999999
LolliPop: The Best Indie Game	2020-05-27	6	17	2	8	0.7345
Carrier Trail	2020-07-01	8	17	2	10	0.7345
ARCADE	2020-10-14	11	17	2	13	0.7345
Infinite Dronin	2020-04-27	4	17	2	6	0.7345
Wise Escape From Prison (현명한 감옥 탈출기)	2020-02-24	2	17	2	4	0.7345
Get Over Here!	2020-05-16	3	17	2	5	0.7345
Boinihi: The Ki Codex	2020-05-27	4	17	2	6	0.7345
The lost Labyrinth	2020-05-31	8	17	2	10	0.7345
My Creampie Heaven	2020-07-24	5	17	2	7	0.7345
Retro War	2020-07-17	2	17	2	4	0.7345
仙境之夜：白兔奇幻记	2020-12-29	10	17	2	12	0.7345
High Speed Cataclysm	2020-12-03	2	17	2	4	0.7345
Chess Destroyer	2020-12-22	5	17	2	7	0.7345
Love n Dream	2020-08-27	70	261	72	142	0.7343999999999999
Vampire: The Masquerade - Shadows of New York	2020-09-10	308	860	262	570	0.7343000000000001
Rover Mechanic Simulator	2020-11-12	171	444	129	300	0.7343000000000001
Orwell's Animal Farm	2020-12-10	30	110	27	57	0.7342000000000001
STRIKERS 1945 III	2020-06-30	19	49	10	29	0.7341
Team up with A Magician	2020-08-14	7	49	10	17	0.7341
Popup Dungeon	2020-08-12	661	722	218	879	0.7340000000000001
Mutant Ops	2020-12-25	238	440	128	366	0.7340000000000001
Shanghai Office Simulator	2020-10-27	804	366	105	909	0.7337
风流刀客	2020-07-16	152	318	90	242	0.7337
Tesla Force	2020-11-19	45	154	40	85	0.7337
Paradox Vector	2020-10-15	7	45	9	16	0.7336
Teleporter: World of Gamers (Alpha)	2020-05-17	18	45	9	27	0.7336
Love Mystery Club	2020-07-30	5	85	20	25	0.7334999999999999
Dark Nights with Poe and Munro	2020-05-19	50	298	84	134	0.7334
Rustler: Prologue	2020-04-09	94	310	88	182	0.7329000000000001
Prehistoric Hunt	2020-12-01	48	109	27	75	0.7329000000000001
The Unexpected Quest Prologue	2020-10-07	16	74	17	33	0.7329000000000001
Soccer Manager 2020	2020-01-29	1126	1147	359	1485	0.7327
Elmarion: Dragon time	2020-03-12	21	427	125	146	0.7327
Case 00: The Cannibal Boy	2020-09-18	4	95	23	27	0.7327
Lantern Bearer	2020-09-10	4	21	3	7	0.7327
Magnia	2020-01-10	3	21	3	6	0.7327
Hentai Harem	2020-03-27	3	21	3	6	0.7327
Operator	2020-08-05	4	21	3	7	0.7327
Sky Journey - Jigsaw Landscapes	2020-11-06	3	21	3	6	0.7327
AOD: Art Of Defense	2020-12-01	111	209	57	168	0.7326
Abyss Crew	2020-04-30	9	7	0	9	0.7326
GORSD	2020-09-18	4	7	0	4	0.7326
FIL	2020-08-01	3	7	0	3	0.7326
georifters	2020-05-29	6	7	0	6	0.7326
Eclipse Horde	2020-07-12	3	7	0	3	0.7326
Gator Parade	2020-04-10	1	7	0	1	0.7326
Heart in the Cell: Rebirth	2020-09-13	3	7	0	3	0.7326
Mystic Hammer	2020-10-23	3	7	0	3	0.7326
Tin & Kuna	2020-09-10	4	7	0	4	0.7326
Carpet Bombing	2020-01-09	3	7	0	3	0.7326
Chuhou Joutai	2020-05-21	2	7	0	2	0.7326
Frostfire Planet	2020-10-14	5	7	0	5	0.7326
Spookyard	2020-11-08	5	7	0	5	0.7326
Castle Torgeath Redux	2020-02-21	3	7	0	3	0.7326
Beardy McStrongarm	2020-03-17	3	7	0	3	0.7326
Lonecastle	2020-04-07	2	7	0	2	0.7326
Galactic Protection Squad | Episode 1	2020-04-27	1	7	0	1	0.7326
SokoBunny	2020-05-22	4	7	0	4	0.7326
Immortal Love: Stone Beauty Collector's Edition	2020-02-14	5	7	0	5	0.7326
Thrillgate	2020-04-07	3	7	0	3	0.7326
KnightRoyale	2020-04-19	3	7	0	3	0.7326
Turniej Robotów	2020-03-19	2	7	0	2	0.7326
Gunslingers of the Wasteland vs. The Zombies From Mars	2020-06-22	2	7	0	2	0.7326
Daiichi Dash	2020-04-26	2	7	0	2	0.7326
Watch&Run	2020-05-05	5	7	0	5	0.7326
Defenders of the West	2020-12-01	5	7	0	5	0.7326
MIBT	2020-08-09	2	7	0	2	0.7326
Tiki Tiki: The Tropical Memory Game	2020-08-28	2	7	0	2	0.7326
ASTROVITY	2020-09-03	3	7	0	3	0.7326
KOORING VR Coding Adventure	2020-08-24	2	7	0	2	0.7326
Rolling Cube	2020-06-03	2	7	0	2	0.7326
Tekling 2: Overdrive	2020-06-01	14	7	0	14	0.7326
HTD	2020-10-01	3	7	0	3	0.7326
Roll The World	2020-08-14	2	7	0	2	0.7326
Cannon Father	2020-06-24	2	7	0	2	0.7326
Captain Clive: Danger From Dione	2020-08-07	2	7	0	2	0.7326
Sheng Tian (升天) - Episode 1	2020-07-31	3	7	0	3	0.7326
Rock Paper SHIFT	2020-07-10	3	7	0	3	0.7326
RealFit	2020-08-28	3	7	0	3	0.7326
シルヴァリオ トリニティ-Beyond the Horizon-	2020-09-03	7	7	0	7	0.7326
Escape from Poalet 	2020-09-11	3	7	0	3	0.7326
Gerrymander Madness: The Anti-Democracy VR Game	2020-07-28	1	7	0	1	0.7326
Shattered Worlds	2020-09-03	6	7	0	6	0.7326
Refraction	2020-08-28	3	7	0	3	0.7326
Spartoi Meadow	2020-08-24	3	7	0	3	0.7326
Otti: house keeper	2020-08-26	3	7	0	3	0.7326
Jet Set Corps	2020-11-11	5	7	0	5	0.7326
Stick Knight Takes Over the Universe	2020-08-28	2	7	0	2	0.7326
Frogworld	2020-08-14	2	7	0	2	0.7326
City 13	2020-10-13	2	7	0	2	0.7326
Balconing Simulator 2020	2020-08-28	5	7	0	5	0.7326
Breadbox Game Pack	2020-08-13	8	7	0	8	0.7326
The Perfect Shape	2020-12-18	2	7	0	2	0.7326
Dimetrosaur 2	2020-09-02	1	7	0	1	0.7326
A Forgetful Loop	2020-11-06	2	7	0	2	0.7326
Finger Breaker	2020-11-30	2	7	0	2	0.7326
Secret of The Lost Keys - Episode I: The Attack on Disred 	2020-10-06	6	7	0	6	0.7326
Griddlers TED and PET	2020-10-30	5	7	0	5	0.7326
Gizmos: Spirit Of The Christmas	2020-12-15	8	7	0	8	0.7326
Vectro Blast	2020-11-19	5	7	0	5	0.7326
Marcella Moon: Saboteurs on the River	2020-10-29	2	7	0	2	0.7326
XOB	2020-11-20	2	7	0	2	0.7326
Forest Battle 森林战斗	2020-12-29	3	7	0	3	0.7326
Path of Memory	2020-12-27	2	7	0	2	0.7326
Cyber Crush 2069	2020-12-12	343	586	176	519	0.7325
The Strange Story Of Brian Fisher: Chapter 1	2020-04-29	8	37	7	15	0.7325
Kingdoms of Amalur: Re-Reckoning	2020-09-08	6390	4123	1367	7757	0.7322
REZ PLZ	2020-07-15	18	33	6	24	0.7321
God of Gym	2020-01-03	7	33	6	13	0.7321
Pejes Vs Zombies	2020-03-09	8	33	6	14	0.7321
Sky Cannoneer	2020-02-20	5	25	4	9	0.7320000000000001
Antarctic Heritage Trust	2020-07-24	11	25	4	15	0.7320000000000001
Overslept	2020-11-22	5	25	4	9	0.7320000000000001
Total Lockdown	2020-03-25	392	627	190	582	0.7319
Creature Romances: For the Ladies	2020-10-31	5	29	5	10	0.7319
HyperDot	2020-01-31	6	29	5	11	0.7319
Up in the Air	2020-02-21	11	29	5	16	0.7319
Street Hoop	2020-01-01	4	29	5	9	0.7319
Sokpop S04: kraken's curse	2020-01-17	7	29	5	12	0.7319
BUGWORLD:ONLINE PRESENTS MITCH MAKER	2020-09-28	4	29	5	9	0.7319
Starfighter General	2020-11-22	4	12	1	5	0.7319
Hive Slayer	2020-10-27	5	12	1	6	0.7319
The Last Monsters	2020-03-20	4	12	1	5	0.7319
Unlanded	2020-04-28	3	12	1	4	0.7319
Heart of Smoke	2020-03-23	2	12	1	3	0.7319
Gerritory	2020-10-24	8	12	1	9	0.7319
Axe Cop	2020-11-26	7	12	1	8	0.7319
Infection	2020-01-08	10	12	1	11	0.7319
Mix-Sign: Girl with 3 Signs	2020-01-06	2	12	1	3	0.7319
Cut Smash Wrap	2020-01-03	2	12	1	3	0.7319
Farmer Pug Dash	2020-01-31	4	12	1	5	0.7319
Tribloos	2020-02-19	108	12	1	109	0.7319
Relentless	2020-03-13	5	12	1	6	0.7319
Cuyo	2020-04-29	4	12	1	5	0.7319
GANZWORKER	2020-03-11	2	12	1	3	0.7319
BadBee	2020-07-25	2	12	1	3	0.7319
曙光之诗	2020-07-30	13	12	1	14	0.7319
Wild Gun	2020-12-10	3	12	1	4	0.7319
Milo's Quest	2020-07-29	3	12	1	4	0.7319
R E A L I T Y	2020-10-30	2	12	1	3	0.7319
1 For Yes, 0 For No	2020-11-06	2	12	1	3	0.7319
Tales of Lagoona	2020-12-16	7	12	1	8	0.7319
The Christmas Spirit: Journey Before Christmas Collector's Edition	2020-12-14	7	12	1	8	0.7319
ManaRocks	2020-05-29	110	279	79	189	0.7318000000000001
Operation Sniff	2020-06-13	7	59	13	20	0.7316
The World Is Ruled According to Sexual Prowess So I’m Playing Dirty to Get My Harem EP1	2020-01-20	5	59	13	18	0.7316
Sakura Knight	2020-01-31	14	59	13	27	0.7316
Lost Circus VR	2020-04-24	4	59	13	17	0.7316
TRANSFORMERS: BATTLEGROUNDS	2020-10-23	14	66	15	29	0.7313
DreadOut 2	2020-02-21	374	1158	366	740	0.7312000000000001
Hentai Chicks 2	2020-11-07	5	111	28	33	0.7311
Kingdom Under Fire: Heroes	2020-06-24	131	271	77	208	0.7309
Pizza Master VR	2020-03-06	10	55	12	22	0.7308
Organosphere	2020-07-23	6	44	9	15	0.7308
Aristocunts	2020-06-12	13	183	50	63	0.7302
Need for Speed™ Rivals	2020-06-04	415	3924	1315	1730	0.7301000000000001
Tour de France 2020	2020-08-27	191	160	43	234	0.73
四国志 ～酒池肉面战记～	2020-08-22	11	51	11	22	0.7299
H-Rescue	2020-01-30	160	381	113	273	0.7293999999999999
Panzer Paladin	2020-07-21	106	378	112	218	0.7293999999999999
After You	2020-10-01	7	65	15	22	0.7293000000000001
Bouboum	2020-12-17	16	65	15	31	0.7293000000000001
My Goddess of Love	2020-04-23	4	36	7	11	0.7293000000000001
The Falconeer	2020-11-10	67	249	71	138	0.7292000000000001
Per Aspera	2020-12-03	8274	3509	1179	9453	0.7290000000000001
Crisis VRigade	2020-02-11	19	204	57	76	0.7289
Deep the Game	2020-01-11	85	702	219	304	0.7286
The Last Sky	2020-06-26	8	32	6	14	0.7286
Glasses and Girls	2020-10-23	3	32	6	9	0.7286
To The Sea : The Courier	2020-01-03	14	16	2	16	0.7286
Folding Edge	2020-03-30	4	16	2	6	0.7286
New Yankee 8: Journey of Odysseus	2020-05-07	13	16	2	15	0.7286
Grit Paintball	2020-06-19	4	16	2	6	0.7286
Traurig Secrets: Prologue	2020-08-28	4	16	2	6	0.7286
Super Nate Adventure	2020-08-21	5	16	2	7	0.7286
Sphere Game	2020-08-05	4	16	2	6	0.7286
Space Architect	2020-11-25	4	16	2	6	0.7286
无名录	2020-10-10	8	16	2	10	0.7286
ココロクローバー パート2/Kokoro Clover Part2	2020-12-28	3	16	2	5	0.7286
Waiting For The Raven	2020-12-22	46	54	12	58	0.7284
Devious Dungeon 2	2020-10-21	8	61	14	22	0.7283
Sex Lesson	2020-08-22	6	61	14	20	0.7283
Alien Shooter - Last Hope	2020-11-06	27	161	44	71	0.728
Cyberpunk SFX	2020-11-29	35	43	9	44	0.728
Damascus	2020-05-15	93	193	54	147	0.7279000000000001
Blockicker	2020-06-17	5	28	5	10	0.7279000000000001
Armoured Commander	2020-07-20	9	28	5	14	0.7279000000000001
Evenicle 2 - Clinical Trial Edition	2020-08-18	149	180	50	199	0.7277
Projection: First Light	2020-09-29	9	20	3	12	0.7276
On The Verge II	2020-07-29	2	20	3	5	0.7276
Lily's Handmaid	2020-04-24	10	20	3	13	0.7276
Escape from Life Inc	2020-05-29	8	20	3	11	0.7276
Chronostation	2020-03-02	5	20	3	8	0.7276
Mahjong Deluxe	2020-05-20	31	20	3	34	0.7276
Drekirokr - Dusk of the Dragon	2020-06-10	4	20	3	7	0.7276
Stress explosion	2020-06-21	11	20	3	14	0.7276
Bishoujo Battle Cyber Panic!	2020-06-19	5	20	3	8	0.7276
Pier Pressure	2020-11-14	8	20	3	11	0.7276
Just Arms	2020-04-19	21	24	4	25	0.7275
Infection Maze	2020-05-27	11	24	4	15	0.7275
Guildmaster: Gratuitous Subtitle	2020-12-07	8	24	4	12	0.7275
Get Ogre It	2020-11-30	602	24	4	606	0.7275
Two Parsecs From Earth	2020-10-16	5	24	4	9	0.7275
My Strange Girlfriends	2020-04-22	5	50	11	16	0.7273999999999999
Em-A-Li	2020-01-02	3	39	8	11	0.7270000000000001
D3D INSIDE 2: HELL	2020-03-10	6	39	8	14	0.7270000000000001
PHAGEBORN online card game	2020-02-07	61	91	23	84	0.7268000000000001
The Imagined Leviathan	2020-09-23	147	124	33	180	0.7267
Threshold	2020-03-12	27	153	42	69	0.7265
Strip 4: Classmate Study	2020-02-29	154	337	101	255	0.7263
Soul Axiom Rebooted	2020-02-27	7	46	10	17	0.7263
Close Combat: Wacht am Rhein	2020-05-07	34	46	10	44	0.7263
Family Mysteries: Poisonous Promises	2020-03-26	28	143	39	67	0.7262000000000001
Pirates? Pirates!	2020-03-30	15	53	12	27	0.726
Tower of Shades	2020-01-16	4	35	7	11	0.7259000000000001
Player's Eleven	2020-02-12	15	35	7	22	0.7259000000000001
Green Elephant: Epilogue	2020-02-14	6	35	7	13	0.7259000000000001
Boreal Tales	2020-05-19	5	35	7	12	0.7259000000000001
Lost Lands: Redemption	2020-12-30	20	35	7	27	0.7259000000000001
Stowaway	2020-11-06	128	433	133	261	0.7256999999999999
Wanking Simulator	2020-03-19	22	262	77	99	0.7256999999999999
Hentai Honeys Slider	2020-02-14	12	110	29	41	0.7255
Bed Lying Simulator	2020-01-16	4	100	26	30	0.7253000000000001
Field Hospital: Dr. Taylor's Story	2020-11-27	4	42	9	13	0.7251000000000001
Lord of Dwarves	2020-05-23	35	56	13	48	0.7249
Mighty Fling	2020-07-20	36	49	11	47	0.7248
DreamWatcher	2020-11-27	11	49	11	22	0.7248
Prison Forever	2020-01-17	4	31	6	10	0.7248
Smashing Spirits: Brazil’s First Boxer	2020-09-10	9	31	6	15	0.7248
RollerBaller	2020-11-14	10	31	6	16	0.7248
Welcome to Emba	2020-12-23	5	31	6	11	0.7248
Red Rage	2020-12-11	3	31	6	9	0.7248
For the People	2020-08-13	294	460	143	437	0.7245999999999999
Falcon Age	2020-10-08	80	135	37	117	0.7245
Deadly Land	2020-02-24	23	96	25	48	0.7243
Shenmue III	2020-11-19	335	716	230	565	0.7242000000000001
The Celtos	2020-03-06	52	109	29	81	0.7242000000000001
JMPR	2020-09-17	2	11	1	3	0.7242000000000001
Stream Battlecards	2020-01-20	6	11	1	7	0.7242000000000001
Dragon Fight VR	2020-03-05	2	11	1	3	0.7242000000000001
Roads Of Time	2020-02-17	5	11	1	6	0.7242000000000001
BEETLES	2020-11-14	6	11	1	7	0.7242000000000001
Rocket Ghost Aidan	2020-01-14	2	11	1	3	0.7242000000000001
Millions of Minions	2020-12-20	4	11	1	5	0.7242000000000001
Protoball Beta	2020-10-02	10	11	1	11	0.7242000000000001
Mosquitoes and zombies	2020-04-29	2	11	1	3	0.7242000000000001
看白海豚的好日子	2020-05-23	2	11	1	3	0.7242000000000001
Asteroids 44 (For Four)	2020-07-30	5	11	1	6	0.7242000000000001
Break Space: Out of Bounds	2020-06-25	3	11	1	4	0.7242000000000001
Robotic Learn	2020-08-01	2	11	1	3	0.7242000000000001
Specimen 13	2020-07-29	7	11	1	8	0.7242000000000001
SPL: Skilled Pilots Live	2020-12-01	3	11	1	4	0.7242000000000001
Where Is My Parking Spot	2020-11-10	5	11	1	6	0.7242000000000001
Lost Keys	2020-12-18	1	11	1	2	0.7242000000000001
梦境实验	2020-10-13	5	11	1	6	0.7242000000000001
Mygnar	2020-10-01	3	11	1	4	0.7242000000000001
Funtime with Buffy	2020-11-30	3	11	1	4	0.7242000000000001
Notruf 112 - Die Feuerwehr Simulation 2: Showroom	2020-04-07	66	76	19	85	0.7241
Seek Girl Ⅳ	2020-01-10	484	1422	475	959	0.7239
Divine Miko Koyori	2020-01-31	453	386	119	572	0.7238
Fighters Wizards	2020-04-18	8	38	8	16	0.7238
Aladdin - Hidden Objects Game	2020-04-24	10	38	8	18	0.7238
100 RUB: Operation Global Denomination	2020-09-04	4	38	8	12	0.7238
Forest and Girls	2020-10-24	3	38	8	11	0.7238
Syntherapy	2020-10-15	4	27	5	9	0.7238
MechCube: Escape	2020-06-16	31	27	5	36	0.7238
lil' Sherman	2020-02-19	4	27	5	9	0.7238
Homeland: Lay to Rest	2020-06-23	5	27	5	10	0.7238
WAIFU HELL	2020-03-24	2524	614	196	2720	0.7237
Kirchhoff's Revenge	2020-01-01	18	89	23	41	0.7236
Sanguine Rose	2020-04-17	56	102	27	83	0.7234999999999999
Burning Knight	2020-06-05	28	79	20	48	0.7234999999999999
Kinky Fight Club	2020-09-29	35	79	20	55	0.7234999999999999
Awkward Girls	2020-06-02	7	79	20	27	0.7234999999999999
My Dangerous Life	2020-07-23	13	45	10	23	0.7234999999999999
Unlock The King 3	2020-03-17	5	45	10	15	0.7234999999999999
Yes, Master!	2020-02-14	148	736	238	386	0.7234
Hellpoint	2020-07-30	1911	2827	975	2886	0.7232
Wild West and Wizards	2020-04-28	124	279	84	208	0.7231000000000001
Endless Escape	2020-08-20	9	62	15	24	0.723
Rage of Car Force: Car Crashing Games	2020-07-30	178	669	216	394	0.7228
Harem Girl: Evie	2020-04-12	5	23	4	9	0.7228
Starship Horizons Bridge Simulator	2020-09-18	7	23	4	11	0.7228
The Firelord	2020-11-22	6	23	4	10	0.7228
VIY	2020-04-18	12	23	4	16	0.7228
Rise of SamuraizerzZz	2020-12-08	4	23	4	8	0.7228
BOOBS SAGA: Prepare To Hentai Edition	2020-05-22	603	1811	617	1220	0.7223999999999999
Электричка	2020-06-07	4	34	7	11	0.7223999999999999
100 Doors Game - Escape from School	2020-03-20	117	480	152	269	0.7223
Sexy Fitness Girl	2020-04-16	114	232	69	183	0.7222
Slave Princess Sarah	2020-12-12	20	75	19	39	0.7222
Nations At War Digital: Core Game	2020-04-25	57	75	19	76	0.7222
Alpacapaca Double Dash	2020-01-29	3	15	2	5	0.7222
Underponder	2020-12-22	5	15	2	7	0.7222
Phantom Path	2020-05-15	3	15	2	5	0.7222
Escalation: Aggressors	2020-02-01	5	15	2	7	0.7222
Paug	2020-06-23	23	15	2	25	0.7222
Chickduck & Catduck	2020-03-22	2	15	2	4	0.7222
Vaccine	2020-04-13	7	15	2	9	0.7222
Shooty Skies Overdrive	2020-08-07	2	15	2	4	0.7222
Out of Shapes	2020-05-19	3	15	2	5	0.7222
Midnight Renegade	2020-06-26	3	15	2	5	0.7222
Antadin DX	2020-09-01	4	15	2	6	0.7222
Asteroids... But Roguelite	2020-09-22	3	15	2	5	0.7222
The Benza RPG	2020-11-01	3	15	2	5	0.7222
Agent of Chaos	2020-12-22	3	15	2	5	0.7222
Color Cube	2020-12-27	2	15	2	4	0.7222
Jay and Silent Bob: Mall Brawl	2020-05-07	21	48	11	32	0.7221
Feast Your Eyes: Little Marshmallow	2020-08-11	7	19	3	10	0.7221
Cubers: Arena	2020-07-28	4	19	3	7	0.7221
Hexogin	2020-05-07	8	19	3	11	0.7221
Adventure Boy Jailbreak	2020-01-25	137	19	3	140	0.7221
Knockout Daddy	2020-02-05	3	19	3	6	0.7221
Incredible Dracula: Ocean's Call	2020-02-27	15	19	3	18	0.7221
War Islands	2020-06-29	7	19	3	10	0.7221
Dirt Bike Motocross Stunts	2020-05-11	40	19	3	43	0.7221
Bulldozer	2020-07-31	3	19	3	6	0.7221
Roads of Rome: New Generation 3 Collector's Edition	2020-11-05	26	19	3	29	0.7221
Enypnion	2020-11-17	4	19	3	7	0.7221
Art of Beauties	2020-01-23	3	41	9	12	0.7220000000000001
SamuraiCooking	2020-06-19	12	41	9	21	0.7220000000000001
RedEX	2020-11-26	17	91	24	41	0.7217
Catapult King	2020-06-26	4	6	0	4	0.7217
Stratside	2020-06-14	37	6	0	37	0.7217
Wira & Taksa: Against the Master of Gravity	2020-08-27	3	6	0	3	0.7217
Necro Wars	2020-01-10	3	6	0	3	0.7217
囧之国	2020-10-09	3	6	0	3	0.7217
BattleCourt	2020-12-22	3	6	0	3	0.7217
UpBoll	2020-07-29	2	6	0	2	0.7217
Convergence Compulsion	2020-07-31	5	6	0	5	0.7217
Thistledown: A Tragedy of Blood.	2020-05-29	2	6	0	2	0.7217
Mondrian - Plastic Reality	2020-09-22	8	6	0	8	0.7217
Clarevoyance	2020-12-17	2	6	0	2	0.7217
Shrine to Anubis	2020-05-14	2	6	0	2	0.7217
Restaurant Solitaire: Pleasant Dinner	2020-01-13	4	6	0	4	0.7217
Pamp Quest	2020-02-20	2	6	0	2	0.7217
Skull Head World	2020-08-07	2	6	0	2	0.7217
Together - A Wish No One Remembers	2020-01-20	3	6	0	3	0.7217
Taurus VR	2020-01-17	2	6	0	2	0.7217
Egypt Solitaire. Match 2 Cards	2020-01-27	5	6	0	5	0.7217
Coffee Break	2020-01-18	3	6	0	3	0.7217
Coin Commander	2020-01-20	2	6	0	2	0.7217
Shine's Adventures 4 (Nightmare)	2020-03-13	2	6	0	2	0.7217
Sweet Holiday Jigsaws: Halloween Night	2020-10-30	2	6	0	2	0.7217
Factory Rally Madness	2020-03-07	2	6	0	2	0.7217
Jumping Mellow	2020-03-23	3	6	0	3	0.7217
XenovaderS	2020-04-19	2	6	0	2	0.7217
Inner Worlds	2020-05-15	2	6	0	2	0.7217
Riposte!	2020-04-29	4	6	0	4	0.7217
GlowyJump	2020-02-21	2	6	0	2	0.7217
Up on the Rooftop	2020-11-02	2	6	0	2	0.7217
Climb the Tower	2020-11-20	2	6	0	2	0.7217
Red Zirion	2020-02-25	2	6	0	2	0.7217
Senshi Tank 2: Space Bots	2020-06-05	2	6	0	2	0.7217
The School Leaving Day	2020-07-16	3	6	0	3	0.7217
The Legacy: Realm of Terror	2020-10-02	3	6	0	3	0.7217
Deeproot Manor	2020-05-23	4	6	0	4	0.7217
Mindframe: The Secret Design Collector's Edition	2020-03-06	5	6	0	5	0.7217
Code Arcturus	2020-08-30	2	6	0	2	0.7217
Madness Fantasy	2020-04-10	3	6	0	3	0.7217
Weaving Tides: Prologue	2020-05-26	6	6	0	6	0.7217
Tuneria	2020-10-23	3	6	0	3	0.7217
Dingleberries	2020-12-07	2	6	0	2	0.7217
Solenars Edge II: Aurora of The Seventh Dawn	2020-06-08	2	6	0	2	0.7217
Beatitas	2020-05-22	2	6	0	2	0.7217
Bad Run - Turbo Edition	2020-04-21	2	6	0	2	0.7217
Way of Boy: Another Way	2020-05-09	2	6	0	2	0.7217
ARCHiTECTUS	2020-08-07	3	6	0	3	0.7217
No One But You	2020-07-30	2	6	0	2	0.7217
Intemporel	2020-05-28	4	6	0	4	0.7217
SnowFighters	2020-08-08	5	6	0	5	0.7217
シルヴァリオ ラグナロク	2020-05-28	4	6	0	4	0.7217
Pyro Fighters	2020-05-15	3	6	0	3	0.7217
My Mud Game	2020-05-29	2	6	0	2	0.7217
Obsolete Souls™	2020-09-29	2	6	0	2	0.7217
Hunting Unlimited 2	2020-09-04	6	6	0	6	0.7217
Droid Guier	2020-06-30	2	6	0	2	0.7217
Da! Russian Quiz	2020-06-16	2	6	0	2	0.7217
Color Security	2020-09-06	2	6	0	2	0.7217
Bunny Memory	2020-06-19	3	6	0	3	0.7217
Five Steps From Hell	2020-07-09	2	6	0	2	0.7217
Whirlibird	2020-07-31	2	6	0	2	0.7217
Fort Golf	2020-09-02	2	6	0	2	0.7217
Portability	2020-10-09	2	6	0	2	0.7217
Element X	2020-10-09	4	6	0	4	0.7217
Election 2020: Battle for the Throne	2020-11-02	2	6	0	2	0.7217
BAL Solid	2020-07-23	1	6	0	1	0.7217
Jigsaw Puzzle: Master Artists of Old	2020-08-08	5	6	0	5	0.7217
Rewrite - DYH	2020-07-31	3	6	0	3	0.7217
Dental Madness: Cavity Mania	2020-08-18	1	6	0	1	0.7217
YRek Lost In Portals	2020-08-13	2	6	0	2	0.7217
Eyes of The Mirror	2020-08-06	2	6	0	2	0.7217
NYAF	2020-11-09	4	6	0	4	0.7217
OUBEY VR – Reise der Monaden	2020-08-11	1	6	0	1	0.7217
Aurora	2020-10-20	4	6	0	4	0.7217
Mahjong Carnaval	2020-08-28	4	6	0	4	0.7217
BLASK 2	2020-12-02	2	6	0	2	0.7217
용가리 용용(Cute dragon Yongyong)	2020-09-15	2	6	0	2	0.7217
Hexagroove: Tactical DJ	2020-10-27	3	6	0	3	0.7217
Human-Like	2020-12-22	2	6	0	2	0.7217
The Spiral Labyrinth	2020-09-29	2	6	0	2	0.7217
POPPIN' DONUTS	2020-09-18	2	6	0	2	0.7217
4X4 Masters	2020-09-25	2	6	0	2	0.7217
Fairytale Mosaics Cinderella	2020-10-30	3	6	0	3	0.7217
Wark & Wimble	2020-10-19	3	6	0	3	0.7217
Ayoub	2020-12-21	6	6	0	6	0.7217
StrateZ	2020-10-23	4	6	0	4	0.7217
The Chronicles of Moses and the Exodus	2020-10-27	4	6	0	4	0.7217
Revenge on the Streets 2	2020-12-25	2	6	0	2	0.7217
Lotharus - Bacon, Ale & Repeat	2020-12-24	1	6	0	1	0.7217
Catch a cat for 60 seconds	2020-12-04	4	6	0	4	0.7217
Starship Turd Nugget: Too Cool For Stool	2020-12-14	2	6	0	2	0.7217
Hentai Two Girls	2020-03-19	5	58	14	19	0.7216
Unmemory	2020-10-13	7	58	14	21	0.7216
MindSeize	2020-02-07	34	206	61	95	0.7211
Ironlights	2020-04-09	30	135	38	68	0.721
Big Mutha Truckers 2	2020-09-01	8	51	12	20	0.721
AKER FERN	2020-06-29	7	71	18	25	0.7209000000000001
Quest? Quest!	2020-11-14	16	30	6	22	0.7209000000000001
UldreVoid	2020-05-14	6	30	6	12	0.7209000000000001
Chroma	2020-12-09	5	30	6	11	0.7209000000000001
Aery - Broken Memories	2020-11-13	12	30	6	18	0.7209000000000001
Prime & Load: 1776	2020-11-25	123	269	82	205	0.7208
Boss Rush: Mythology	2020-07-10	12	84	22	34	0.7208
Bodyless	2020-09-15	997	44	10	1007	0.7206
Hentai Sakyubus	2020-01-24	3	37	8	11	0.7205
Cannibal Cuisine	2020-05-20	40	74	19	59	0.7204
Invasion Machine	2020-02-26	68	374	118	186	0.7199
Escape: The Brother's Saloon	2020-05-05	41	77	20	61	0.7199
Artificial Extinction	2020-03-13	73	192	57	130	0.7197
Shing!	2020-08-28	67	228	69	136	0.7195
Lunch A Palooza	2020-05-14	4	26	5	9	0.7194
迷失 赛博之城	2020-05-22	9	26	5	14	0.7194
Greedy Dungeon	2020-07-22	9	26	5	14	0.7194
Tattoo and Girls	2020-09-30	3	26	5	8	0.7194
Jumping Knight	2020-12-17	4	26	5	9	0.7194
Quest: Escape Room 2	2020-12-15	4	26	5	9	0.7194
Builders of Egypt: Prologue	2020-03-02	918	2875	1015	1933	0.7192000000000001
Obsurity	2020-02-24	14	161	47	61	0.7192000000000001
Lawyer Guy: Defender of Justice	2020-11-06	26	99	27	53	0.7192000000000001
Religion inc	2020-10-16	236	70	18	254	0.7190000000000001
Kaion Tale MMORPG	2020-04-23	63	188	56	119	0.7189
Speaking Simulator	2020-01-30	12	40	9	21	0.7189
Atlantis Royale	2020-06-05	9	40	9	18	0.7189
Hentai Karada	2020-04-02	5	40	9	14	0.7189
Hentai Cool Girls	2020-08-25	4	40	9	13	0.7189
HOT HENTAI PUZZLE VOL.1	2020-12-01	5	40	9	14	0.7189
Franchise Hockey Manager 7	2020-12-16	248	194	58	306	0.7188
Selfless Heroes	2020-04-14	44	33	7	51	0.7187
Lone Land	2020-07-16	6	50	12	18	0.7184
NECROSIS : RECONFIGURATED	2020-09-24	17	50	12	29	0.7184
Effie	2020-01-28	237	297	93	330	0.7182
Greed Knights	2020-10-27	62	92	25	87	0.7182
Evil Democracy: 1932	2020-10-02	42	367	117	159	0.7181000000000001
Solar Purge	2020-07-29	10	22	4	14	0.7178
Woden GP	2020-08-31	6	22	4	10	0.7178
Sword Game	2020-08-21	8	22	4	12	0.7178
Naked Warrior	2020-08-31	6	22	4	10	0.7178
Re:Turn - One Way Trip	2020-10-14	26	101	28	54	0.7176
Getaway Storm	2020-02-07	8	53	13	21	0.7176
Blueplanet VR	2020-06-15	7	43	10	17	0.7176
12 bananas	2020-09-16	5	138	40	45	0.7175
Void Source	2020-08-22	749	82	22	771	0.7173999999999999
As Far As The Eye	2020-09-10	1532	1425	495	2027	0.7173
Syberia The World Before - Prologue	2020-10-08	294	1037	355	649	0.7173
Charterstone: Digital Edition	2020-03-26	292	177	53	345	0.7172
Brain Break	2020-11-18	15	113	32	47	0.7170000000000001
Risen Kingdom	2020-02-28	146	239	74	220	0.7169
GOD STARFIGHTER	2020-02-04	6	29	6	12	0.7169
Bunker Defense	2020-10-14	13	29	6	19	0.7169
Rocky Planet	2020-02-23	8	29	6	14	0.7169
My Silly Life	2020-07-29	3	29	6	9	0.7169
Langrisser I & II	2020-03-10	418	510	168	586	0.7168000000000001
Guardians of the Ashes	2020-05-31	180	335	107	287	0.7167
絶望プリズン	2020-02-14	261	360	116	377	0.7162999999999999
Star Goddess	2020-03-07	3	18	3	6	0.7162999999999999
Harem Girl: Samantha	2020-04-08	6	18	3	9	0.7162999999999999
Kili's treasure	2020-01-20	3	18	3	6	0.7162999999999999
Hold 10 Seconds	2020-05-08	5	18	3	8	0.7162999999999999
Hooplord	2020-04-09	2	18	3	5	0.7162999999999999
Amends VR	2020-05-13	2	18	3	5	0.7162999999999999
Mine Dungeon2 ~Rurumu's trip~	2020-09-29	6	18	3	9	0.7162999999999999
Algebra Ridge	2020-11-30	2	18	3	5	0.7162999999999999
The Schizophrenic Dynasty of Müller	2020-11-02	5	18	3	8	0.7162999999999999
StarPrey	2020-11-23	4	18	3	7	0.7162999999999999
POLYGON	2020-03-06	1247	14417	5392	6639	0.7162000000000001
Quintus and the Absent Truth	2020-10-14	19	59	15	34	0.7162000000000001
My Sweet Washing Machine!	2020-10-23	4	59	15	19	0.7162000000000001
Soccer Manager 2021	2020-12-16	1187	1483	520	1707	0.716
Dead Dreams	2020-02-06	13	39	9	22	0.7156999999999999
Fallout 76	2020-04-14	32982	60650	23253	56235	0.7155
Chef	2020-08-20	572	905	311	883	0.7155
Home Life Simulator	2020-05-22	8	118	34	42	0.7155
Wizards: Wand of Epicosity	2020-08-04	4	10	1	5	0.7155
Age of Pixels	2020-04-01	4	10	1	5	0.7155
Dave-Man	2020-07-15	3	10	1	4	0.7155
Future Girls	2020-08-14	8	10	1	9	0.7155
Adrift Arena	2020-02-18	2	10	1	3	0.7155
Thunder Kid II	2020-01-29	2	10	1	3	0.7155
Catlandia: Crisis at Fort Pawprint	2020-02-26	3	10	1	4	0.7155
RESPITE 2.0	2020-06-20	1	10	1	2	0.7155
Virtual Viking	2020-04-08	6	10	1	7	0.7155
Stolen Rage	2020-03-20	2	10	1	3	0.7155
My Sail And My Sea	2020-06-30	2	10	1	3	0.7155
Tanklike	2020-07-01	4	10	1	5	0.7155
Truzzle	2020-07-10	3	10	1	4	0.7155
シルヴァリオ ヴェンデッタ-Verse of Orpheus-	2020-09-03	12	10	1	13	0.7155
Traphouse Druglord	2020-08-17	3	10	1	4	0.7155
Zombies Must Die	2020-09-01	3	10	1	4	0.7155
The Fire	2020-12-10	4	10	1	5	0.7155
Eldrador Creatures 	2020-11-19	11	10	1	12	0.7155
Pulut Adventure RPG	2020-09-10	5	10	1	6	0.7155
Elmo's Kangaroo of the damned: PUNISHMENT EDITION	2020-11-12	3	10	1	4	0.7155
Secrets of Magic 4: Potion Master	2020-12-22	6	10	1	7	0.7155
Movie Tycoon Simulator 2020	2020-11-26	3	10	1	4	0.7155
Digital Paintball Redux	2020-04-07	12	65	17	29	0.7153
Null & Peta -Invasion of the Queen Bug-	2020-01-31	32	65	17	49	0.7153
Kari	2020-07-14	23	87	24	47	0.7152
Miasma Caves	2020-02-28	3	14	2	5	0.7152
Double Pug Switch	2020-10-22	2	14	2	4	0.7152
Stream Animals: Free For All	2020-02-23	9	14	2	11	0.7152
Shine's Adventures 3 (Sea Fight)	2020-01-12	3	14	2	5	0.7152
迷失渡口VR	2020-03-02	3	14	2	5	0.7152
Evil Heart Fever	2020-03-24	6	14	2	8	0.7152
Queens Garden: Sakura Season	2020-05-07	9	14	2	11	0.7152
アルティメットダンジョン「紅」	2020-05-16	5	14	2	7	0.7152
HEPTAGON	2020-07-15	3	14	2	5	0.7152
Skycadia	2020-12-08	4	14	2	6	0.7152
Tantal	2020-10-22	6	14	2	8	0.7152
Jewel Match Solitaire Collector's Edition	2020-11-19	9	14	2	11	0.7152
Colonials Programme	2020-12-30	2	14	2	4	0.7152
Brave Hero	2020-12-21	2	14	2	4	0.7152
Cyber Hunter	2020-06-18	1994	7624	2832	4826	0.715
SGS Afrika Korps	2020-11-12	19	52	13	32	0.715
Tinkertown	2020-12-03	290	664	225	515	0.7149
Chronicle: Unit Eight	2020-11-23	7	32	7	14	0.7149
The Last Day Defense VR	2020-06-03	7	32	7	14	0.7149
Malmyr	2020-12-21	13	32	7	20	0.7149
Midnight Ride	2020-04-12	244	487	162	406	0.7148000000000001
Harvest Island: Demo	2020-12-18	19	96	27	46	0.7148000000000001
Wet Dog Corp	2020-05-04	6	25	5	11	0.7148000000000001
Rat Racer	2020-03-12	4	25	5	9	0.7148000000000001
Sokpop S07: Blue Drifter	2020-01-27	3	25	5	8	0.7148000000000001
Apprehend;Girlfriend	2020-06-16	5	25	5	10	0.7148000000000001
Dreamland Solitaire: Dark Prophecy	2020-07-17	14	25	5	19	0.7148000000000001
Tyrania - A Kinetic Visual Novel	2020-05-27	16	99	28	44	0.7147
Meatball	2020-12-04	5	71	19	24	0.7145999999999999
Gangsta Underground : The Poker	2020-05-04	12	42	10	22	0.7145999999999999
AeternoBlade II	2020-09-07	14	42	10	24	0.7145999999999999
Rocking Legend	2020-08-06	11	42	10	21	0.7145999999999999
Fantasy World Online Tycoon	2020-04-20	9	42	10	19	0.7145999999999999
Skydome	2020-11-10	226	212	66	292	0.7144
三国群英传4	2020-11-13	93	117	34	127	0.7143
Battle Star	2020-11-03	120	132	39	159	0.7142000000000001
Family Mysteries 3: Criminal Mindset	2020-07-16	22	77	21	43	0.7141
重明鸟 Bright Bird	2020-03-12	948	577	195	1143	0.7140000000000001
Tribal Wars	2020-11-12	509	394	130	639	0.7137000000000001
Space Wars	2020-04-24	7	45	11	18	0.7137000000000001
RogueJack: Roguelike Blackjack	2020-05-27	13	35	8	21	0.7134999999999999
BloodLust 2: Nemesis	2020-03-26	26	89	25	51	0.7134
Magical Swordmaiden	2020-12-19	209	89	25	234	0.7134
Knights and Dungeons	2020-07-12	221	92	26	247	0.7133
Folklore Hunter	2020-02-24	114	737	254	368	0.7132
Morbid: The Seven Acolytes	2020-12-03	218	663	227	445	0.7132
Bake 'n Switch	2020-08-21	31	64	17	48	0.7131000000000001
XCOM: Chimera Squad	2020-04-24	35955	15074	5740	41695	0.713
Hotshot Racing	2020-09-10	338	1061	373	711	0.713
Yuki Onna | 雪女	2020-01-03	24	113	33	57	0.713
Half-Life: Absolute Zero	2020-07-10	264	434	145	409	0.7128
Supersonic Tank Cats	2020-11-04	4	28	6	10	0.7126
Aquarius	2020-03-11	4	21	4	8	0.7125
Lorera	2020-07-15	6	21	4	10	0.7125
Rainy City: Pandemic	2020-08-10	3	21	4	7	0.7125
Rogue Summoner	2020-09-03	6	21	4	10	0.7125
Shine's Adventures 0 (Zombies Reload)	2020-07-26	5	21	4	9	0.7125
Porcini	2020-10-01	7	21	4	11	0.7125
Tenami	2020-11-20	101	21	4	105	0.7125
Sentinels of Freedom	2020-04-16	405	192	60	465	0.7123999999999999
Ashmedai: Queen of Lust	2020-06-23	22	51	13	35	0.7123999999999999
Twin-Turbo Supercharged Nitro-Fueled Papamobile	2020-07-17	9	38	9	18	0.7123
Ironsmith Simulator: Prologue	2020-06-08	27	76	21	48	0.7122
Close to the Sun	2020-05-05	89	620	213	302	0.7120000000000001
Mini Words: Top Movies	2020-04-10	9	54	14	23	0.7119
Funny Business with My Precious Coach (Anipuzzle Series)	2020-09-25	7	88	25	32	0.7118000000000001
Doomtrooper CCG	2020-08-03	27	112	33	60	0.7116
Phantasy Star Online 2 New Genesis	2020-08-05	59558	15282	5872	65430	0.7112999999999999
Lumin's Path	2020-01-25	24	60	16	40	0.7112
Sakura Knight 2	2020-06-01	18	60	16	34	0.7112
Onee Chanbara Origin	2020-10-14	234	720	251	485	0.7111
Deck of Ashes	2020-06-09	268	712	248	516	0.7111
雾之本境S	2020-06-26	25	273	89	114	0.711
Area 86	2020-04-15	8	31	7	15	0.711
CurryKitten FPV Simulator	2020-06-12	5	31	7	12	0.711
Коридоры их воспоминаний	2020-08-03	2	31	7	9	0.711
Alchemist Simulator	2020-10-23	92	233	75	167	0.7108
CORONAVIRUS BATTLEGROUNDS: Coronavirus News	2020-06-15	5	44	11	16	0.7107
Plants vs. Zombies: Battle for Neighborville	2020-06-04	2330	8302	3167	5497	0.7104
Britannic	2020-01-18	14	78	22	36	0.7101999999999999
Paranoia: Deliver Me	2020-04-29	15	99	29	44	0.7101000000000001
Quantum Suicide	2020-09-10	69	84	24	93	0.7101000000000001
DREAMO	2020-02-20	6	47	12	18	0.7101000000000001
Super Gear Quest	2020-05-05	6	17	3	9	0.71
Climbros	2020-03-10	5	17	3	8	0.71
#Funtime	2020-07-16	4	17	3	7	0.71
HEXTERMINATE	2020-05-22	7	17	3	10	0.71
Evil Cult	2020-05-13	3	17	3	6	0.71
溜冰的猪少	2020-06-01	4	17	3	7	0.71
SOL DIVIDE -SWORD OF DARKNESS-	2020-07-20	5	17	3	8	0.71
Robin Hood: Winds of Freedom	2020-08-06	15	17	3	18	0.71
Newton's Cradle Puzzle Game	2020-06-10	3	17	3	6	0.71
RE: Get To Schol On Time	2020-10-01	4	17	3	7	0.71
Perilous Warp	2020-10-20	18	209	67	85	0.7099
Adam: Robot World	2020-10-30	6	24	5	11	0.7099
Steel & Bone	2020-05-18	6	24	5	11	0.7099
Bright Days in Quarantine	2020-07-18	5	24	5	10	0.7099
Coffin Rot Brewing Co.	2020-03-13	7	34	8	15	0.7098000000000001
Infinite Tournament Paintball	2020-08-03	16	50	13	29	0.7097
Iron Harvest	2020-09-01	8164	8852	3400	11564	0.7094
The Nine Regions	2020-10-30	1561	1157	417	1978	0.7094
梅塔特隆 Metatron	2020-04-09	40	125	38	78	0.7094
Strobophagia | Rave Horror	2020-10-28	27	53	14	41	0.7093
West of Dead	2020-06-18	224	1046	376	600	0.7091
Lighthouse Keeper	2020-11-22	4	139	43	47	0.7088
Gravulse	2020-12-21	137	59	16	153	0.7088
Calamari Clash	2020-01-17	19	62	17	36	0.7087000000000001
Alder's Blood: Prologue	2020-02-12	38	98	29	67	0.7086
Waifu Uncovered	2020-04-10	11	95	28	39	0.7084999999999999
Dragon Extinction	2020-10-16	14	71	20	34	0.7084
Awakening of Celestial	2020-02-12	2	5	0	2	0.7084
IgKnight Food Fight	2020-05-21	4	5	0	4	0.7084
Astrela Starlight	2020-04-10	3	5	0	3	0.7084
Sunny Shine Funland!	2020-09-08	4	5	0	4	0.7084
Superior Wizards	2020-11-01	2	5	0	2	0.7084
The Dungeon Paradox	2020-06-02	4	5	0	4	0.7084
Steady	2020-07-17	2	5	0	2	0.7084
Captain Hannon - The Belanzano	2020-03-30	3	5	0	3	0.7084
Scikor Final Scale	2020-02-28	2	5	0	2	0.7084
Fruit Factory	2020-09-25	4	5	0	4	0.7084
NEKOPUGI	2020-01-07	2	5	0	2	0.7084
Beat Boxing	2020-11-03	3	5	0	3	0.7084
Happy Grumps	2020-07-17	2	5	0	2	0.7084
Tri6: Infinite	2020-07-17	3	5	0	3	0.7084
Space Grunts 2	2020-05-27	3	5	0	3	0.7084
Pixel Puzzles 4k: Japan	2020-12-07	4	5	0	4	0.7084
EleMetals: Death Metal Death Match!	2020-04-24	6	5	0	6	0.7084
A Time Paradox	2020-09-01	3	5	0	3	0.7084
Dunmakia Kingdom	2020-01-19	5	5	0	5	0.7084
The Underground King	2020-07-16	5	5	0	5	0.7084
Long loot the King	2020-01-03	1	5	0	1	0.7084
Many Faces	2020-01-07	2	5	0	2	0.7084
Brick Blaster	2020-05-05	3	5	0	3	0.7084
Cold Winter Morning	2020-01-26	1	5	0	1	0.7084
Bloody Ending	2020-02-20	3	5	0	3	0.7084
Psicose?	2020-02-15	5	5	0	5	0.7084
Staying Together	2020-06-03	2	5	0	2	0.7084
Oasis	2020-03-17	2	5	0	2	0.7084
City Breaker	2020-03-27	2	5	0	2	0.7084
Revel Rousers	2020-04-24	3	5	0	3	0.7084
Kernmantle	2020-10-05	2	5	0	2	0.7084
Simple Farm	2020-04-01	2	5	0	2	0.7084
Minoes	2020-05-13	4	5	0	4	0.7084
Bastard Little Zombie	2020-04-09	4	5	0	4	0.7084
Flying Soldiers	2020-09-22	2	5	0	2	0.7084
soundStrider	2020-07-10	2	5	0	2	0.7084
Suspicious Spaceroads	2020-05-03	2	5	0	2	0.7084
KaveXplorer	2020-10-13	2	5	0	2	0.7084
Roll Control	2020-05-18	2	5	0	2	0.7084
Replicated	2020-05-13	2	5	0	2	0.7084
Costa's Classic Cosmic Pizzas	2020-11-23	2	5	0	2	0.7084
Our Beautiful Earth	2020-06-01	4	5	0	4	0.7084
Phaser	2020-06-22	4	5	0	4	0.7084
LV99: Final Fortress	2020-07-08	2	5	0	2	0.7084
Earth: 9000	2020-09-10	3	5	0	3	0.7084
Tofu Topple	2020-10-02	5	5	0	5	0.7084
VR King of Battle Cards	2020-08-04	1	5	0	1	0.7084
HUNTERS All Star Battle	2020-07-24	1	5	0	1	0.7084
Stream Smash	2020-06-19	2	5	0	2	0.7084
Painted Legend 2	2020-07-25	1	5	0	1	0.7084
Duo Defenders	2020-07-31	3	5	0	3	0.7084
AVRACH RESURRECTION	2020-07-15	2	5	0	2	0.7084
The Last Surface	2020-06-15	3	5	0	3	0.7084
Nine Lives	2020-10-27	2	5	0	2	0.7084
Master vs Slave	2020-06-25	4	5	0	4	0.7084
Limiter!	2020-07-01	4	5	0	4	0.7084
Open The Chest 2	2020-09-23	2	5	0	2	0.7084
Enga Extreme Battle Race	2020-07-01	2	5	0	2	0.7084
This Throne Is Mine - The Card Game	2020-07-30	4	5	0	4	0.7084
Rockjack	2020-11-19	2	5	0	2	0.7084
Henosis	2020-07-23	2	5	0	2	0.7084
GUN DOG ROCK RAPID	2020-07-14	2	5	0	2	0.7084
PECO	2020-10-04	3	5	0	3	0.7084
PillPop	2020-07-24	3	5	0	3	0.7084
Charge!	2020-11-19	4	5	0	4	0.7084
labyrinth 2	2020-08-07	3	5	0	3	0.7084
Hive Mind	2020-10-27	4	5	0	4	0.7084
BIG-Bobby-Car – The Big Race	2020-09-24	3	5	0	3	0.7084
パクっちゃうぞ！！	2020-08-26	1	5	0	1	0.7084
Masked Vale	2020-08-07	2	5	0	2	0.7084
PROJECT : KNIGHT™	2020-08-10	3	5	0	3	0.7084
Mystic Midway: Rest in Pieces	2020-08-21	2	5	0	2	0.7084
Save Aisha	2020-10-02	2	5	0	2	0.7084
End Reach	2020-10-30	1	5	0	1	0.7084
Breeders	2020-08-25	3	5	0	3	0.7084
Strike VR	2020-09-04	2	5	0	2	0.7084
Invasion Resistance 2	2020-08-30	4	5	0	4	0.7084
Don't Die! Douche!	2020-10-29	2	5	0	2	0.7084
TinyCrack	2020-09-15	3	5	0	3	0.7084
Lost Gems	2020-09-07	2	5	0	2	0.7084
1x! Space Adventure	2020-09-22	2	5	0	2	0.7084
Hexdoku	2020-12-22	2	5	0	2	0.7084
PLANET LEV	2020-12-10	5	5	0	5	0.7084
Stella Voyager	2020-10-07	6	5	0	6	0.7084
JumpMan	2020-10-19	3	5	0	3	0.7084
Monstermonger	2020-10-19	3	5	0	3	0.7084
Project Summit	2020-11-20	4	5	0	4	0.7084
TechnoRunner	2020-11-13	3	5	0	3	0.7084
Monstermörder	2020-11-18	5	5	0	5	0.7084
Hollow Destiny	2020-11-27	2	5	0	2	0.7084
Royal Roads 2 The Magic Box	2020-11-27	6	5	0	6	0.7084
Mouse Hero	2020-12-30	1	5	0	1	0.7084
Otome the Exorcist	2020-08-22	167	74	21	188	0.7083
WRC 8 FIA World Rally Championship	2020-09-08	498	796	284	782	0.7081000000000001
A pirate quartermaster	2020-10-02	11	40	10	21	0.7081000000000001
Nevaeh	2020-09-17	9	40	10	19	0.7081000000000001
Odd Adventure of Chub, Color, 23 and You	2020-11-19	6	40	10	16	0.7081000000000001
Lost Wing	2020-07-31	10	27	6	16	0.7081000000000001
3D Hentai Checkers	2020-05-15	6	27	6	12	0.7081000000000001
Dallen Clicker Ultimate	2020-09-17	6	27	6	12	0.7081000000000001
Miner Ultra Rag Smash	2020-11-04	6	27	6	12	0.7081000000000001
Country Girl Keiko	2020-01-17	185	164	52	237	0.7079000000000001
Burning mountain and sea 烈山海	2020-10-21	16	115	35	51	0.7078
Finding the Soul Orb	2020-02-14	5	43	11	16	0.7076000000000001
Insexsity	2020-10-02	27	43	11	38	0.7076000000000001
Little Reaper	2020-07-20	9	13	2	11	0.7075
Rockets are Super Hard	2020-05-19	6	13	2	8	0.7075
The Haunted House of Doom	2020-10-13	3	13	2	5	0.7075
Cybershift	2020-12-11	4	13	2	6	0.7075
Langton's Ant	2020-08-29	4	13	2	6	0.7075
Vector Prospector	2020-11-20	3	13	2	5	0.7075
Diesel Attack	2020-03-03	4	13	2	6	0.7075
BOMBERX	2020-03-16	6	13	2	8	0.7075
BATTLE POLYGON	2020-01-27	5	13	2	7	0.7075
Gem Master	2020-05-04	2	13	2	4	0.7075
Hedera	2020-05-21	3	13	2	5	0.7075
東方金株店 ~Touhou MONEY STOCKS SHOPS~	2020-08-20	8	13	2	10	0.7075
Hardbass Clicker	2020-07-01	4	13	2	6	0.7075
Above the Stars	2020-10-31	28	13	2	30	0.7075
Space Hole 2020	2020-11-16	3	13	2	5	0.7075
VR Hentai Girl	2020-10-06	3	13	2	5	0.7075
Silicon Valley Investor	2020-11-19	8	13	2	10	0.7075
Good puzzle	2020-10-23	2	13	2	4	0.7075
Crazy Mafioso	2020-11-16	6	13	2	8	0.7075
Griefhelm	2020-08-20	135	214	70	205	0.7073
Phoenix Point	2020-12-03	4993	3603	1372	6365	0.7069
Panic Station VR	2020-02-27	8	30	7	15	0.7068000000000001
Sausage Hunter	2020-06-17	4	20	4	8	0.7068000000000001
RESONARK X	2020-07-31	5	20	4	9	0.7068000000000001
surviv.io - 2D Battle Royale	2020-09-24	347	1828	682	1029	0.7067
Beetle Uprising	2020-11-05	19	52	14	33	0.7067
Dirty Harry's Thunder Drive	2020-02-18	8	52	14	22	0.7067
心境 Mind VR Exploration	2020-10-06	5	52	14	19	0.7067
BE-A Walker	2020-05-07	143	296	100	243	0.7066
Transport INC	2020-08-27	496	563	199	695	0.7065
Save Your Nuts	2020-04-16	16	58	16	32	0.7064
Osman Gazi	2020-09-18	7	67	19	26	0.7062999999999999
安堂的心理咨询室：杯中之心	2020-10-01	15	64	18	33	0.7062999999999999
Gaia Beyond	2020-08-20	181	165	53	234	0.7062
Asterix & Obelix XXL	2020-10-22	108	311	106	214	0.7059000000000001
Escape Quest	2020-09-29	110	176	57	167	0.7059000000000001
Godhood	2020-08-11	887	720	259	1146	0.7058
Efflorescence of Lust	2020-02-04	153	403	140	293	0.7058
Beach Ball Valley	2020-10-10	11	9	1	12	0.7057
Horde Of Plenty	2020-06-11	2	9	1	3	0.7057
Zenodeath	2020-09-04	5	9	1	6	0.7057
Gatlin'	2020-09-16	2	9	1	3	0.7057
Flower Design Two	2020-12-03	3	9	1	4	0.7057
Crypterion	2020-11-17	7	9	1	8	0.7057
Hentai XXX Plus: Jigsaws Vol 1	2020-06-25	2	9	1	3	0.7057
Timpu's treasure	2020-04-24	2	9	1	3	0.7057
Section Six	2020-05-19	3	9	1	4	0.7057
Boom Boomerang	2020-08-31	4	9	1	5	0.7057
labyrinth	2020-01-09	3	9	1	4	0.7057
Drifting in Space	2020-02-28	3	9	1	4	0.7057
Hard, Fast, & Flashy	2020-02-08	4	9	1	5	0.7057
Unlord	2020-06-01	3	9	1	4	0.7057
Naught	2020-07-30	2	9	1	3	0.7057
CoronaFighter	2020-05-28	4	9	1	5	0.7057
Cyber Seraph	2020-07-17	2	9	1	3	0.7057
続そのひぐらしVS東方UNIVERSE2	2020-06-26	3	9	1	4	0.7057
Salvage	2020-06-18	2	9	1	3	0.7057
Hurry Up!	2020-09-10	6	9	1	7	0.7057
Heretic's Lot: Prologue	2020-06-08	5	9	1	6	0.7057
Rolling Arcade	2020-06-10	2	9	1	3	0.7057
The Zombie's Horror	2020-06-19	3	9	1	4	0.7057
Mean-While	2020-09-04	2	9	1	3	0.7057
Lone King	2020-07-04	2	9	1	3	0.7057
PUFIWEHO	2020-12-26	2	9	1	3	0.7057
Pixboy	2020-08-07	4	9	1	5	0.7057
Son of Aral	2020-07-23	4	9	1	5	0.7057
Dragon Lapis	2020-10-02	10	9	1	11	0.7057
Monster Killer	2020-08-05	2	9	1	3	0.7057
Clowns	2020-08-21	3	9	1	4	0.7057
The Girl of Glass: The Journey Begins	2020-09-07	6	9	1	7	0.7057
Inseparable	2020-11-06	3	9	1	4	0.7057
Batterneers	2020-12-01	6	9	1	7	0.7057
Infectra	2020-09-22	2	9	1	3	0.7057
Quarantine simulator	2020-10-15	2	9	1	3	0.7057
Mixx Island	2020-11-02	6	9	1	7	0.7057
Diodius ~PREMONITION~	2020-12-03	4	9	1	5	0.7057
Jungle Town: Birthday quest	2020-12-03	6	9	1	7	0.7057
Guns Blazing	2020-12-01	4	9	1	5	0.7057
Life of A Yandere Simp	2020-12-25	4	9	1	5	0.7057
Click on their Heads	2020-12-29	3	9	1	4	0.7057
Holiday Time	2020-11-20	12	122	38	50	0.7056
Dieselpunk Wars Prologue	2020-04-20	97	119	37	134	0.7055
Meridian 157: Prologue	2020-12-09	21	119	37	58	0.7055
The Watchers	2020-02-06	33	280	95	128	0.7053
Scraps: Modular Vehicle Combat	2020-12-18	31	116	36	67	0.7053
Iron Danger	2020-03-25	209	625	224	433	0.7051999999999999
Unformed	2020-04-24	10	36	9	19	0.7051999999999999
Pendula Swing - The Complete Journey	2020-03-08	11	36	9	20	0.7051999999999999
时之痕 Trace Of Time	2020-07-24	11	36	9	20	0.7051999999999999
Last of Ass	2020-12-05	3	36	9	12	0.7051999999999999
FADE	2020-12-09	5	36	9	14	0.7051999999999999
Ostranauts	2020-09-10	390	503	178	568	0.7051000000000001
Rising Lords	2020-05-27	299	441	155	454	0.7049
Forbidden Ingress	2020-04-23	17	186	61	78	0.7049
MiniTracks	2020-11-13	8	23	5	13	0.7048000000000001
Trailer Trashers	2020-03-26	5	23	5	10	0.7048000000000001
The Charm of Love	2020-10-29	3	23	5	8	0.7048000000000001
Educational Games for Kids	2020-09-10	21	23	5	26	0.7048000000000001
HOLY QURAN VR EXPERİENCE	2020-09-15	2	23	5	7	0.7048000000000001
Spinning_Kid	2020-10-10	5	23	5	10	0.7048000000000001
Lawnmower Game: Racing	2020-10-16	6	75	22	28	0.7045
Strange Creatures	2020-05-01	39	121	38	77	0.7044
Saint Kotar: The Yellow Mask	2020-06-18	194	232	78	272	0.7043
Goodnight, Lily	2020-09-17	16	69	20	36	0.7042
破镜恐惧	2020-09-23	8	45	12	20	0.7042
10 Miles To Safety	2020-10-21	411	650	235	646	0.7041
Car Trader Simulator	2020-11-04	465	340	118	583	0.7041
黄河大合唱	2020-05-22	7	63	18	25	0.7041
Test Tube Titans	2020-03-06	19	48	13	32	0.7041
Rugby League Team Manager 3	2020-05-28	26	54	15	41	0.7039
Elmarion: Dragon princess	2020-12-14	16	54	15	31	0.7039
Enemy On Board	2020-05-08	891	1142	425	1316	0.7038
Desktop Farm	2020-07-31	704	475	169	873	0.7037000000000001
某旅行者的偷拍相册	2020-12-31	209	669	243	452	0.7034999999999999
Without Romance	2020-09-16	16	89	27	43	0.7034999999999999
Grayland	2020-01-15	16	26	6	22	0.7034
Hero must die. again	2020-02-26	21	26	6	27	0.7034
Maidesktop	2020-06-26	6	26	6	12	0.7034
Angry Zombies	2020-02-27	3	26	6	9	0.7034
Time Hacker	2020-10-16	8	26	6	14	0.7034
Freedom: How I Escaped	2020-08-14	10	26	6	16	0.7034
Boiling Steel: Preface	2020-01-10	16	86	26	42	0.7033
K-Point Ski Jumping	2020-01-24	38	86	26	64	0.7033
Penguin's Dogma	2020-06-25	12	16	3	15	0.7033
PBA Basketball Slam Arcade Edition	2020-08-31	5	16	3	8	0.7033
Divine Favor	2020-08-10	3	16	3	6	0.7033
Dezinsector	2020-09-24	3	16	3	6	0.7033
Huuma Mina: The Secret of Immortality (Censored)	2020-11-11	7	16	3	10	0.7033
浮生万千之前世今生	2020-01-28	22	83	25	47	0.7031000000000001
The Dark Crystal: Age of Resistance Tactics	2020-02-04	81	80	24	105	0.7029000000000001
Siren Head: Awakening	2020-10-30	81	522	188	269	0.7026000000000001
Brittany Home Alone	2020-04-10	16	97	30	46	0.7026000000000001
PulseBall	2020-10-03	12	29	7	19	0.7025
Mira and the Mysteries of Alchemy	2020-10-16	118	94	29	147	0.7023
Rocket Science	2020-02-20	29	71	21	50	0.7023
Battlefield™ V	2020-06-11	89814	109492	45235	135049	0.7020000000000001
Second Extinction™	2020-10-13	2056	3941	1545	3601	0.7020000000000001
80's OVERDRIVE	2020-11-19	19	365	129	148	0.7020000000000001
The Twins	2020-01-24	3	32	8	11	0.7019
Krush Kill 'N Destroy Xtreme	2020-07-23	18	105	33	51	0.7018000000000001
PositronX	2020-10-29	8	62	18	26	0.7017
好久不见 - Long Time No See	2020-09-14	104	174	58	162	0.7015000000000001
PONG Quest™	2020-04-21	18	35	9	27	0.7015000000000001
Timeless Paradox VR	2020-03-04	5	35	9	14	0.7015000000000001
Zero Tolerance	2020-08-18	5	35	9	14	0.7015000000000001
Cherry VX	2020-07-27	18	201	68	86	0.7014
Where in the World is Carmen Sandiego?	2020-08-31	19	56	16	35	0.7014
Reboot	2020-11-05	32	82	25	57	0.7012999999999999
October Night Games	2020-10-29	21	53	15	36	0.7012999999999999
Mira	2020-03-25	8	38	10	18	0.7012999999999999
Speed Swing	2020-05-28	46	38	10	56	0.7012999999999999
Toilet Management Simulator	2020-07-27	167	217	74	241	0.7012
Samosbor	2020-02-06	19	149	49	68	0.7012
Warren The Warlock	2020-06-12	31	50	14	45	0.7012
Forge and Fight	2020-12-02	61	47	13	74	0.7011000000000001
Lusitania	2020-04-11	7	44	12	19	0.7011000000000001
GranAge	2020-12-30	228	344	122	350	0.7008
The Mutational	2020-02-10	110	19	4	114	0.7008
Villain Project	2020-02-21	3	19	4	7	0.7008
ゴシックマーダー -運命を変えるアドベンチャー-	2020-02-13	4	19	4	8	0.7008
VoxFox	2020-06-18	7	19	4	11	0.7008
Missing Time	2020-08-19	10	19	4	14	0.7008
Hentai it's my life	2020-12-26	3	19	4	7	0.7008
Defentron	2020-12-17	5	19	4	9	0.7008
BATTLE BEARS 1: Zombies!	2020-12-28	6	19	4	10	0.7008
Wallachia: Reign of Dracula	2020-02-28	15	93	29	44	0.7007
Sokpop S06: Ollie & Bollie: Outdoor Estate	2020-01-17	102	137	45	147	0.7001000000000001
Pixel Starships	2020-05-01	545	1226	468	1013	0.6999
Gym Tycoon	2020-11-23	18	67	20	38	0.6999
Steamy Sextet	2020-01-13	1448	292	103	1551	0.6997
Swordsman VR	2020-09-25	28	352	126	154	0.6995
Masters of Puzzle	2020-05-29	7	22	5	12	0.6994
Thunderflash	2020-03-23	3	22	5	8	0.6994
Human Origin	2020-06-10	4	22	5	9	0.6994
Alien Cat 3	2020-07-06	5	22	5	10	0.6994
Mind-Blowing Girls	2020-10-15	3	22	5	8	0.6994
Weakless	2020-03-04	21	78	24	45	0.6990999999999999
Unsung Heroes: The Golden Mask	2020-01-28	14	58	17	31	0.6990999999999999
Ayre	2020-05-26	3	12	2	5	0.6990999999999999
Music Escape	2020-01-31	3	12	2	5	0.6990999999999999
Primate Signal	2020-12-05	2	12	2	4	0.6990999999999999
Safe Climbing	2020-06-19	3	12	2	5	0.6990999999999999
Sokpop S03: skidlocked	2020-01-17	3	12	2	5	0.6990999999999999
Puzzle Tower	2020-01-13	5	12	2	7	0.6990999999999999
War Ender Evolution	2020-01-19	3	12	2	5	0.6990999999999999
Flirt Balls	2020-01-09	3	12	2	5	0.6990999999999999
One True Cuddle	2020-09-02	2	12	2	4	0.6990999999999999
Cave Game	2020-02-27	5	12	2	7	0.6990999999999999
NYC Bungee	2020-05-01	4	12	2	6	0.6990999999999999
iota	2020-09-24	2	12	2	4	0.6990999999999999
RoboDo	2020-10-03	5	12	2	7	0.6990999999999999
My Sweet Confession	2020-05-08	3	12	2	5	0.6990999999999999
Ready? Set. Haiya!	2020-05-08	2	12	2	4	0.6990999999999999
Fear the Dark Unknown: Chloe	2020-05-01	3	12	2	5	0.6990999999999999
Ring of Fire: Prologue	2020-12-15	4	12	2	6	0.6990999999999999
Seaside Cafe Story	2020-11-05	5	12	2	7	0.6990999999999999
Enoki	2020-11-13	7	12	2	9	0.6990999999999999
Good puzzle: Castles	2020-11-09	2	12	2	4	0.6990999999999999
My Yandere Sister loves me too much!	2020-10-16	25	155	52	77	0.6989
三国吕布传说	2020-11-05	15	55	16	31	0.6988
The Dark Pictures Anthology: Little Hope	2020-10-29	4997	4837	1941	6938	0.6986
DUAL GEAR	2020-07-29	106	248	87	193	0.6986
育种村	2020-01-24	7	52	15	22	0.6986
GUN LADY	2020-02-20	5	52	15	20	0.6986
Sakura Knight 3	2020-09-07	22	52	15	37	0.6986
Wait! Life is beautiful!	2020-08-27	13	160	54	67	0.6985
Bonfire	2020-03-26	18	25	6	24	0.6985
蔚蓝月下	2020-04-01	7	25	6	13	0.6985
Kongfusion	2020-07-28	3	25	6	9	0.6985
Rinlo	2020-10-07	6	25	6	12	0.6985
Landlord Girls	2020-07-13	946	1495	580	1526	0.6984
Outside The Grid	2020-06-18	14	141	47	61	0.6984
Seek Girl Ⅶ	2020-12-11	350	877	333	683	0.6983
Kabukicho Story	2020-08-01	3	49	14	17	0.6983
The Curse of Kubel	2020-07-24	334	339	122	456	0.6981999999999999
Take That	2020-08-21	9	69	21	30	0.6981
Starblazer	2020-09-14	4	28	7	11	0.698
Mahasona	2020-06-20	13	28	7	20	0.698
Low Poly Forces	2020-06-22	6	28	7	13	0.698
Shadow of Valhalla	2020-08-20	5	28	7	12	0.698
Eggs Catcher VR	2020-11-24	7	28	7	14	0.698
Lovely Fox	2020-08-23	5	83	26	31	0.6979000000000001
Combat Wings	2020-05-04	4	40	11	15	0.6978
Leap of Love	2020-12-31	19	40	11	30	0.6978
Radical Relocation	2020-08-31	66	135	45	111	0.6977
NEXORIA	2020-01-05	6	37	10	16	0.6977
Projectile Dysfunction	2020-08-28	10	37	10	20	0.6977
Bring me a man, Santa	2020-12-15	6	37	10	16	0.6977
Infinity Heroes	2020-03-19	15	31	8	23	0.6977
Hentai Pansuto	2020-01-10	3	31	8	11	0.6977
Grave of the Petrified	2020-03-12	10	34	9	19	0.6976000000000001
The Sojourn	2020-09-29	31	124	41	72	0.6975
Everyone Dies	2020-01-03	10	91	29	39	0.6973999999999999
Bubble Girl	2020-11-27	12	60	18	30	0.6970000000000001
Rock of Ages 3: Make & Break	2020-07-21	205	637	240	445	0.6969
Harem Girl: Alicia	2020-03-20	9	74	23	32	0.6968000000000001
Meditation VR	2020-07-31	12	57	17	29	0.6966
DIMENSION REIGN	2020-03-19	92	155	53	145	0.6961
Dreamgate	2020-02-20	15	68	21	36	0.6959000000000001
Star Girl Proxima	2020-01-17	3	15	3	6	0.6959000000000001
Monster Viator	2020-02-05	7	15	3	10	0.6959000000000001
Infinite Beyond The Mind	2020-05-07	4	15	3	7	0.6959000000000001
ERO Girl Painter	2020-02-28	4	15	3	7	0.6959000000000001
Korpus: Buried over the Black Soil	2020-02-14	4	15	3	7	0.6959000000000001
HANGMAN II	2020-04-20	2	15	3	5	0.6959000000000001
Simply Puzzles: Codewords	2020-06-01	5	15	3	8	0.6959000000000001
Dondar	2020-07-25	5	15	3	8	0.6959000000000001
nightmAR Protocol	2020-08-25	4	15	3	7	0.6959000000000001
Zombie camping	2020-10-19	4	15	3	7	0.6959000000000001
3D Hentai Puzzle	2020-11-02	4	15	3	7	0.6959000000000001
Pole of Cold	2020-11-05	3	15	3	6	0.6959000000000001
Close Contact	2020-11-02	3	15	3	6	0.6959000000000001
Flying Hero X	2020-12-18	6	15	3	9	0.6959000000000001
Roscosmas Landing	2020-11-27	5	15	3	8	0.6959000000000001
Super tanks RPG	2020-12-09	2	15	3	5	0.6959000000000001
Hand Simulator: Horror	2020-12-22	103	550	207	310	0.6958
Best Friend Forever	2020-08-27	64	128	43	107	0.6958
Mosh Pit Simulator	2020-03-10	7	51	15	22	0.6958
Powder VR	2020-12-17	7	51	15	22	0.6958
A Game of Humans	2020-06-05	11	51	15	26	0.6958
Vaccine19	2020-12-25	7	51	15	22	0.6958
The Debug™	2020-11-19	4	51	15	19	0.6958
Ciel Fledge: A Daughter Raising Simulator	2020-02-20	55	79	25	80	0.6957
Doom & Destiny Worlds	2020-09-18	48	79	25	73	0.6957
Solar System VR	2020-09-05	12	181	63	75	0.6956
Cyber Attack	2020-08-20	67	109	36	103	0.6956
Need for Speed™	2020-06-04	1260	10192	4226	5486	0.6953
Rokka	2020-12-28	4	45	13	17	0.6950000000000001
Plague M.D.	2020-11-10	22	103	34	56	0.6947
SUPER RECOILFIGHT	2020-05-23	13	73	23	36	0.6947
Heroes Showdown	2020-05-14	519	250	90	609	0.6946
Treachery in Beatdown City	2020-03-31	9	42	12	21	0.6946
Trollhunters: Defenders of Arcadia	2020-09-25	13	42	12	25	0.6946
Cyber Agent	2020-06-09	60	342	126	186	0.6945
Haxity	2020-06-17	129	59	18	147	0.6945
Hoppup!	2020-11-23	30	59	18	48	0.6945
Forgotten Passages	2020-01-17	3	18	4	7	0.6944
AVA: Dark History	2020-02-17	6	18	4	10	0.6944
Cragls	2020-01-27	13	18	4	17	0.6944
The Adventures of Eggbert	2020-05-31	3	18	4	7	0.6944
LINGERING	2020-07-07	8	18	4	12	0.6944
Freddy Spaghetti 2.0	2020-11-02	4	18	4	8	0.6944
Hollow Witch	2020-12-18	8	18	4	12	0.6944
Devastated	2020-02-27	4	8	1	5	0.6944
Planet Bash	2020-11-21	10	8	1	11	0.6944
Great Adventure in the World of Sky	2020-04-06	3	8	1	4	0.6944
Drone Wars VR	2020-06-02	2	8	1	3	0.6944
UFO : Brawlers from Beyond	2020-10-27	4	8	1	5	0.6944
Sokpop S04: clutchball	2020-01-17	2	8	1	3	0.6944
Tower Of Heresy	2020-01-09	3	8	1	4	0.6944
Puck Buddies	2020-11-26	10	8	1	11	0.6944
Shell Corp	2020-08-21	7	8	1	8	0.6944
Clown Nightmare, Satan's Joke	2020-04-05	2	8	1	3	0.6944
Pity Pit	2020-03-18	3	8	1	4	0.6944
Hentai Babes - Nations	2020-04-06	2	8	1	3	0.6944
Jade Cicada	2020-04-15	2	8	1	3	0.6944
Miden Tower	2020-04-30	8	8	1	9	0.6944
Easy puzzle: Bridges	2020-04-11	3	8	1	4	0.6944
BlindBlade II	2020-04-10	2	8	1	3	0.6944
Dungeon Throne	2020-08-11	3	8	1	4	0.6944
Far Eastern Federal University Virtual Expo	2020-05-26	1	8	1	2	0.6944
Escape from the Cosmic Abyss	2020-06-23	2	8	1	3	0.6944
Dark Tales: Edgar Allan Poe's The Bells Collector's Edition	2020-05-16	8	8	1	9	0.6944
Ashley: The Emptiness Inside	2020-08-13	3	8	1	4	0.6944
Home: A Quarantine Story	2020-09-25	2	8	1	3	0.6944
Claw Crane Company	2020-08-14	3	8	1	4	0.6944
Sweet Love	2020-07-30	3	8	1	4	0.6944
Ultikill	2020-12-06	4	8	1	5	0.6944
Choco Pixel 7	2020-07-12	2	8	1	3	0.6944
Being Mindful	2020-07-28	2	8	1	3	0.6944
Cheat or Die	2020-09-18	2	8	1	3	0.6944
Pipemania	2020-08-11	3	8	1	4	0.6944
Vincula	2020-10-23	8	8	1	9	0.6944
Dark Room VR	2020-09-01	2	8	1	3	0.6944
One Last Dungeon	2020-12-24	4	8	1	5	0.6944
Redd's Runaway	2020-10-27	2	8	1	3	0.6944
Path Maker	2020-10-24	3	8	1	4	0.6944
12 MiniBattles	2020-09-25	4	8	1	5	0.6944
Pleiades - A Subversion Saga Game	2020-11-11	3	8	1	4	0.6944
Alchemy Absorption: Melody	2020-11-20	2	8	1	3	0.6944
On Closer Inspection	2020-12-08	2	8	1	3	0.6944
The Rig	2020-06-26	5	39	11	16	0.6943
Deadtime Defenders	2020-02-18	9	39	11	20	0.6943
Unforgotten	2020-12-17	7	39	11	18	0.6943
Rocket Bots	2020-07-28	8	39	11	19	0.6943
Fury of Dracula: Digital Edition	2020-11-12	107	153	53	160	0.6940000000000001
ChioHero	2020-11-13	41	36	10	51	0.6939000000000001
VR Jetpack Game	2020-07-02	11	36	10	21	0.6939000000000001
Love n Dream: Virtual Happiness	2020-12-19	156	192	68	224	0.6938
Soulfire	2020-08-04	579	613	235	814	0.6936
Fallen Angel	2020-10-22	202	113	38	240	0.6936
Devil's Kiss	2020-02-21	9	33	9	18	0.6936
Geometric Feel the Beats	2020-08-19	7	33	9	16	0.6936
ASCIIDENT	2020-03-19	5	21	5	10	0.6936
Absolute Territory	2020-09-01	3	21	5	8	0.6936
DominaTRIX - Hentai Storytelling Puzzle	2020-02-21	3	21	5	8	0.6936
Dreadtides	2020-04-02	9	21	5	14	0.6936
Crimson Ranch	2020-09-24	3	21	5	8	0.6936
Battlefield 3™ 	2020-06-11	640	5916	2450	3090	0.6935
FIT Food	2020-07-28	10	86	28	38	0.6934
Star Souls	2020-03-03	8	30	8	16	0.6934
Locked	2020-07-22	8	30	8	16	0.6934
Rain Island	2020-03-07	6	27	7	13	0.6933
What Makes Us Special	2020-04-27	5	27	7	12	0.6933
Wizodd	2020-05-11	5	27	7	12	0.6933
Block Arena	2020-10-06	14	27	7	21	0.6933
Hentai Nureta Puzzle Power Girls	2020-10-30	3	27	7	10	0.6933
Prisoner 518	2020-08-28	3	24	6	9	0.6933
Gigantosaurus The Game	2020-03-27	15	24	6	21	0.6933
异邦人-The foreigner	2020-02-06	7	24	6	13	0.6933
Fatec's Out	2020-05-13	3	24	6	9	0.6933
Enter Digiton	2020-08-14	4	24	6	10	0.6933
Highly Likely	2020-09-18	16	118	40	56	0.6931999999999999
Space Station Tycoon	2020-10-29	38	102	34	72	0.6931999999999999
Decently Bad Tower Defense	2020-05-25	9	94	31	40	0.6931999999999999
Balls Royale	2020-04-08	156	75	24	180	0.6931999999999999
Arrest of a stone Buddha	2020-02-27	18	178	63	81	0.6929000000000001
Gunman And The Witch	2020-02-14	39	131	45	84	0.6929000000000001
Nomads of Driftland	2020-12-07	79	91	30	109	0.6927
我的公司996	2020-10-23	449	257	94	543	0.6925
US Spy: Mission in Russia	2020-02-15	21	149	52	73	0.6925
Taimanin Collection: Battle Arena	2020-07-09	458	510	195	653	0.6924
Ultimate Ski Jumping 2020	2020-04-03	19	47	14	33	0.6924
Cave Digger PC	2020-08-14	27	47	14	41	0.6924
A Game of Thrones: The Board Game	2020-10-06	1080	1104	438	1518	0.6923
World of Tennis: Roaring ’20s	2020-01-13	72	180	64	136	0.6923
Bastide	2020-02-26	65	213	77	142	0.6920000000000001
Epitaph	2020-10-29	4	4	0	4	0.6920000000000001
Choo-Choo! The Train Rides!	2020-08-10	4	4	0	4	0.6920000000000001
VIRUS RUSH	2020-07-30	1	4	0	1	0.6920000000000001
Flailure	2020-11-06	4	4	0	4	0.6920000000000001
Chrono Project	2020-06-30	2	4	0	2	0.6920000000000001
Shadowy Contracts	2020-10-08	4	4	0	4	0.6920000000000001
Deepsea Salvor	2020-01-31	2	4	0	2	0.6920000000000001
Truck the System	2020-09-11	2	4	0	2	0.6920000000000001
Shooting Blaster Big Bang Boom	2020-04-16	2	4	0	2	0.6920000000000001
An Egg Can Dream	2020-05-20	3	4	0	3	0.6920000000000001
Lonely Arts	2020-05-21	2	4	0	2	0.6920000000000001
Grey: An Alien Dream	2020-02-11	1	4	0	1	0.6920000000000001
Puzzle Patrol	2020-02-08	2	4	0	2	0.6920000000000001
Bumble Butt	2020-04-29	3	4	0	3	0.6920000000000001
Night Road	2020-03-20	1	4	0	1	0.6920000000000001
Axeson's Fury VR	2020-04-30	2	4	0	2	0.6920000000000001
Doubles Hard	2020-06-09	2	4	0	2	0.6920000000000001
Kukui 2	2020-10-02	3	4	0	3	0.6920000000000001
My Wet Leto Comic	2020-05-08	2	4	0	2	0.6920000000000001
Moderium	2020-01-08	3	4	0	3	0.6920000000000001
Piñata Attack	2020-02-04	1	4	0	1	0.6920000000000001
Night Witch: 588	2020-01-31	2	4	0	2	0.6920000000000001
Reach Coin	2020-01-14	1	4	0	1	0.6920000000000001
The Square Game	2020-02-25	3	4	0	3	0.6920000000000001
This Is Not The End	2020-03-31	2	4	0	2	0.6920000000000001
AudioWizards	2020-01-22	6	4	0	6	0.6920000000000001
Hero's Journey	2020-03-18	2	4	0	2	0.6920000000000001
OneShot	2020-02-27	2	4	0	2	0.6920000000000001
I'm Calling The Cops!	2020-01-31	3	4	0	3	0.6920000000000001
The Big Heap	2020-02-20	2	4	0	2	0.6920000000000001
Blind Battle Championship	2020-03-07	1	4	0	1	0.6920000000000001
EMPTY	2020-02-14	2	4	0	2	0.6920000000000001
Stalker	2020-07-28	2	4	0	2	0.6920000000000001
Alice Sisters	2020-09-20	2	4	0	2	0.6920000000000001
Neon Parasite	2020-11-13	2	4	0	2	0.6920000000000001
2 Times Circles	2020-06-19	1	4	0	1	0.6920000000000001
Skin and Bones	2020-04-06	2	4	0	2	0.6920000000000001
Jesus Christ RPG: Lucifer	2020-04-01	3	4	0	3	0.6920000000000001
A Week In The Cold	2020-06-26	2	4	0	2	0.6920000000000001
RADARjAM	2020-07-28	3	4	0	3	0.6920000000000001
Crazy Projectile	2020-04-06	5	4	0	5	0.6920000000000001
Once Upon an Electric Dream	2020-04-08	1	4	0	1	0.6920000000000001
Super No Crying in Baseball	2020-07-23	2	4	0	2	0.6920000000000001
Arko	2020-04-17	2	4	0	2	0.6920000000000001
Sophie's Cubes	2020-04-08	2	4	0	2	0.6920000000000001
Beat the Machine: Rebooted	2020-07-15	10	4	0	10	0.6920000000000001
Looking Glass	2020-05-01	1	4	0	1	0.6920000000000001
Sayonara Electric	2020-12-23	1	4	0	1	0.6920000000000001
Deadsigns	2020-06-30	3	4	0	3	0.6920000000000001
Iron Reckoning	2020-11-05	2	4	0	2	0.6920000000000001
Abracadabrew : Prologue	2020-07-28	4	4	0	4	0.6920000000000001
Milk and Cookies	2020-05-08	4	4	0	4	0.6920000000000001
Suli Fallen Harmony	2020-06-23	2	4	0	2	0.6920000000000001
Face on Fire	2020-06-01	2	4	0	2	0.6920000000000001
XpCade	2020-07-26	2	4	0	2	0.6920000000000001
Freedom! Do or Die	2020-05-01	1	4	0	1	0.6920000000000001
M.U.S.T. Repeat	2020-08-05	2	4	0	2	0.6920000000000001
Space Mercenary Shooter : Episode 2	2020-08-19	3	4	0	3	0.6920000000000001
Chaos Party	2020-10-16	12	4	0	12	0.6920000000000001
Raid on the Zone	2020-09-11	1	4	0	1	0.6920000000000001
Cosmodome	2020-06-02	6	4	0	6	0.6920000000000001
The Forsaken Ruins	2020-05-27	2	4	0	2	0.6920000000000001
Wrap It!	2020-06-16	2	4	0	2	0.6920000000000001
Improbable Soccer	2020-07-12	4	4	0	4	0.6920000000000001
Shape Shooter	2020-06-26	1	4	0	1	0.6920000000000001
Energysaber Masta VR	2020-06-11	1	4	0	1	0.6920000000000001
Squaxel	2020-09-19	1	4	0	1	0.6920000000000001
Cross the Moon	2020-07-29	2	4	0	2	0.6920000000000001
Maze	2020-06-17	3	4	0	3	0.6920000000000001
Shikari Rising	2020-06-25	2	4	0	2	0.6920000000000001
Die drei Freunde von der Reitschule	2020-07-31	3	4	0	3	0.6920000000000001
Winter's Trumpet	2020-07-10	2	4	0	2	0.6920000000000001
Snow Trail	2020-07-11	3	4	0	3	0.6920000000000001
Liege Dragon	2020-08-31	6	4	0	6	0.6920000000000001
No Cure	2020-07-09	1	4	0	1	0.6920000000000001
Onmyoudou - Arcade Edition	2020-07-17	2	4	0	2	0.6920000000000001
The protectors of Deya	2020-07-07	3	4	0	3	0.6920000000000001
The Soldiers Factory	2020-07-26	2	4	0	2	0.6920000000000001
Opus Ludum	2020-08-10	2	4	0	2	0.6920000000000001
Spaceslingers	2020-11-17	2	4	0	2	0.6920000000000001
Ultragun Dreamland	2020-09-02	8	4	0	8	0.6920000000000001
Worlds Align: Deadly Dream Collector's Edition	2020-07-17	8	4	0	8	0.6920000000000001
Misplaced	2020-09-25	3	4	0	3	0.6920000000000001
ヨガって！奥様	2020-08-19	2	4	0	2	0.6920000000000001
Uploaded	2020-08-31	3	4	0	3	0.6920000000000001
Learn Spanish VR	2020-09-17	1	4	0	1	0.6920000000000001
Tales of Esferia: Araxis	2020-09-30	3	4	0	3	0.6920000000000001
Helixian	2020-09-30	4	4	0	4	0.6920000000000001
Fishhead: Blueprint	2020-08-18	2	4	0	2	0.6920000000000001
Zodiakalik	2020-08-19	3	4	0	3	0.6920000000000001
Impossible Maze	2020-09-04	3	4	0	3	0.6920000000000001
Chess++	2020-08-21	2	4	0	2	0.6920000000000001
Abiko The Miko	2020-10-01	2	4	0	2	0.6920000000000001
Jumping Platform Minigame	2020-09-10	1	4	0	1	0.6920000000000001
Abstractanks	2020-11-12	4	4	0	4	0.6920000000000001
Anamnesis	2020-09-22	2	4	0	2	0.6920000000000001
Ducktopia	2020-09-21	2	4	0	2	0.6920000000000001
Starmind	2020-09-17	2	4	0	2	0.6920000000000001
Arc Wizards 2	2020-09-22	2	4	0	2	0.6920000000000001
Hyper Psychic Gauntlets	2020-12-03	1	4	0	1	0.6920000000000001
ToVer Defense	2020-10-22	1	4	0	1	0.6920000000000001
自西徂东	2020-10-28	2	4	0	2	0.6920000000000001
The Den of Worms	2020-10-15	4	4	0	4	0.6920000000000001
Secure the Skies	2020-11-18	2	4	0	2	0.6920000000000001
Mr. Hibbl	2020-10-30	2	4	0	2	0.6920000000000001
To My Best Friend	2020-12-10	2	4	0	2	0.6920000000000001
Block Wizard	2020-11-02	3	4	0	3	0.6920000000000001
Poultry Parade	2020-10-13	2	4	0	2	0.6920000000000001
Techno Tower Defense	2020-11-12	2	4	0	2	0.6920000000000001
CITY - 909	2020-10-30	3	4	0	3	0.6920000000000001
Alien Duel Elements	2020-11-27	2	4	0	2	0.6920000000000001
ADRPAN	2020-11-06	2	4	0	2	0.6920000000000001
Mana Gloom	2020-12-29	2	4	0	2	0.6920000000000001
Choco Pixel S	2020-11-08	2	4	0	2	0.6920000000000001
Formosa Night Market VR Arcade(by Taiwan)	2020-12-23	2	4	0	2	0.6920000000000001
Honkstory 2: There was No 1	2020-11-19	2	4	0	2	0.6920000000000001
The Life of Bally	2020-11-25	2	4	0	2	0.6920000000000001
The Never Ending Game	2020-12-12	2	4	0	2	0.6920000000000001
Blewie	2020-12-09	2	4	0	2	0.6920000000000001
Playing Pride & Prejudice 1: An Austen Armoire	2020-12-16	2	4	0	2	0.6920000000000001
3x3 the adventure game	2020-12-15	1	4	0	1	0.6920000000000001
Castle of the Land	2020-11-26	1	4	0	1	0.6920000000000001
Double Jump	2020-12-22	2	4	0	2	0.6920000000000001
Shredded Secrets	2020-12-07	2	4	0	2	0.6920000000000001
Sun Girls	2020-12-16	2	4	0	2	0.6920000000000001
The Trap	2020-12-15	1	4	0	1	0.6920000000000001
Matts Project Zombies Endless	2020-12-15	6	4	0	6	0.6920000000000001
Carperation	2020-12-22	3	4	0	3	0.6920000000000001
Hell's Revenge 3D	2020-12-30	2	4	0	2	0.6920000000000001
Afterparty	2020-10-22	104	446	170	274	0.6916
Tales Of Glory 2 - Retaliation	2020-12-21	20	148	52	72	0.6914
Soundart	2020-04-02	25	55	17	42	0.6914
Hanako | 花子さん	2020-12-12	100	127	44	144	0.6912
Fap Simulator 2020	2020-02-14	6	82	27	33	0.691
Cybernetic Fault	2020-09-25	310	82	27	337	0.691
FAIRY TAIL	2020-07-30	1930	1036	413	2343	0.6909000000000001
Tactical Operations	2020-06-11	119	186	67	186	0.6908
Seek Girl V	2020-08-28	229	652	255	484	0.6907
Castle Kong	2020-06-05	39	38	11	50	0.6907
Old Gods Rising	2020-05-21	15	87	29	44	0.6904000000000001
AccidentHouse	2020-12-22	5	60	19	24	0.6901
Noise Hunters	2020-05-27	15	76	25	40	0.6897
Metachromium 	2020-09-15	10	11	2	12	0.6897
Geno The Fallen King	2020-01-18	2	11	2	4	0.6897
Haramatia	2020-07-03	3	11	2	5	0.6897
SKYCAT	2020-04-03	3	11	2	5	0.6897
Killer Gin	2020-10-26	4	11	2	6	0.6897
Knight Solitaire	2020-01-01	4	11	2	6	0.6897
FlyManMissile	2020-01-24	2	11	2	4	0.6897
Bato: Treasures of Tibet	2020-01-16	4	11	2	6	0.6897
Super Orbit	2020-01-21	2	11	2	4	0.6897
Impressions	2020-02-04	8	11	2	10	0.6897
Good Goliath	2020-03-31	5	11	2	7	0.6897
Find Me	2020-12-11	3	11	2	5	0.6897
Get Gem	2020-05-15	2	11	2	4	0.6897
Jack Walker: Ethereal	2020-10-14	2	11	2	4	0.6897
House of Fear	2020-05-07	5	11	2	7	0.6897
Easy puzzle: Landscape	2020-04-20	2	11	2	4	0.6897
Professor Lupo: Ocean	2020-10-05	3	11	2	5	0.6897
Jumper Starman	2020-06-11	3	11	2	5	0.6897
コモラ・リアルワールドエスケープ	2020-07-03	35	11	2	37	0.6897
Liberated: Free Trial	2020-07-23	9	11	2	11	0.6897
Day of the Dead: Solitaire Collection	2020-10-28	5	11	2	7	0.6897
Prehistoric Dude	2020-08-11	3	11	2	5	0.6897
Legends of Solitaire: Diamond Relic	2020-08-05	4	11	2	6	0.6897
Four Civilizations	2020-08-28	6	11	2	8	0.6897
Bricks Frenzy	2020-08-17	3	11	2	5	0.6897
Raid!	2020-09-24	4	11	2	6	0.6897
Ordeal	2020-10-06	3	11	2	5	0.6897
BITROOM	2020-10-09	2	11	2	4	0.6897
LongPath	2020-10-15	3	11	2	5	0.6897
Dots!	2020-11-20	3	11	2	5	0.6897
MegaRamp	2020-11-24	2	11	2	4	0.6897
Mafia II: Definitive Edition	2020-05-19	6162	12768	5472	11634	0.6896
Bound Forest	2020-08-17	30	32	9	39	0.6894
Epic Card Game	2020-02-20	54	81	27	81	0.6890999999999999
Football Forever 3	2020-03-27	72	171	62	134	0.6886
Orbi Universo	2020-01-10	256	143	51	307	0.6886
Ad Agency Tycoon	2020-07-27	7	43	13	20	0.6885
Mystery Hotel - Hidden Object Detective Game	2020-10-16	13	43	13	26	0.6885
Inside Her (bedroom)	2020-06-19	4	26	7	11	0.6883
Naginata	2020-12-03	5	26	7	12	0.6883
Nehrim: At Fate's Edge	2020-06-12	333	457	178	511	0.6881999999999999
Pro 11	2020-02-13	66	163	59	125	0.6881999999999999
The Revenant Prince	2020-08-13	12	14	3	15	0.688
Outgun	2020-10-08	12	14	3	15	0.688
Delta G	2020-03-16	7	14	3	10	0.688
Stars and Snowdrops	2020-03-23	3	14	3	6	0.688
Voxel Crusade	2020-04-24	4	14	3	7	0.688
TERROR SQUID	2020-10-15	7	14	3	10	0.688
Portal Dogs	2020-02-25	2	14	3	5	0.688
Gravity Escape From The Maze	2020-03-19	2	14	3	5	0.688
Nordic Storm Solitaire	2020-01-04	6	14	3	9	0.688
Radical Solitaire	2020-03-24	4	14	3	7	0.688
Wishy Washy	2020-05-08	3	14	3	6	0.688
Axegend：Episode I	2020-06-16	8	14	3	11	0.688
Brain Boom	2020-07-10	9	14	3	12	0.688
Signs of the Sojourner: Prologue	2020-05-29	14	14	3	17	0.688
Altwaldheim: Town in Turmoil	2020-08-14	4	14	3	7	0.688
Hentai Students: Love Puzzle	2020-11-22	4	14	3	7	0.688
Cyberemo 2007	2020-06-22	6	83	28	34	0.6879000000000001
Neverinth	2020-06-17	98	709	283	381	0.6878000000000001
Rover Wars	2020-04-17	8	23	6	14	0.6878000000000001
DuelVox	2020-07-27	4	23	6	10	0.6878000000000001
GOLF MONSTER	2020-10-16	6	23	6	12	0.6878000000000001
Angel Sex Pet	2020-12-24	6	23	6	12	0.6878000000000001
Frick, Inc.	2020-12-18	9	23	6	15	0.6878000000000001
Succubus Domination	2020-03-26	4	40	12	16	0.6877
GAG	2020-08-07	3	40	12	15	0.6877
CHALICE	2020-06-07	3	40	12	15	0.6877
Battle Arena VR	2020-11-26	8	40	12	20	0.6877
Zero IDLE	2020-10-20	256	220	82	338	0.6876000000000001
法利恩戰記 Furion Chronicles	2020-03-16	37	88	30	67	0.6875
Battle Bruise 2	2020-01-21	3	20	5	8	0.6875
Help! I am REALLY horny!	2020-02-25	5	20	5	10	0.6875
Femida	2020-02-25	7	20	5	12	0.6875
Fragile Box	2020-02-21	5	20	5	10	0.6875
故鄉戰爭 HOMETOWN WAR	2020-04-28	4	20	5	9	0.6875
Space Empires III	2020-10-08	10	20	5	15	0.6875
Swimsanity!	2020-08-07	8	17	4	12	0.6875
StressOut	2020-12-10	4	17	4	8	0.6875
吾光笔记	2020-11-30	5	17	4	9	0.6875
Wolf & Pigs	2020-05-13	3	17	4	7	0.6875
Sokpop S07: Goblet Cave	2020-01-27	3	17	4	7	0.6875
Apastron	2020-08-18	3	17	4	7	0.6875
Endless RPG: Random Dungeon Map Generator for D&D 5e	2020-04-15	7	17	4	11	0.6875
Apoc Runner	2020-06-01	5	17	4	9	0.6875
Blackjack Hands	2020-05-13	3	17	4	7	0.6875
Wild Honesty: A party game for deeper conversations	2020-09-30	13	17	4	17	0.6875
PlayZ	2020-08-06	3	17	4	7	0.6875
LOCIS	2020-12-17	7	17	4	11	0.6875
Boobs VR	2020-09-05	2	17	4	6	0.6875
Throne of Fate	2020-10-21	14	17	4	18	0.6875
Naked Erotic Dance Girls	2020-10-15	4	17	4	8	0.6875
Close Combat: The Longest Day	2020-06-02	38	48	15	53	0.687
Notre Dame (VR)	2020-09-10	12	48	15	27	0.687
Interstellar Rift	2020-09-24	389	1074	440	829	0.6863
Orangeblood	2020-01-14	431	243	92	523	0.6863
Generation Streets	2020-02-10	27	141	51	78	0.6863
War Remains: Dan Carlin Presents an Immersive Memory	2020-05-21	9	82	28	37	0.6859999999999999
Party Arena: Board Game Battler	2020-07-07	15	34	10	25	0.6859999999999999
MINImax Tinyverse	2020-01-15	96	369	144	240	0.6858
Escape the Clinic	2020-07-07	43	288	111	154	0.6853
中国特色动物庄园	2020-04-30	18	42	13	31	0.6851999999999999
Hit Zero: Chronos	2020-11-11	9	42	13	22	0.6851999999999999
Krush Kill ‘N Destroy 2: Krossfire	2020-07-23	31	165	61	92	0.6851
Sokpop S05: Pear Quest	2020-01-17	4	31	9	13	0.6851
Tomatenquark	2020-05-24	9	31	9	18	0.6851
Smart Thief	2020-12-01	10	31	9	19	0.6851
Drift Of The Hill	2020-02-14	29	587	236	265	0.685
Dangerous Lands - Magic and RPG	2020-02-11	5	50	16	21	0.6849
BustyBiz	2020-11-20	659	991	408	1067	0.6848000000000001
Family Man	2020-05-22	226	364	143	369	0.6845
Chaos Combat Chess	2020-10-20	114	179	67	181	0.6843000000000001
Furry Woof	2020-06-23	5	55	18	23	0.6840999999999999
Savage Vessels	2020-03-02	15	28	8	23	0.6840999999999999
Cutish	2020-01-28	7	28	8	15	0.6840999999999999
Poker Hands	2020-03-27	5	28	8	13	0.6840999999999999
Wasteland Remastered	2020-02-25	81	154	57	138	0.684
Future Love Space Machine	2020-04-07	27	129	47	74	0.6839000000000001
The Suicide of Rachel Foster	2020-02-19	415	3571	1539	1954	0.6836
Bee Simulator	2020-11-17	85	560	227	312	0.6831999999999999
Unto The End	2020-12-09	107	263	102	209	0.6831999999999999
Pattern	2020-04-07	7	25	7	14	0.6831
Roguelite 2	2020-02-05	6	25	7	13	0.6831
These Nights Alone	2020-12-05	6	25	7	13	0.6831
Lab Craft Survival	2020-12-21	2	25	7	9	0.6831
Death Tales	2020-10-01	7	36	11	18	0.6829999999999999
Work Trip	2020-07-20	11	36	11	22	0.6829999999999999
Red Wings	2020-10-13	1114	484	195	1309	0.6829000000000001
Hotfix	2020-10-21	7	44	14	21	0.6828000000000001
Quantum League - Open Beta	2020-02-21	535	556	226	761	0.6826000000000001
Sometimes Always Monsters	2020-04-02	79	113	41	120	0.6825
DEAD OR ALIVE Xtreme Venus Vacation [JP]	2020-08-18	2218	155	58	2276	0.6824
Pro Player Life	2020-10-23	19	85	30	49	0.682
Libertad o Muerte!	2020-06-12	12	22	6	18	0.682
Shadowrain	2020-02-03	4	22	6	10	0.682
Monster surprised you-ki chan	2020-05-06	7	22	6	13	0.682
DeLight:The Journey Home	2020-11-19	8	22	6	14	0.682
My Strong Horse	2020-06-01	3	22	6	9	0.682
Really Trash Game	2020-05-20	4	22	6	10	0.682
Poco In	2020-08-10	3	22	6	9	0.682
The Darkest Island	2020-08-25	2	22	6	8	0.682
Fox Simulator	2020-08-06	4	22	6	10	0.682
Astro Sentai Jarbonder	2020-12-15	3	22	6	9	0.682
Wizardry: Labyrinth of Lost Souls	2020-01-15	290	237	92	382	0.6819
Tank Battle	2020-05-26	25	95	34	59	0.6818000000000001
DreadStar	2020-10-20	8	33	10	18	0.6818000000000001
破坏效应	2020-09-25	16	33	10	26	0.6818000000000001
Warborn	2020-06-12	21	41	13	34	0.6817000000000001
Hentai Milf Quiz 3	2020-10-06	5	67	23	28	0.6816
Biosys Inc	2020-11-15	3	7	1	4	0.6815000000000001
INFILTRIA	2020-03-03	4	7	1	5	0.6815000000000001
Block	2020-05-15	3	7	1	4	0.6815000000000001
IGOR MAKS The Meme Lord	2020-04-10	3	7	1	4	0.6815000000000001
Fighting Moore	2020-01-06	2	7	1	3	0.6815000000000001
Two Love	2020-01-25	2	7	1	3	0.6815000000000001
Cover Your Eyes	2020-11-06	3	7	1	4	0.6815000000000001
Post Scriptum CTG: Collectible Token Game	2020-03-12	7	7	1	8	0.6815000000000001
Dusk Warlocks	2020-01-10	9	7	1	10	0.6815000000000001
Kubble Star	2020-03-02	4	7	1	5	0.6815000000000001
Data Dream	2020-05-08	3	7	1	4	0.6815000000000001
萌萌２次大戰（略）３豪華限定版 Moe Moe World War II-3 Deluxe Edition	2020-02-14	3	7	1	4	0.6815000000000001
Alien street battle	2020-02-07	3	7	1	4	0.6815000000000001
CATharsis	2020-03-11	2	7	1	3	0.6815000000000001
CUBeKA	2020-02-12	2	7	1	3	0.6815000000000001
Clipped	2020-03-27	6	7	1	7	0.6815000000000001
Two Worlds - The 3D Art Gallery	2020-07-14	2	7	1	3	0.6815000000000001
Mystic Escape - Diary of a Prisoner	2020-03-19	4	7	1	5	0.6815000000000001
Crown of the Empire Around the World	2020-10-23	5	7	1	6	0.6815000000000001
Witch Zoe - Hentai Shuffle	2020-03-27	5	7	1	6	0.6815000000000001
Dungeon Of Dark	2020-04-20	3	7	1	4	0.6815000000000001
Boo's Balloons	2020-05-08	2	7	1	3	0.6815000000000001
Rockytown	2020-07-14	2	7	1	3	0.6815000000000001
A Lot of Universes	2020-07-11	2	7	1	3	0.6815000000000001
Remedy	2020-07-03	4	7	1	5	0.6815000000000001
鲸走：前篇	2020-06-16	3	7	1	4	0.6815000000000001
Into the TIMEVERSE	2020-07-14	3	7	1	4	0.6815000000000001
Cannonship	2020-06-08	2	7	1	3	0.6815000000000001
Detective Solitaire Inspector Magic and the Man Without Face	2020-06-15	5	7	1	6	0.6815000000000001
Ms. Holmes: Five Orange Pips Collector's Edition	2020-05-26	6	7	1	7	0.6815000000000001
Troll Patrol	2020-06-22	5	7	1	6	0.6815000000000001
Mülltrennungssimulator 2021	2020-06-19	4	7	1	5	0.6815000000000001
Salubrious Scales	2020-07-10	3	7	1	4	0.6815000000000001
Nekopter	2020-07-18	3	7	1	4	0.6815000000000001
True Detective Solitaire	2020-08-07	4	7	1	5	0.6815000000000001
Hidden Expedition: The Price of Paradise Collector's Edition	2020-06-26	8	7	1	9	0.6815000000000001
CYNOROID GAIDEN	2020-08-29	4	7	1	5	0.6815000000000001
Your Music Puzzle	2020-11-19	3	7	1	4	0.6815000000000001
Hey ma i'm a Dragon Now	2020-09-14	1	7	1	2	0.6815000000000001
Infinity Coloring Pixel	2020-09-21	5	7	1	6	0.6815000000000001
Eyeb	2020-10-10	2	7	1	3	0.6815000000000001
Sloth Tales	2020-10-30	4	7	1	5	0.6815000000000001
The Tool	2020-10-30	3	7	1	4	0.6815000000000001
Ruinverse	2020-12-04	6	7	1	7	0.6815000000000001
Foglight	2020-11-02	3	7	1	4	0.6815000000000001
Javols VR	2020-12-01	2	7	1	3	0.6815000000000001
Attack of the Mechadonk - The ultimate donkey	2020-11-29	1	7	1	2	0.6815000000000001
Twisted: A Dark Fairytale	2020-11-18	4	7	1	5	0.6815000000000001
Mead Crafter	2020-11-25	2	7	1	3	0.6815000000000001
Gem Deeps	2020-12-21	2	7	1	3	0.6815000000000001
Fill And Cross Christmas Riddles	2020-12-22	4	7	1	5	0.6815000000000001
MoonQuest	2020-02-25	34	77	27	61	0.6812
Escape from the hospital	2020-05-22	9	82	29	38	0.6811
Volleyball Heaven	2020-07-22	12	19	5	17	0.6809999999999999
DreamBack VR	2020-06-10	6	19	5	11	0.6809999999999999
Crazy Critters - Combat Cats	2020-05-22	6	19	5	11	0.6809999999999999
Roast Party	2020-08-29	15	19	5	20	0.6809999999999999
Bingo Hall	2020-01-21	9	19	5	14	0.6809999999999999
3 min per day! Improve your aged eyes(Presbyopia)	2020-07-30	4	19	5	9	0.6809999999999999
Pretty Girls Mahjong Solitaire [GREEN]	2020-10-28	8	19	5	13	0.6809999999999999
Cyberforge: First Light	2020-10-26	7	19	5	12	0.6809999999999999
Spinning_Kid_2	2020-11-18	3	19	5	8	0.6809999999999999
异界大富翁	2020-11-30	20	19	5	25	0.6809999999999999
Hashiriya Drifter	2020-07-10	132	936	393	525	0.6809000000000001
UNDER the SAND	2020-09-25	88	766	319	407	0.6809000000000001
Blind Spot	2020-04-09	15	30	9	24	0.6805
Logistique	2020-09-12	44	433	176	220	0.6804000000000001
DRAG	2020-08-11	52	158	60	112	0.6804000000000001
The Chosen Warriors	2020-08-17	1814	69	24	1838	0.6803
My Breast Friend Sally	2020-09-30	160	437	178	338	0.6801
HexON	2020-02-07	12	51	17	29	0.6801
Queen's Glory	2020-05-01	53	446	182	235	0.68
DOTORI	2020-03-28	3	16	4	7	0.68
Stratos	2020-07-17	20	16	4	24	0.68
Journey of the Broken Circle	2020-09-18	5	16	4	9	0.68
Bakemono	2020-05-04	2	16	4	6	0.68
Game Of Puzzles: Space	2020-01-22	2	16	4	6	0.68
Never Date Werewolves	2020-04-16	25	16	4	29	0.68
Go, Go Cowboy	2020-06-26	3	16	4	7	0.68
Oneons	2020-08-31	2	16	4	6	0.68
Eat or DIE!	2020-10-06	3	16	4	7	0.68
VR Hentai Cat	2020-11-19	2	16	4	6	0.68
VR Hentai	2020-12-03	2	16	4	6	0.68
Lorenzo il Magnifico	2020-10-05	11	61	21	32	0.6794
PBA Pro Bowling 2021	2020-12-29	22	61	21	43	0.6794
Family Mysteries 2: Echoes of Tomorrow	2020-04-30	23	96	35	58	0.6793000000000001
Sokpop S01: jut	2020-01-17	3	13	3	6	0.6793000000000001
Northern Lights	2020-02-26	2	13	3	5	0.6793000000000001
Hunt the Muglump	2020-03-15	3	13	3	6	0.6793000000000001
Dr. Atominus	2020-07-22	2	13	3	5	0.6793000000000001
Possession 1881	2020-06-05	5	13	3	8	0.6793000000000001
Video Editor Tycoon	2020-05-25	5	13	3	8	0.6793000000000001
Chromalition	2020-05-27	3	13	3	6	0.6793000000000001
Pink Island	2020-05-22	4	13	3	7	0.6793000000000001
Box Factory	2020-07-09	2	13	3	5	0.6793000000000001
Dragon Drop: Tabletop Multi-tool	2020-07-20	8	13	3	11	0.6793000000000001
Spinodrum	2020-08-24	5	13	3	8	0.6793000000000001
グランドインテンション・アジャストメント	2020-08-31	47	13	3	50	0.6793000000000001
Nova Odessa	2020-09-10	2	13	3	5	0.6793000000000001
Link Wars	2020-05-29	256	10	2	258	0.6793000000000001
Glitchangels	2020-12-10	4	10	2	6	0.6793000000000001
OctaFight	2020-04-07	6	10	2	8	0.6793000000000001
William's Love Prelude	2020-01-06	4	10	2	6	0.6793000000000001
A Player's Heart	2020-02-13	12	10	2	14	0.6793000000000001
Relax Simulator	2020-02-07	3	10	2	5	0.6793000000000001
Mr Maker 3D Level Editor	2020-05-27	3	10	2	5	0.6793000000000001
Life of a Mercenary	2020-06-04	9	10	2	11	0.6793000000000001
Drive Forward	2020-02-28	3	10	2	5	0.6793000000000001
Bloom: The Forest Burns	2020-06-23	5	10	2	7	0.6793000000000001
ASTRALODE Freeminers	2020-06-23	3	10	2	5	0.6793000000000001
Zombie Slayer	2020-06-11	5	10	2	7	0.6793000000000001
Captain Disaster in: The Dark Side of the Moon	2020-05-21	4	10	2	6	0.6793000000000001
En-Train	2020-08-28	4	10	2	6	0.6793000000000001
Dooria	2020-07-17	6	10	2	8	0.6793000000000001
Viking Chronicles: Tale of the lost Queen	2020-06-29	5	10	2	7	0.6793000000000001
Red dust	2020-10-11	3	10	2	5	0.6793000000000001
Rebel Reenactment: Battle of the Wilderness	2020-08-30	2	10	2	4	0.6793000000000001
You Can Pet The Dog VR	2020-08-28	2	10	2	4	0.6793000000000001
Mahjong World Contest 2	2020-09-04	4	10	2	6	0.6793000000000001
Do It With Hay	2020-09-04	4	10	2	6	0.6793000000000001
羅斯之旅 Roce's Journey	2020-10-30	3	10	2	5	0.6793000000000001
VR Zeppelin Airship Trips: Flying hotel experiences in VR	2020-11-14	2	10	2	4	0.6793000000000001
英雄坛说X·归来	2020-11-28	4	10	2	6	0.6793000000000001
Azur Lane: Crosswave	2020-02-13	10413	4863	2158	12571	0.6792
The Soul Stone War	2020-03-05	85	66	23	108	0.6792
Rusty gun	2020-08-12	4	27	8	12	0.6790999999999999
Breaking Lockdown	2020-06-17	3	27	8	11	0.6790999999999999
Adventure of Bears	2020-10-28	4	27	8	12	0.6790999999999999
The Last Of Anime	2020-12-04	3	35	11	14	0.679
Arcane Showdown	2020-09-30	135	266	106	241	0.6789000000000001
Battletoads	2020-08-20	768	1227	526	1294	0.6788
Motoride Rollercoaster VR	2020-07-22	5	48	16	21	0.6788
Isles of Limbo	2020-09-03	25	190	74	99	0.6787000000000001
Transient: Extended Edition	2020-10-28	67	173	67	134	0.6785
HINGE VR	2020-11-28	17	137	52	69	0.6785
Pulang : Insanity	2020-03-14	31	93	34	65	0.6784
INFLUXIS	2020-09-01	11	83	30	41	0.6781999999999999
ZAAM	2020-08-13	8	40	13	21	0.6781
Absinth	2020-10-23	5	68	24	29	0.6779999999999999
Leafling Online	2020-12-15	192	441	182	374	0.6779000000000001
DepthQVR_AQUA	2020-10-08	6	24	7	13	0.6776000000000001
Pretty Girls Mahjong Solitaire [BLUE]	2020-10-09	7	24	7	14	0.6776000000000001
Dismantled	2020-12-07	6	24	7	13	0.6776000000000001
Break the Web	2020-03-25	5	45	15	20	0.6775
Kwaidan	2020-01-31	6	32	10	16	0.6775
Hentai Tights	2020-01-03	4	32	10	14	0.6775
RUSSIAPHOBIA	2020-12-25	1452	3853	1718	3170	0.6773
My Cute Roommate	2020-04-22	216	363	149	365	0.677
凶手不是我 Perfect Crime	2020-10-01	256	312	127	383	0.677
When I Was Young	2020-07-10	15	92	34	49	0.6766
Battlefield™ Hardline	2020-06-11	279	1785	784	1063	0.6765000000000001
The Guise	2020-10-20	12	37	12	24	0.6765000000000001
Spinch	2020-09-03	29	128	49	78	0.6763
12 Hours to Die	2020-07-05	26	128	49	75	0.6763
The Ambassador: Fractured Timelines	2020-08-13	17	147	57	74	0.6762
Agent-00	2020-05-26	9	42	14	23	0.6759999999999999
The Otterman Empire	2020-07-02	5	21	6	11	0.6759000000000001
C.H.A.S.E.D.	2020-07-23	4	21	6	10	0.6759000000000001
The Legend of Zuri	2020-05-20	10	21	6	16	0.6759000000000001
Moving Letters	2020-10-17	3	21	6	9	0.6759000000000001
Fortune Summoners	2020-08-21	69	29	9	78	0.6758
Circadian City	2020-10-01	83	106	40	123	0.6757
Edge of Reality	2020-07-16	4	47	16	20	0.6757
Heavy Metal Babes	2020-12-21	245	456	191	436	0.6756000000000001
Football School	2020-01-09	23	62	22	45	0.6756000000000001
Quest: Escape Room	2020-10-03	4	52	18	22	0.6755
东方剑姬在西方旅行的故事	2020-11-11	50	52	18	68	0.6755
Empires and Tribes	2020-05-01	51	191	76	127	0.6753
NAMCO MUSEUM ARCHIVES Vol 1	2020-06-17	20	79	29	49	0.6751
Trendpoker 3D: Free Online Poker	2020-04-14	72	79	29	101	0.6751
Blackthorn Arena	2020-05-20	3098	2535	1133	4231	0.675
Mad Experiments: Escape Room	2020-11-12	58	186	74	132	0.675
Circle of Football	2020-08-06	92	91	34	126	0.6748000000000001
Derange	2020-05-28	4	34	11	15	0.6748000000000001
Resolutiion	2020-05-28	29	86	32	61	0.6745
Here Be Dragons	2020-01-30	19	98	37	56	0.6744
A Walk in the Woods	2020-04-21	139	64	23	162	0.6744
NewCity	2020-06-12	92	296	122	214	0.6743000000000001
Untale: King of Revinia	2020-11-06	15	39	13	28	0.6743000000000001
Hunting Moon - Nameless Doll	2020-08-01	4	39	13	17	0.6743000000000001
Jelly Brawl: Classic	2020-08-18	59	266	109	168	0.6742
Sokpop S06: Sunset Kingdom	2020-01-17	13	81	30	43	0.6742
Disaster Report 4: Summer Memories	2020-04-07	184	275	113	297	0.6741
Puzzle Girls: Alexa	2020-03-05	16	54	19	35	0.6741
Ponpu	2020-12-02	15	44	15	30	0.6741
DevLife	2020-08-21	15	44	15	30	0.6741
Nijikoi no Houkakou	2020-07-15	7	18	5	12	0.674
Their Radiance	2020-06-07	2	18	5	7	0.674
Sol 705	2020-07-31	10	18	5	15	0.674
Flavortown	2020-10-31	5	18	5	10	0.674
CatMafia	2020-11-23	6	18	5	11	0.674
Hell Loop	2020-12-24	3	18	5	8	0.674
Samurai Revenge	2020-12-15	4	18	5	9	0.674
ROBOTICS;NOTES DaSH	2020-10-14	28	112	43	71	0.6739
Encore Classic Puzzle & Board Games	2020-09-16	24	26	8	32	0.6739
Spaceflux	2020-09-30	10	26	8	18	0.6739
街机捕鱼	2020-08-05	69	256	105	174	0.6736
Cyber Pussy 2020	2020-01-09	5	71	26	31	0.6736
Last Floor	2020-03-16	2313	196	79	2392	0.6735
Gnomes & Goblins	2020-09-23	23	83	31	54	0.6734
Ether Loop	2020-01-21	168	221	90	258	0.6731999999999999
STAR WARS™: Squadrons	2020-10-01	36492	16262	7591	44083	0.6729999999999999
Banana Hell	2020-11-07	371	519	222	593	0.6729999999999999
Kawaii Girl	2020-04-25	38	73	27	65	0.6727
Veritas	2020-02-12	14	36	12	26	0.6725
ReversiQuest2	2020-01-06	26	36	12	38	0.6725
Devilish Girl	2020-04-27	3	41	14	17	0.6724
Necronator: Dead Wrong	2020-07-30	177	331	139	316	0.6722
The Rule of Land: Pioneers	2020-09-09	313	215	88	401	0.6720999999999999
Cartonfall: Fortress	2020-08-12	6	15	4	10	0.672
Runner Heroes	2020-01-03	4	15	4	8	0.672
Puzzle Girls	2020-04-28	5	15	4	9	0.672
Racing Bike Fight	2020-04-29	50	15	4	54	0.672
Apprentice Knight-Iona	2020-04-21	3	15	4	7	0.672
小小愿景	2020-08-27	8	15	4	12	0.672
"""Zieh eine Karte""-Simulator"	2020-08-26	2	15	4	6	0.672
Furgal's Jetpack	2020-09-22	4	15	4	8	0.672
Sex Simulator 2020	2020-10-16	4	63	23	27	0.6718999999999999
The Yolk Street	2020-04-01	12	23	7	19	0.6718000000000001
Truck and Logistics Simulator	2020-06-23	400	982	434	834	0.6717000000000001
紫塞秋风 The Wind Road	2020-07-09	4874	4475	2062	6936	0.6715000000000001
Seed Hunter 猎源	2020-05-22	132	250	104	236	0.6709999999999999
The Stranger VR	2020-09-14	8	48	17	25	0.6709
Hoser Hockey	2020-12-01	10	28	9	19	0.6709
Police Chase	2020-09-18	4	28	9	13	0.6709
Sperm Runner	2020-08-04	3	28	9	12	0.6709
Conqueror's Blade	2020-04-06	19178	17351	8200	27378	0.6706000000000001
Jung's Labyrinth	2020-09-05	11	43	15	26	0.6706000000000001
The Girl of Glass: A Summer Bird's Tale	2020-09-22	9	43	15	24	0.6706000000000001
Log Jammers	2020-05-26	17	3	0	17	0.6706000000000001
Empress of Gold	2020-04-26	2	3	0	2	0.6706000000000001
Sector Assault	2020-02-06	4	3	0	4	0.6706000000000001
Conc Jump	2020-04-28	4	3	0	4	0.6706000000000001
Chessers	2020-10-19	2	3	0	2	0.6706000000000001
Micromanagement	2020-06-30	2	3	0	2	0.6706000000000001
Card Battle Spirit Link	2020-05-03	3	3	0	3	0.6706000000000001
MagnetoBotty	2020-07-31	1	3	0	1	0.6706000000000001
Lost Bazaar	2020-07-26	5	3	0	5	0.6706000000000001
Burst Drive	2020-04-06	3	3	0	3	0.6706000000000001
Rocket Golf	2020-12-31	1	3	0	1	0.6706000000000001
A Giant Problem	2020-04-01	5	3	0	5	0.6706000000000001
Global Fortune	2020-01-21	2	3	0	2	0.6706000000000001
Function	2020-06-23	2	3	0	2	0.6706000000000001
Boogie Bot	2020-08-31	2	3	0	2	0.6706000000000001
Pillowheads	2020-07-16	4	3	0	4	0.6706000000000001
Cyborgs Attack	2020-12-03	2	3	0	2	0.6706000000000001
Orbitblazers	2020-01-09	2	3	0	2	0.6706000000000001
Vole Complexity	2020-10-13	2	3	0	2	0.6706000000000001
Blender Bros	2020-08-25	2	3	0	2	0.6706000000000001
Morbolbo: Enter the Maze	2020-01-31	3	3	0	3	0.6706000000000001
Spock in the Dama Kingdom	2020-11-04	3	3	0	3	0.6706000000000001
Virulent Addiction	2020-05-03	5	3	0	5	0.6706000000000001
CRYPTIC	2020-12-25	2	3	0	2	0.6706000000000001
Adventure mosaics. Forest spirits	2020-03-05	9	3	0	9	0.6706000000000001
Match Solitaire	2020-02-20	2	3	0	2	0.6706000000000001
Louie	2020-09-04	4	3	0	4	0.6706000000000001
OS Omega	2020-04-23	3	3	0	3	0.6706000000000001
Through The Unknown	2020-01-17	3	3	0	3	0.6706000000000001
Consumed Awakening	2020-06-22	2	3	0	2	0.6706000000000001
Lightale	2020-03-03	2	3	0	2	0.6706000000000001
SOONA	2020-07-13	1	3	0	1	0.6706000000000001
Jeremiah	2020-03-26	1	3	0	1	0.6706000000000001
CHAMELEON | くるくるカメレオン	2020-01-07	4	3	0	4	0.6706000000000001
Zombie Mutant DNA	2020-03-17	1	3	0	1	0.6706000000000001
MyBot	2020-01-29	2	3	0	2	0.6706000000000001
Bombergeddon	2020-04-10	3	3	0	3	0.6706000000000001
Mayhem Masters	2020-03-27	4	3	0	4	0.6706000000000001
Buddy Bash	2020-04-30	4	3	0	4	0.6706000000000001
ArtPulse	2020-02-10	2	3	0	2	0.6706000000000001
Matcha Warriors	2020-06-24	2	3	0	2	0.6706000000000001
驱灵	2020-02-25	2	3	0	2	0.6706000000000001
NUMTATE	2020-02-20	2	3	0	2	0.6706000000000001
Volleyballed	2020-06-18	3	3	0	3	0.6706000000000001
Terra Lander II - Rockslide Rescue	2020-02-28	2	3	0	2	0.6706000000000001
Wonderland Nights: White Rabbit's Diary	2020-06-11	3	3	0	3	0.6706000000000001
Pyro the Exterminator	2020-03-19	3	3	0	3	0.6706000000000001
Dantes Bullet Inferno	2020-02-19	1	3	0	1	0.6706000000000001
The Botanist	2020-11-20	2	3	0	2	0.6706000000000001
Witch and Spirit	2020-06-15	4	3	0	4	0.6706000000000001
K'nife Fight	2020-09-14	2	3	0	2	0.6706000000000001
The Astro Parcel Service	2020-04-17	7	3	0	7	0.6706000000000001
Chuck Meowrris	2020-02-28	2	3	0	2	0.6706000000000001
ZYNET	2020-09-24	1	3	0	1	0.6706000000000001
Performer	2020-07-31	1	3	0	1	0.6706000000000001
Bigwig Flint	2020-03-07	2	3	0	2	0.6706000000000001
Tales in the TAXI	2020-03-13	2	3	0	2	0.6706000000000001
Little Adventures	2020-09-29	2	3	0	2	0.6706000000000001
Whisper	2020-08-12	1	3	0	1	0.6706000000000001
Bells 'n' Whistles	2020-07-30	2	3	0	2	0.6706000000000001
Move It Up	2020-07-17	2	3	0	2	0.6706000000000001
The Travelyan Home	2020-03-13	2	3	0	2	0.6706000000000001
Nyxx	2020-05-08	2	3	0	2	0.6706000000000001
NETABOKU -A robot girl changes my life as a bedridden boy-	2020-12-17	2	3	0	2	0.6706000000000001
Andarigas	2020-03-27	1	3	0	1	0.6706000000000001
No Exit	2020-03-29	1	3	0	1	0.6706000000000001
Blaster Squad	2020-04-23	4	3	0	4	0.6706000000000001
Dark Solitaire. Mystical Circus	2020-10-13	4	3	0	4	0.6706000000000001
Flappy Hypership Out of Control	2020-04-01	2	3	0	2	0.6706000000000001
XRacer 2: Evolution	2020-04-26	3	3	0	3	0.6706000000000001
MUSCLE POWER	2020-04-17	3	3	0	3	0.6706000000000001
Jaw Breakers & The Confection Connection	2020-05-13	1	3	0	1	0.6706000000000001
Premier Manager 08	2020-06-26	5	3	0	5	0.6706000000000001
Sol-Hel	2020-04-04	1	3	0	1	0.6706000000000001
Infinite Abyss	2020-04-13	2	3	0	2	0.6706000000000001
ColorsInvaders	2020-04-27	2	3	0	2	0.6706000000000001
Etheldia Pepper	2020-04-15	2	3	0	2	0.6706000000000001
Swoosh	2020-04-19	2	3	0	2	0.6706000000000001
Jigsaw Puzzles for Kids and Adults - Europe	2020-04-20	4	3	0	4	0.6706000000000001
Coward	2020-04-28	3	3	0	3	0.6706000000000001
The Legend of Cesar 	2020-07-10	1	3	0	1	0.6706000000000001
Ball of Doom	2020-04-18	2	3	0	2	0.6706000000000001
送小鸡回家Send chicken home	2020-04-24	2	3	0	2	0.6706000000000001
ロストカラーズ／再装版 / LOSTCOLORS	2020-04-24	5	3	0	5	0.6706000000000001
Operation of North Kingdom	2020-05-13	1	3	0	1	0.6706000000000001
Wire	2020-05-04	1	3	0	1	0.6706000000000001
AdaptaTank	2020-04-27	1	3	0	1	0.6706000000000001
Astrozombies	2020-08-25	3	3	0	3	0.6706000000000001
Rebirth	2020-05-08	6	3	0	6	0.6706000000000001
Space Trains	2020-05-24	3	3	0	3	0.6706000000000001
Hunt Planet Bug	2020-05-20	1	3	0	1	0.6706000000000001
Galaxy Cat	2020-05-15	2	3	0	2	0.6706000000000001
Overseer	2020-07-31	3	3	0	3	0.6706000000000001
The Cubedex of Brass and Wood	2020-09-01	4	3	0	4	0.6706000000000001
Meditation 2 ~ Wisdom and Christian Art	2020-05-24	2	3	0	2	0.6706000000000001
CAMEO: CCTV Detective	2020-05-29	2	3	0	2	0.6706000000000001
Color Game	2020-06-01	1	3	0	1	0.6706000000000001
Ace of Space	2020-07-09	1	3	0	1	0.6706000000000001
ArrowBall	2020-11-09	4	3	0	4	0.6706000000000001
Vacation Adventures: Park Ranger 10	2020-05-21	5	3	0	5	0.6706000000000001
The Hunter's Journals - Red Ripper	2020-10-31	1	3	0	1	0.6706000000000001
astro dash	2020-12-05	1	3	0	1	0.6706000000000001
Adventure mosaics. Small Islanders	2020-08-11	6	3	0	6	0.6706000000000001
Meditation 3 ~ Sophia Code	2020-05-27	2	3	0	2	0.6706000000000001
Corona Simulator	2020-06-23	2	3	0	2	0.6706000000000001
Wall Ninja	2020-10-06	3	3	0	3	0.6706000000000001
Bluevolution	2020-06-18	1	3	0	1	0.6706000000000001
Solitaire Beach Season Sounds of Waves	2020-06-15	4	3	0	4	0.6706000000000001
Chickamauga Battles	2020-08-27	5	3	0	5	0.6706000000000001
Nexagon	2020-06-09	2	3	0	2	0.6706000000000001
Libe	2020-08-07	1	3	0	1	0.6706000000000001
Jane Skriff	2020-08-28	1	3	0	1	0.6706000000000001
Kaapelipeli: The Cable Game	2020-07-10	2	3	0	2	0.6706000000000001
Para Bellum	2020-10-23	2	3	0	2	0.6706000000000001
牝静的开端	2020-07-03	1	3	0	1	0.6706000000000001
Chimeras: Cherished Serpent Collector's Edition	2020-06-05	6	3	0	6	0.6706000000000001
Kawaii Memory	2020-08-21	1	3	0	1	0.6706000000000001
Boss Ass	2020-10-03	9	3	0	9	0.6706000000000001
Relic Guardians: Complete Edition	2020-06-22	2	3	0	2	0.6706000000000001
Sudden Way	2020-07-21	3	3	0	3	0.6706000000000001
300k - The Game	2020-07-23	2	3	0	2	0.6706000000000001
MagVigor	2020-12-22	3	3	0	3	0.6706000000000001
Spherical alliance	2020-10-27	2	3	0	2	0.6706000000000001
Tetron	2020-08-14	2	3	0	2	0.6706000000000001
BAFF F	2020-06-28	3	3	0	3	0.6706000000000001
归途	2020-07-13	1	3	0	1	0.6706000000000001
Museum of War	2020-07-29	1	3	0	1	0.6706000000000001
Requiem Aeternam Eden	2020-07-31	1	3	0	1	0.6706000000000001
Bloodway Infinity	2020-08-04	2	3	0	2	0.6706000000000001
Gunboat	2020-09-04	3	3	0	3	0.6706000000000001
Altered Destiny	2020-08-07	2	3	0	2	0.6706000000000001
Lareissa Everbright	2020-09-08	2	3	0	2	0.6706000000000001
Wings Of Legends	2020-07-31	2	3	0	2	0.6706000000000001
Last Space Mission	2020-07-23	1	3	0	1	0.6706000000000001
Starshot	2020-08-16	2	3	0	2	0.6706000000000001
VR Marco Polo's Travelling in Medieval Asia (The Far East, Chinese, Japanese, Shogun, Khitan...revisit A.D. 1290)	2020-07-27	3	3	0	3	0.6706000000000001
Jewel of Kuru	2020-08-07	1	3	0	1	0.6706000000000001
Boxfight	2020-11-02	4	3	0	4	0.6706000000000001
Olympic Basketball	2020-07-29	2	3	0	2	0.6706000000000001
Whizz Ball	2020-12-21	4	3	0	4	0.6706000000000001
Stonebot Adventures	2020-08-11	2	3	0	2	0.6706000000000001
Arcanion: Tales of Magi	2020-09-09	2	3	0	2	0.6706000000000001
Pixel Ninja	2020-08-10	2	3	0	2	0.6706000000000001
Turtle vs. Portal	2020-08-27	2	3	0	2	0.6706000000000001
Dreadful Shadows	2020-10-31	7	3	0	7	0.6706000000000001
Escape Knox Manor	2020-10-16	2	3	0	2	0.6706000000000001
Fruit Clicker	2020-09-18	3	3	0	3	0.6706000000000001
LouveSystems' TrackMasters	2020-09-04	6	3	0	6	0.6706000000000001
Absolutely Goode Championship	2020-08-24	2	3	0	2	0.6706000000000001
Todd's Spider Dream	2020-09-30	2	3	0	2	0.6706000000000001
The Light at the End of the Ocean	2020-09-01	2	3	0	2	0.6706000000000001
Xentron Attack	2020-09-11	1	3	0	1	0.6706000000000001
BOOM Bound	2020-12-30	2	3	0	2	0.6706000000000001
Modern Puzzle	2020-08-26	1	3	0	1	0.6706000000000001
DogFight	2020-11-11	1	3	0	1	0.6706000000000001
Project Gravity	2020-09-21	3	3	0	3	0.6706000000000001
Emurinoo	2020-09-28	3	3	0	3	0.6706000000000001
Crisis Arcana	2020-09-18	2	3	0	2	0.6706000000000001
Flood Fill	2020-09-21	3	3	0	3	0.6706000000000001
Virtual Ricochet	2020-11-03	2	3	0	2	0.6706000000000001
DroneGlitch	2020-10-05	2	3	0	2	0.6706000000000001
Monty Kong	2020-11-12	1	3	0	1	0.6706000000000001
Expiration	2020-11-05	4	3	0	4	0.6706000000000001
Second Chance	2020-09-28	2	3	0	2	0.6706000000000001
Project Ultra	2020-09-30	2	3	0	2	0.6706000000000001
Fantasy Heroes 2	2020-10-22	5	3	0	5	0.6706000000000001
Battle Sad Boy	2020-10-02	2	3	0	2	0.6706000000000001
Cave Crawl	2020-10-25	3	3	0	3	0.6706000000000001
Brew & Brawl - Gnomes vs. Dwarves	2020-10-29	3	3	0	3	0.6706000000000001
Too Much Water	2020-12-17	2	3	0	2	0.6706000000000001
Yachu Dice	2020-10-22	6	3	0	6	0.6706000000000001
Candy Bear 2	2020-11-20	2	3	0	2	0.6706000000000001
Cultus	2020-10-20	7	3	0	7	0.6706000000000001
Half Blood RPG	2020-10-30	2	3	0	2	0.6706000000000001
Space Force Squadron	2020-10-21	3	3	0	3	0.6706000000000001
The Wizard Game	2020-11-27	1	3	0	1	0.6706000000000001
Friend Fighters	2020-11-04	3	3	0	3	0.6706000000000001
The Gurion Mountains	2020-11-05	2	3	0	2	0.6706000000000001
The Dark Stares Back	2020-12-24	2	3	0	2	0.6706000000000001
Microjob	2020-12-21	2	3	0	2	0.6706000000000001
Ring Miner	2020-12-31	3	3	0	3	0.6706000000000001
Evade Zero	2020-12-18	2	3	0	2	0.6706000000000001
You are alone	2020-12-07	2	3	0	2	0.6706000000000001
Robo Gauntlet	2020-12-16	2	3	0	2	0.6706000000000001
Mahjong Solitaire 100	2020-12-17	3	3	0	3	0.6706000000000001
VR Atlantis Search: with Deep Diving	2020-12-01	1	3	0	1	0.6706000000000001
Brandins Buttons	2020-12-10	2	3	0	2	0.6706000000000001
Trajectory Fracture	2020-12-25	2	3	0	2	0.6706000000000001
The Adventures on Uranus	2020-12-17	1	3	0	1	0.6706000000000001
Christmas Mosaic Puzzle	2020-12-22	3	3	0	3	0.6706000000000001
Verse Surf	2020-11-19	8	38	13	21	0.6705
Republique VR	2020-06-16	140	60	22	162	0.6704000000000001
Thief Simulator VR	2020-11-05	90	682	300	390	0.6701
Emu War!	2020-03-20	3	12	3	6	0.6698000000000001
DumbFight	2020-01-08	7	12	3	10	0.6698000000000001
Vampire Martina-Bloody Day 228	2020-01-11	3	12	3	6	0.6698000000000001
Chipmunk's Adventures	2020-10-21	3	12	3	6	0.6698000000000001
Arranged	2020-01-31	3	12	3	6	0.6698000000000001
Twitchoos RUN: Socks & Stream	2020-06-23	2	12	3	5	0.6698000000000001
Die Wolf	2020-03-05	4	12	3	7	0.6698000000000001
Meowhalla	2020-02-14	3	12	3	6	0.6698000000000001
吞噬追踪	2020-03-12	4	12	3	7	0.6698000000000001
Kick the VIRUS	2020-04-18	3	12	3	6	0.6698000000000001
Qube Qross	2020-12-14	3	12	3	6	0.6698000000000001
Missile Tank	2020-08-27	6	12	3	9	0.6698000000000001
Lockdown VR: Kidnapped	2020-08-20	14	12	3	17	0.6698000000000001
Murder by Moonlight - Call of the Wolf	2020-10-09	6	12	3	9	0.6698000000000001
10mg: Sealed Estate	2020-10-15	3	12	3	6	0.6698000000000001
AO Tennis 2	2020-01-09	435	830	369	804	0.6695000000000001
Terrorarium	2020-07-28	21	20	6	27	0.6694
Rollers	2020-02-11	12	20	6	18	0.6694
Stargaze	2020-11-20	4	20	6	10	0.6694
Run For Your Life	2020-08-17	5	20	6	11	0.6694
Zero-based World	2020-07-17	36	132	53	89	0.6692
Animal Rescuer	2020-12-22	8	45	16	24	0.6691
Farmtale	2020-04-13	97	175	72	169	0.6688
Aery - Sky Castle	2020-10-08	9	40	14	23	0.6687000000000001
REGOLA	2020-04-12	3	25	8	11	0.6685
Vagrus - The Riven Realms: Prologue	2020-07-10	66	113	45	111	0.6684
Rover Mechanic Simulator: Training Day	2020-05-21	22	64	24	46	0.6684
Formula Car Racing Simulator	2020-01-21	50	35	12	62	0.6684
True Hate	2020-10-02	5	35	12	17	0.6684
SpellPunk VR	2020-04-24	4	30	10	14	0.6683
Hellpoint: The Thespian Feast	2020-02-20	62	503	221	283	0.6679
Jar Wars	2020-02-25	30	131	53	83	0.6679
Hockey Manager 20|20	2020-01-31	24	59	22	46	0.6678000000000001
Quiet Godo	2020-11-13	9	47	17	26	0.6677
Squishies	2020-01-24	2	9	2	4	0.6676000000000001
Waves of Death	2020-03-20	4	9	2	6	0.6676000000000001
Flaky Bakery	2020-01-22	3	9	2	5	0.6676000000000001
Living Dead	2020-03-06	4	9	2	6	0.6676000000000001
Pencil Fantastic	2020-12-08	3	9	2	5	0.6676000000000001
Empire Live	2020-05-15	8	9	2	10	0.6676000000000001
SafeHome	2020-02-25	4	9	2	6	0.6676000000000001
The Innkeeper	2020-04-03	4	9	2	6	0.6676000000000001
Business Wars - The Card Game	2020-04-03	3	9	2	5	0.6676000000000001
Physical Glitch	2020-01-25	3	9	2	5	0.6676000000000001
Tank Ball	2020-03-12	2	9	2	4	0.6676000000000001
Roko-Loko into Ratozinger's Castle	2020-02-29	2	9	2	4	0.6676000000000001
James Peris: Sin licencia ni control - Edición definitiva	2020-03-12	3	9	2	5	0.6676000000000001
Poly Duels	2020-02-25	8	9	2	10	0.6676000000000001
Tunnel Bird	2020-03-26	3	9	2	5	0.6676000000000001
Tentacle Manor	2020-04-30	4	9	2	6	0.6676000000000001
Hard Rock Pinball	2020-04-15	2	9	2	4	0.6676000000000001
Coof Attack	2020-12-01	6	9	2	8	0.6676000000000001
Mission Biotech	2020-05-13	5	9	2	7	0.6676000000000001
The Chronicles of Confucius's Journey	2020-05-12	4	9	2	6	0.6676000000000001
Choco Pixel 5	2020-05-14	2	9	2	4	0.6676000000000001
Dungeon of Trials	2020-06-25	2	9	2	4	0.6676000000000001
Kármán line: the edge of war	2020-08-20	3	9	2	5	0.6676000000000001
Bring Dad Home	2020-06-24	2	9	2	4	0.6676000000000001
Maidens of the Ocean Solitaire	2020-06-14	4	9	2	6	0.6676000000000001
Hidden Valley Tower Defense	2020-08-31	3	9	2	5	0.6676000000000001
Professor Rubik’s Brain Fitness	2020-11-12	3	9	2	5	0.6676000000000001
AutoLand	2020-08-13	2	9	2	4	0.6676000000000001
Beat Me If You Can	2020-09-10	6	9	2	8	0.6676000000000001
Japanese Romaji Adventure	2020-08-28	3	9	2	5	0.6676000000000001
1001 Jigsaw World Tour Africa	2020-10-30	3	9	2	5	0.6676000000000001
MOAI 6: Unexpected Guests	2020-11-05	16	9	2	18	0.6676000000000001
Nerm the Worm	2020-10-23	3	9	2	5	0.6676000000000001
Otherside	2020-11-02	2	9	2	4	0.6676000000000001
The Tides of Time	2020-11-30	4	9	2	6	0.6676000000000001
Girls on puzzle 2	2020-12-02	2	9	2	4	0.6676000000000001
MUMMMASTER!	2020-12-25	2	9	2	4	0.6676000000000001
RPG World - Action RPG Maker	2020-07-17	39	377	164	203	0.6673
The Forgotten Land	2020-06-16	14	42	15	29	0.6670999999999999
Hero of Not Our Time	2020-10-09	42	105	42	84	0.6667000000000001
GONNER2	2020-10-22	26	82	32	58	0.6667000000000001
End of War 1945	2020-05-08	12	17	5	17	0.6666
Dungeon Origins	2020-01-23	11	17	5	16	0.6666
Floppy Heroes 2	2020-04-17	7	17	5	12	0.6666
Rainbows, toilets & unicorns	2020-04-17	4	17	5	9	0.6666
The Last Saviour	2020-07-24	4	17	5	9	0.6666
HYPERBOLIC Arcade Trading	2020-09-03	4	17	5	9	0.6666
Beauty Contest	2020-11-08	4	17	5	9	0.6666
The Developer	2020-09-17	4	17	5	9	0.6666
The Bible - Exodus	2020-09-22	2	17	5	7	0.6666
BreakBlast	2020-10-26	7	17	5	12	0.6666
Ghost Stories 2	2020-11-11	6	37	13	19	0.6665000000000001
Super Soccer Blast	2020-06-19	35	91	36	71	0.6663
Fireflies	2020-03-18	4	6	1	5	0.6662
ELISEISK 2074	2020-09-21	2	6	1	3	0.6662
Quash	2020-11-06	4	6	1	5	0.6662
Blind Spot VR / 盲点 VR	2020-02-06	3	6	1	4	0.6662
Sanguine Soul	2020-01-11	3	6	1	4	0.6662
OCEAN OF BATTLES	2020-01-23	2	6	1	3	0.6662
Deadly Night - No Escape	2020-07-07	2	6	1	3	0.6662
Crazy Eights 3D Premium	2020-08-08	6	6	1	7	0.6662
Beast Brigade	2020-10-15	2	6	1	3	0.6662
Fantaventura	2020-02-20	2	6	1	3	0.6662
Vile Matter	2020-01-14	2	6	1	3	0.6662
Dimension of Dreams	2020-06-04	7	6	1	8	0.6662
Slay The Bigies	2020-03-18	2	6	1	3	0.6662
Universe Quiz	2020-02-14	2	6	1	3	0.6662
Divine Legacy	2020-09-11	3	6	1	4	0.6662
Sokpop S03: Doler	2020-01-17	2	6	1	3	0.6662
Craftica	2020-03-26	2	6	1	3	0.6662
The Legend of Eldridge Scrolls: Woop	2020-07-02	3	6	1	4	0.6662
千里の棋譜 ～現代将棋ミステリー～	2020-02-26	11	6	1	12	0.6662
Shape Arena	2020-08-03	19	6	1	20	0.6662
Stellaxy	2020-02-06	4	6	1	5	0.6662
The Unseen Fears: Ominous Talent Collector's Edition	2020-01-24	5	6	1	6	0.6662
Space Mega Force Man	2020-02-14	2	6	1	3	0.6662
The Mermaid's Secret Remedy The Love Spell	2020-02-19	2	6	1	3	0.6662
Smile	2020-02-27	5	6	1	6	0.6662
Boom Stick	2020-02-27	2	6	1	3	0.6662
Entelechy	2020-03-10	2	6	1	3	0.6662
Chronicle of Daneya	2020-03-19	3	6	1	4	0.6662
Stimuli	2020-04-01	3	6	1	4	0.6662
Kyo's Routine	2020-04-03	2	6	1	3	0.6662
Strato's Sylph Asterism	2020-05-06	2	6	1	3	0.6662
Sakura Stars	2020-05-21	1	6	1	2	0.6662
PUZZL	2020-04-29	2	6	1	3	0.6662
[NTRPG] Wife Punishment 妻子的惩罚!!~风情客栈的公交车~	2020-05-14	2	6	1	3	0.6662
PT+	2020-09-25	2	6	1	3	0.6662
Living Legends Remastered: Ice Rose Collector's Edition	2020-05-08	6	6	1	7	0.6662
The Fantastic Adventure of Monsieur Grape!	2020-07-03	2	6	1	3	0.6662
Greedy Maze	2020-07-27	3	6	1	4	0.6662
Butterfly 3. Funny Twins.	2020-08-11	2	6	1	3	0.6662
Lunar Rover	2020-07-17	2	6	1	3	0.6662
Candle In Darkness	2020-08-13	2	6	1	3	0.6662
Covert Commando	2020-12-25	2	6	1	3	0.6662
Souls Lore	2020-08-20	3	6	1	4	0.6662
沉默沼泽	2020-09-14	4	6	1	5	0.6662
Wild Baffo	2020-10-16	3	6	1	4	0.6662
LIFESPAWN	2020-09-13	8	6	1	9	0.6662
Drilly Willis	2020-11-09	2	6	1	3	0.6662
Ursa	2020-12-24	2	6	1	3	0.6662
Match It!	2020-10-21	2	6	1	3	0.6662
Bloody Horde	2020-10-09	5	6	1	6	0.6662
Summoner Apprentice	2020-12-07	2	6	1	3	0.6662
DUNGEON OF NAZARICK	2020-11-07	2	6	1	3	0.6662
Outta This Kingdom	2020-11-26	4	6	1	5	0.6662
Bridge to Another World: Secrets of the Nutcracker Collector's Edition	2020-12-21	6	6	1	7	0.6662
Swords and Sandals Crusader Redux	2020-11-04	20	77	30	50	0.6659999999999999
Faerie Solitaire Dire	2020-09-07	17	32	11	28	0.6659999999999999
Dungeon Solver	2020-05-18	5	32	11	16	0.6659999999999999
Jessika	2020-08-25	22	134	55	77	0.6659
Peekaboo Collection - 3 Tales of Horror	2020-04-14	4	27	9	13	0.6657
ABC: Audioreactive Beat Circle	2020-08-21	5	27	9	14	0.6657
HentaiTeachers	2020-01-11	3	22	7	10	0.6657
The Amazing Fantastics	2020-02-13	3	22	7	10	0.6657
NEAVE	2020-04-29	6	22	7	13	0.6657
Coronavirus Quarantine Simulator	2020-06-16	12	22	7	19	0.6657
Damn, what was yesterday?	2020-07-03	3	22	7	10	0.6657
Reflect Horizons	2020-08-25	3	22	7	10	0.6657
Shiny Summer	2020-09-17	3	22	7	10	0.6657
Dread Nautical	2020-10-27	16	22	7	23	0.6657
Dwarf Shop	2020-03-19	40	65	25	65	0.6651
Formula Retro Racing	2020-05-15	12	58	22	34	0.6651
Never BreakUp Beta	2020-10-16	101	131	54	155	0.6648999999999999
Accident: The Pilot	2020-07-16	83	488	218	301	0.6647
CyberTaxi	2020-10-30	6	97	39	45	0.6647
Hot And Lovely 2	2020-03-26	129	352	155	284	0.6645000000000001
妙连千军 Million Dungeon	2020-06-12	203	197	84	287	0.6643000000000001
KnotBot	2020-05-08	12	34	12	24	0.6641
Genesis Alpha One Deluxe Edition	2020-02-25	783	1432	667	1450	0.664
Professional Farmer: Cattle and Crops	2020-10-15	1308	1154	534	1842	0.664
Möbius Front '83	2020-11-05	250	273	119	369	0.6639
Mist Hunter	2020-02-14	7	29	10	17	0.6633
Not Dead Yet	2020-12-16	12	29	10	22	0.6633
Wanderlust: Transsiberian	2020-04-09	5	29	10	15	0.6633
Try To Reach 10	2020-02-01	11	14	4	15	0.6633
Welcome to Primrose Lake	2020-02-10	5	14	4	9	0.6633
BlazeSky	2020-09-21	5	14	4	9	0.6633
Flatspace	2020-01-24	6	14	4	10	0.6633
Counter Fight 4	2020-02-20	6	14	4	10	0.6633
Hunting Unlimited 1	2020-08-07	4	14	4	8	0.6633
Nightvision	2020-10-13	4	14	4	8	0.6633
The Battle of Angels	2020-05-15	3	14	4	7	0.6633
Dungeons of Clay	2020-10-12	3	14	4	7	0.6633
Tyrgard - Trial of honor	2020-07-03	3	14	4	7	0.6633
4ife	2020-07-09	5	14	4	9	0.6633
Lockdown Hero	2020-07-20	6	14	4	10	0.6633
ProjectTeo	2020-09-09	7	14	4	11	0.6633
Starport Delta	2020-03-28	42	55	21	63	0.6631999999999999
ADULT SHERIFF	2020-01-04	8	145	61	69	0.6629
Your amazing T-Gotchi!	2020-10-09	128	293	129	257	0.6628000000000001
DOOR	2020-11-26	6	24	8	14	0.6627
Defective Holiday	2020-05-01	3	24	8	11	0.6627
Motionless	2020-07-24	3	24	8	11	0.6627
Gladiators IDLE	2020-12-17	3	24	8	11	0.6627
The Catch: Carp & Coarse Fishing	2020-06-30	168	193	83	251	0.6626000000000001
Unlock The King 2	2020-01-31	8	64	25	33	0.6626000000000001
GLADOM - 2D PVP Free & Skill Based	2020-04-22	8	19	6	14	0.6625
Johnny Mystery and The Halloween Killer	2020-06-22	3	19	6	9	0.6625
Alchemage	2020-11-05	26	186	80	106	0.6622
Danger Gazers	2020-01-02	13	50	19	32	0.6620999999999999
Hentai Milf Quiz 2	2020-08-27	4	43	16	20	0.6620999999999999
Deep Despair	2020-02-17	121	177	76	197	0.6619
Drugs and Crime Idle	2020-12-11	88	157	67	155	0.6615000000000001
LesLove.Club: Emily and Sarah	2020-06-06	8	31	11	19	0.6614
Withstand	2020-03-05	75	224	98	173	0.6613
Whiskey.Mafia. Leo's Family	2020-07-21	11	239	105	116	0.6612
机忆	2020-06-18	13	52	20	33	0.6611
Hentai Cyberpunk	2020-08-13	4	45	17	21	0.6609
Slinger VR	2020-04-23	10	38	14	24	0.6609
Blood price	2020-08-11	20	79	32	52	0.6606000000000001
Aquila Bird Flight Simulator	2020-12-27	5	26	9	14	0.6603
Red Rush	2020-05-21	9	26	9	18	0.6603
Diesel Punch	2020-07-18	3	26	9	12	0.6603
Guts 'N Goals: Preseason	2020-07-30	16	26	9	25	0.6603
Anime - Space Sniper	2020-11-15	2	26	9	11	0.6603
Uniform Girl	2020-04-03	107	276	123	230	0.6602
Hentai Milf Quiz	2020-06-18	10	147	63	73	0.6601
White Day VR: Courage Test	2020-10-30	4	47	18	22	0.6598999999999999
City Monsters	2020-04-17	26	33	12	38	0.6596
UIFO DEFENSE HD	2020-01-18	9	33	12	21	0.6596
Cumming Hotel - A Gay Furry Slice of Life	2020-03-20	7	33	12	19	0.6596
Oh My Girl / 我的女孩	2020-03-26	5	33	12	17	0.6596
Hentai Maid Club	2020-10-22	4	33	12	16	0.6596
Legend of Towercraft	2020-06-05	60	56	22	82	0.6595000000000001
Dungeon Defenders: Awakened	2020-05-28	2877	2948	1431	4308	0.6593000000000001
Medicinal Herbs - Cannabis Grow Simulator	2020-09-23	12	21	7	19	0.6593000000000001
Antares	2020-02-27	3	21	7	10	0.6593000000000001
Demian	2020-12-17	16	21	7	23	0.6593000000000001
Landflix Odyssey	2020-11-13	4	11	3	7	0.6593000000000001
Welcome To... Chichester 2 - Part 2 : No Regrets For The Future	2020-06-23	2	11	3	5	0.6593000000000001
Pooplers	2020-03-12	6	11	3	9	0.6593000000000001
Super Hiking Simulator 2020	2020-02-28	3	11	3	6	0.6593000000000001
Castle Fight	2020-06-15	2	11	3	5	0.6593000000000001
Time Agent	2020-05-19	3	11	3	6	0.6593000000000001
Dark Sales	2020-05-29	3	11	3	6	0.6593000000000001
No One Can Ever Know	2020-07-17	3	11	3	6	0.6593000000000001
Buddi Bot: Your Machine Learning AI Helper With Advanced Neural Networking!	2020-09-29	4	11	3	7	0.6593000000000001
Ragozin on Moon	2020-11-10	4	11	3	7	0.6593000000000001
GyroBlade	2020-12-21	3	11	3	6	0.6593000000000001
Last Year: The Nightmare	2020-10-26	198	382	174	372	0.6592
Time To Stop Time	2020-11-06	33	96	40	73	0.6591
Adventures Diary of Merchant	2020-03-26	20	58	23	43	0.6587000000000001
Cyrano Story	2020-04-16	1253	729	342	1595	0.6586
Crunch Element	2020-12-19	48	320	145	193	0.6586
Inops	2020-06-11	26	16	5	31	0.6586
Mini Transport	2020-02-21	3	16	5	8	0.6586
Labyrinth of the Witch	2020-02-12	43	16	5	48	0.6586
Vacation: dayOFF	2020-09-23	4	16	5	9	0.6586
Tarek	2020-12-04	6	16	5	11	0.6586
Industrial Firefighters	2020-12-22	9	16	5	14	0.6586
Mermaid Adventures: The Magic Pearl	2020-12-16	5	16	5	10	0.6586
Dark Fantasy: Epic Jigsaw Puzzle	2020-04-20	7	42	16	23	0.6585
TSM3:Gemini Strategy/双子战纪	2020-04-10	11	35	13	24	0.6581999999999999
A Buttload of Free Games	2020-04-10	12	35	13	25	0.6581999999999999
Follower:Sacrifice	2020-02-27	18	28	10	28	0.6581999999999999
Gangsta Magic	2020-09-17	4	28	10	14	0.6581999999999999
Beat Me!	2020-08-19	18	51	20	38	0.6581
Marvel's Avengers - The Definitive Edition	2020-09-04	31165	18901	9505	40670	0.6578
Those Who Remain	2020-05-28	157	395	182	339	0.6574
To Hell with Hell	2020-02-25	15	53	21	36	0.6573000000000001
RPG NPC Simulator VR	2020-02-25	10	53	21	31	0.6573000000000001
Gripper: Prologue	2020-08-06	16	53	21	37	0.6573000000000001
Ballad of The Masked Bandits	2020-06-01	32	37	14	46	0.6569
ZERO GUNNER 2-	2020-12-21	9	37	14	23	0.6569
Hentai Waifu 101	2020-07-15	5	37	14	19	0.6569
Trapped Guys	2020-10-26	21	23	8	29	0.6567000000000001
Primeval Planet: Angimanation	2020-10-09	11	23	8	19	0.6567000000000001
Hentai Nureta Puzzle College	2020-10-30	3	23	8	11	0.6567000000000001
Doodle Derby	2020-09-03	19	55	22	41	0.6566
Drafting Tales	2020-12-11	18	55	22	40	0.6566
Escape from Skull Dungeon	2020-08-25	19	55	22	41	0.6566
重装无限·Metal Infinite	2020-07-16	6	30	11	17	0.6565000000000001
Ludus	2020-02-20	185	339	156	341	0.6563
Virtual Battlegrounds	2020-04-15	140	334	154	294	0.6558
Peasants War	2020-04-15	24	92	39	63	0.6558
Harem Girl: Nikki	2020-03-31	9	83	35	44	0.6551
DMLC!	2020-06-25	33	18	6	39	0.6551
Car Crush Racing Simulator	2020-04-26	50	18	6	56	0.6551
HEX Hacking Simulator	2020-07-31	7	18	6	13	0.6551
Golden Moon	2020-05-27	15	18	6	21	0.6551
Baby Coyote	2020-09-25	3	18	6	9	0.6551
Aripi	2020-11-08	2	18	6	8	0.6551
Space Commander: War and Trade	2020-11-04	170	347	161	331	0.655
Hollow Head	2020-01-13	4	32	12	16	0.655
YesterMorrow	2020-11-05	24	41	16	40	0.6547
Similo: The Card Game	2020-09-17	11	25	9	20	0.6546
Hollow Mind: The Lost Puppy	2020-12-08	6	25	9	15	0.6546
Final Fleet	2020-07-24	4	8	2	6	0.6542
Birthright Cataclysm - Overture	2020-12-09	4	8	2	6	0.6542
Board Games VR	2020-01-12	9	8	2	11	0.6542
Blade of Arena	2020-10-31	6	8	2	8	0.6542
Circle of Sumo	2020-05-08	5	8	2	7	0.6542
Dr Tacocat	2020-04-16	2	8	2	4	0.6542
1001 Jigsaw. Ice Age	2020-02-23	3	8	2	5	0.6542
Jack In Town	2020-01-10	3	8	2	5	0.6542
Labyrinths of the World: The Wild Side Collector's Edition	2020-01-03	6	8	2	8	0.6542
Paws and Effect	2020-02-28	6	8	2	8	0.6542
P-BOT	2020-03-06	3	8	2	5	0.6542
Escape Rebooted	2020-01-29	3	8	2	5	0.6542
Sokpop S07: labyrinth	2020-01-30	3	8	2	5	0.6542
FierceWind Decay	2020-10-15	2	8	2	4	0.6542
被遺棄的雙子 Gemini of the abandoned	2020-02-28	2	8	2	4	0.6542
Sky Seeker	2020-08-29	4	8	2	6	0.6542
MINE	2020-05-01	4	8	2	6	0.6542
Bad Meme	2020-05-28	3	8	2	5	0.6542
OMG: One Million Guns	2020-05-20	3	8	2	5	0.6542
Taken Away	2020-10-23	3	8	2	5	0.6542
Twin Breaker: A Sacred Symbols Adventure	2020-09-23	4	8	2	6	0.6542
Divine Adventure	2020-12-10	7	8	2	9	0.6542
故乡的记忆：味缘篇	2020-09-24	2	8	2	4	0.6542
Battle Hunters	2020-11-05	4	8	2	6	0.6542
Soul Catcher	2020-10-02	3	8	2	5	0.6542
Kasmo	2020-09-18	2	8	2	4	0.6542
Until Last Breath	2020-10-16	2	8	2	4	0.6542
Eye of the Beholder	2020-11-30	2	8	2	4	0.6542
Orbital Invaders	2020-10-21	2	8	2	4	0.6542
Rouge Wars	2020-12-09	5	8	2	7	0.6542
Doctor Bunny	2020-11-24	4	8	2	6	0.6542
Spinny's Journey	2020-11-26	2	8	2	4	0.6542
Head Worms	2020-12-21	3	8	2	5	0.6542
Naudrion	2020-12-25	21	76	32	53	0.6541
PAW Patrol Mighty Pups Save Adventure Bay	2020-11-06	45	91	39	84	0.6539
COVID: The Outbreak	2020-05-29	31	65	27	58	0.6537999999999999
FM	2020-05-29	8	43	17	25	0.6537999999999999
Go For a Walk	2020-01-12	3	13	4	7	0.6537999999999999
Lust of the Apartment Wives	2020-02-10	4	13	4	8	0.6537999999999999
Witchcraft: Pandoras Box	2020-01-03	5	13	4	9	0.6537999999999999
Friend Sighting	2020-02-27	3	13	4	7	0.6537999999999999
Pandora Galaxy	2020-07-17	7	13	4	11	0.6537999999999999
Bulk Dominoes VR: Kinetic Rush	2020-11-24	3	13	4	7	0.6537999999999999
Ahlman Mansion 2020	2020-05-18	8	13	4	12	0.6537999999999999
海腹川背 BaZooKa!	2020-05-28	14	13	4	18	0.6537999999999999
Sexy Caravan	2020-08-14	5	13	4	9	0.6537999999999999
Haunted Hotel: Lost Time Collector's Edition	2020-06-19	8	13	4	12	0.6537999999999999
Pillow Simulator	2020-12-15	5	13	4	9	0.6537999999999999
DOGMAN	2020-11-06	2	13	4	6	0.6537999999999999
Poco In Dungeon	2020-12-21	5	13	4	9	0.6537999999999999
Schastye	2020-08-27	4	146	65	69	0.6537000000000001
Monster Truck Championship	2020-10-15	36	108	47	83	0.6537000000000001
HospitalityVR	2020-08-18	12	78	33	45	0.6537000000000001
Mr.King Luo!Don't be kidding	2020-02-11	10	34	13	23	0.6537000000000001
A Long Way Down	2020-08-27	104	152	68	172	0.6533
Utopia Colony	2020-02-14	12	67	28	40	0.6533
Inexistence Rebirth	2020-05-22	14	67	28	42	0.6533
Bloom	2020-01-25	5	27	10	15	0.6529
Fortoresse	2020-12-17	12	36	14	26	0.6526000000000001
Mission IDLE	2020-12-31	6	36	14	20	0.6526000000000001
Electro Ride Prologue	2020-05-30	41	122	54	95	0.6525
Fantasy General II: Prologue	2020-07-02	22	58	24	46	0.6525
Nightwalker	2020-05-07	3	20	7	10	0.6525
ExoTanks	2020-12-21	27	124	55	82	0.6524
Katana Kata	2020-01-28	6	47	19	25	0.6523000000000001
BadLads	2020-04-17	26	90	39	65	0.652
Eternal Magic	2020-04-17	620	472	226	846	0.6517000000000001
I, AI	2020-07-17	6	38	15	21	0.6517000000000001
Call of Coronga	2020-07-10	7	38	15	22	0.6517000000000001
World of Soccer RELOADED	2020-10-28	69	77	33	102	0.6515000000000001
Captain Tsubasa - Rise of New Champions	2020-08-27	4442	2882	1454	5896	0.6514
Death end re;Quest 2	2020-08-18	256	267	125	381	0.6511
Rebirth Fantasy Online	2020-06-09	98	100	44	142	0.6509999999999999
Good Morning World	2020-05-04	88	123	55	143	0.6509
Mysteria~Occult Shadows~	2020-09-30	554	2139	1076	1630	0.6508
燎刃	2020-06-22	8	40	16	24	0.6508
Animal Rescuer: Prologue	2020-10-07	27	83	36	63	0.6507
Human Simulator	2020-01-13	7	22	8	15	0.6503
Evergate: Ki's Awakening	2020-10-29	10	22	8	18	0.6503
Silent Mansion : Summoner Part2	2020-12-04	5	22	8	13	0.6503
王国幻境	2020-04-10	7	31	12	19	0.6502
Goosebumps Dead of Night	2020-06-19	7	31	12	19	0.6502
CrashMetal Cyberpunk	2020-12-17	916	314	149	1065	0.6501
Light Tracer 2	2020-07-30	8	15	5	13	0.65
Rock, Paper, Scissors Simulator	2020-01-10	2	15	5	7	0.65
Me and Myself	2020-01-06	7	15	5	12	0.65
Pixel Dominance	2020-02-04	2	15	5	7	0.65
Aether Field	2020-02-17	4	15	5	9	0.65
Magical Miri	2020-04-18	4	15	5	9	0.65
Metal Gunner	2020-06-16	3	15	5	8	0.65
GoldFish Brain	2020-12-07	3	15	5	8	0.65
Groove Fit Kingdom!	2020-07-15	4	15	5	9	0.65
Mad Bus	2020-12-09	4	15	5	9	0.65
Let's Learn Shogi	2020-12-15	4	15	5	9	0.65
Bleeding Edge	2020-03-24	1464	1062	528	1992	0.6497
MENTAL	2020-02-20	17	57	24	41	0.6496
P.A.I.N.T.	2020-06-11	32	76	33	65	0.6493000000000001
The Last Element: Looking For Tomorrow	2020-11-11	5	99	44	49	0.6492
Headshot VR	2020-07-13	10	59	25	35	0.6492
Seven Doors	2020-06-26	6	59	25	31	0.6492
Jump To Die 2 - Bloody Soul	2020-02-08	21	33	13	34	0.6492
How to punish a witch	2020-06-24	5	33	13	18	0.6492
Northern Lights	2020-12-14	78	173	80	158	0.6491
Flag Collection	2020-12-08	4	61	26	30	0.6489
Pinup Ball	2020-02-13	27	82	36	63	0.6487
Goblin Times	2020-04-14	6	24	9	15	0.6487
Sex Apocalypse	2020-07-31	3	24	9	12	0.6487
Andarilho	2020-11-13	2428	739	366	2794	0.6483
Mech Engineer	2020-12-16	20	86	38	58	0.6483
Saber Fight VR	2020-01-03	11	117	53	64	0.6482
Alien 911 Prologue	2020-04-27	47	50	21	68	0.6479
Random Heroes: Gold Edition	2020-04-10	10	50	21	31	0.6479
Underground Keeper 2	2020-06-29	2	5	1	3	0.6478
Miney Company: A Data Racket	2020-02-22	2	5	1	3	0.6478
Tranquil Garden	2020-09-19	3	5	1	4	0.6478
Rapture	2020-08-25	5	5	1	6	0.6478
Rolling Rumble	2020-10-19	3	5	1	4	0.6478
Xtreme Typing	2020-08-25	2	5	1	3	0.6478
Fairytale Solitaire. Witch Charms	2020-02-03	5	5	1	6	0.6478
Tasty Jigsaw: Happy Hour	2020-03-09	3	5	1	4	0.6478
Fight High	2020-02-20	3	5	1	4	0.6478
Bounce Knight	2020-03-20	2	5	1	3	0.6478
Ninja Run	2020-01-17	2	5	1	3	0.6478
Rhythm of the Gods	2020-03-23	3	5	1	4	0.6478
FEB - Brazilian Elite Force	2020-01-14	1	5	1	2	0.6478
Frog X Log	2020-04-10	1	5	1	2	0.6478
Haustoria	2020-03-20	2	5	1	3	0.6478
Terminal Singularity	2020-07-17	3	5	1	4	0.6478
Recluses	2020-03-12	1	5	1	2	0.6478
Kingdom vs Zombies	2020-04-26	2	5	1	3	0.6478
陆大迹神Ⅱ	2020-01-21	12	5	1	13	0.6478
Politicking	2020-05-31	8	5	1	9	0.6478
Crocodine: The Buffet	2020-04-10	4	5	1	5	0.6478
Roboshark Rampage	2020-03-13	2	5	1	3	0.6478
Bounty For Sharks	2020-02-18	2	5	1	3	0.6478
Simple LOTO Simulator	2020-03-23	3	5	1	4	0.6478
Wandering Through The Vines	2020-02-14	1	5	1	2	0.6478
Hiragana POW!	2020-03-03	1	5	1	2	0.6478
Captain Pegleg	2020-12-27	2	5	1	3	0.6478
Wacky Golf Land	2020-04-24	3	5	1	4	0.6478
VR Mummy Girl	2020-03-20	4	5	1	5	0.6478
Military Service	2020-04-07	2	5	1	3	0.6478
Sunrise 7	2020-03-27	3	5	1	4	0.6478
Dungeon & Derision	2020-08-07	3	5	1	4	0.6478
Collection Quest	2020-05-18	4	5	1	5	0.6478
Death Taxi 3000	2020-06-18	2	5	1	3	0.6478
我是熊孩子	2020-04-21	3	5	1	4	0.6478
BoxxyQuest: The Gathering Storm	2020-05-08	5	5	1	6	0.6478
Projet Océara	2020-05-25	2	5	1	3	0.6478
Party Mashup	2020-07-28	5	5	1	6	0.6478
Turkey Hunting Unlimited	2020-05-29	4	5	1	5	0.6478
The Door Of Redemption	2020-06-30	2	5	1	3	0.6478
Holiday Mosaics Christmas Puzzles	2020-06-09	4	5	1	5	0.6478
Hentai XXX Plus: Jigsaws Vol 2	2020-07-11	3	5	1	4	0.6478
Solitaire. Elemental Wizards	2020-09-09	4	5	1	5	0.6478
灰烬行星与填鸭少女	2020-08-09	3	5	1	4	0.6478
Apprentice Arriving	2020-07-07	3	5	1	4	0.6478
Bomber Games	2020-12-08	5	5	1	6	0.6478
Brain Marmelade	2020-07-14	2	5	1	3	0.6478
Forsaken Flesh	2020-07-31	5	5	1	6	0.6478
Healing Movement	2020-07-28	2	5	1	3	0.6478
Max and the Book of Chaos	2020-07-30	2	5	1	3	0.6478
7n7	2020-07-31	1	5	1	2	0.6478
Starship Intruder	2020-08-04	2	5	1	3	0.6478
Ghost Beat	2020-10-15	2	5	1	3	0.6478
The Kingdom of Gardenia	2020-10-01	1	5	1	2	0.6478
休止符 StopSign	2020-08-13	3	5	1	4	0.6478
Kidgilantes	2020-09-23	3	5	1	4	0.6478
The Owl Quest	2020-08-18	2	5	1	3	0.6478
Battletronics	2020-08-21	3	5	1	4	0.6478
Ninja Castle Escape	2020-08-28	4	5	1	5	0.6478
Cowboys n' Stuff	2020-09-10	3	5	1	4	0.6478
Anime Jigsaw Puzzles	2020-08-27	2	5	1	3	0.6478
Egypt Picross Pharaohs Riddles	2020-08-31	8	5	1	9	0.6478
Sponsor-A-Planet	2020-10-13	1	5	1	2	0.6478
Memories of Fireflies	2020-10-29	2	5	1	3	0.6478
Guns N Stuff	2020-09-23	4	5	1	5	0.6478
DumbBots: Hello World	2020-09-16	4	5	1	5	0.6478
Voyeur	2020-10-12	2	5	1	3	0.6478
Sudoku Forever	2020-09-25	2	5	1	3	0.6478
Consequence	2020-11-11	2	5	1	3	0.6478
Gem Legend	2020-10-30	5	5	1	6	0.6478
Asian Riddles 3	2020-11-20	5	5	1	6	0.6478
Insect Adventure Demo	2020-10-21	4	5	1	5	0.6478
Dual Guns Fantasy	2020-11-21	2	5	1	3	0.6478
Sokpop S09: skelets	2020-11-05	3	5	1	4	0.6478
Fox in the Woods	2020-11-30	1	5	1	2	0.6478
Whats wrong with me?	2020-12-08	2	5	1	3	0.6478
Hustomten	2020-12-14	2	5	1	3	0.6478
KINESIS	2020-12-21	4	5	1	5	0.6478
约会模拟器：原型	2020-12-24	2	5	1	3	0.6478
Alice's Jigsaw Time Travel	2020-12-29	3	5	1	4	0.6478
Mineirinho Director's Cut	2020-01-03	698	1013	508	1206	0.6476999999999999
Sokpop S01: Bombini	2020-01-17	2	10	3	5	0.6476000000000001
Is the President a Traitor?	2020-01-25	4	10	3	7	0.6476000000000001
Bonfire	2020-03-03	2	10	3	5	0.6476000000000001
Synthetic blood: Mind Shift	2020-02-26	3	10	3	6	0.6476000000000001
Bunny Quest	2020-03-08	3	10	3	6	0.6476000000000001
GraFi St.Patrick	2020-03-15	5	10	3	8	0.6476000000000001
Sweet Solitaire: School Witch	2020-04-27	5	10	3	8	0.6476000000000001
Night Jackal	2020-05-04	2	10	3	5	0.6476000000000001
Covid-Racing	2020-07-10	2	10	3	5	0.6476000000000001
I AM FLY	2020-06-22	2	10	3	5	0.6476000000000001
Anagrams	2020-12-31	5	10	3	8	0.6476000000000001
Magic Griddlers	2020-09-03	6	10	3	9	0.6476000000000001
Mine Crazy: The Korean Grinder	2020-10-09	3	10	3	6	0.6476000000000001
Artifact Hunter	2020-10-22	6	10	3	9	0.6476000000000001
Town Fall Zombie	2020-11-05	4	10	3	7	0.6476000000000001
Amulet of Time: Shadow of La Rochelle	2020-12-04	7	37	15	22	0.6475
Wasted World	2020-05-06	59	52	22	81	0.6474
Zombie Claus	2020-01-02	6	26	10	16	0.6473000000000001
Spacky's Nightshift	2020-03-11	3	26	10	13	0.6473000000000001
War Smith	2020-04-20	6	26	10	16	0.6473000000000001
Volta-X	2020-08-12	16	26	10	26	0.6473000000000001
Lynium	2020-11-19	5	26	10	15	0.6473000000000001
Ashes 2	2020-01-04	11	17	6	17	0.6473000000000001
Dr. Derk's Mutant Battlegrounds	2020-07-28	19	17	6	25	0.6473000000000001
Kamile: The Fall	2020-03-16	2	17	6	8	0.6473000000000001
Shades Of Heroes	2020-11-02	7	17	6	13	0.6473000000000001
BATYA	2020-01-27	3	17	6	9	0.6473000000000001
Super DEE	2020-03-23	4	17	6	10	0.6473000000000001
Damn Dolls	2020-04-22	3	17	6	9	0.6473000000000001
Robots, Death & Venice	2020-08-01	3	17	6	9	0.6473000000000001
Fishing Sim World®: Bass Pro Shops Edition	2020-11-03	12	17	6	18	0.6473000000000001
~Azur Ring~virgin and slave's phylacteries	2020-07-17	76	155	72	148	0.6472
The Bonfire 2: Uncharted Shores	2020-08-21	205	191	90	295	0.6468
RollerCoaster VR Universe	2020-05-15	11	79	35	46	0.6467
汉武大帝传	2020-06-20	21	79	35	56	0.6467
The Innsmouth Case	2020-06-23	29	83	37	66	0.6464
Clan N	2020-08-06	7	28	11	18	0.6462000000000001
Exit Limbo: Opening	2020-11-05	5	28	11	16	0.6462000000000001
CyberOps Prologue	2020-05-09	15	28	11	26	0.6462000000000001
Silmaris: Dice Kingdom	2020-12-04	75	60	26	101	0.6461
Engine Evolution	2020-05-08	49	172	81	130	0.6459
Under: Depths of Fear	2020-10-26	43	168	79	122	0.6459
Captain Fly and Sexy Girls at the Night Club	2020-04-04	5	43	18	23	0.6458
休闲游戏合集	2020-12-11	28	43	18	46	0.6458
Relicta	2020-08-04	75	237	114	189	0.6452
Hentai ASMR	2020-11-27	3	30	12	15	0.6452
Nothing & Nowhere	2020-05-18	4	19	7	11	0.6452
Gray platformer	2020-04-01	3	19	7	10	0.6452
The Magic Storm	2020-05-15	3	19	7	10	0.6452
The Elf's Lewd Training	2020-07-03	6	19	7	13	0.6452
Vectromirror	2020-10-13	9	19	7	16	0.6452
Rugby 20	2020-01-23	53	131	61	114	0.6448999999999999
ALLBLACK Phase 1	2020-12-06	7	47	20	27	0.6448999999999999
CyberHive	2020-11-03	8	32	13	21	0.6444
Street Hero	2020-08-14	6	32	13	19	0.6444
Racing Glider	2020-02-27	4	34	14	18	0.6437999999999999
Phobos	2020-11-20	114	118	55	169	0.6436000000000001
Vixen Wars	2020-05-26	102	114	53	155	0.6436000000000001
Surviving Titan	2020-04-30	86	112	52	138	0.6436000000000001
The Elven Educator ~another ver~	2020-05-15	22	21	8	30	0.6436000000000001
Racing Juke	2020-06-14	4	21	8	12	0.6436000000000001
Just Take Your Left	2020-11-18	2	21	8	10	0.6436000000000001
Axis Football 2020	2020-10-07	60	120	56	116	0.6435
AlterVerse	2020-12-23	13	12	4	17	0.6435
There Is a Way	2020-09-09	4	12	4	8	0.6435
Cube Runner 2	2020-10-14	3	12	4	7	0.6435
Zapitalism	2020-02-12	12	12	4	16	0.6435
Hell To Raze	2020-08-11	5	12	4	9	0.6435
Hentai beautiful girls 4	2020-07-15	4	12	4	8	0.6435
Lust Vessel	2020-10-22	10	12	4	14	0.6435
Blackjack Championship	2020-08-25	148	498	250	398	0.6432
Breaking Gates	2020-11-17	5	36	15	20	0.6432
DarkStory Online	2020-05-22	231	273	134	365	0.6428
Tactical Three Kingdoms (T3K) - Strategy and War	2020-05-11	44	75	34	78	0.6424
Last Warrior	2020-02-13	5	23	9	14	0.6424
Hexia	2020-12-20	5	23	9	14	0.6424
Escape to Sidious	2020-09-01	8	23	9	17	0.6424
Sokpop S08: Ginseng Hero	2020-04-16	5	23	9	14	0.6424
COVID-19 Isolation	2020-06-10	4	23	9	13	0.6424
Instability	2020-07-28	6	23	9	15	0.6424
Darksburg	2020-09-23	1287	1544	807	2094	0.6416
Bookbound Brigade	2020-01-30	10	25	10	20	0.6414
Machina of the Planet Tree -Unity Unions-	2020-05-15	21	25	10	31	0.6414
Retro Drift	2020-08-12	4	25	10	14	0.6414
BDSM VR	2020-11-25	2	25	10	12	0.6414
Astellia	2020-01-30	1181	1090	566	1747	0.6412000000000001
Iron Disco	2020-11-05	16	52	23	39	0.6408
StarDroneVR	2020-02-07	4	2	0	4	0.6408
Raging Fists: Retribution	2020-07-23	2	2	0	2	0.6408
Billy	2020-02-03	2	2	0	2	0.6408
Trains & Things	2020-01-23	2	2	0	2	0.6408
Dear Home	2020-10-01	3	2	0	3	0.6408
William and the Lands of Rage	2020-01-14	2	2	0	2	0.6408
Melody Flight	2020-04-24	2	2	0	2	0.6408
Mission Ring Possible	2020-04-02	2	2	0	2	0.6408
Gnubbl	2020-01-01	2	2	0	2	0.6408
Wawa United	2020-09-11	4	2	0	4	0.6408
Champions of Thora	2020-03-05	4	2	0	4	0.6408
Thigh Climbers	2020-04-24	2	2	0	2	0.6408
LETHAL STRIKE	2020-04-01	2	2	0	2	0.6408
Grimalkin: Solar Defense Force	2020-01-10	3	2	0	3	0.6408
Chronac	2020-04-25	2	2	0	2	0.6408
El Tesoro de Isla Alcachofa	2020-02-05	2	2	0	2	0.6408
Cyber-Ante	2020-12-31	1	2	0	1	0.6408
Furries & Scalies: Super Scary Halloween Spooky Times	2020-06-08	1	2	0	1	0.6408
Marburgh	2020-12-26	1	2	0	1	0.6408
Tomb Typing	2020-08-25	2	2	0	2	0.6408
Ziggy's Typing Pyramid	2020-10-15	1	2	0	1	0.6408
Served!	2020-02-27	4	2	0	4	0.6408
Offcoast	2020-06-16	1	2	0	1	0.6408
Interphase	2020-02-12	1	2	0	1	0.6408
SUCCESSOR OF THE KEY	2020-09-30	1	2	0	1	0.6408
Exphelius: Arena	2020-11-19	2	2	0	2	0.6408
Eutergeläuter	2020-07-24	1	2	0	1	0.6408
Vertigo	2020-01-30	6	2	0	6	0.6408
Lands of Pharaoh: Episode 1	2020-01-07	2	2	0	2	0.6408
Drift Alone	2020-04-15	2	2	0	2	0.6408
Hippoboar Rancher	2020-03-31	6	2	0	6	0.6408
Sliding Puzzle Collection	2020-01-07	2	2	0	2	0.6408
Nine Circles of Hell	2020-01-02	1	2	0	1	0.6408
Winter Break	2020-01-03	14	2	0	14	0.6408
Mystic Ruin: A New Dawn	2020-07-31	2	2	0	2	0.6408
DonDon Busters!!	2020-01-22	4	2	0	4	0.6408
FlickerMAZE	2020-01-01	2	2	0	2	0.6408
The Blackbird of Amor	2020-06-15	1	2	0	1	0.6408
loathe the game	2020-04-10	2	2	0	2	0.6408
Virtually Real Life	2020-02-07	1	2	0	1	0.6408
RC Plane VR	2020-01-15	2	2	0	2	0.6408
异星前线	2020-03-23	2	2	0	2	0.6408
A Lanterns Glow	2020-05-01	3	2	0	3	0.6408
Jumplord	2020-02-07	1	2	0	1	0.6408
That Lava Escape Game	2020-01-20	2	2	0	2	0.6408
Beach Bar VR	2020-03-22	1	2	0	1	0.6408
InfiniWordSlide	2020-12-23	4	2	0	4	0.6408
Pyramid Defense	2020-01-23	1	2	0	1	0.6408
VOXEL HORIZON	2020-04-14	7	2	0	7	0.6408
Wat A Life	2020-03-21	2	2	0	2	0.6408
Super Rocket Ride	2020-10-16	2	2	0	2	0.6408
ManaTech	2020-03-26	1	2	0	1	0.6408
Secret City: Chalk of Fate Collector's Edition	2020-01-20	4	2	0	4	0.6408
Forest of MATH	2020-02-20	2	2	0	2	0.6408
Bridge Crawler	2020-03-20	1	2	0	1	0.6408
S0	2020-02-12	2	2	0	2	0.6408
Dead's Prison Watcher	2020-02-15	2	2	0	2	0.6408
Armorik the Viking: The Eight Conquests	2020-03-10	1	2	0	1	0.6408
Wire Flying Maid	2020-02-13	1	2	0	1	0.6408
Bob Wants to Go Home	2020-02-20	2	2	0	2	0.6408
Of Evil and Darkness	2020-03-03	1	2	0	1	0.6408
Anti Air	2020-08-01	1	2	0	1	0.6408
Building The Universe	2020-04-16	2	2	0	2	0.6408
Raid	2020-06-25	2	2	0	2	0.6408
Memory Player	2020-04-25	1	2	0	1	0.6408
kosmickop	2020-12-11	1	2	0	1	0.6408
Bomb Fight	2020-02-25	5	2	0	5	0.6408
Get Good by Vypur	2020-05-15	3	2	0	3	0.6408
Rubicon	2020-08-31	5	2	0	5	0.6408
Conflict Europe	2020-10-09	2	2	0	2	0.6408
Quarter Horse Racing	2020-03-06	1	2	0	1	0.6408
Campgrounds IV Collector's Edition	2020-02-21	6	2	0	6	0.6408
Go Far Away	2020-04-19	1	2	0	1	0.6408
火星计划 - Mars Plan	2020-04-10	3	2	0	3	0.6408
Gnomes & Co	2020-12-19	2	2	0	2	0.6408
Warp Factor	2020-04-20	2	2	0	2	0.6408
Wild West Steam Loco	2020-03-11	2	2	0	2	0.6408
Valkyrie's Arrow(瓦尔基丽的箭)	2020-03-28	2	2	0	2	0.6408
BLIND QUEST - The Enchanted Castle	2020-03-19	2	2	0	2	0.6408
あの日見た夕陽	2020-03-27	2	2	0	2	0.6408
Casus	2020-08-21	3	2	0	3	0.6408
Around the Fire	2020-03-20	1	2	0	1	0.6408
Fairy Fire - Defender of the Fairies	2020-04-30	2	2	0	2	0.6408
Microodyssey	2020-09-10	1	2	0	1	0.6408
Smashing Healthy VR	2020-04-18	2	2	0	2	0.6408
Kurogane of the sky	2020-04-17	2	2	0	2	0.6408
方圈 Square Circle	2020-04-07	2	2	0	2	0.6408
Premier Manager 06/07	2020-07-03	5	2	0	5	0.6408
Zombusters	2020-10-26	1	2	0	1	0.6408
PuzzleKid	2020-04-22	4	2	0	4	0.6408
南十字作战队	2020-08-11	1	2	0	1	0.6408
Pandemic Panic!	2020-04-23	1	2	0	1	0.6408
The Lilliputian Runner	2020-05-01	2	2	0	2	0.6408
Sunset fighter	2020-04-18	2	2	0	2	0.6408
Storynth	2020-07-10	2	2	0	2	0.6408
Apocalypse Survivor	2020-05-16	1	2	0	1	0.6408
City Defender	2020-05-07	1	2	0	1	0.6408
就这消消乐	2020-05-14	2	2	0	2	0.6408
PXL-SHIP	2020-05-04	1	2	0	1	0.6408
Masquerade of Miasma	2020-05-25	2	2	0	2	0.6408
Fantasy Mosaics 33: Inventor's Workshop	2020-05-07	5	2	0	5	0.6408
Barrel Blast	2020-11-13	1	2	0	1	0.6408
WiP	2020-05-20	2	2	0	2	0.6408
Les Manley in: Search for the King	2020-11-06	2	2	0	2	0.6408
Beware of the Blob	2020-05-27	3	2	0	3	0.6408
SkunkHunter 101	2020-05-28	2	2	0	2	0.6408
Dumb Roguelike-like RPG	2020-05-14	2	2	0	2	0.6408
 Succubus Hotel	2020-09-11	4	2	0	4	0.6408
Hyde & Zeke	2020-06-02	2	2	0	2	0.6408
Explode On Contact	2020-12-18	1	2	0	1	0.6408
Bop'N Wrestle	2020-12-04	1	2	0	1	0.6408
Cupcake: an Apartment Adventure	2020-08-07	1	2	0	1	0.6408
Marshall Mellow	2020-06-26	2	2	0	2	0.6408
Touch The Floor	2020-06-04	1	2	0	1	0.6408
Logic - Electrons Connect	2020-07-03	4	2	0	4	0.6408
Host	2020-09-01	1	2	0	1	0.6408
Wire Flying Maid 2	2020-06-08	1	2	0	1	0.6408
Widgets and Gidgets	2020-06-13	2	2	0	2	0.6408
CRASH: Autodrive - Prologue	2020-08-18	2	2	0	2	0.6408
The Perplexing Orb 2	2020-11-17	1	2	0	1	0.6408
Tiny T	2020-07-19	1	2	0	1	0.6408
Lords of the Shattered Kingdom	2020-06-29	5	2	0	5	0.6408
ZONEX	2020-07-01	1	2	0	1	0.6408
The Great Adventures of Hemeko & CH0_CH0	2020-09-29	2	2	0	2	0.6408
Reiterland - Meine Rennpferde	2020-07-31	1	2	0	1	0.6408
Space Wave Race	2020-07-07	3	2	0	3	0.6408
Whiskers & Tail	2020-08-25	1	2	0	1	0.6408
GALSAD - Galactic Salvage and Disposal	2020-11-17	2	2	0	2	0.6408
Throwing Stone	2020-07-03	1	2	0	1	0.6408
Wotheguel	2020-08-19	2	2	0	2	0.6408
Analog Party Sim	2020-07-08	1	2	0	1	0.6408
Groove Balls	2020-07-25	1	2	0	1	0.6408
Wizards Of The West	2020-12-01	1	2	0	1	0.6408
PURRfection! The cat tossing game!!	2020-07-03	1	2	0	1	0.6408
Le Voyage de Toki	2020-08-31	1	2	0	1	0.6408
PICK ME UP! - Rescue Rangers -	2020-11-04	1	2	0	1	0.6408
Stoirs VR	2020-07-31	1	2	0	1	0.6408
Monster Blast	2020-07-03	2	2	0	2	0.6408
Connect-X	2020-07-22	2	2	0	2	0.6408
Stone it!	2020-09-24	2	2	0	2	0.6408
Zeko	2020-08-07	2	2	0	2	0.6408
Sheep Island	2020-07-13	4	2	0	4	0.6408
Psi 5 Trading Co	2020-10-02	2	2	0	2	0.6408
XF5700 Mantis Experimental Fighter	2020-10-02	2	2	0	2	0.6408
CATMAN-GIMMICK ACTION GAME-	2020-07-22	1	2	0	1	0.6408
Magical Stock Princess	2020-07-21	1	2	0	1	0.6408
Ziggy The Chaser	2020-07-21	3	2	0	3	0.6408
Mega Roller Ball	2020-08-04	2	2	0	2	0.6408
Seasons of the Samurai	2020-11-26	2	2	0	2	0.6408
Dream Of Salmon	2020-08-19	1	2	0	1	0.6408
Try to Survive!	2020-08-04	2	2	0	2	0.6408
Destructive Behavior	2020-07-24	1	2	0	1	0.6408
回纹战棋	2020-08-01	1	2	0	1	0.6408
Circles of Hell	2020-07-30	2	2	0	2	0.6408
Beat Flip	2020-09-08	2	2	0	2	0.6408
RunDrill	2020-11-21	3	2	0	3	0.6408
Messier111	2020-10-21	2	2	0	2	0.6408
The Scam	2020-08-03	1	2	0	1	0.6408
PULSAR	2020-08-11	2	2	0	2	0.6408
Tales From Evenfall	2020-09-23	2	2	0	2	0.6408
Px Art	2020-08-14	2	2	0	2	0.6408
Ninjas Busters: Whack A Ninja	2020-12-01	3	2	0	3	0.6408
Escaping Hell	2020-08-20	1	2	0	1	0.6408
aMAZEd	2020-08-31	1	2	0	1	0.6408
Unscripted	2020-12-17	1	2	0	1	0.6408
The Struggles Of Stefan	2020-11-20	2	2	0	2	0.6408
eyeDASH	2020-08-21	2	2	0	2	0.6408
Pathfinder Puzzle	2020-09-01	1	2	0	1	0.6408
魔法考核冒险	2020-08-26	2	2	0	2	0.6408
This Game is Trash	2020-09-20	2	2	0	2	0.6408
Fateholder Quest	2020-08-27	2	2	0	2	0.6408
Venkazoid Blast	2020-08-24	2	2	0	2	0.6408
Left Dex	2020-09-18	1	2	0	1	0.6408
P.I.D.	2020-10-14	2	2	0	2	0.6408
Accel Magician Mimi	2020-09-22	2	2	0	2	0.6408
Simply Hard Platformer	2020-09-04	2	2	0	2	0.6408
Happy Summer Holiday(愉快的暑假)	2020-12-15	2	2	0	2	0.6408
Battle Command	2020-09-01	2	2	0	2	0.6408
Punchout: Music	2020-09-18	2	2	0	2	0.6408
Thyra Adventure	2020-12-23	1	2	0	1	0.6408
Monochro	2020-09-15	2	2	0	2	0.6408
Red Sector	2020-09-30	2	2	0	2	0.6408
IMPAVIDVM	2020-11-13	2	2	0	2	0.6408
Compost	2020-09-11	2	2	0	2	0.6408
VR Time Machine Travelling in ancient civilizations: Mayan Kingdom, Inca Empire, Indians, and Aztecs before conquest A.D.1000	2020-09-02	1	2	0	1	0.6408
Lactea Volleyball	2020-11-02	2	2	0	2	0.6408
Friendly Find	2020-09-04	2	2	0	2	0.6408
Handy Machines VR	2020-09-30	2	2	0	2	0.6408
Table Soccer Club	2020-12-22	2	2	0	2	0.6408
Pixel Art - Mash-Up	2020-09-14	2	2	0	2	0.6408
Penny RPG: Shadows of the Lost - A Blood City Tale	2020-12-01	1	2	0	1	0.6408
VR Travelling in 18th-19th Century Europe	2020-09-17	1	2	0	1	0.6408
Once upon a time in the Gold Rush VR: shoot and ride	2020-11-12	1	2	0	1	0.6408
Ball Fall	2020-09-12	1	2	0	1	0.6408
Holidays	2020-09-16	2	2	0	2	0.6408
Historical Games: Chariot Racing	2020-11-13	3	2	0	3	0.6408
VR Travelling towards World War III Scenario: Post Nuclear War Earth Fantasy	2020-09-15	1	2	0	1	0.6408
Goblin Takes No Argument[s]	2020-10-21	1	2	0	1	0.6408
星尘战区 Stardust Theater	2020-10-06	1	2	0	1	0.6408
Paddle Combat	2020-09-18	2	2	0	2	0.6408
Sokoban: Bunny Tales	2020-10-29	4	2	0	4	0.6408
California Games II	2020-09-29	2	2	0	2	0.6408
Horizon Odyssey	2020-12-15	4	2	0	4	0.6408
Deception	2020-11-02	2	2	0	2	0.6408
Wardroid	2020-10-02	2	2	0	2	0.6408
Curious Alice	2020-11-23	4	2	0	4	0.6408
Bunker Down	2020-10-15	3	2	0	3	0.6408
Minestrife	2020-10-07	2	2	0	2	0.6408
Mega Veg Man	2020-10-05	2	2	0	2	0.6408
Strike Solitaire 3	2020-11-27	5	2	0	5	0.6408
Anime - Match The Memory	2020-10-07	2	2	0	2	0.6408
Diamond hunt	2020-10-09	1	2	0	1	0.6408
Vocal Space Shooter	2020-11-14	2	2	0	2	0.6408
Spot The Dot	2020-10-30	2	2	0	2	0.6408
Blue fencer Resurrection	2020-10-15	2	2	0	2	0.6408
Awesome Mix Tape	2020-12-12	2	2	0	2	0.6408
Biscuitts 3	2020-11-26	2	2	0	2	0.6408
Dark Asteroids	2020-11-05	2	2	0	2	0.6408
Before Dark	2020-10-21	2	2	0	2	0.6408
Mister Universe	2020-12-18	2	2	0	2	0.6408
Coronarun	2020-10-22	2	2	0	2	0.6408
Frog's Princess	2020-12-09	2	2	0	2	0.6408
Slime with a Sword	2020-11-09	2	2	0	2	0.6408
KosmoSquad	2020-11-10	3	2	0	3	0.6408
Space Squadron	2020-11-18	2	2	0	2	0.6408
Super vs. World	2020-11-01	4	2	0	4	0.6408
Veiled Basilisk	2020-12-09	2	2	0	2	0.6408
Super Star Shooter 16	2020-11-12	2	2	0	2	0.6408
Lava Escape Mine	2020-11-10	2	2	0	2	0.6408
Paper Shooter!	2020-11-30	2	2	0	2	0.6408
NobleEscape	2020-12-28	2	2	0	2	0.6408
ANIQUILATION: First Contact	2020-12-21	1	2	0	1	0.6408
Torto: Cursed Divine	2020-12-11	3	2	0	3	0.6408
Sluggy Jean Takes a Hike	2020-12-04	1	2	0	1	0.6408
Dontdy	2020-11-24	2	2	0	2	0.6408
Amborettio	2020-12-21	2	2	0	2	0.6408
Blind_	2020-11-26	2	2	0	2	0.6408
Tales of Lagoona 2: Peril at Poseidon Park	2020-12-16	4	2	0	4	0.6408
Pokoh	2020-12-04	2	2	0	2	0.6408
Guess Colors	2020-12-08	2	2	0	2	0.6408
Tiny Strife	2020-12-02	1	2	0	1	0.6408
大正ゾンビろまん（プラス）	2020-12-04	1	2	0	1	0.6408
Millennium Atoll	2020-12-01	1	2	0	1	0.6408
Max Raider	2020-12-16	1	2	0	1	0.6408
iGuide Knossos VR	2020-12-04	6	2	0	6	0.6408
2D Owen	2020-12-21	1	2	0	1	0.6408
Monolith VR	2020-12-18	1	2	0	1	0.6408
Jigsaw Puzzle - Pixel Art Master	2020-12-28	2	2	0	2	0.6408
VR Wonderland: mini civilizations in a forest	2020-12-28	2	2	0	2	0.6408
The Snowman's Journey	2020-12-29	2	2	0	2	0.6408
Debugger 3.16 // Recoded // Despair of the Developer Edition	2020-10-19	5	14	5	10	0.6406999999999999
SCP: One More Life	2020-02-14	3	14	5	8	0.6406999999999999
Immortal Hero	2020-08-27	3	14	5	8	0.6406999999999999
Choices That Matter: And The Sun Went Out	2020-11-04	5	14	5	10	0.6406999999999999
Unbeliever	2020-08-24	3	14	5	8	0.6406999999999999
Steel Fury Kharkov 1942	2020-06-24	14	98	46	60	0.6402
Shohei's Adult Streaming Channel	2020-08-21	32	92	43	75	0.6401000000000001
ClickRaid2	2020-04-16	249	82	38	287	0.6401000000000001
Fight or Flight	2020-10-27	17	70	32	49	0.6401000000000001
The Black Masses	2020-03-12	225	628	323	548	0.64
Fragment's Moonrise	2020-06-23	136	29	12	148	0.64
DriftZ	2020-07-12	5	29	12	17	0.64
The Raintime	2020-06-05	15	31	13	28	0.6395000000000001
Warm Village 暖暖村物语	2020-02-05	234	268	134	368	0.6393
Aster	2020-05-01	32	166	81	113	0.6393
Tabletop Playground	2020-05-15	258	121	58	316	0.6391
亦春秋 Power Of Seasons	2020-06-02	527	606	313	840	0.639
Planet Protector VR	2020-11-24	3	7	2	5	0.6389
Terra Incognito - Antarctica 1911	2020-03-19	4	7	2	6	0.6389
Outpost Delta	2020-10-20	5	7	2	7	0.6389
Mr. Joshua Carrot	2020-01-02	3	7	2	5	0.6389
Eldritch University	2020-06-12	4	7	2	6	0.6389
Sokpop S02: spider ponds	2020-01-17	2	7	2	4	0.6389
Solitaire Call of Honor	2020-01-16	4	7	2	6	0.6389
Sokpop S05: passenger seat	2020-01-17	2	7	2	4	0.6389
Napoleon in Russia	2020-02-05	6	7	2	8	0.6389
TaskForce Gamma-13 : An SCP Tale	2020-01-16	2	7	2	4	0.6389
Super Kickers League	2020-01-24	5	7	2	7	0.6389
Sheol	2020-01-07	2	7	2	4	0.6389
Skin Stealers	2020-04-10	136	7	2	138	0.6389
Carrots and Cream	2020-06-16	2	7	2	4	0.6389
Star Shaman	2020-10-22	2	7	2	4	0.6389
Climb	2020-07-30	3	7	2	5	0.6389
Square Fast	2020-04-26	2	7	2	4	0.6389
A.I-記憶女神	2020-05-31	1	7	2	3	0.6389
逃出图书馆(Escape from Library)	2020-05-19	6	7	2	8	0.6389
Grim Tales: The Generous Gift Collector's Edition	2020-04-17	7	7	2	9	0.6389
Zagan Must Be Rescued	2020-05-11	7	7	2	9	0.6389
Rocky Mayhem	2020-05-13	1	7	2	3	0.6389
Defensive Attacks	2020-07-07	2	7	2	4	0.6389
Freediving Hunter Spearfishing the World	2020-07-01	3	7	2	5	0.6389
Sword and Spirit	2020-06-06	3	7	2	5	0.6389
AstroWings: Space War	2020-09-24	2	7	2	4	0.6389
Frag	2020-10-29	3	7	2	5	0.6389
Viral Execution	2020-07-23	2	7	2	4	0.6389
Treasure of Cutuma 3rd	2020-07-15	4	7	2	6	0.6389
DR MILOS REVENGE	2020-07-10	18	7	2	20	0.6389
Flea	2020-10-30	1	7	2	3	0.6389
Snack Tick	2020-09-22	3	7	2	5	0.6389
FoxVoltex	2020-07-30	5	7	2	7	0.6389
Alien Cat 6	2020-08-14	2	7	2	4	0.6389
Tahul	2020-08-17	2	7	2	4	0.6389
AVANTI - The Joy of Driving	2020-10-14	3	7	2	5	0.6389
Fairy Godmother Stories: Dark Deal Collector's Edition	2020-07-24	5	7	2	7	0.6389
Mystical Mayhem	2020-10-29	1	7	2	3	0.6389
Space Empires: Starfury	2020-08-03	3	7	2	5	0.6389
Clouds of Rain	2020-10-23	3	7	2	5	0.6389
Sanguine Melancholia	2020-09-03	4	7	2	6	0.6389
California Games	2020-09-04	4	7	2	6	0.6389
Bean Climb	2020-10-30	3	7	2	5	0.6389
Quiet Valley	2020-10-08	2	7	2	4	0.6389
Mousebound	2020-10-23	5	7	2	7	0.6389
TEXT: Russia	2020-10-21	2	7	2	4	0.6389
The Enthralling Realms: The Blacksmith's Revenge	2020-10-20	4	7	2	6	0.6389
Wait! Where's My Lunch?	2020-11-19	2	7	2	4	0.6389
Cookie Store	2020-11-09	3	7	2	5	0.6389
Moonlit	2020-12-18	2	7	2	4	0.6389
SCAR	2020-07-15	6	35	15	21	0.6388
Little One	2020-01-14	5	16	6	11	0.6388
12 Labours of Hercules X: Greed for Speed	2020-04-22	16	16	6	22	0.6388
Hentai beautiful girls 3	2020-05-06	3	16	6	9	0.6388
MOMO.EXE VR	2020-08-14	5	16	6	11	0.6388
Sudoku Starry Sky	2020-11-10	10	16	6	16	0.6388
KONSAIRI	2020-10-28	6	16	6	12	0.6388
Jack's Labyrinth	2020-12-21	3	16	6	9	0.6388
Moonshine Maniacs - A Wild West Saga	2020-06-22	6	37	16	22	0.6385000000000001
Wonder Blade	2020-10-29	10	39	17	27	0.6383
Hentai Swimming Club	2020-07-27	4	39	17	21	0.6383
Sink Again	2020-12-17	39	83	39	78	0.638
Terminal Conflict	2020-09-24	10	43	19	29	0.6379
Rugby Union Team Manager 3	2020-10-08	31	43	19	50	0.6379
Space Travel Idle	2020-09-22	669	319	162	831	0.6378
艾斯菲尔的谎言	2020-12-25	5	45	20	25	0.6378
Massive	2020-08-06	7	71	33	40	0.6377
The Outcast Lovers	2020-07-31	7	47	21	28	0.6377
История бомжа	2020-08-23	3	47	21	24	0.6377
Dark Side of War	2020-12-04	4	47	21	25	0.6377
The Running Man	2020-06-25	79	61	28	107	0.6376
Banzai Escape 2	2020-02-18	7	18	7	14	0.6375000000000001
The World Of Others	2020-02-14	3	18	7	10	0.6375000000000001
Codename: Terranova	2020-07-27	9	18	7	16	0.6375000000000001
Dead Cubes	2020-02-19	4	18	7	11	0.6375000000000001
An Evil Existence	2020-09-21	6	18	7	13	0.6375000000000001
Fake Lay	2020-05-05	360	520	270	630	0.637
Ice Maze	2020-01-22	26	98	47	73	0.6365999999999999
The Wild Age	2020-02-04	55	194	97	152	0.6365
Colony 42	2020-03-25	5	20	8	13	0.6365
Celestian Tales: Realms Beyond	2020-05-07	19	20	8	27	0.6365
Oil Wars	2020-03-21	6	20	8	14	0.6365
Mesmer	2020-10-16	13	20	8	21	0.6365
Silk Roads: Caravan Kings	2020-10-01	6	20	8	14	0.6365
Drone Swarm	2020-10-20	342	167	83	425	0.6362
100 hidden gnomes	2020-12-02	5	88	42	47	0.6361
异世界的无厘头生活	2020-05-29	19	138	68	87	0.6358
Operation Covid-19	2020-06-12	7	22	9	16	0.6358
Smart City Plan	2020-03-06	69	74	35	104	0.6354
Chunker	2020-09-22	7	24	10	17	0.6353
Planet Bounce	2020-01-07	4	26	11	15	0.6349
IdleCoin	2020-12-21	53	26	11	64	0.6349
Chronos: Before the Ashes	2020-12-01	320	327	169	489	0.6347
Gift Girl	2020-03-13	110	364	189	299	0.6346
World Of Conquerors - Origins	2020-02-19	33	56	26	59	0.6346
Bios Ex	2020-04-17	2	9	3	5	0.6345000000000001
Love on Paper	2020-09-10	3	9	3	6	0.6345000000000001
Δ Time	2020-09-01	3	9	3	6	0.6345000000000001
Underneath	2020-01-05	4	9	3	7	0.6345000000000001
CityWarHeroes VR	2020-02-28	6	9	3	9	0.6345000000000001
Chico	2020-04-07	2	9	3	5	0.6345000000000001
Math Path	2020-06-10	2	9	3	5	0.6345000000000001
Danko and the mystery of the jungle	2020-03-18	2	9	3	5	0.6345000000000001
Super Foosball	2020-02-21	5	9	3	8	0.6345000000000001
Hollow Remnant	2020-02-14	2	9	3	5	0.6345000000000001
Dark City: Dublin Collector's Edition	2020-03-13	8	9	3	11	0.6345000000000001
Let's Learn Korean! Vocabulary	2020-04-24	4	9	3	7	0.6345000000000001
NoWaitHero	2020-05-08	14	9	3	17	0.6345000000000001
Journey to the Centre of the Cell	2020-05-18	8	9	3	11	0.6345000000000001
Mezmeratu	2020-10-29	2	9	3	5	0.6345000000000001
1001 Jigsaw: Earth Chronicles 2	2020-08-05	4	9	3	7	0.6345000000000001
Killing Sun / 抗日大刀队：日军总部	2020-07-20	3	9	3	6	0.6345000000000001
Killer Dog	2020-07-16	3	9	3	6	0.6345000000000001
Slip 'n Dip	2020-08-04	4	9	3	7	0.6345000000000001
Tequila Sunrise テキーラサンライズ	2020-07-23	4	9	3	7	0.6345000000000001
Sakura Dimensions	2020-11-26	3	9	3	6	0.6345000000000001
Fantasy Friends	2020-11-06	2	9	3	5	0.6345000000000001
Crash'em Derby	2020-09-24	8	9	3	11	0.6345000000000001
Squares Rage	2020-10-23	2	9	3	5	0.6345000000000001
Endless	2020-10-23	4	9	3	7	0.6345000000000001
Guns And Waifus	2020-11-05	3	9	3	6	0.6345000000000001
Kinda Heroes	2020-12-10	15	52	24	39	0.6344
Impostor Inside Us	2020-11-19	5	52	24	29	0.6344
Island Explorer VR	2020-05-08	20	30	13	33	0.6344
Book of Shadows	2020-11-01	4	30	13	17	0.6344
Hentai Nureta Puzzle Cyberpunk	2020-12-19	3	30	13	16	0.6344
Leaper	2020-12-23	5	30	13	18	0.6344
NEKO-GIRL PLAY	2020-02-26	4	34	15	19	0.6342
Deep, In the Forest	2020-04-10	9	40	18	27	0.6341
Survive In Russia	2020-02-17	8	40	18	26	0.6341
Happy Engine	2020-01-10	8	38	17	25	0.6341
Conglomerate 451	2020-02-20	94	142	71	165	0.6335000000000001
Dark Hero Party	2020-04-10	116	200	102	218	0.6332
Panther VR	2020-06-16	20	65	31	51	0.6324000000000001
Inferno	2020-10-01	1129	11	4	1133	0.6321
The Dreams of Candlelight	2020-01-24	9	11	4	13	0.6321
Pandora: Chains of Chaos	2020-09-22	3	11	4	7	0.6321
Forest Woodman	2020-01-03	3	11	4	7	0.6321
Trump and Virus	2020-05-12	3	11	4	7	0.6321
Your Human is Sick	2020-05-15	32	11	4	36	0.6321
Sue's Story	2020-08-03	4	11	4	8	0.6321
EndlessShinyBlues	2020-11-30	3	11	4	7	0.6321
Christmas Patchwork Frozen	2020-08-07	5	11	4	9	0.6321
Yes Brother	2020-07-24	6	11	4	10	0.6321
Fear of The Unknown	2020-09-03	3	11	4	7	0.6321
Monolithic	2020-12-15	4	11	4	8	0.6321
Strong towers	2020-10-23	6	11	4	10	0.6321
Artificer	2020-09-10	50	51	24	74	0.6311
DreamFly	2020-09-08	10	47	22	32	0.6307
A Plunge into Darkness	2020-03-19	997	13	5	1002	0.6306
Full Animal Party	2020-03-23	9	13	5	14	0.6306
Ramiwo	2020-02-19	3	13	5	8	0.6306
Henchman For Hire	2020-04-23	4	13	5	9	0.6306
Radio Station	2020-03-30	3	13	5	8	0.6306
Bacon Quest - Lovers' Beef Special Edition	2020-04-29	4	13	5	9	0.6306
悟梦图 Dreaming Atlas	2020-07-31	3	13	5	8	0.6306
Ski Doom VR	2020-08-14	3	13	5	8	0.6306
VR Hentai room	2020-07-22	2	13	5	7	0.6306
Run Dummy Run	2020-08-11	2	13	5	7	0.6306
Hentai Vs Orcs	2020-11-12	5	41	19	24	0.6301
Draft Day Sports: College Basketball 2020	2020-03-10	69	39	18	87	0.63
BegieAde ~a lyric of lie and retribution~	2020-11-12	20	39	18	38	0.63
The Persistence	2020-05-21	32	100	50	82	0.6299
Weaponry Dealer VR	2020-04-17	9	37	17	26	0.6298
Juken Jigoku | 受験地獄	2020-01-16	18	37	17	35	0.6298
KURT - DER FUSSBALLMANAGER	2020-03-06	7	15	6	13	0.6298
Occupational Hazards: Episode 1	2020-04-23	8	15	6	14	0.6298
Disarmed	2020-05-16	3	15	6	9	0.6298
MEGALAN 11	2020-05-17	3	15	6	9	0.6298
BorderCollie Game	2020-06-03	2	15	6	8	0.6298
Dark Cards	2020-09-10	6	15	6	12	0.6298
Boxing Coach	2020-10-16	4	15	6	10	0.6298
My Universe - My Baby	2020-11-26	7	15	6	13	0.6298
The Dark: Survival RPG	2020-09-23	5	15	6	11	0.6298
Atlantica Global	2020-05-14	1761	528	285	2046	0.6296
Ortharion project	2020-12-23	14	98	49	63	0.6296
Viticulture	2020-07-10	60	111	56	116	0.6295000000000001
Hunting Moon	2020-06-15	7	62	30	37	0.6295000000000001
Quest Rooms	2020-03-11	41	79	39	80	0.6293
Sheptun	2020-02-13	4	17	7	11	0.6293
Liar Trick -Psychological Crime Mystery-	2020-07-30	10	17	7	17	0.6293
Man in gravity	2020-08-11	3	17	7	10	0.6293
Aisling and the Tavern of Elves	2020-11-06	10	17	7	17	0.6293
Hentai VR 18+	2020-11-02	2	17	7	9	0.6293
StoneTide: Age of Pirates	2020-11-27	6	29	13	19	0.6291
The Uncertain: Light At The End	2020-10-08	183	575	312	495	0.629
Zefira	2020-01-10	131	77	38	169	0.629
Legacy - Witch Island 2	2020-10-03	6	27	12	18	0.629
Fear Protocol: Codename Omega Starring Agent Jack Banger	2020-11-10	4	27	12	16	0.629
Eterna: Heroes Fall	2020-11-19	11	19	8	19	0.629
DUMB Infernal	2020-01-26	3	19	8	11	0.629
Terminal squad: Swarmites	2020-01-30	3	19	8	11	0.629
DREAMLIVE	2020-02-21	4	19	8	12	0.629
Before Nightfall: Summertime	2020-07-24	3	19	8	11	0.629
Target Runner	2020-07-31	6	19	8	14	0.629
ZOMBIE! HENTAI! DEFENSE!	2020-09-22	4	19	8	12	0.629
Gravity_Kid	2020-10-07	4	19	8	12	0.629
Kiiroi Hana	2020-12-18	3	19	8	11	0.629
Stellar Commanders	2020-02-20	19	58	28	47	0.6289
18+ MEMORY	2020-01-31	5	58	28	33	0.6289
Flat Earth Simulator	2020-11-11	6	58	28	34	0.6289
Graywalkers: Purgatory	2020-01-15	9	21	9	18	0.6289
Fxxx Me Royally!! Horny Magical Princess	2020-12-18	19	21	9	28	0.6289
Hinterhalt 3	2020-04-25	4	21	9	13	0.6289
Kingdom Karnage	2020-08-01	24	21	9	33	0.6289
Qbio	2020-10-30	6	23	10	16	0.6288
football girl	2020-12-04	3	23	10	13	0.6288
Survive the Blackout	2020-02-06	42	56	27	69	0.6287
Contagion VR: Outbreak	2020-12-11	102	424	229	331	0.6281
鬼斗	2020-04-16	84	67	33	117	0.6276
Avaria: Chains of Lust	2020-07-27	168	117	60	228	0.6272
Cartoon Strike	2020-10-14	96	302	162	258	0.6271
Westmark Manor	2020-06-18	17	46	22	39	0.6271
Curse of Anabelle	2020-02-20	28	89	45	73	0.6267
We should talk.	2020-07-16	27	76	38	65	0.6267
dev_me	2020-05-30	20	61	30	50	0.6267
Imagine Lifetimes	2020-11-26	35	74	37	72	0.6264000000000001
Succubuses love CREAMPIE	2020-09-16	6	42	20	26	0.6264000000000001
Alder's Blood: Definitive Edition	2020-04-10	184	153	80	264	0.6263000000000001
Ancient charm	2020-03-11	8	40	19	27	0.6261
Fragile	2020-11-12	48	241	129	177	0.6259
Rainbow Dreams	2020-01-03	4	4	1	5	0.6251
Helix Brawl	2020-05-21	3	4	1	4	0.6251
DeepLands	2020-07-01	2	4	1	3	0.6251
Cube Man	2020-08-15	2	4	1	3	0.6251
Cookie Invaders	2020-12-01	6	4	1	7	0.6251
Strike Master Apocalypse	2020-01-07	1	4	1	2	0.6251
Flat Earths!	2020-02-27	6	4	1	7	0.6251
Escape the Lab	2020-11-07	3	4	1	4	0.6251
fight wisdom	2020-01-13	2	4	1	3	0.6251
Juicy Army: Prologue	2020-12-15	2	4	1	3	0.6251
SHOOTING CHICKEN BRUTAL SUCKERS	2020-07-11	2	4	1	3	0.6251
Super Crystal Hunter	2020-02-16	2	4	1	3	0.6251
New Planets	2020-01-20	1	4	1	2	0.6251
Log 141	2020-01-31	2	4	1	3	0.6251
Super Squash	2020-03-06	2	4	1	3	0.6251
Escape The Manor	2020-01-28	3	4	1	4	0.6251
Draught Kraft	2020-05-14	3	4	1	4	0.6251
Indian Army - Mission POK 	2020-02-26	2	4	1	3	0.6251
Legion's Crawl 2	2020-08-31	3	4	1	4	0.6251
Detectives United III: Timeless Voyage Collector's Edition	2020-02-07	6	4	1	7	0.6251
OneJump	2020-03-07	2	4	1	3	0.6251
NeonFlight	2020-02-26	2	4	1	3	0.6251
Tank Game	2020-04-20	136	4	1	137	0.6251
Oh So Lucky! Doctor : A Surgery Soap Opera	2020-03-13	2	4	1	3	0.6251
VR Mini Bowling 2	2020-04-10	3	4	1	4	0.6251
Zatorski, Ph.D.	2020-03-31	2	4	1	3	0.6251
Hecaton	2020-04-05	4	4	1	5	0.6251
Defend the village from goblins	2020-04-24	1	4	1	2	0.6251
Super Worm 3D	2020-04-29	2	4	1	3	0.6251
Archer VR	2020-04-30	3	4	1	4	0.6251
Cube Miners	2020-05-15	4	4	1	5	0.6251
Traumatic Syndrome	2020-05-01	2	4	1	3	0.6251
Type Up	2020-05-03	3	4	1	4	0.6251
Shape Storm	2020-05-12	1	4	1	2	0.6251
Jack Hayes: The Lazarus Sign	2020-09-08	2	4	1	3	0.6251
Rogue Planet	2020-05-23	2	4	1	3	0.6251
The End of Labyronia: Nerubis	2020-05-13	4	4	1	5	0.6251
Phogbound	2020-07-01	3	4	1	4	0.6251
Slime Climb	2020-06-16	136	4	1	137	0.6251
The Last Farm	2020-09-02	7	4	1	8	0.6251
Meditation Journey: VR Zen Garden	2020-06-26	2	4	1	3	0.6251
Retrowave Hexon	2020-06-25	1	4	1	2	0.6251
Thrust Legend	2020-07-01	2	4	1	3	0.6251
PuppetShow: Fatal Mistake Collector's Edition	2020-06-12	7	4	1	8	0.6251
Button Lock	2020-07-21	2	4	1	3	0.6251
Poly Race	2020-11-30	2	4	1	3	0.6251
Hungry Boy	2020-07-13	2	4	1	3	0.6251
The Night of Joe	2020-10-28	2	4	1	3	0.6251
Space Battle Arena	2020-08-19	5	4	1	6	0.6251
Abyssal Agent Alyss	2020-12-21	6	4	1	7	0.6251
Sweetest Thing	2020-07-25	2	4	1	3	0.6251
The Holy City	2020-08-02	2	4	1	3	0.6251
Keizudo	2020-07-23	2	4	1	3	0.6251
Memory Battle	2020-08-31	2	4	1	3	0.6251
Domestic Defense	2020-07-30	2	4	1	3	0.6251
BAO	2020-10-16	4	4	1	5	0.6251
A Little Bird	2020-09-17	2	4	1	3	0.6251
Path of the Martyrs	2020-08-25	2	4	1	3	0.6251
Record of Battle 3D Maiden Wars	2020-08-20	2	4	1	3	0.6251
B.D.K	2020-11-13	1	4	1	2	0.6251
Snowman Saves Christmas	2020-12-01	1	4	1	2	0.6251
VR historical journey to the age of Crusaders: Medieval Jerusalem, Saracen Cities, Arabic Culture, East Land	2020-09-23	1	4	1	2	0.6251
Hex Slayer	2020-10-15	5	4	1	6	0.6251
Hungry Horace	2020-09-17	2	4	1	3	0.6251
Plummet	2020-12-11	3	4	1	4	0.6251
BeetleQuest	2020-09-25	1	4	1	2	0.6251
Rage Jump	2020-09-23	3	4	1	4	0.6251
Grid Fight - Mask of the Goddess Prologue	2020-12-07	2	4	1	3	0.6251
Solitaire Halloween Story	2020-11-23	3	4	1	4	0.6251
Look and Find - Curiosity	2020-12-09	3	4	1	4	0.6251
Sunshine Manor Prologue	2020-10-07	5	4	1	6	0.6251
Godslayer|one	2020-10-20	2	4	1	3	0.6251
Cats and Food 4: New Year	2020-11-08	2	4	1	3	0.6251
Hypercide	2020-12-01	2	4	1	3	0.6251
Blood Knot	2020-11-13	2	4	1	3	0.6251
Forgotten Soundscape	2020-11-16	2	4	1	3	0.6251
Fish and Groove	2020-11-16	1	4	1	2	0.6251
Dragon Ninja Clan	2020-11-27	3	4	1	4	0.6251
DvG: Conquering Giants	2020-12-08	2	4	1	3	0.6251
Cyclemania	2020-12-04	2	4	1	3	0.6251
You Pilot A Piece Of S****: GAIDEN	2020-12-13	3	4	1	4	0.6251
逢魔之時	2020-12-15	2	4	1	3	0.6251
Choco Pixel D	2020-12-28	3	4	1	4	0.6251
Company of Heroes: Europe in Ruins	2020-06-13	22	64	32	54	0.6246
Cricket Captain 2020	2020-06-18	182	64	32	214	0.6246
Great British Railway Journeys	2020-03-05	13	32	15	28	0.6245
Pendragon	2020-09-22	93	75	38	131	0.6244
Last Oasis	2020-03-26	33287	14754	8645	41932	0.6242
COMBAT ARMS: THE CLASSIC	2020-07-14	681	809	454	1135	0.6242
Escape the City	2020-10-23	4	30	14	18	0.624
Hellbound	2020-08-04	127	738	414	541	0.6238
Resequenced	2020-04-24	10	60	30	40	0.6238
20 Minute Metropolis - The Action City Builder	2020-09-03	11	28	13	24	0.6235
Rascal Fight	2020-04-30	41	28	13	54	0.6235
Ecchi Jack	2020-08-19	8	28	13	21	0.6235
The Academy	2020-06-20	47	45	22	69	0.6234000000000001
Megalith	2020-05-08	15	43	21	36	0.623
Boreal Blade	2020-11-12	110	346	191	301	0.6226
魔神之战	2020-02-19	57	24	11	68	0.6226
Skull Rogue	2020-02-04	4	24	11	15	0.6226
Liminal	2020-12-13	9	24	11	20	0.6226
Heart's Medicine - Doctor's Oath	2020-06-25	77	105	55	132	0.6224000000000001
Corridor: Amount of Fear	2020-11-24	8	41	20	28	0.6224000000000001
COCKHEAD	2020-09-27	999	490	274	1273	0.6222
Rebel Galaxy Outlaw	2020-09-22	318	507	284	602	0.6221
Go All Out: Free To Play	2020-01-09	7	22	10	17	0.6221
GirLand	2020-02-21	3	22	10	13	0.6221
Bishoujo Battle Hanafuda Koi-Koi	2020-05-19	8	22	10	18	0.6221
Power & Revolution 2020 Edition	2020-09-17	296	524	294	590	0.6219
HaberDashers	2020-05-27	18	52	26	44	0.6219
Kaku Ancient Seal (Alpha) 	2020-11-27	22	52	26	48	0.6219
Eclipse: Edge of Light	2020-01-14	3	20	9	12	0.6215
Super Chicken Catchers	2020-02-18	34	20	9	43	0.6215
The Island Story	2020-06-05	8	20	9	17	0.6215
Zombie Island	2020-01-01	8	81	42	50	0.6214000000000001
Mirage	2020-08-07	29	186	101	130	0.6212
Car Dealer	2020-04-19	32	124	66	98	0.6212
The Unholy Society	2020-02-25	4	18	8	12	0.621
Block Busters	2020-02-07	10	18	8	18	0.621
Bingo VR	2020-06-11	4	18	8	12	0.621
Tropical Air hockey	2020-02-14	3	18	8	11	0.621
Battle for Iwo Jima	2020-03-04	9	18	8	17	0.621
Viking Fight	2020-09-14	5	18	8	13	0.621
Sillyfun Valley	2020-12-31	3	18	8	11	0.621
Alienautics	2020-01-05	4	6	2	6	0.621
Starship Saboteur Prototype	2020-05-05	4	6	2	6	0.621
Shooting Star	2020-02-08	2	6	2	4	0.621
Interlude	2020-08-10	323	6	2	325	0.621
The Burning Descent	2020-04-30	8	6	2	10	0.621
Dorky Fork	2020-08-24	3	6	2	5	0.621
Ai no Uta	2020-01-17	3	6	2	5	0.621
Myridian	2020-02-10	7	6	2	9	0.621
イヌワシ ～うらぶれ探偵とお嬢様刑事の池袋事件ファイル～	2020-03-04	5	6	2	7	0.621
Rhyme Storm	2020-10-12	3	6	2	5	0.621
SquaresStory	2020-03-31	4	6	2	6	0.621
Spot Sample Witness Simulator	2020-05-26	2	6	2	4	0.621
Down The Hole	2020-04-08	4	6	2	6	0.621
Creator's Chasm	2020-05-05	2	6	2	4	0.621
Nazi Labs	2020-05-15	2	6	2	4	0.621
Light Years Apart	2020-06-11	20	6	2	22	0.621
Space Roaming	2020-05-14	2	6	2	4	0.621
Ultimate Wall Defense Force	2020-09-03	2	6	2	4	0.621
Not My President - Level 1	2020-05-29	2	6	2	4	0.621
Empire of the Wicked	2020-06-04	3	6	2	5	0.621
VR-NISSAGE 3 - John Wentz Art Exhibition	2020-07-03	2	6	2	4	0.621
Zombeer	2020-06-18	2	6	2	4	0.621
Hanefield Asylum	2020-07-23	2	6	2	4	0.621
Elasto Mania II	2020-08-31	5	6	2	7	0.621
Cube Shifter	2020-08-14	5	6	2	7	0.621
OUBEY VR - Samurai	2020-08-06	1	6	2	3	0.621
Bor	2020-08-17	2	6	2	4	0.621
三国 看海与模拟 Three Kingdoms Simulator	2020-08-03	3	6	2	5	0.621
This is My Dungeon	2020-11-16	3	6	2	5	0.621
Operation TP	2020-09-15	136	6	2	138	0.621
My Neighborhood Arcade	2020-09-28	4	6	2	6	0.621
赛博侦探-艾尔塔特	2020-10-30	4	6	2	6	0.621
World of Pets: Match 3 and Decorate	2020-12-08	3	6	2	5	0.621
Metu Caligine	2020-11-14	2	6	2	4	0.621
The Legend of Eratus: Dragonlord	2020-11-17	5	6	2	7	0.621
Proven: A Math RPG	2020-12-03	4	6	2	6	0.621
600Seconds ~The Deep Church~	2020-12-22	5	6	2	7	0.621
Gothic 1881	2020-12-08	2	6	2	4	0.621
Stars Survivor	2020-12-05	4	6	2	6	0.621
Ricky did nothing wrong	2020-12-04	2	6	2	4	0.621
Pray And Spray	2020-12-19	4	6	2	6	0.621
Seasons With Furry	2020-11-20	3	48	24	27	0.6209
Xuan-Yuan Sword VII	2020-10-28	12320	5755	3398	15718	0.6204999999999999
Leons Identität	2020-09-04	25	77	40	65	0.6204999999999999
Chromo XY	2020-11-06	34	16	7	41	0.6204999999999999
Doodle Creatures	2020-03-15	6	16	7	13	0.6204999999999999
Starters Orders Classic Horse Racing	2020-03-07	14	16	7	21	0.6204999999999999
Tinseltown Tycoon	2020-05-12	9	16	7	16	0.6204999999999999
Nudist Beach Survival Simulator 2	2020-09-01	4	16	7	11	0.6204999999999999
Brain off	2020-10-26	7	16	7	14	0.6204999999999999
Godking: Master of Rituals	2020-09-16	22	33	16	38	0.62
Space Avenger – Empire of Nexx	2020-10-09	6	14	6	12	0.62
Bunker 56	2020-01-02	3	14	6	9	0.62
Summer Days	2020-10-23	12	14	6	18	0.62
Strip Card Duel	2020-04-03	4	14	6	10	0.62
Adventure Field™ 3 Definitive Edition	2020-03-30	10	14	6	16	0.62
Bubble Tea : game for thinking and imagination	2020-05-21	5	14	6	11	0.62
Return to Sector 9	2020-06-12	4	14	6	10	0.62
Fantasy Gladiators	2020-08-08	5	14	6	11	0.62
Baking Bustle	2020-10-15	8	14	6	14	0.62
Cafe Deux Femmes	2020-09-24	5	14	6	11	0.62
Powerboat VR	2020-12-29	3	14	6	9	0.62
Time For You	2020-07-31	110	197	108	218	0.6199
Worms Rumble	2020-12-01	767	1271	736	1503	0.6198
Stay home and play with waifu!	2020-05-06	5	44	22	27	0.6197
OkunoKA Madness	2020-09-08	6	8	3	9	0.6197
BorderStrain	2020-03-12	5	8	3	8	0.6197
Miniturn	2020-07-17	4	8	3	7	0.6197
Hard to be a King	2020-06-30	3	8	3	6	0.6197
退廃思考	2020-01-02	3	8	3	6	0.6197
Malvin`s Prehistoric Adventures	2020-09-04	2	8	3	5	0.6197
Ourea	2020-07-21	4	8	3	7	0.6197
Box:Boxing	2020-04-11	2	8	3	5	0.6197
Awaken The Time	2020-11-05	1	8	3	4	0.6197
VR Aim Trainer	2020-07-25	3	8	3	6	0.6197
Everything Explosive	2020-08-19	5	8	3	8	0.6197
Shutter 2	2020-10-23	2	8	3	5	0.6197
American Isekai Prologue	2020-07-14	4	8	3	7	0.6197
Ayano the Exorcist	2020-08-29	10	8	3	13	0.6197
Loofy	2020-09-27	2	8	3	5	0.6197
Fashion Show Makeover Mega Pack	2020-09-29	5	8	3	8	0.6197
It's Six Random Characters and a Single Floor Dungeon, That's the Whole Game	2020-11-02	2	8	3	5	0.6197
古龙传说	2020-12-12	7	8	3	10	0.6197
Sokpop S10: Pipo Park	2020-11-28	4	8	3	7	0.6197
LineArt Jigsaw Puzzle - Erotica Christmas	2020-12-23	2	8	3	5	0.6197
Override 2: Super Mech League	2020-12-22	62	73	38	100	0.6196
Crumbling World	2020-05-21	4	12	5	9	0.6196
CatDog Puzzle	2020-02-24	2	12	5	7	0.6196
Polary	2020-03-20	4	12	5	9	0.6196
Prisme 7	2020-04-23	13	12	5	18	0.6196
Antidote	2020-06-19	3	12	5	8	0.6196
Chaos	2020-10-30	2	12	5	7	0.6196
All Hail The Cook-o-tron	2020-12-21	4	12	5	9	0.6196
LineArt Jigsaw Puzzle - Erotica	2020-10-20	3	12	5	8	0.6196
Arcana Sands of Destiny	2020-12-10	8	12	5	13	0.6196
Cyberpunica 2.0.2.0	2020-11-09	3	12	5	8	0.6196
ArchiTac	2020-06-25	27	137	74	101	0.6195
Plastic Rebellion	2020-09-23	4	10	4	8	0.6195
Fallen Hearts	2020-06-02	4	10	4	8	0.6195
Street Sweeper	2020-02-18	3	10	4	7	0.6195
Brain Please Don't	2020-07-01	2	10	4	6	0.6195
Card Apocalypse 旅人战记	2020-08-13	4	10	4	8	0.6195
Penny's Path	2020-07-24	2	10	4	6	0.6195
Mystery Case Files: The Harbinger Collector's Edition	2020-08-21	13	10	4	17	0.6195
Let's Learn Japanese! Kanji Sudoku	2020-10-01	3	10	4	7	0.6195
Hunting Simulator 2	2020-07-16	383	372	210	593	0.6187
Daikaiju Daikessen: Versus	2020-11-18	25	78	41	66	0.6187
SpelunKing: The Mine Match	2020-04-04	14	29	14	28	0.6186
Chess Knights: High Noon	2020-12-15	7	29	14	21	0.6186
Project Speed	2020-05-18	14	69	36	50	0.6185
FIREGROUND	2020-01-13	11	40	20	31	0.6183
Clash: Mutants Vs Pirates	2020-06-12	44	67	35	79	0.618
HARTS ISLAND	2020-06-03	5	27	13	18	0.6178
Retrowave Drift	2020-11-23	8	27	13	21	0.6178
Model Railway Easily Christmas	2020-01-27	10	25	12	22	0.6169
问道仙途	2020-07-02	21	25	12	33	0.6169
Gravity Mummy	2020-09-22	4	25	12	16	0.6169
HalfLight	2020-04-01	126	86	46	172	0.6168
Crawling Of The Dead	2020-04-23	10	36	18	28	0.6168
Knockout Party	2020-09-12	30	77	41	71	0.6164000000000001
Deskmate Girl	2020-06-29	169	145	80	249	0.6162
Uncrewed	2020-03-26	19	91	49	68	0.6162
Startup Valley Adventure - Episode 1	2020-07-30	8	23	11	19	0.616
Gene Rain:Wind Tower	2020-01-04	7	23	11	18	0.616
Baby Shark VR Dancing	2020-04-21	3	23	11	14	0.616
Color Phase	2020-09-03	36	34	17	53	0.6159
잭과 콩나무: 숨겨진 이야기	2020-04-22	53	186	104	157	0.6158
FALAFEL Restaurant Simulator	2020-08-28	52	80	43	95	0.6152000000000001
Circle	2020-01-18	3	32	16	19	0.615
Beyond This Side	2020-03-20	11	32	16	27	0.615
Rescue Elves	2020-03-21	8	57	30	38	0.6149
Stories of Submission: Learn Your Place	2020-08-12	8	21	10	18	0.6149
LA Monsters	2020-10-29	4	21	10	14	0.6149
Ertugrul Gazi	2020-12-28	3	21	10	13	0.6149
Nubarron: The adventure of an unlucky gnome	2020-01-30	312	444	257	569	0.6148
CrossWorlds: Escape	2020-03-20	30	92	50	80	0.6147
Ezaron Defense Alpha	2020-05-20	45	69	37	82	0.614
Bone Marrow	2020-03-16	3	30	15	18	0.614
Angry Bunny 2: Lost hole	2020-03-13	3	30	15	18	0.614
Missy's Transformation Tournament	2020-05-28	14	19	9	23	0.6138
Jelly Brawl	2020-10-27	9	19	9	18	0.6138
Drifters Loot the Galaxy - Beta	2020-08-14	63	19	9	72	0.6138
迷途	2020-11-10	4	19	9	13	0.6138
Hentai Forever	2020-12-19	3	19	9	12	0.6138
The First Friend	2020-12-10	3	19	9	12	0.6138
3on3 FreeStyle: Rebound	2020-07-15	657	1389	830	1487	0.6136
Survival Frenzy	2020-01-10	139	182	103	242	0.6133
Another Try	2020-04-19	53	170	96	149	0.6132
Live the Life	2020-09-16	79	244	140	219	0.6129
Armed to the Gears	2020-04-08	75	122	68	143	0.6129
Color Defense	2020-01-20	106	28	14	120	0.6129
No King No Kingdom VR	2020-02-16	5	17	8	13	0.6125
Super Toy Cars 2	2020-05-14	8	17	8	16	0.6125
Windmill Kings	2020-01-30	6	17	8	14	0.6125
Crystal Story: The Hero and the Evil Witch	2020-05-29	11	17	8	19	0.6125
Endless Battle: Return of Hero +1	2020-07-22	37	17	8	45	0.6125
Feel Up a Sexy Lifeguard!	2020-11-04	10	17	8	18	0.6125
Soft Wind	2020-12-21	3	17	8	11	0.6125
Veterans Online	2020-05-22	202	201	115	317	0.612
Struggle Offensive	2020-11-01	22	106	59	81	0.6119
RollingSky	2020-02-20	9	63	34	43	0.6119
Monster Girl Breeder	2020-09-18	18	63	34	52	0.6119
Tavern Cards	2020-04-11	5	42	22	27	0.6118
PixelForces.io	2020-02-23	8	26	13	21	0.6118
Gods of Love: An Otome Visual Novel	2020-03-09	19	26	13	32	0.6118
Theme Park Simulator	2020-02-13	6	26	13	19	0.6118
Dawn of Fear	2020-06-10	4	26	13	17	0.6118
Welcome to Pussy Paradise	2020-04-24	8	26	13	21	0.6118
CasinoLife Poker	2020-08-05	28	75	41	69	0.6116
Dreadlands	2020-11-09	36	121	68	104	0.6113000000000001
Dorian Morris Adventure	2020-11-16	6	15	7	13	0.6111
Idle Space	2020-02-21	8	15	7	15	0.6111
World Championship Boxing Manager™	2020-05-12	10	15	7	17	0.6111
City Destructor	2020-04-14	14	15	7	21	0.6111
Hard Driver	2020-06-26	2	15	7	9	0.6111
D100 Dungeon	2020-09-14	11	15	7	18	0.6111
Shu's Misfortune	2020-12-22	4	15	7	11	0.6111
Directive Nine	2020-09-10	4	15	7	11	0.6111
Starship Commander: Arcade	2020-09-10	5	33	17	22	0.611
The Trud	2020-05-22	8	33	17	25	0.611
Meeple Station	2020-04-10	150	489	290	440	0.6104999999999999
Fire Escape	2020-04-29	7	24	12	19	0.6104999999999999
Pledge: Extra credit	2020-09-09	138	83	46	184	0.6103000000000001
Star Sonata 2	2020-06-12	170	137	78	248	0.61
Naked News	2020-02-07	4	64	35	39	0.6098
Victory and Glory: The American Civil War	2020-04-01	35	45	24	59	0.6098
Brick Building	2020-07-28	31	31	16	47	0.6098
Helicopter Simulator	2020-08-06	19	98	55	74	0.6097
SWORD ART ONLINE Alicization Lycoris	2020-07-09	8590	3867	2390	10980	0.6095
Tales of the Deck	2020-02-06	5	13	6	11	0.6095
Typical Cliche	2020-03-10	5	13	6	11	0.6095
ANARCHY	2020-05-07	137	13	6	143	0.6095
YATB：You Are The Best - Egypt Chapter	2020-03-20	4	13	6	10	0.6095
PhotoWorld	2020-10-26	2	13	6	8	0.6095
Slide Mini	2020-12-30	9	13	6	15	0.6095
Jane Angel 2: Fallen Heaven	2020-12-28	4	13	6	10	0.6095
Car Trader Simulator - Welcome to the Business	2020-06-23	240	279	164	404	0.6091
Labirinto 2	2020-03-14	3	22	11	14	0.609
Burnout™ Paradise Remastered	2020-06-04	599	3146	1947	2546	0.6087
Gaijin Troubles	2020-02-03	4	36	19	23	0.6085
Marble Parkour	2020-12-02	4	29	15	19	0.6085
Mya of the Desert	2020-04-24	33	72	40	73	0.6084
WGT Golf	2020-04-13	446	1279	784	1230	0.6079
Anthology of Fear: Prologue	2020-05-27	13	65	36	49	0.6079
Little Town Hero	2020-07-09	11	11	5	16	0.6076
PRISON OF SON	2020-01-30	2	11	5	7	0.6076
TAXIDERMY	2020-01-15	7	11	5	12	0.6076
First Day: Home Defender	2020-01-29	4	11	5	9	0.6076
NonetEnsemble～魔法仕掛けの迷宮～	2020-02-13	8	11	5	13	0.6076
Santa Monica Paradise	2020-05-29	4	11	5	9	0.6076
Desktop Man	2020-10-04	11	11	5	16	0.6076
Zombie Rush - Heroes	2020-09-18	25	11	5	30	0.6076
Letter Vetter	2020-11-27	6	11	5	11	0.6076
Warhammer Underworlds: Online	2020-04-21	793	936	572	1365	0.6074
Celestial	2020-02-07	4	20	10	14	0.6074
Rascallz: Tiki Tiki	2020-06-22	6	20	10	16	0.6074
The Line	2020-08-04	4	20	10	14	0.6074
Cube Gothic	2020-09-24	3	20	10	13	0.6074
The Gateway Trilogy	2020-03-31	18	27	14	32	0.6071
ODIA	2020-07-10	3	27	14	17	0.6071
Skelattack	2020-06-02	19	63	35	54	0.6070000000000001
Kika & Daigo: A Curious Tale	2020-01-21	15	63	35	50	0.6070000000000001
John Wick Hex	2020-12-04	85	320	192	277	0.6059
ANIME WORLD	2020-08-31	7	106	61	68	0.6059
Futuball - Future Football Manager Game	2020-03-17	36	32	17	53	0.6059
Model Melissa	2020-05-15	19	18	9	28	0.6055
Sokpop S06: Klym	2020-01-17	5	18	9	14	0.6055
Model Railway Easily	2020-01-28	6	18	9	15	0.6055
Rhythmic Retro Racer	2020-03-11	3	18	9	12	0.6055
Inferno Wizards	2020-04-17	6	18	9	15	0.6055
Dragon's Eye	2020-08-14	3	9	4	7	0.6054
Defense And Revenge	2020-05-01	3	9	4	7	0.6054
Inglorious Pirate	2020-01-22	2	9	4	6	0.6054
Virtual Race Car Engineer 2020	2020-01-24	9	9	4	13	0.6054
Witch College 2	2020-02-24	2	9	4	6	0.6054
Puzzle Girls: Cute	2020-07-22	5	9	4	9	0.6054
Sniper Shooting Alpha Strike	2020-07-22	30	9	4	34	0.6054
Knight's maze	2020-06-02	2	9	4	6	0.6054
Elly's Cake Cafe	2020-06-14	4	9	4	8	0.6054
The Fall of Eskaria	2020-06-22	2	9	4	6	0.6054
Aster Fpv Drone Simulator	2020-10-22	6	9	4	10	0.6054
The Surreal Imaginarium	2020-07-23	2	9	4	6	0.6054
Last Memory	2020-07-24	2	9	4	6	0.6054
Black Knight - Milena	2020-10-09	6	9	4	10	0.6054
Five-Finger Gunslinger	2020-09-01	136	9	4	140	0.6054
Water Rain	2020-08-24	5	9	4	9	0.6054
Landing	2020-09-11	3	9	4	7	0.6054
NetGunner	2020-10-12	6	9	4	10	0.6054
Simp Attack	2020-12-01	2	9	4	6	0.6054
Aefen Fall	2020-12-04	11	37	20	31	0.6052000000000001
Medal of Honor™: Above and Beyond	2020-12-11	318	1326	825	1143	0.6049
Girls' civilization	2020-01-06	126	156	92	218	0.6045
Fritz Chess 17 Steam Edition	2020-07-29	29	47	26	55	0.6045
Australian Football Coach 2020	2020-08-22	16	23	12	28	0.6037
Rocket Arena	2020-07-14	1136	1156	722	1858	0.6036
Elf Breeding Farm	2020-02-21	27	108	63	90	0.6036
MusicWave	2020-05-02	9	40	22	31	0.6035
Bogatyr	2020-01-27	5	40	22	27	0.6035
Rise: The Vieneo Province	2020-02-04	7	16	8	15	0.6034
The Shadow Society	2020-02-06	70	16	8	78	0.6034
Dissection	2020-04-21	3	16	8	11	0.6034
野球拳 The Warlin of Heroes	2020-09-06	5	16	8	13	0.6034
Legacy - Witch Island	2020-09-21	5	16	8	13	0.6034
Araha : Curse of Yieun Island	2020-01-06	51	176	105	156	0.6032000000000001
Sabotaj	2020-12-25	898	2622	1662	2560	0.603
Esports Life Tycoon	2020-09-03	423	411	252	675	0.603
Adventures of Tara	2020-02-21	18	28	15	33	0.6028
Haypi Monster 3	2020-05-29	18	28	15	33	0.6028
Percussive VR	2020-12-24	3	7	3	6	0.6028
Rise of the Foederati	2020-05-04	4	7	3	7	0.6028
Thunderballs	2020-10-30	5	7	3	8	0.6028
Paizuri Fantasies Kinetic Novel	2020-04-17	4	7	3	7	0.6028
Sokpop S02: kamer	2020-01-17	2	7	3	5	0.6028
1001 JIGSAW. MYTHS OF ANCIENT GREECE	2020-01-21	5	7	3	8	0.6028
Warchasm	2020-06-12	2	7	3	5	0.6028
Dethcube	2020-05-20	2	7	3	5	0.6028
Contract	2020-02-24	4	7	3	7	0.6028
Into The Infinite	2020-04-24	1	7	3	4	0.6028
Attack of the alien thingies from lava!	2020-02-19	4	7	3	7	0.6028
Fields of Glory	2020-04-28	5	7	3	8	0.6028
AZ: Oath of Brotherhood Prologue 1	2020-03-19	2	7	3	5	0.6028
Dragon Banner	2020-05-08	2	7	3	5	0.6028
Saving Stages	2020-04-20	6	7	3	9	0.6028
VRDJ	2020-05-26	2	7	3	5	0.6028
Mind Mirror	2020-08-07	4	7	3	7	0.6028
韦弗利山 - Waverly Hills	2020-09-30	2	7	3	5	0.6028
Dim Glow	2020-06-26	2	7	3	5	0.6028
Eternal Pain: Epiphany	2020-07-13	4	7	3	7	0.6028
Robowork	2020-08-20	3	7	3	6	0.6028
Asian Riddles 2	2020-09-07	4	7	3	7	0.6028
Strip Black Jack - Santa Babe	2020-11-13	4	7	3	7	0.6028
END OF THE WORLD - NTR	2020-11-24	3	7	3	6	0.6028
Fishy But In 2.5D	2020-12-03	2	7	3	5	0.6028
Immortal Realms: Vampire Wars	2020-08-28	547	302	184	731	0.6026
Kawaii Girl 2	2020-08-28	103	193	116	219	0.6024
The Laundry	2020-07-21	6	58	33	39	0.6021
Dark Raider	2020-06-05	8	43	24	32	0.6020000000000001
Escape First 3	2020-03-21	167	120	71	238	0.6019
Nom Nom Apocalypse	2020-02-13	10	21	11	21	0.6017
Ghostship Chronicles	2020-11-17	14	21	11	25	0.6017
Fish Simulator: Aquarium Manager	2020-02-10	13	21	11	24	0.6017
Emberheart	2020-09-30	11	21	11	22	0.6017
Fred3ric	2020-09-21	4	21	11	15	0.6017
PSIONIC	2020-11-20	5	21	11	16	0.6017
Boom Blaster	2020-07-17	6	26	14	20	0.601
Swordbreaker: Back to The Castle	2020-02-21	11	51	29	40	0.6009000000000001
Gunhouse	2020-02-06	7	14	7	14	0.6009000000000001
Spacer: Legacies	2020-09-23	7	14	7	14	0.6009000000000001
Inside the Box	2020-06-12	9	14	7	16	0.6009000000000001
Draft Day Sports: Pro Football 2021	2020-10-01	36	31	17	53	0.6006
Metal Commando	2020-11-18	5	31	17	22	0.6006
Malus	2020-03-10	20	178	108	128	0.6001
CSC | Space MMO	2020-09-03	126	298	184	310	0.5999
Rakion Chaos Force	2020-03-25	5740	1952	1251	6991	0.5998
FortressV2	2020-12-31	265	309	191	456	0.5998
Fractured State	2020-04-10	3	5	2	5	0.5997
ad movere	2020-12-04	3	5	2	5	0.5997
The Dealer	2020-11-02	2	5	2	4	0.5997
Until September	2020-09-17	4	5	2	6	0.5997
Garden City	2020-11-20	6	5	2	8	0.5997
Lights, Camera, Reaction!	2020-10-30	2	5	2	4	0.5997
Cube Chase	2020-02-20	2	5	2	4	0.5997
晴空：未来的守望	2020-04-20	2	5	2	4	0.5997
Retro	2020-02-27	2	5	2	4	0.5997
Armoured Onslaught	2020-02-28	2	5	2	4	0.5997
Perpetual Dream	2020-03-16	3	5	2	5	0.5997
Cyber Battle 69	2020-06-30	3	5	2	5	0.5997
You are next	2020-03-06	3	5	2	5	0.5997
RUNPUZZLE	2020-03-31	2	5	2	4	0.5997
Ninja Scarf	2020-06-05	7	5	2	9	0.5997
King of the Streets	2020-04-25	6	5	2	8	0.5997
Labyrinth: The Exit Is Closer	2020-04-01	1	5	2	3	0.5997
Naked Puzzle: Girls	2020-04-10	4	5	2	6	0.5997
Fatal Evidence: The Missing Collector's Edition	2020-03-20	6	5	2	8	0.5997
Slash Roll	2020-08-26	4	5	2	6	0.5997
Fall Of The Mafia	2020-04-09	2	5	2	4	0.5997
Mindframe Arena	2020-04-18	3	5	2	5	0.5997
Audio Party Pack	2020-05-14	4	5	2	6	0.5997
The Broston Saga	2020-04-25	2	5	2	4	0.5997
Not Our Home: Platinum Edition	2020-05-06	2	5	2	4	0.5997
Another FPS Game	2020-05-09	3	5	2	5	0.5997
Future Fragments - Command Z	2020-05-20	1	5	2	3	0.5997
Pandemia: Virus Outbreak	2020-05-20	2	5	2	4	0.5997
Rogue Robots	2020-06-12	2	5	2	4	0.5997
Cruel Galaxy: Discordia	2020-06-30	3	5	2	5	0.5997
ハンターハーツ Hunter Hearts	2020-06-04	5	5	2	7	0.5997
Addle Earth	2020-08-28	3	5	2	5	0.5997
Finding Kathy	2020-07-17	2	5	2	4	0.5997
Orbit Outlaws	2020-11-04	5	5	2	7	0.5997
Whispers of the Ancients	2020-11-06	5	5	2	7	0.5997
Slime Up	2020-06-23	1	5	2	3	0.5997
Colorize	2020-07-03	1	5	2	3	0.5997
I'm a love interest in my childhood friend's reverse harem!!!	2020-09-01	3	5	2	5	0.5997
Mina & Michi	2020-09-22	3	5	2	5	0.5997
Valletine against Darkne	2020-08-07	1	5	2	3	0.5997
Six Paths	2020-08-14	3	5	2	5	0.5997
Darkness Eternal	2020-08-07	3	5	2	5	0.5997
Knightczech	2020-10-14	3	5	2	5	0.5997
Crystal Ortha	2020-11-06	7	5	2	9	0.5997
Labyrinths of the World: Hearts of the Planet Collector's Edition	2020-08-17	9	5	2	11	0.5997
Save the Date	2020-10-05	2	5	2	4	0.5997
Evil Icebox	2020-09-16	2	5	2	4	0.5997
剑决	2020-10-06	2	5	2	4	0.5997
Pitched Battle	2020-09-25	4	5	2	6	0.5997
Knight`s Pride	2020-09-26	2	5	2	4	0.5997
Slaves of Magic prelude	2020-12-14	2	5	2	4	0.5997
Bloodland	2020-10-29	6	5	2	8	0.5997
Change the World	2020-10-22	2	5	2	4	0.5997
Ozone Guardian	2020-10-09	3	5	2	5	0.5997
Emberlight	2020-10-14	30	5	2	32	0.5997
Elon's Dream	2020-10-28	2	5	2	4	0.5997
Gael's Quest	2020-11-18	3	5	2	5	0.5997
Christmas day	2020-12-24	2	5	2	4	0.5997
Ramses: Rise of Empire	2020-12-17	7	5	2	9	0.5997
Finding Alina	2020-12-15	2	5	2	4	0.5997
Big Adventure Of Fighting Chicken	2020-12-21	2	5	2	4	0.5997
Isekai: Reincarnation in a New World	2020-12-25	3	5	2	5	0.5997
Hentai Simulator	2020-08-28	4	44	25	29	0.5994
扶搖直上	2020-05-13	21	19	10	31	0.5994
Black blood	2020-03-21	2	19	10	12	0.5994
Stabby Cats	2020-05-20	9	19	10	19	0.5994
House in the village by the river v2.0	2020-12-17	3	19	10	13	0.5994
Russian Reality	2020-12-12	6	19	10	16	0.5994
Draw a Stickman: EPIC 3	2020-05-07	49	91	54	103	0.5991
A-Tech Cybernetic VR	2020-03-27	35	445	279	314	0.5989
Puzzle Island VR	2020-05-19	4	24	13	17	0.5989
Hentai Amazon Girls	2020-03-08	2	24	13	15	0.5989
Bishoujo Battle Mahjong Solitaire	2020-05-21	11	24	13	24	0.5989
Bitchy Boss Bimbofication	2020-08-14	11	24	13	24	0.5989
Ratten Reich - Dance of Kings	2020-10-26	7	29	16	23	0.5988
Airplane Mode	2020-10-15	62	175	107	169	0.5985
Forklift Simulator 2019	2020-11-06	27	47	27	54	0.5982999999999999
Memories of Mars	2020-03-12	593	1005	643	1236	0.598
Lives so Sweet	2020-01-26	5	12	6	11	0.598
BattleParty	2020-04-27	5	12	6	11	0.598
Hentai Collection: Memory	2020-06-08	4	12	6	10	0.598
Auto Kitchen	2020-06-12	7	12	6	13	0.598
Tommy's Tragedy	2020-07-21	3	12	6	9	0.598
Our Past	2020-09-15	4	12	6	10	0.598
Ghone is gone	2020-01-22	47	42	24	71	0.5979
Grimm 1865	2020-01-28	9	37	21	30	0.5975
Ary and the secret of seasons	2020-09-01	65	106	64	129	0.5972999999999999
Shakes on a Plane	2020-12-15	22	32	18	40	0.5971000000000001
Zoo Constructor	2020-01-03	11	17	9	20	0.5968
Porsche Hall of Legends VR	2020-02-24	4	17	9	13	0.5968
Prank Call	2020-11-05	14	17	9	23	0.5968
Croppy Boy	2020-08-28	39	77	46	85	0.5965
Goblin Jargon	2020-05-15	13	40	23	36	0.5963
Dragon Souls	2020-10-02	15	48	28	43	0.596
Moorhuhn Kart	2020-05-04	12	48	28	40	0.596
PostZ	2020-12-15	3	3	1	4	0.596
Morth	2020-09-16	2	3	1	3	0.596
Have a N.I.C.E day!	2020-04-02	2	3	1	3	0.596
Cyber City Escape	2020-06-25	1	3	1	2	0.596
Marble Odyssey	2020-09-23	2	3	1	3	0.596
Seven Red Lines	2020-01-12	2	3	1	3	0.596
Aerial Raver	2020-03-25	3	3	1	4	0.596
Detective Bot	2020-05-26	2	3	1	3	0.596
Endless Void	2020-09-29	2	3	1	3	0.596
Gericonia 2	2020-02-03	3	3	1	4	0.596
DeepSea	2020-06-01	2	3	1	3	0.596
Profitania	2020-03-18	10	3	1	11	0.596
Survivor Jones	2020-12-18	1	3	1	2	0.596
踢飞地牢	2020-01-13	2	3	1	3	0.596
FLAGFIGHTS	2020-01-11	6	3	1	7	0.596
World of Voidia（虚亚世界）	2020-02-01	2	3	1	3	0.596
Tune the Tone	2020-04-22	3	3	1	4	0.596
Into The Valley	2020-03-02	3	3	1	4	0.596
IMM Defense 2	2020-01-23	2	3	1	3	0.596
SSTR	2020-12-14	3	3	1	4	0.596
Crapht Box	2020-02-13	2	3	1	3	0.596
GodOrEvil.1	2020-02-10	2	3	1	3	0.596
Rocket Panda Panic	2020-09-07	2	3	1	3	0.596
Hades Ultimate Fighting Ball	2020-03-31	3	3	1	4	0.596
F-117A Stealth Fighter	2020-05-21	2	3	1	3	0.596
Feed The Horsebear	2020-04-03	1	3	1	2	0.596
PASVAN	2020-03-04	3	3	1	4	0.596
Hexagon Heroes	2020-10-12	2	3	1	3	0.596
Remnants of the Dawn	2020-09-30	2	3	1	3	0.596
Just Like Golf	2020-05-15	2	3	1	3	0.596
Box Voyage	2020-06-01	4	3	1	5	0.596
SubDivide	2020-07-17	2	3	1	3	0.596
Space Junk	2020-06-18	2	3	1	3	0.596
Astonishing Baseball 20	2020-05-15	2	3	1	3	0.596
Taiga	2020-10-08	2	3	1	3	0.596
罗马之链	2020-08-04	4	3	1	5	0.596
Belongings	2020-07-16	1	3	1	2	0.596
Orc's Civil War	2020-06-28	2	3	1	3	0.596
3d Maze In Space	2020-05-28	1	3	1	2	0.596
The Village Story	2020-06-19	1	3	1	2	0.596
Steam revolution	2020-08-14	2	3	1	3	0.596
RetroBound	2020-09-11	2	3	1	3	0.596
KANAPOCALYPSE	2020-06-13	2	3	1	3	0.596
防衛の村長～Mayor of Defense～	2020-06-30	4	3	1	5	0.596
Enchanted Kingdom: The Secret of the Golden Lamp Collector's Edition	2020-05-29	8	3	1	9	0.596
The Haunted Exmone Theatre	2020-07-17	2	3	1	3	0.596
Bananas Academy's Psyber	2020-07-06	3	3	1	4	0.596
2945VR	2020-07-13	2	3	1	3	0.596
miniStrike	2020-11-01	2	3	1	3	0.596
Swallow The Blue	2020-07-08	1	3	1	2	0.596
Exploaris: Vermis story	2020-09-22	1	3	1	2	0.596
Pendelum	2020-08-21	4	3	1	5	0.596
At The Downstairs	2020-07-17	2	3	1	3	0.596
The Chase	2020-11-12	2	3	1	3	0.596
KHIO	2020-07-24	2	3	1	3	0.596
Time Gap Puppies	2020-09-02	2	3	1	3	0.596
Sokodice	2020-09-17	2	3	1	3	0.596
Dream Stone 2	2020-08-26	2	3	1	3	0.596
Super Wiloo Demake	2020-07-31	2	3	1	3	0.596
GamerZ CastlE Rush!	2020-09-01	1	3	1	2	0.596
President's Sniper Shooting	2020-08-26	1	3	1	2	0.596
Table Top Turrets	2020-09-16	1	3	1	2	0.596
きみとぼくとかくしごと	2020-12-29	1	3	1	2	0.596
背徳シレネ	2020-12-30	2	3	1	3	0.596
Stones of the Revenant	2020-09-09	2	3	1	3	0.596
VR historical journey to the Buddhist civilizations: VR ancient India and Asia	2020-09-23	2	3	1	3	0.596
Impossible Mission II	2020-09-11	3	3	1	4	0.596
1Day一天	2020-09-30	1	3	1	2	0.596
SpaceCrash	2020-11-16	2	3	1	3	0.596
太古未来	2020-10-08	2	3	1	3	0.596
DOGFIGHTER -WW2-	2020-10-07	5	3	1	6	0.596
Eat fish 3D	2020-11-10	2	3	1	3	0.596
Jigsaw Boom	2020-11-20	2	3	1	3	0.596
4Line	2020-12-30	4	3	1	5	0.596
CAT SUDOKU🐱	2020-10-14	2	3	1	3	0.596
Vagrant Sword	2020-10-29	3	3	1	4	0.596
Horace Goes Skiing	2020-10-23	1	3	1	2	0.596
Round 99	2020-12-22	2	3	1	3	0.596
Keywords of A Life	2020-11-02	2	3	1	3	0.596
Difficult Platformer Game	2020-11-04	2	3	1	3	0.596
The Games: Winter Edition	2020-10-28	1	3	1	2	0.596
Ellie's Travel Diary	2020-12-07	4	3	1	5	0.596
LabRat	2020-11-05	3	3	1	4	0.596
GENIUS AT WORK!	2020-12-02	2	3	1	3	0.596
Unlimited Fight	2020-12-10	2	3	1	3	0.596
CATTCH	2020-12-22	2	3	1	3	0.596
Naughty Memories: Asian Beauty	2020-12-11	2	3	1	3	0.596
Omega Blade	2020-12-24	2	3	1	3	0.596
Mechanic Miner	2020-02-20	168	116	71	239	0.5954
Potion Paws	2020-10-30	33	43	25	58	0.5954
Pombero - The Lord of Night	2020-11-23	6	30	17	23	0.5952000000000001
鋼鉄戦記C21	2020-10-15	113	62	37	150	0.5947
What Happened	2020-07-30	34	62	37	71	0.5947
Motion Of The Heart	2020-04-02	3	38	22	25	0.5947
They Are Beasts	2020-03-01	5	25	14	19	0.5946
PhyxBox	2020-01-30	8	25	14	22	0.5946
Puzzzle	2020-12-05	6	25	14	20	0.5946
Card Blitz: WWII	2020-10-26	19	46	27	46	0.5945
The Dark Side	2020-01-20	3	10	5	8	0.5943
Orion13	2020-02-13	2	10	5	7	0.5943
Sokpop S04: Kart kids	2020-01-17	4	10	5	9	0.5943
Roman Way	2020-07-29	5	10	5	10	0.5943
Cyborg Arena 2	2020-03-30	2	10	5	7	0.5943
Welcome To Chichester OVN 3 : The Mysterious Affair At The Violet Hotel	2020-06-07	2	10	5	7	0.5943
Drift Racing Rally	2020-05-11	30	10	5	35	0.5943
Wild West Survival	2020-08-01	4	10	5	9	0.5943
Girls Memory Card	2020-07-14	2	10	5	7	0.5943
Returning the favor of the dog	2020-08-28	9	10	5	14	0.5943
Arcante	2020-10-27	3	10	5	8	0.5943
Dark Unreal	2020-12-10	2	10	5	7	0.5943
Majestic-12	2020-04-29	3	1	0	3	0.5942000000000001
Turtle VR	2020-01-28	1	1	0	1	0.5942000000000001
Tiki Brawl	2020-10-08	3	1	0	3	0.5942000000000001
Fuzzy's Quest	2020-01-01	1	1	0	1	0.5942000000000001
BioEntity	2020-09-24	1	1	0	1	0.5942000000000001
Sealer Assist	2020-01-07	2	1	0	2	0.5942000000000001
Pure Metal: Feature 1	2020-06-10	1	1	0	1	0.5942000000000001
E-Ball	2020-02-21	1	1	0	1	0.5942000000000001
War Trigger 2	2020-01-03	1	1	0	1	0.5942000000000001
Way Of The Orb	2020-03-23	1	1	0	1	0.5942000000000001
The Vox: Tower Defense	2020-06-05	3	1	0	3	0.5942000000000001
Game of Drones	2020-05-06	2	1	0	2	0.5942000000000001
Eat my Shuriken and Die!	2020-06-03	3	1	0	3	0.5942000000000001
The Adventures of 00 Dilly®	2020-02-12	2	1	0	2	0.5942000000000001
Wayblock	2020-10-03	2	1	0	2	0.5942000000000001
Road Rage Royale	2020-10-12	2	1	0	2	0.5942000000000001
My Town: Dessert Slice	2020-03-06	4	1	0	4	0.5942000000000001
Son.Light.Sleepwalker	2020-11-25	1	1	0	1	0.5942000000000001
Fabrication	2020-12-11	2	1	0	2	0.5942000000000001
Pixels Guide to Staying Dead	2020-07-20	1	1	0	1	0.5942000000000001
Noms the Fish	2020-04-20	2	1	0	2	0.5942000000000001
Alpha Command	2020-08-14	1	1	0	1	0.5942000000000001
Gravinoid	2020-02-20	1	1	0	1	0.5942000000000001
圣山ShenShan	2020-11-02	1	1	0	1	0.5942000000000001
重生轮回	2020-12-14	1	1	0	1	0.5942000000000001
Tiktalec And The Dino Moonbase	2020-04-17	1	1	0	1	0.5942000000000001
Couch Storm: Battle Royale	2020-01-28	1	1	0	1	0.5942000000000001
Sharpshooter Plus	2020-02-28	2	1	0	2	0.5942000000000001
Furries & Scalies: Friendswood	2020-01-31	1	1	0	1	0.5942000000000001
荒凉城市	2020-08-11	2	1	0	2	0.5942000000000001
Last Man	2020-05-15	1	1	0	1	0.5942000000000001
What's Left	2020-01-06	2	1	0	2	0.5942000000000001
10 Second Shuriken	2020-04-29	2	1	0	2	0.5942000000000001
Ealu	2020-12-04	2	1	0	2	0.5942000000000001
West-Ward	2020-08-11	2	1	0	2	0.5942000000000001
Final Frontier	2020-02-17	1	1	0	1	0.5942000000000001
Firezone	2020-02-06	1	1	0	1	0.5942000000000001
Savage	2020-01-01	1	1	0	1	0.5942000000000001
Power Struggle	2020-02-03	2	1	0	2	0.5942000000000001
SULVER'S JOURNEY	2020-11-10	1	1	0	1	0.5942000000000001
Tile Conqueror	2020-02-04	2	1	0	2	0.5942000000000001
ギャルモンフォークロア～ 女の子モンスターがいっぱい! ～	2020-06-25	1	1	0	1	0.5942000000000001
Legendary Arcane 2 Universe	2020-03-13	1	1	0	1	0.5942000000000001
Ray Versus	2020-01-03	4	1	0	4	0.5942000000000001
Dungeon Chest	2020-07-01	1	1	0	1	0.5942000000000001
Mr Jorries!	2020-08-21	1	1	0	1	0.5942000000000001
Plunkocity	2020-06-22	1	1	0	1	0.5942000000000001
Cytoclash	2020-11-06	1	1	0	1	0.5942000000000001
Survived	2020-10-05	2	1	0	2	0.5942000000000001
Hovershift	2020-03-16	1	1	0	1	0.5942000000000001
Bangers & Mash	2020-10-09	2	1	0	2	0.5942000000000001
SoulfulLand	2020-01-17	1	1	0	1	0.5942000000000001
Cursed Pagoda	2020-02-26	1	1	0	1	0.5942000000000001
Kamodo Steve: Janitor on Fire!	2020-07-20	2	1	0	2	0.5942000000000001
FOOD FACTORY VR	2020-04-23	2	1	0	2	0.5942000000000001
Hero Soul: I Want to be a Hero!	2020-11-16	2	1	0	2	0.5942000000000001
Memory	2020-04-29	3	1	0	3	0.5942000000000001
March Of Soldiers	2020-07-01	1	1	0	1	0.5942000000000001
Galactic Asteroids Patrol	2020-01-15	2	1	0	2	0.5942000000000001
Cube Smash	2020-01-28	1	1	0	1	0.5942000000000001
乔乔的铁拳 Joe's Fists	2020-04-28	1	1	0	1	0.5942000000000001
love the game	2020-04-10	2	1	0	2	0.5942000000000001
Brawl Hopper	2020-01-01	1	1	0	1	0.5942000000000001
C.Y.S.M.A.	2020-01-26	1	1	0	1	0.5942000000000001
Talshard	2020-02-05	1	1	0	1	0.5942000000000001
Tranject	2020-01-01	1	1	0	1	0.5942000000000001
The inside of a drawer	2020-01-28	1	1	0	1	0.5942000000000001
My Adventure	2020-04-17	2	1	0	2	0.5942000000000001
Mission:Amazing	2020-01-02	2	1	0	2	0.5942000000000001
Ephemera	2020-07-10	2	1	0	2	0.5942000000000001
Legend of Streets	2020-01-18	1	1	0	1	0.5942000000000001
Trantor the Last Stormtrooper	2020-01-14	1	1	0	1	0.5942000000000001
Path of Zen	2020-01-20	2	1	0	2	0.5942000000000001
Cranky Cannon	2020-03-06	2	1	0	2	0.5942000000000001
Get the Banana	2020-01-27	1	1	0	1	0.5942000000000001
Our Journeys ~ A Collection of Visual Novels	2020-02-04	2	1	0	2	0.5942000000000001
Our Journeys 2 ~ A Collection of Visual Novels	2020-03-03	1	1	0	1	0.5942000000000001
L'Cestrue Seyuntres	2020-12-12	2	1	0	2	0.5942000000000001
Gjana's World	2020-01-20	2	1	0	2	0.5942000000000001
RETRO-PIXEL COLOR PALETTE: Color by Number	2020-01-23	3	1	0	3	0.5942000000000001
欢乐逗病毒	2020-01-22	1	1	0	1	0.5942000000000001
Pick, shoot, repeat!	2020-01-21	1	1	0	1	0.5942000000000001
Space Ranger VR	2020-02-25	4	1	0	4	0.5942000000000001
Cardsweeper	2020-02-03	1	1	0	1	0.5942000000000001
Recoil	2020-09-01	2	1	0	2	0.5942000000000001
KIWAYA	2020-02-22	2	1	0	2	0.5942000000000001
Super Arcade Boy in Goodbye Greenies	2020-02-21	1	1	0	1	0.5942000000000001
Humble Rumble	2020-01-27	4	1	0	4	0.5942000000000001
Escape From The Grim	2020-02-14	1	1	0	1	0.5942000000000001
Devastation - Annihilate the Alien Race	2020-02-06	3	1	0	3	0.5942000000000001
Synonym	2020-06-25	1	1	0	1	0.5942000000000001
Speed And Survive Ball, 速度与幸存之球	2020-02-11	2	1	0	2	0.5942000000000001
Yuhha: Stolen Treasure	2020-11-25	1	1	0	1	0.5942000000000001
Straight Battler VI	2020-02-06	2	1	0	2	0.5942000000000001
Freedom Isn't Free	2020-04-02	1	1	0	1	0.5942000000000001
Classic Card Game Go Fish	2020-01-27	1	1	0	1	0.5942000000000001
Classic Card Game Solitaire Mahjong	2020-01-27	4	1	0	4	0.5942000000000001
墨游记 Inkball adventures	2020-02-09	1	1	0	1	0.5942000000000001
CanCan the Game	2020-08-27	1	1	0	1	0.5942000000000001
Me and (My) Cat's Castle X	2020-02-21	1	1	0	1	0.5942000000000001
Crypt Of Shadows	2020-03-30	0	1	0	0	0.5942000000000001
Sudd City Adventures	2020-05-22	2	1	0	2	0.5942000000000001
Cube	2020-03-08	1	1	0	1	0.5942000000000001
降神战役 -A Story of the usurpers-	2020-03-10	3	1	0	3	0.5942000000000001
Fatal Wings	2020-03-05	1	1	0	1	0.5942000000000001
Pixel Pileup Party	2020-02-21	1	1	0	1	0.5942000000000001
The Adventures of Spunk Dodgers and Splat	2020-04-09	1	1	0	1	0.5942000000000001
Realm Hacker	2020-04-15	2	1	0	2	0.5942000000000001
Sunburnt	2020-02-28	1	1	0	1	0.5942000000000001
Super Toxicboy	2020-02-25	1	1	0	1	0.5942000000000001
Euler Wars	2020-02-29	1	1	0	1	0.5942000000000001
Archaid	2020-03-27	2	1	0	2	0.5942000000000001
Stanga	2020-03-17	1	1	0	1	0.5942000000000001
RATTUS	2020-03-04	3	1	0	3	0.5942000000000001
Magic Archers	2020-07-26	2	1	0	2	0.5942000000000001
Festoon	2020-07-29	4	1	0	4	0.5942000000000001
Summoners Mist	2020-03-06	2	1	0	2	0.5942000000000001
Vilundia	2020-03-06	2	1	0	2	0.5942000000000001
Escape of Mari: The Polar Ladybug	2020-03-13	2	1	0	2	0.5942000000000001
Super Astreus 2	2020-04-14	4	1	0	4	0.5942000000000001
Seconds in Space	2020-09-28	1	1	0	1	0.5942000000000001
Purple Saturn Day	2020-04-28	1	1	0	1	0.5942000000000001
Murders in Space	2020-05-12	1	1	0	1	0.5942000000000001
Marshmallow Tank	2020-04-16	9	1	0	9	0.5942000000000001
Doctor Klyvinski	2020-04-10	1	1	0	1	0.5942000000000001
Rushberry Mercs	2020-03-30	2	1	0	2	0.5942000000000001
Cork The Volcano	2020-03-31	25	1	0	25	0.5942000000000001
Abacus Finch	2020-03-31	2	1	0	2	0.5942000000000001
Swatch Out!	2020-03-31	2	1	0	2	0.5942000000000001
What's Inside??	2020-03-23	1	1	0	1	0.5942000000000001
iMemo	2020-03-26	1	1	0	1	0.5942000000000001
SpaceFoes	2020-04-12	2	1	0	2	0.5942000000000001
Pixel Fixer	2020-07-04	2	1	0	2	0.5942000000000001
HookSharks	2020-05-27	5	1	0	5	0.5942000000000001
Stealth Master	2020-04-02	2	1	0	2	0.5942000000000001
FotoMuseo 3D	2020-05-18	2	1	0	2	0.5942000000000001
Project Toon Tanks	2020-04-01	2	1	0	2	0.5942000000000001
Amber Time	2020-04-14	1	1	0	1	0.5942000000000001
Dodo Adventures	2020-08-14	1	1	0	1	0.5942000000000001
snake::reloaded	2020-04-06	1	1	0	1	0.5942000000000001
Elemental Defenders	2020-04-02	1	1	0	1	0.5942000000000001
Zango's Shark Adventure	2020-07-31	1	1	0	1	0.5942000000000001
Premier Manager 05/06	2020-07-10	4	1	0	4	0.5942000000000001
Aliens Love Beefs	2020-05-30	1	1	0	1	0.5942000000000001
Endless Savagery	2020-04-08	2	1	0	2	0.5942000000000001
Light: A Maze Game	2020-04-13	5	1	0	5	0.5942000000000001
fine DUST	2020-04-21	1	1	0	1	0.5942000000000001
Bud Masters	2020-04-19	3	1	0	3	0.5942000000000001
Be Coronavirus	2020-04-21	1	1	0	1	0.5942000000000001
Space War Machine	2020-05-11	2	1	0	2	0.5942000000000001
Traffic Storm	2020-05-12	1	1	0	1	0.5942000000000001
Cyber Quest 2077	2020-04-10	1	1	0	1	0.5942000000000001
Polarities	2020-05-08	2	1	0	2	0.5942000000000001
Hunter of the Disowned	2020-07-17	1	1	0	1	0.5942000000000001
Center2048	2020-05-13	1	1	0	1	0.5942000000000001
SpinZap	2020-05-01	2	1	0	2	0.5942000000000001
Advanced creator of labyrinths	2020-04-22	1	1	0	1	0.5942000000000001
Puzzle Dungeon	2020-07-01	1	1	0	1	0.5942000000000001
漏气宝大冒险 Balloon Man Adventure	2020-05-04	1	1	0	1	0.5942000000000001
Alien Harvest Leader	2020-11-12	1	1	0	1	0.5942000000000001
Hentai Stories - Elven	2020-07-06	1	1	0	1	0.5942000000000001
The Worlds Most Impossible Game	2020-07-20	1	1	0	1	0.5942000000000001
Dwarf Slayer	2020-08-09	2	1	0	2	0.5942000000000001
Business Shark	2020-08-01	1	1	0	1	0.5942000000000001
Squares	2020-05-19	1	1	0	1	0.5942000000000001
PhaseWorm	2020-05-04	2	1	0	2	0.5942000000000001
Centauri Dominion	2020-05-30	1	1	0	1	0.5942000000000001
Extreme Social Distancing	2020-05-18	2	1	0	2	0.5942000000000001
The Ancient Lands	2020-05-11	1	1	0	1	0.5942000000000001
Robot Builder War	2020-06-20	1	1	0	1	0.5942000000000001
Neon Beat Rider	2020-05-25	2	1	0	2	0.5942000000000001
Sound Science	2020-05-13	1	1	0	1	0.5942000000000001
Underdog Arena	2020-06-26	1	1	0	1	0.5942000000000001
Naturalealia	2020-05-22	1	1	0	1	0.5942000000000001
Plato Shoot	2020-09-30	2	1	0	2	0.5942000000000001
Timequest	2020-11-06	1	1	0	1	0.5942000000000001
Dam Busters	2020-08-10	1	1	0	1	0.5942000000000001
Buck Bradley Comic Adventure 2	2020-07-20	2	1	0	2	0.5942000000000001
Isolation Story	2020-10-27	1	1	0	1	0.5942000000000001
NicoNotes The Whoo	2020-05-29	1	1	0	1	0.5942000000000001
Les Manley in: Lost in L.A.	2020-11-06	1	1	0	1	0.5942000000000001
Song of sheep gathering in Philia	2020-05-13	2	1	0	2	0.5942000000000001
My Personal World	2020-05-26	1	1	0	1	0.5942000000000001
Knight's Destiny	2020-06-12	1	1	0	1	0.5942000000000001
Breakout Planet	2020-05-28	1	1	0	1	0.5942000000000001
Saiku's Endless Labyrinth	2020-05-12	2	1	0	2	0.5942000000000001
Small Ball	2020-05-21	1	1	0	1	0.5942000000000001
Ungeon	2020-10-30	2	1	0	2	0.5942000000000001
Rachael Savage	2020-08-17	2	1	0	2	0.5942000000000001
Freelance Trucker: Insurance Fraud Edition	2020-11-19	1	1	0	1	0.5942000000000001
Way of Heroes	2020-09-08	2	1	0	2	0.5942000000000001
The Sight in a mirror	2020-05-31	1	1	0	1	0.5942000000000001
动绘（Drawing）	2020-09-05	2	1	0	2	0.5942000000000001
Arena Experiment	2020-06-12	1	1	0	1	0.5942000000000001
Rubikingdom	2020-12-23	2	1	0	2	0.5942000000000001
My UnReal pet	2020-07-17	1	1	0	1	0.5942000000000001
The Train: Escape to Normandy	2020-08-07	1	1	0	1	0.5942000000000001
Outlast	2020-06-17	2	1	0	2	0.5942000000000001
MonsterTerritory	2020-05-27	2	1	0	2	0.5942000000000001
Dark Heart Mansion	2020-06-07	2	1	0	2	0.5942000000000001
Captain Prosper	2020-06-13	1	1	0	1	0.5942000000000001
Chess of Chains	2020-07-15	2	1	0	2	0.5942000000000001
Lost Ed	2020-06-23	2	1	0	2	0.5942000000000001
Trazz	2020-09-07	2	1	0	2	0.5942000000000001
Roopit and Boopit	2020-06-16	2	1	0	2	0.5942000000000001
Trident	2020-06-22	2	1	0	2	0.5942000000000001
Kill The Humans	2020-07-06	1	1	0	1	0.5942000000000001
Foxy's Adventure	2020-06-16	2	1	0	2	0.5942000000000001
Combat Mech VR	2020-08-25	1	1	0	1	0.5942000000000001
Novellus VR Carnival	2020-08-31	1	1	0	1	0.5942000000000001
Kwarn Armada Tactics	2020-08-21	1	1	0	1	0.5942000000000001
Matrix Blocks	2020-06-18	1	1	0	1	0.5942000000000001
Hop Skip Jump	2020-07-28	3	1	0	3	0.5942000000000001
Dungeon Scale	2020-07-21	4	1	0	4	0.5942000000000001
Slimey Champions	2020-06-17	58	1	0	58	0.5942000000000001
Wreck the Insects	2020-06-22	2	1	0	2	0.5942000000000001
Steel Thunder	2020-09-04	2	1	0	2	0.5942000000000001
Bugz!	2020-06-23	1	1	0	1	0.5942000000000001
Duality of Doodles	2020-08-14	1	1	0	1	0.5942000000000001
Life of Food	2020-07-10	2	1	0	2	0.5942000000000001
Karakia Shooter	2020-06-30	1	1	0	1	0.5942000000000001
Night Rogue	2020-07-17	1	1	0	1	0.5942000000000001
Shuffs	2020-06-29	1	1	0	1	0.5942000000000001
Beaver Fun™ River Run - Steam Edition	2020-06-26	1	1	0	1	0.5942000000000001
Impossible Target	2020-07-01	1	1	0	1	0.5942000000000001
Default Unreal Physics and Assets AKA DUPA Project	2020-11-11	1	1	0	1	0.5942000000000001
The first titans	2020-09-09	1	1	0	1	0.5942000000000001
Mini Army Tactics Medieval	2020-07-10	3	1	0	3	0.5942000000000001
Really Bad Flying Machine	2020-07-27	3	1	0	3	0.5942000000000001
DNA Farm	2020-07-31	1	1	0	1	0.5942000000000001
Aenaon	2020-07-26	1	1	0	1	0.5942000000000001
Doctor Lee	2020-08-05	1	1	0	1	0.5942000000000001
Exp Parasite	2020-09-16	1	1	0	1	0.5942000000000001
War War	2020-08-07	2	1	0	2	0.5942000000000001
Gravity SQUARE	2020-07-30	2	1	0	2	0.5942000000000001
Fairy Bubble	2020-08-12	1	1	0	1	0.5942000000000001
Strange Lands	2020-07-25	1	1	0	1	0.5942000000000001
推箱子(Push Box)	2020-08-10	1	1	0	1	0.5942000000000001
游戏而已	2020-10-19	1	1	0	1	0.5942000000000001
Input Out	2020-10-19	2	1	0	2	0.5942000000000001
pop and well	2020-07-23	2	1	0	2	0.5942000000000001
Atria Valkyrie	2020-10-01	1	1	0	1	0.5942000000000001
She Salutes	2020-07-30	2	1	0	2	0.5942000000000001
Secret Agent Allan Martin in ... Phoenix Erupting	2020-11-03	1	1	0	1	0.5942000000000001
Rogue Randy	2020-08-04	1	1	0	1	0.5942000000000001
AnotherOne	2020-11-25	2	1	0	2	0.5942000000000001
The Maze Escaper	2020-08-03	1	1	0	1	0.5942000000000001
Star Rover	2020-09-23	1	1	0	1	0.5942000000000001
VR Time Machine Travelling in history: Medieval Castle, Fort, and Village Life in 1071-1453 Europe	2020-07-31	2	1	0	2	0.5942000000000001
86	2020-09-03	2	1	0	2	0.5942000000000001
Mecha Destruction	2020-08-12	1	1	0	1	0.5942000000000001
Insane Creations	2020-09-04	1	1	0	1	0.5942000000000001
CounterBlocks	2020-10-21	1	1	0	1	0.5942000000000001
Poly Pirates	2020-09-07	2	1	0	2	0.5942000000000001
Zero Wrath Vendetta	2020-08-07	1	1	0	1	0.5942000000000001
Treasures of the Roman Empire	2020-09-01	1	1	0	1	0.5942000000000001
Splinter	2020-08-21	1	1	0	1	0.5942000000000001
World War Academy	2020-12-10	3	1	0	3	0.5942000000000001
Space Crisis	2020-08-14	2	1	0	2	0.5942000000000001
Jungles of Maxtheria	2020-10-15	1	1	0	1	0.5942000000000001
SkeleToon:forgotten memories	2020-08-25	2	1	0	2	0.5942000000000001
Waste X	2020-09-11	1	1	0	1	0.5942000000000001
Ninja Kunoichi	2020-09-04	2	1	0	2	0.5942000000000001
MagicalGirl Mimi	2020-08-20	2	1	0	2	0.5942000000000001
 雨漏り人生 - Rain Leak Life	2020-10-02	1	1	0	1	0.5942000000000001
Marbles: Razor's Wrath	2020-10-26	2	1	0	2	0.5942000000000001
Asteroad	2020-11-02	2	1	0	2	0.5942000000000001
Astero	2020-08-28	2	1	0	2	0.5942000000000001
Sushi Slammers	2020-08-27	2	1	0	2	0.5942000000000001
Corona Sector	2020-09-01	1	1	0	1	0.5942000000000001
Road Home	2020-11-10	2	1	0	2	0.5942000000000001
Seeking revenge	2020-10-18	1	1	0	1	0.5942000000000001
Ice star Chapter 2	2020-08-28	1	1	0	1	0.5942000000000001
サブリミナルレジオン	2020-12-31	1	1	0	1	0.5942000000000001
BlockBustersVR	2020-10-13	2	1	0	2	0.5942000000000001
Glory	2020-09-02	2	1	0	2	0.5942000000000001
The mouse and the cheese	2020-10-16	1	1	0	1	0.5942000000000001
Square vs Triangles	2020-10-21	1	1	0	1	0.5942000000000001
One Night on Halloween	2020-10-29	2	1	0	2	0.5942000000000001
Crônicas de Landulph	2020-09-28	1	1	0	1	0.5942000000000001
Lost	2020-10-13	1	1	0	1	0.5942000000000001
This Is Not Chess	2020-10-21	1	1	0	1	0.5942000000000001
Dark Dealings	2020-11-05	2	1	0	2	0.5942000000000001
Dung Beetle Strike	2020-10-13	2	1	0	2	0.5942000000000001
Archery Arena	2020-12-29	3	1	0	3	0.5942000000000001
Hogogeist	2020-10-07	1	1	0	1	0.5942000000000001
Planet Blood	2020-11-26	4	1	0	4	0.5942000000000001
Space Debris	2020-11-17	3	1	0	3	0.5942000000000001
Hentai Babes - Aqua	2020-10-02	1	1	0	1	0.5942000000000001
Gummy Bear Mafia	2020-09-22	1	1	0	1	0.5942000000000001
Run Die Jump	2020-10-05	3	1	0	3	0.5942000000000001
TECHPACK	2020-09-25	1	1	0	1	0.5942000000000001
Lone Archer	2020-10-16	2	1	0	2	0.5942000000000001
Knightmare	2020-11-27	1	1	0	1	0.5942000000000001
Don't Miss The King	2020-10-09	1	1	0	1	0.5942000000000001
Grilled	2020-11-12	1	1	0	1	0.5942000000000001
The Storm	2020-09-30	1	1	0	1	0.5942000000000001
109 Remastered	2020-11-05	1	1	0	1	0.5942000000000001
Little Big Monsters	2020-10-22	1	1	0	1	0.5942000000000001
JumpJumpBall	2020-09-26	2	1	0	2	0.5942000000000001
Hunt the Lights	2020-10-27	2	1	0	2	0.5942000000000001
Synth Swinger	2020-10-05	3	1	0	3	0.5942000000000001
Flicker	2020-09-16	1	1	0	1	0.5942000000000001
Random(platformer)	2020-10-13	2	1	0	2	0.5942000000000001
Car Jump	2020-10-07	2	1	0	2	0.5942000000000001
MAYOR MADNESS	2020-10-22	2	1	0	2	0.5942000000000001
Attack from Planet Smiley	2020-11-01	1	1	0	1	0.5942000000000001
Rhythm 'n Bullets	2020-11-09	1	1	0	1	0.5942000000000001
Chandrayaan VR	2020-12-29	1	1	0	1	0.5942000000000001
Mythos Ever After: A Cthulhu Dating Sim	2020-10-28	1	1	0	1	0.5942000000000001
Timeline Traveler II: Dream	2020-10-29	2	1	0	2	0.5942000000000001
Dragu's Puzzle Adventure	2020-10-21	1	1	0	1	0.5942000000000001
Zeltrus	2020-11-12	2	1	0	2	0.5942000000000001
Troy: The malware fight	2020-11-26	2	1	0	2	0.5942000000000001
Keep Wall	2020-11-15	4	1	0	4	0.5942000000000001
Burn The Witch	2020-12-28	3	1	0	3	0.5942000000000001
ChronoTecture: The Eprologue	2020-12-11	2	1	0	2	0.5942000000000001
Dubbing Time	2020-11-17	1	1	0	1	0.5942000000000001
依澪	2020-11-10	1	1	0	1	0.5942000000000001
Spacebug	2020-12-06	1	1	0	1	0.5942000000000001
nuri VR - Coding	2020-11-02	1	1	0	1	0.5942000000000001
Crazy Rabbit AntiLogic	2020-11-10	2	1	0	2	0.5942000000000001
Dark Blocks	2020-11-12	1	1	0	1	0.5942000000000001
Void Encounter	2020-11-23	3	1	0	3	0.5942000000000001
Taiwan Richman	2020-11-20	3	1	0	3	0.5942000000000001
Dimensions	2020-12-17	3	1	0	3	0.5942000000000001
Mahjong Worlds	2020-12-02	2	1	0	2	0.5942000000000001
BringIT to MOM	2020-11-11	1	1	0	1	0.5942000000000001
Stress Random	2020-11-25	1	1	0	1	0.5942000000000001
Christmas Rhythm	2020-11-10	1	1	0	1	0.5942000000000001
Game Dev Company	2020-11-17	3	1	0	3	0.5942000000000001
Cubiya	2020-12-21	1	1	0	1	0.5942000000000001
Be : Twin	2020-11-17	3	1	0	3	0.5942000000000001
Kilemol	2020-11-27	1	1	0	1	0.5942000000000001
Flippen Run Mike	2020-11-15	1	1	0	1	0.5942000000000001
The Prologue to a Dream of Home	2020-11-21	1	1	0	1	0.5942000000000001
Big Cat Rescue	2020-11-18	1	1	0	1	0.5942000000000001
Tetrogue Dragons	2020-11-26	2	1	0	2	0.5942000000000001
月下にて舞う	2020-12-07	2	1	0	2	0.5942000000000001
The Guardians of Peace	2020-12-21	2	1	0	2	0.5942000000000001
Angry Fugu	2020-11-24	3	1	0	3	0.5942000000000001
Seiso Master KEN	2020-12-24	2	1	0	2	0.5942000000000001
Space Sprinter VR	2020-12-17	1	1	0	1	0.5942000000000001
Monstrous Molecules	2020-12-21	1	1	0	1	0.5942000000000001
The Garden of Orilon	2020-12-09	2	1	0	2	0.5942000000000001
VR Brewing Simulator	2020-12-24	2	1	0	2	0.5942000000000001
Four Course Combat	2020-12-25	1	1	0	1	0.5942000000000001
MAP GAME: Or Something	2020-12-25	2	1	0	2	0.5942000000000001
LoopWorlds	2020-12-31	1	1	0	1	0.5942000000000001
Sokoban Gianta	2020-12-29	2	1	0	2	0.5942000000000001
Lockdown	2020-05-15	9	20	11	20	0.594
The Old House	2020-09-10	7	68	41	48	0.5938
Project Amalthea: Battlegrounds	2020-10-12	61	41	24	85	0.5937
Asteroid Fight	2020-04-10	88	15	8	96	0.5937
Alisa Quest	2020-11-24	6	15	8	14	0.5937
Pieces of Me: Northbound	2020-01-09	4	15	8	12	0.5937
My Universe - Cooking Star Restaurant	2020-11-10	9	15	8	17	0.5937
Education	2020-04-23	6	60	36	42	0.5935
Moonlight Mansion	2020-03-16	9	28	16	25	0.593
Farm Day 2021	2020-11-11	7	28	16	23	0.593
Corrupted Hospital : Summoner Part1	2020-10-23	5	44	26	31	0.5929
Follia - Dear father	2020-04-29	57	102	63	120	0.5928
Ray's The Dead	2020-10-22	19	36	21	40	0.5928
P.A.M.E.L.A.	2020-06-18	175	529	344	519	0.5922
R.B.I. Baseball 20	2020-03-17	134	200	127	261	0.5921000000000001
Leap of Champions	2020-02-02	12	23	13	25	0.5921000000000001
Excalibots	2020-07-12	12	23	13	25	0.5921000000000001
Untitled Space Game	2020-11-16	26	23	13	39	0.5921000000000001
ROMANCE OF THE THREE KINGDOMS XIV	2020-01-16	16482	7766	5229	21711	0.5920000000000001
The beasts of 9500	2020-05-29	418	355	229	647	0.5920000000000001
Island of Deception	2020-04-01	117	100	62	179	0.5920000000000001
Respublica	2020-07-04	43	135	85	128	0.5913
RUN HARE RUN	2020-04-24	117	18	10	127	0.5910000000000001
黄昏印记	2020-02-26	15	18	10	25	0.5910000000000001
AeternoBlade	2020-09-07	7	18	10	17	0.5910000000000001
Grimm & Tonic	2020-01-31	4	26	15	19	0.5906
Luna : The Dimemsion Watcher	2020-06-05	78	26	15	93	0.5906
FirstQueen1 NEXT	2020-06-03	14	26	15	29	0.5906
Design girl team	2020-05-21	7	26	15	22	0.5906
Babel 最后的夜晚	2020-12-03	11	26	15	26	0.5906
Immanence	2020-01-22	19	62	38	57	0.5901
Ostrofa	2020-02-05	56	48	29	85	0.5901
PowersVR	2020-10-10	7	37	22	29	0.5901
Snowballer	2020-10-09	45	13	7	52	0.59
Coin Pickers	2020-01-05	3	13	7	10	0.59
Rule the Rail!	2020-02-17	6	13	7	13	0.59
Divine Stone	2020-11-18	3	13	7	10	0.59
N.I.C.E. 2	2020-04-02	4	8	4	8	0.5897
Will: The Beginning	2020-04-21	3	8	4	7	0.5897
Knight Dice	2020-11-04	4	8	4	8	0.5897
Battle Bandits	2020-02-25	3	8	4	7	0.5897
Mazovian Adventure	2020-02-05	3	8	4	7	0.5897
King of Vikings	2020-03-01	2	8	4	6	0.5897
Choco Pixel 3	2020-03-06	2	8	4	6	0.5897
Woman's body: For adults 3	2020-04-08	2	8	4	6	0.5897
PiLKO	2020-05-01	2	8	4	6	0.5897
Flowers Garden Solitaire	2020-06-16	3	8	4	7	0.5897
VR Astronomy and Geography Lab (Universe Spacecraft, Solar System, Earth, Moon, Relativity, Flying over the World, etc)	2020-06-28	3	8	4	7	0.5897
Birthright	2020-10-22	3	8	4	7	0.5897
Cube Raiders	2020-10-30	3	8	4	7	0.5897
Enthrean Radiance : Prologue	2020-10-29	3	8	4	7	0.5897
The Pillar	2020-06-10	7	29	17	24	0.5895
Werewolf Voice - Best Board Game	2020-05-07	130	29	17	147	0.5895
3D Hentai Blackjack	2020-03-25	6	29	17	23	0.5895
Arctic Anxiety	2020-07-02	40	164	105	145	0.5893
Pangea Survival	2020-08-21	23	54	33	56	0.5893
Miku	2020-04-10	3	21	12	15	0.5892000000000001
Off The Chains Disc Golf	2020-11-12	8	21	12	20	0.5892000000000001
雀魂麻将(MahjongSoul)	2020-07-15	35277	23628	16256	51533	0.5886
Wurm Online	2020-07-24	1371	1018	681	2052	0.5886
Heavenworld	2020-04-14	69	142	91	160	0.5883
Hijacker Jack	2020-12-07	20	35	21	41	0.588
Beneath steel clouds	2020-01-10	52	125	80	132	0.5877
Icarus Online	2020-03-12	206	137	88	294	0.5876
Cathedral 3-D	2020-10-28	13	55	34	47	0.5875
World End Echo	2020-08-01	12	16	9	21	0.5875
VERGJORN	2020-06-25	6	16	9	15	0.5875
H-Hour: World's Elite	2020-02-17	302	648	433	735	0.5872999999999999
Failspace	2020-01-23	31	27	16	47	0.5870000000000001
Draft Day Sports: Pro Basketball 2021	2020-11-19	58	27	16	74	0.5870000000000001
Fault: Elder Orb	2020-07-17	4369	2418	1648	6017	0.5869
BMX The Game	2020-08-28	112	350	232	344	0.5865
Immortal Legacy: The Jade Cipher	2020-05-21	33	47	29	62	0.5864
Food Chain	2020-09-03	69	47	29	98	0.5864
Summer Games Heroes	2020-01-04	13	30	18	31	0.5863
AChat	2020-04-04	101	330	219	320	0.5860000000000001
Somewhere: Sect of Relic	2020-05-05	3	19	11	14	0.5859000000000001
Elliot and the Musical Journey	2020-05-15	5	19	11	16	0.5859000000000001
Defense high	2020-04-17	6	19	11	17	0.5859000000000001
Yandere Escape	2020-02-28	8	56	35	43	0.5858
NOVA 1492	2020-01-14	21	33	20	41	0.5857
Sokpop S08: Lairchitect	2020-07-08	7	33	20	27	0.5857
Brass Town Wrestling	2020-01-30	3	11	6	9	0.5855
Pyrax	2020-03-01	4	11	6	10	0.5855
VasterClaws 3:Dragon slayer of the God world	2020-03-19	21	11	6	27	0.5855
Spacen: The Beginning	2020-04-10	3	11	6	9	0.5855
MiNNaDe Counter Fight	2020-05-01	8	11	6	14	0.5855
VR Immersive Fitness Gym (Cycling, marathon, football, yoga etc)	2020-06-04	3	11	6	9	0.5855
Commander '85 Prologue	2020-07-16	7	11	6	13	0.5855
Beach Love Shop	2020-07-29	4	11	6	10	0.5855
Business Simulator	2020-09-30	4	11	6	10	0.5855
Gallic Wars: Battle Simulator Prologue	2020-10-16	9	11	6	15	0.5855
despatch: Entity Astray	2020-11-13	3	11	6	9	0.5855
Hentai I'm coming!	2020-04-09	6	68	43	49	0.5854
Space Station Manager	2020-04-06	16	36	22	38	0.5853
零怨 The curse of the dead	2020-02-05	8	22	13	21	0.5849000000000001
Synthesis: Mind, Body and Soul	2020-02-15	21	22	13	34	0.5849000000000001
Little Bunny	2020-05-16	4	22	13	17	0.5849000000000001
The Bluecoats: North & South	2020-11-05	13	60	38	51	0.5841
AGOS - A Game Of Space	2020-10-28	30	57	36	66	0.5841
Dunrog	2020-10-01	18	25	15	33	0.5841
이 AI를 복구해주세요.	2020-07-11	22	25	15	37	0.5841
Crowded Blue Dot	2020-09-11	77	31	19	96	0.5833
Snake-a-roni	2020-05-15	4	14	8	12	0.5833
DAHALO	2020-03-17	3	14	8	11	0.5833
VNHL 2022	2020-01-04	6	14	8	14	0.5833
Battlecraft	2020-02-10	8	14	8	16	0.5833
东方鬼神玉	2020-05-17	7	14	8	15	0.5833
Johann Weiss	2020-05-22	3	14	8	11	0.5833
Airborne: Trials	2020-12-27	5	6	3	8	0.5833
Shield Shock	2020-03-20	2	6	3	5	0.5833
Westminster Darkly	2020-08-01	5	6	3	8	0.5833
Hassle 1977	2020-11-03	4	6	3	7	0.5833
You Are A Bird	2020-03-06	3	6	3	6	0.5833
Introvert	2020-02-17	2	6	3	5	0.5833
Ohayou! Beginner's Japanese	2020-04-21	2	6	3	5	0.5833
Demelia's Isle	2020-10-09	6	6	3	9	0.5833
Biscuitts	2020-08-05	3	6	3	6	0.5833
The Zone	2020-06-26	4	6	3	7	0.5833
The Hilltop Mansion	2020-05-27	3	6	3	6	0.5833
Flain - Tao force & Cubes	2020-06-02	2	6	3	5	0.5833
Dört Model Müzesi	2020-12-28	2	6	3	5	0.5833
Hero or Villain: Battle Royale	2020-09-16	21	6	3	24	0.5833
卡牌游戏	2020-07-15	7	6	3	10	0.5833
The Luminous Underground	2020-12-17	19	6	3	22	0.5833
Gryphon Knight Epic: Definitive Edition	2020-08-20	2	6	3	5	0.5833
Death: The Ascension	2020-10-20	3	6	3	6	0.5833
Cosmic Disco	2020-12-27	3	6	3	6	0.5833
Invaders	2020-08-25	2	6	3	5	0.5833
Dispersion	2020-08-21	3	6	3	6	0.5833
のっぺらぼう	2020-09-18	6	6	3	9	0.5833
Way Walkers: University	2020-10-22	18	6	3	21	0.5833
天仙变	2020-10-30	5	6	3	8	0.5833
Splash	2020-11-02	2	6	3	5	0.5833
SPACE Craft	2020-11-17	2	6	3	5	0.5833
Connected Towers	2020-12-28	2	6	3	5	0.5833
Planet Station	2020-09-25	5	34	21	26	0.583
Weed Farmer Simulator	2020-03-16	32	116	76	108	0.5828
三国志天下布武 Rise of Three Kingdoms	2020-12-11	49	61	39	88	0.5826
The Feud: Wild West Tactics	2020-07-22	49	58	37	86	0.5826
Hypnolab VR	2020-08-28	21	46	29	50	0.5826
Heroic Armored Company	2020-08-20	13	101	66	79	0.5824
Krum - Battle Arena	2020-06-30	12	17	10	22	0.5821000000000001
Hard Night VR	2020-07-04	4	17	10	14	0.5821000000000001
Strip Black Jack - Hot Gym	2020-07-02	6	17	10	16	0.5821000000000001
Battle Village	2020-08-11	3	17	10	13	0.5821000000000001
Abyss The Forgotten Past: Prologue	2020-12-04	111	74	48	159	0.5815
Infectious	2020-08-20	13	23	14	27	0.5809000000000001
Disease -Hidden Object-	2020-08-26	10	23	14	24	0.5809000000000001
王者神域	2020-09-02	24	23	14	38	0.5809000000000001
Gala Collider	2020-01-16	20	26	16	36	0.5807
Hentai Dates	2020-12-21	4	26	16	20	0.5807
HENTAI HORROR: The Eight Pictures	2020-02-03	7	138	92	99	0.5806
Amarok Dreams	2020-10-06	18	44	28	46	0.5806
Sexena: Arena Tales	2020-11-25	182	78	51	233	0.5805
Alice | 愛莉澄【DEMO】	2020-06-26	12	41	26	38	0.5805
Graffiti Bombing	2020-08-29	17	32	20	37	0.5805
ACT	2020-12-27	12	32	20	32	0.5805
Disobedient Sheep	2020-04-21	6	9	5	11	0.5796
Void Of Heroes	2020-11-03	5	9	5	10	0.5796
Iron Blood VR	2020-04-04	7	9	5	12	0.5796
Start! Heart Thief！	2020-05-01	5	9	5	10	0.5796
A Story In Space	2020-08-20	2	9	5	7	0.5796
Brain Test	2020-08-03	6	9	5	11	0.5796
The Evil in the Forest	2020-12-22	3	9	5	8	0.5796
サチ江-死道-	2020-08-29	18	9	5	23	0.5796
Pax Nova	2020-04-28	201	230	157	358	0.5786
The Fallen	2020-03-04	19	45	29	48	0.5786
九霄缳神记	2020-04-15	296	284	195	491	0.5784
Tower! 3D	2020-07-31	12	39	25	37	0.5782
Spaceteam VR	2020-05-21	17	12	7	24	0.5782
Anomaly Hunter - Prologue	2020-08-20	12	12	7	19	0.5782
Neko Jump	2020-05-22	5	12	7	12	0.5782
Самозванец	2020-02-20	3	12	7	10	0.5782
Sweet Thomas	2020-01-16	6	12	7	13	0.5782
TWELVE CONTAINERS	2020-06-30	8	12	7	15	0.5782
The Escape from Bungalow	2020-07-11	3	12	7	10	0.5782
Truck Life	2020-08-06	206	870	610	816	0.5781000000000001
VR Jurrasic Escape	2020-12-08	4	33	21	25	0.5779
War Room	2020-11-18	200	313	216	416	0.5778
Isles of Pangaea	2020-09-20	5	30	19	24	0.5777
Remothered: Broken Porcelain 	2020-10-13	246	433	301	547	0.5776
Blackstone Academy for the Magical Arts	2020-04-09	50	15	9	59	0.5776
Hentai Jazz	2020-07-22	4	15	9	13	0.5776
Ray Eager	2020-04-12	32	27	17	49	0.5775
The Change Architect	2020-11-25	9	27	17	26	0.5775
Das Balkonzimmer	2020-12-02	4	27	17	21	0.5775
Grimtale Island	2020-11-26	5	24	15	20	0.5774
Code of Princess EX	2020-10-02	18	24	15	33	0.5774
Rune the First Wanderer	2020-06-17	22	21	13	35	0.5773
Personality Dating Sim	2020-06-19	5	21	13	18	0.5773
Waifu Breaker	2020-06-05	7	18	11	18	0.5773
Infected zone	2020-08-18	9	18	11	20	0.5773
Out of Reach: Treasure Royale	2020-10-14	129	282	195	324	0.5770000000000001
MadGuns	2020-07-03	25	266	184	209	0.5766
KATANA KAMI: A Way of the Samurai Story 	2020-02-20	941	193	133	1074	0.5759000000000001
Tamarin	2020-09-10	32	66	44	76	0.5758
Hentai Girlfriend Simulator	2020-01-31	3	53	35	38	0.5758
BeachHead 2020	2020-12-15	9	37	24	33	0.5758
TeamJumpers	2020-06-09	9	31	20	29	0.5750000000000001
DANGER! Escape Lab	2020-12-15	73	31	20	93	0.5750000000000001
Sex Apartments	2020-02-22	5	28	18	23	0.5746
I'mitation The Eight Suicide Note	2020-04-19	23	54	36	59	0.5743
Sokpop S09: Flipper Volcano	2020-09-15	24	25	16	40	0.5740999999999999
Hybrid Beasts	2020-10-08	3	4	2	5	0.5739
Store Crasher	2020-04-22	2	4	2	4	0.5739
MOTION	2020-03-13	2	4	2	4	0.5739
Onslaught: Armoured Assault	2020-02-16	3	4	2	5	0.5739
Scooter Delivery VR	2020-06-23	1	4	2	3	0.5739
Combat Helicopter - Surgical Strike PC/VR	2020-08-12	2	4	2	4	0.5739
The Pointless Car Chase	2020-02-20	2	4	2	4	0.5739
Power Stealers	2020-01-28	2	4	2	4	0.5739
Shadows of Larth	2020-02-19	3	4	2	5	0.5739
Heroes Swipe Right	2020-03-20	3	4	2	5	0.5739
Sword and Adventurer	2020-05-15	3	4	2	5	0.5739
PixHunter	2020-01-05	2	4	2	4	0.5739
COWBOY YAKUZA	2020-02-18	6	4	2	8	0.5739
Fly Fly Tank	2020-03-30	4	4	2	6	0.5739
Election simulator	2020-01-09	2	4	2	4	0.5739
FLYING SHOT	2020-01-28	3	4	2	5	0.5739
FireTry	2020-01-09	2	4	2	4	0.5739
Hentai Babes - Servants	2020-03-02	2	4	2	4	0.5739
Genius!	2020-03-18	11	4	2	13	0.5739
Somny & Yawn: Dream Detectives	2020-03-13	6	4	2	8	0.5739
Topang	2020-03-17	2	4	2	4	0.5739
Arc Defence	2020-06-26	2	4	2	4	0.5739
Panzer Crew VR	2020-07-27	7	4	2	9	0.5739
Premier Manager 09	2020-06-19	5	4	2	7	0.5739
Dry Grass	2020-04-09	6	4	2	8	0.5739
Kane's Shadow	2020-04-23	2	4	2	4	0.5739
Toilet Paper Crisis Simulator 2020	2020-05-18	1	4	2	3	0.5739
Tower of God	2020-04-13	6	4	2	8	0.5739
PLOID SAGA	2020-06-25	2	4	2	4	0.5739
The Odd Neon Void	2020-04-21	2	4	2	4	0.5739
The Employee	2020-05-27	2	4	2	4	0.5739
World of FUNDO	2020-06-23	2	4	2	4	0.5739
Virus Kombat	2020-05-12	1	4	2	3	0.5739
Ultimate Chess	2020-04-24	3	4	2	5	0.5739
Dig Bombers	2020-07-21	3	4	2	5	0.5739
Fear Of The Dark	2020-06-06	2	4	2	4	0.5739
Strike Solitaire 2	2020-06-11	3	4	2	5	0.5739
Deja Vu Collector's Edition	2020-10-14	4	4	2	6	0.5739
The Cabin	2020-07-20	2	4	2	4	0.5739
I Wanna Build a Robot	2020-06-29	1	4	2	3	0.5739
Choco Pixel 6	2020-06-17	2	4	2	4	0.5739
Detective Boiled-Hard / Case File - Death of the Space Dino Hunter	2020-06-23	1	4	2	3	0.5739
NO MAN IS AN ISLAND	2020-12-25	2	4	2	4	0.5739
Jubeez	2020-07-07	3	4	2	5	0.5739
Being Centered	2020-07-13	2	4	2	4	0.5739
Gassy Man	2020-07-20	1	4	2	3	0.5739
TinyPoker	2020-07-23	2	4	2	4	0.5739
I'm Oh, So Busy...: A Week with Yoshimi	2020-11-13	2	4	2	4	0.5739
Flying propeller	2020-07-31	2	4	2	4	0.5739
Aeloren Tactics	2020-08-17	3	4	2	5	0.5739
Rover Mechanic Challenge - ERC Competition	2020-09-14	6	4	2	8	0.5739
InMaze	2020-07-28	1	4	2	3	0.5739
Building 847	2020-10-23	1	4	2	3	0.5739
Lloyd the Monkey 2	2020-08-14	2	4	2	4	0.5739
OUBEY VR – Cosmic Voyage	2020-08-11	2	4	2	4	0.5739
Dead Body Killer	2020-08-30	2	4	2	4	0.5739
Alien Cat 8	2020-09-04	1	4	2	3	0.5739
Pandemic Bunny	2020-09-09	3	4	2	5	0.5739
Mind Muscle VR	2020-12-05	2	4	2	4	0.5739
Star Maidens Chronicle: Definitive Edition	2020-10-30	4	4	2	6	0.5739
Sokoban (Boxman) Classic	2020-09-30	6	4	2	8	0.5739
Mad Taxi	2020-09-15	2	4	2	4	0.5739
Divilixa	2020-10-28	2	4	2	4	0.5739
DIERY HEAVEN	2020-10-02	2	4	2	4	0.5739
Tales from Zilmurik	2020-10-01	4	4	2	6	0.5739
TRY TO WIN 2	2020-10-12	2	4	2	4	0.5739
Temple of Apshai Trilogy	2020-10-19	3	4	2	5	0.5739
DruMidia	2020-11-22	2	4	2	4	0.5739
Space Abyss	2020-12-10	2	4	2	4	0.5739
IMUGI	2020-12-12	2	4	2	4	0.5739
Surviving Medieval	2020-02-05	7	19	12	19	0.5731
Sokpop S08: Popo's Tower	2020-06-10	6	19	12	18	0.5731
1917: The Prologue	2020-11-06	6	19	12	18	0.5731
Gaia	2020-04-03	41	55	37	78	0.5728
Fright Night Sex Fest	2020-12-18	7	16	10	17	0.5726
美足小屋	2020-04-24	27	86	59	86	0.5723
Sokpop S01: King of the Sandcastle	2020-01-17	5	13	8	13	0.5721
Heroes Of Maidan 3	2020-04-22	3	13	8	11	0.5721
Umihara Kawase Fresh!	2020-05-28	7	13	8	15	0.5721
OPEC IDLE	2020-10-06	18	13	8	26	0.5721
여우불	2020-10-08	3	13	8	11	0.5721
Sweet Halloween	2020-09-25	5	13	8	13	0.5721
Bahamian Rhapsody	2020-12-04	7	13	8	15	0.5721
Port Royale 4	2020-09-25	1934	903	652	2586	0.5719
DEFENDERS OF THE FALLEN ISLAND	2020-05-27	10	29	19	29	0.5719
Vital Signs: Emergency Department	2020-10-15	7	29	19	26	0.5719
Bird Simulator	2020-01-07	8	29	19	27	0.5719
MiniState	2020-02-20	79	49	33	112	0.5718
Schwerpunkt	2020-07-28	3	7	4	7	0.5718
A Matter of Time	2020-10-17	2	7	4	6	0.5718
Cover Sky	2020-04-10	2	7	4	6	0.5718
Lustlock Labyrinth	2020-05-28	6	7	4	10	0.5718
黎明霞光	2020-01-10	2	7	4	6	0.5718
Sokpop S03: soko loco	2020-01-17	3	7	4	7	0.5718
Sokpop S03: visser	2020-01-17	2	7	4	6	0.5718
Aldred Knight	2020-02-01	3	7	4	7	0.5718
Wanko of Marriage ~Welcome to The Dog's Tail!~	2020-10-20	7	7	4	11	0.5718
MoonRun	2020-05-22	3	7	4	7	0.5718
Comrade-in-Arms	2020-03-03	3	7	4	7	0.5718
Demon Blast	2020-04-20	1	7	4	5	0.5718
Group Project Simulator	2020-04-10	4	7	4	8	0.5718
Bat of Dead	2020-04-15	2	7	4	6	0.5718
Farm Builder	2020-06-12	5	7	4	9	0.5718
血潭江湖百里荣	2020-04-30	2	7	4	6	0.5718
No Honor	2020-06-10	3	7	4	7	0.5718
God Hates Us	2020-07-14	2	7	4	6	0.5718
My Universe - Pet Clinic Cats & Dogs	2020-12-03	6	7	4	10	0.5718
POLYGON: Life	2020-07-31	2	7	4	6	0.5718
Critterland	2020-08-15	4	7	4	8	0.5718
Toilet Paper Unleashed	2020-07-31	2	7	4	6	0.5718
The Forgotten Island - v1.0	2020-09-15	4	7	4	8	0.5718
Summoner VR : The ruined village	2020-09-18	3	7	4	7	0.5718
Zball III	2020-09-17	3	7	4	7	0.5718
Jumpman	2020-11-19	3	7	4	7	0.5718
客栈江湖-Vagabond Inn	2020-08-17	68	39	26	94	0.5717
Mines of Volantis	2020-09-01	23	10	6	29	0.5717
Red Town	2020-04-24	3	10	6	9	0.5717
486	2020-06-01	2	10	6	8	0.5717
Sokpop S08: Clickbox	2020-04-10	7	10	6	13	0.5717
Queen's Coast Casino - Uncut	2020-05-06	9	10	6	15	0.5717
Riders 2491	2020-07-24	4	10	6	10	0.5717
Out of Oblivion	2020-08-17	3	10	6	9	0.5717
Space Bar At The End Of The Galaxy	2020-08-21	4	10	6	10	0.5717
Psych	2020-09-30	2	10	6	8	0.5717
Rainy	2020-09-18	2	10	6	8	0.5717
Invasion 2: Doomed	2020-10-17	6	10	6	12	0.5717
Wrath Of The Violent Vicar - Interactive Grindhouse Movie	2020-10-20	2	10	6	8	0.5717
Angel Tears	2020-10-27	3	10	6	9	0.5717
Hold Out	2020-08-06	14	26	17	31	0.5712
Just Drift It !	2020-04-03	12	26	17	29	0.5712
DEMON'S SWORD SNAKES	2020-10-20	11	26	17	28	0.5712
鬼王~Oni	2020-10-31	25	36	24	49	0.5710000000000001
Go Kart Run!	2020-04-09	77	60	41	118	0.5707
Deep Space	2020-11-23	10	88	61	71	0.5706
Granado Espada Japan	2020-03-05	801	43	29	830	0.5705
Horse Racing Rally	2020-03-19	9	23	15	24	0.5703
Bomber Barn	2020-01-31	11	33	22	33	0.5702
POWER	2020-09-03	43	64	44	87	0.5700000000000001
War Trigger 3	2020-01-24	38	197	140	178	0.5699000000000001
Paws and Soul: First Step	2020-06-18	23	40	27	50	0.5698
Windbound	2020-08-28	935	543	394	1329	0.5694
Fighting Clans	2020-03-03	7	30	20	27	0.5694
Capital Simulator	2020-09-09	10	30	20	30	0.5694
Last Escape	2020-09-04	6	20	13	19	0.5694
WWE 2K BATTLEGROUNDS	2020-09-18	425	534	389	814	0.5685
Wing of Misadventure Retro	2020-12-04	246	223	160	406	0.5685
Kings Of Streets	2020-06-20	49	87	61	110	0.5684
Case Kovacs - Agent 228	2020-12-02	9	27	18	27	0.5684
Trackmaster	2020-12-11	8	17	11	19	0.5683
Great Utopia	2020-01-30	7	17	11	18	0.5683
Samurai Aces III: Sengoku Cannon	2020-07-13	7	17	11	18	0.5683
Grandmother	2020-09-28	5	17	11	16	0.5683
Men Bang	2020-08-18	42	55	38	80	0.5681
Patricia	2020-09-04	56	34	23	79	0.5681
Messy Room Simulator	2020-09-21	10	24	16	26	0.5673
Ogre Tale	2020-08-20	93	63	44	137	0.5671
艾鲁大陆	2020-04-29	23	38	26	49	0.5671
Realm of Alters	2020-09-25	32	31	21	53	0.5671
WREST	2020-07-28	5	14	9	14	0.5669
Customer Cums First!	2020-01-17	8	14	9	17	0.5669
Submersed	2020-01-24	3	14	9	12	0.5669
Danger Zombies	2020-05-16	4	14	9	13	0.5669
Kings Town	2020-10-19	8	14	9	17	0.5669
Table Manners	2020-02-14	98	264	192	290	0.5665
City Eye: Prologue	2020-06-17	15	42	29	44	0.5663
Winning Post 9 2020	2020-03-12	1441	35	24	1465	0.5660000000000001
Koliseum Soccer VR	2020-03-10	6	11	7	13	0.5653
Zulup	2020-02-03	5	11	7	12	0.5653
Dancing Angels	2020-05-28	6	11	7	13	0.5653
Cuba2077	2020-08-10	2	11	7	9	0.5653
The Seven Keys : Escape Room	2020-09-26	5	11	7	12	0.5653
Keepers of the Trees	2020-08-07	23	50	35	58	0.5652
Aery - Little Bird Adventure	2020-10-16	10	32	22	32	0.5649000000000001
Fear of Dark	2020-06-08	10	54	38	48	0.5647
Sand to Surf	2020-04-24	20	25	17	37	0.5645
Invisible Cock: They never saw it cumming!	2020-11-13	9	25	17	26	0.5645
Soul Reaper	2020-09-30	8	18	12	20	0.5644
Alien Cat 5	2020-07-21	4	18	12	16	0.5644
Furry Heroes	2020-10-16	7	18	12	19	0.5644
League of Angels-Heaven's Fury	2020-09-04	356	361	268	624	0.5633
Necromunda: Underhive Wars	2020-09-07	4260	1475	1114	5374	0.5632
Model Kit Simulator VR	2020-01-22	2	8	5	7	0.5632
Silver Whistle	2020-06-18	3	8	5	8	0.5632
Premier Manager 02/03	2020-07-31	7	8	5	12	0.5632
Gelldonia	2020-10-09	7	8	5	12	0.5632
TCSTRIKERS1	2020-12-08	2	8	5	7	0.5632
Skully	2020-08-04	31	125	91	122	0.5631
Club Soccer Director 2021	2020-08-06	91	79	57	148	0.5625
Path of the Sramana	2020-03-11	4	15	10	14	0.5625
佣兵战歌	2020-01-15	10	37	26	36	0.5623
BOSSGARD	2020-05-21	180	148	109	289	0.5616
Solo King - Single Player : Texas Hold'em Poker	2020-03-04	10	30	21	31	0.5614
Eight	2020-11-04	7	30	21	28	0.5614
Bermuda - Lost Survival	2020-09-26	81	280	209	290	0.5613
The Walking Evil	2020-05-01	11	57	41	52	0.5612
Among School Girls	2020-10-06	3	19	13	16	0.561
Bus Mechanic Simulator	2020-05-14	149	85	62	211	0.5609000000000001
Happy Geography Fun	2020-02-14	2	5	3	5	0.5605
The Treasure of the Dragon	2020-02-14	3	5	3	6	0.5605
Story in the Dream World -Volcano And Possession- Demo	2020-01-04	1	5	3	4	0.5605
匿名信：隐匿者 / Anonymous Letter ：Prowler	2020-02-03	3	5	3	6	0.5605
Ghost In The Barn House	2020-01-24	2	5	3	5	0.5605
Dish Life: The Game	2020-02-25	2	5	3	5	0.5605
Quarres	2020-03-31	2	5	3	5	0.5605
The Tide	2020-03-27	1	5	3	4	0.5605
Therapy Sheep	2020-05-09	2	5	3	5	0.5605
Chesscake	2020-04-15	2	5	3	5	0.5605
Night Spasm	2020-05-15	1	5	3	4	0.5605
CoronaWhomp!	2020-06-18	3	5	3	6	0.5605
Zomcade	2020-05-22	1	5	3	4	0.5605
West Legends	2020-06-24	3	5	3	6	0.5605
UNITED COMMAND ®	2020-08-05	4	5	3	7	0.5605
Martian Potato	2020-06-16	2	5	3	5	0.5605
Data mining 8	2020-06-05	2	5	3	5	0.5605
Artifacts	2020-09-15	3	5	3	6	0.5605
Marie Antoinette's Solitaire	2020-06-25	4	5	3	7	0.5605
AIDA: The Beginning of the Story	2020-10-16	3	5	3	6	0.5605
The Line	2020-08-10	2	5	3	5	0.5605
Warrecs 2	2020-08-28	5	5	3	8	0.5605
Mafia Gangster City	2020-07-31	4	5	3	7	0.5605
Adventures in Morality: An Interactive Case Study	2020-08-14	5	5	3	8	0.5605
Battle Sweeper	2020-08-13	3	5	3	6	0.5605
Bouncer Story	2020-11-03	3	5	3	6	0.5605
The_Good_Book_VN	2020-09-21	2	5	3	5	0.5605
10mg: Locked In	2020-10-15	3	5	3	6	0.5605
Mage World - The Wizard's Stone	2020-10-29	3	5	3	6	0.5605
Theo's World	2020-11-19	2	5	3	5	0.5605
Strange Midnight	2020-11-03	2	5	3	5	0.5605
Maniac Path	2020-10-29	1	5	3	4	0.5605
Free Spirit VR Meditation	2020-12-11	2	5	3	5	0.5605
LineArt Jigsaw Puzzle - Erotica 2	2020-11-25	2	5	3	5	0.5605
TenebriS	2020-12-23	1	5	3	4	0.5605
Element Battle Royale	2020-04-24	22	50	36	58	0.5602
炼器师	2020-09-05	12	23	16	28	0.5602
Battle Royale Bootcamp	2020-01-21	4	12	8	12	0.56
Adventure In Aellion	2020-08-26	10	12	8	18	0.56
ALTERITY EXPERIENCE	2020-01-15	3	12	8	11	0.56
八般武艺 MAVR3D	2020-05-07	4	12	8	12	0.56
BattleStick 2	2020-09-24	13	12	8	21	0.56
CLOWN	2020-11-25	3	12	8	11	0.56
Wolcen: Lords of Mayhem	2020-02-13	127542	36731	28618	156160	0.5599000000000001
Hide Or Die	2020-05-01	1314	875	669	1983	0.5594
Dark Fantasy Warriors	2020-12-23	3	31	22	25	0.5594
There Is No Tomorrow	2020-01-16	4	16	11	15	0.5586
Monster Girl Garden	2020-01-17	9	16	11	20	0.5586
Calm Girls	2020-05-20	6	16	11	17	0.5586
Starfall Online	2020-02-20	189	76	56	245	0.5584
Three kingdoms story: Conussia	2020-05-08	28	64	47	75	0.5581
Anime Studio Tycoon	2020-11-13	10	20	14	24	0.5579999999999999
Critter Clicker	2020-10-04	113	52	38	151	0.5578000000000001
Anime Wave Simulator	2020-09-15	5	40	29	34	0.5575
INTERSTELLAR PRIME	2020-01-08	10	28	20	30	0.5575
Astra	2020-10-26	10	28	20	30	0.5575
Ageless	2020-07-28	170	176	133	303	0.5572
Cradle of Links VR	2020-10-20	2	2	1	3	0.5569
Wraithmind	2020-11-12	2	2	1	3	0.5569
Chime Sharp Game Composer Edition	2020-03-19	2	2	1	3	0.5569
Liquid Sunshine	2020-07-21	2	2	1	3	0.5569
Cyber Watch	2020-01-12	2	2	1	3	0.5569
Dark Man	2020-05-08	2	2	1	3	0.5569
Flying Circus	2020-05-18	3	2	1	4	0.5569
Shield of Shalwend	2020-03-14	1	2	1	2	0.5569
Krakout challenge	2020-04-22	2	2	1	3	0.5569
El Remedio de Aldorf	2020-02-14	1	2	1	2	0.5569
Going Up?	2020-04-20	1	2	1	2	0.5569
The Demon - Nicolas Eymerich Inquisitor Audiogame	2020-03-27	2	2	1	3	0.5569
Player Power	2020-05-14	1	2	1	2	0.5569
KobberParty - Castle Explorer	2020-03-20	2	2	1	3	0.5569
Code Tracer	2020-04-24	1	2	1	2	0.5569
Ninjapple	2020-03-02	1	2	1	2	0.5569
Maverick	2020-08-25	1	2	1	2	0.5569
INVESTMENT HERO	2020-02-01	2	2	1	3	0.5569
Yuna and other troubles	2020-01-09	4	2	1	5	0.5569
Comet Golf	2020-02-20	1	2	1	2	0.5569
Hero Index	2020-02-28	2	2	1	3	0.5569
Planet Colonization	2020-12-07	2	2	1	3	0.5569
Hexon	2020-04-18	2	2	1	3	0.5569
Monster Capture King	2020-02-15	2	2	1	3	0.5569
Catch Your Kitty	2020-01-10	1	2	1	2	0.5569
The Blueness of a Wound	2020-09-01	1	2	1	2	0.5569
Pioneerz	2020-02-03	2	2	1	3	0.5569
Sokpop S04: Peppered	2020-01-17	1	2	1	2	0.5569
The Puzzle Box Society	2020-02-10	3	2	1	4	0.5569
往け！往け！マグロ - THE SHOOTING MAGURO -	2020-06-19	2	2	1	3	0.5569
Operation Deep Magic: Cryptanalysis	2020-01-21	2	2	1	3	0.5569
Spooky Spins Remastered - Steam Edition	2020-01-21	2	2	1	3	0.5569
Valentines Desire - Steam Edition	2020-01-30	1	2	1	2	0.5569
7WORLDS: The Dreaming Dale	2020-02-02	1	2	1	2	0.5569
Blast Rush Classic	2020-05-04	3	2	1	4	0.5569
Little Big Rabbits	2020-02-11	5	2	1	6	0.5569
fullybroKEN - A Unique Post-Apocalyptic RPG	2020-03-07	2	2	1	3	0.5569
Reach	2020-02-19	1	2	1	2	0.5569
Return to Sender	2020-03-20	3	2	1	4	0.5569
Swamp Castle	2020-06-04	4	2	1	5	0.5569
Canon - Legend of the New Gods	2020-08-07	2	2	1	3	0.5569
Man Face Spider I	2020-03-20	2	2	1	3	0.5569
Breaking Blocks	2020-03-25	2	2	1	3	0.5569
Heartless reseller is Roguelike	2020-05-17	1	2	1	2	0.5569
勇者的十日人生	2020-12-22	1	2	1	2	0.5569
SpeedFighter	2020-04-12	1	2	1	2	0.5569
C-TAS: A Virtual Chinese Learning Game	2020-07-29	1	2	1	2	0.5569
Delirium	2020-04-14	2	2	1	3	0.5569
Official Wicked Vixxen Whack-A-Dick	2020-05-06	2	2	1	3	0.5569
The Spoon Of Doom	2020-07-24	1	2	1	2	0.5569
驱逐之剑	2020-08-22	3	2	1	4	0.5569
VR长征	2020-11-05	2	2	1	3	0.5569
'Member the Alamo?	2020-05-20	1	2	1	2	0.5569
Krim: The War in the Crimea, 1941-42	2020-07-02	2	2	1	3	0.5569
Isorropia	2020-05-17	107	2	1	108	0.5569
GeoLogic	2020-05-18	2	2	1	3	0.5569
End of Panduora	2020-06-25	2	2	1	3	0.5569
MelDEV Power Boat Racing	2020-05-23	4	2	1	5	0.5569
Cybxus Heart	2020-06-12	1	2	1	2	0.5569
The Medic	2020-05-21	1	2	1	2	0.5569
时间卡牌 TimelineCard	2020-05-26	3	2	1	4	0.5569
DRazor	2020-05-23	1	2	1	2	0.5569
Little Chick	2020-06-07	4	2	1	5	0.5569
DontFallAsleep	2020-06-28	1	2	1	2	0.5569
Dynarog	2020-06-17	4	2	1	5	0.5569
枪炮派对	2020-06-12	1	2	1	2	0.5569
Untitled Video Game	2020-06-10	1	2	1	2	0.5569
Space Mining	2020-06-19	2	2	1	3	0.5569
VRandish	2020-07-10	1	2	1	2	0.5569
Final Hope: The Plot	2020-09-03	2	2	1	3	0.5569
Neon Fusion	2020-10-08	2	2	1	3	0.5569
Pokie The Stickfigure	2020-07-02	2	2	1	3	0.5569
Captain MAYO	2020-07-16	2	2	1	3	0.5569
I_Darkness	2020-07-15	4	2	1	5	0.5569
完美电路 Electric Circuit	2020-07-14	2	2	1	3	0.5569
The Kalalau Trail	2020-08-18	3	2	1	4	0.5569
VR Time Travelling in Medieval Towns and Islands: Magellan's Life in ancient Europe, the Great Exploration Age, and A.D.1500 Time Machine	2020-08-05	3	2	1	4	0.5569
BattleMaster	2020-09-16	2	2	1	3	0.5569
FIRE TRUMP - Air Combat VR	2020-09-16	1	2	1	2	0.5569
HEXONEX	2020-08-12	1	2	1	2	0.5569
I'm Russia	2020-08-27	3	2	1	4	0.5569
Tumbled	2020-09-24	1	2	1	2	0.5569
The Banana Saved The World	2020-11-06	3	2	1	4	0.5569
Folkloric Excursion	2020-12-10	1	2	1	2	0.5569
Trash Can Dungeon - Battle Against The ZOO	2020-08-20	2	2	1	3	0.5569
Wesprau Senki	2020-08-20	3	2	1	4	0.5569
EPEJSODION Dodgeball Attack	2020-08-26	3	2	1	4	0.5569
Dream Knights	2020-08-28	2	2	1	3	0.5569
Rocket Squad	2020-09-29	6	2	1	7	0.5569
Rescue Rina	2020-09-25	2	2	1	3	0.5569
The Message	2020-12-07	1	2	1	2	0.5569
RGB Simulator	2020-11-16	1	2	1	2	0.5569
Harmless Demons	2020-09-25	1	2	1	2	0.5569
VR Travelling back to our childhoods: VR 1980s	2020-09-15	2	2	1	3	0.5569
超僧大戦Z	2020-09-24	1	2	1	2	0.5569
Toupei55	2020-09-28	2	2	1	3	0.5569
Timeline Traveler	2020-09-28	2	2	1	3	0.5569
Save the Planet	2020-10-21	2	2	1	3	0.5569
Sublunar	2020-11-13	3	2	1	4	0.5569
Jiguland	2020-10-20	2	2	1	3	0.5569
Pirate Jigsaw	2020-10-30	4	2	1	5	0.5569
911 Emergency Manager	2020-11-20	4	2	1	5	0.5569
Costume Kingdom	2020-12-07	3	2	1	4	0.5569
Stranded 2	2020-10-19	2	2	1	3	0.5569
Modern Arena	2020-10-22	3	2	1	4	0.5569
Adventures of Megara: Antigone and the Living Toys	2020-12-10	5	2	1	6	0.5569
Rise of Zombies	2020-10-30	2	2	1	3	0.5569
Zen! Slider	2020-10-22	3	2	1	4	0.5569
Ostatni Dzien w Pracy	2020-11-05	1	2	1	2	0.5569
ガリア戦記　雄篇アンナーレス	2020-10-29	3	2	1	4	0.5569
Super Whiplash	2020-11-12	3	2	1	4	0.5569
ONNANOKO KEEPER	2020-12-12	2	2	1	3	0.5569
Conrun Virtual Gym	2020-12-12	1	2	1	2	0.5569
Did you hear that?	2020-11-20	1	2	1	2	0.5569
Nevermore - Documentary Kinetic Novel	2020-11-30	1	2	1	2	0.5569
弹幕大修仙 - 开篇	2020-12-04	2	2	1	3	0.5569
NOMAD	2020-12-10	1	2	1	2	0.5569
一人之下之寻炁迷踪	2020-12-25	2	2	1	3	0.5569
Omi Domini	2020-12-04	2	2	1	3	0.5569
Insect: Bombardier beetle	2020-12-22	1	2	1	2	0.5569
YABAI MANTIS VR	2020-12-24	2	2	1	3	0.5569
PetDrivr	2020-12-24	2	2	1	3	0.5569
Maxi Pool Masters VR	2020-08-18	3	9	6	9	0.5566
Summer Girl	2020-06-22	3	9	6	9	0.5566
Night of the Scarecrows	2020-03-29	4	9	6	10	0.5566
Castle Wonders - A Castle Tale	2020-08-25	7	9	6	13	0.5566
Mysterica	2020-10-09	5	9	6	11	0.5566
Seditionis: Tower Defense	2020-11-18	4	9	6	10	0.5566
Don't Crash - The Zombie Game	2020-12-25	2	9	6	8	0.5566
Naval Armada: World Warships Battle	2020-01-15	22	79	59	81	0.5561
To the Edge of the Sky	2020-05-29	145	37	27	172	0.5559000000000001
The Mystery of Bikini Island	2020-09-11	11	29	21	32	0.5555
BiteVille	2020-10-23	16	29	21	37	0.5555
Zibbs - Alien Survival	2020-11-08	4	13	9	13	0.5555
Raccoon The Miner	2020-02-24	4	13	9	13	0.5555
Monster Gals!!	2020-04-02	4	13	9	13	0.5555
Rocky Ride	2020-05-08	4	13	9	13	0.5555
Agence	2020-09-28	7	13	9	16	0.5555
Sightbringer	2020-09-03	2	13	9	11	0.5555
G.I. Joe: Operation Blackout	2020-12-15	9	50	37	46	0.5553
Tarzan VR	2020-11-17	11	25	18	29	0.5553
Monopolka	2020-04-13	7	21	15	22	0.5552
Free Company VR	2020-01-08	8	21	15	23	0.5552
Flash Snooker Game	2020-07-04	16	21	15	31	0.5552
Control Over	2020-12-03	9	21	15	24	0.5552
MONEY LOVES SILENCE	2020-02-24	6	17	12	18	0.5552
GraFi Lunar	2020-01-03	4	17	12	16	0.5552
Pretty Girls Klondike Solitaire	2020-11-24	6	17	12	18	0.5552
Shadow Arena	2020-05-21	4958	3103	2444	7402	0.555
Legends of Aria	2020-07-08	1170	909	711	1881	0.5545
BIOHAZARD RE:3 Z Version	2020-04-02	3140	130	99	3239	0.5545
DRAGON QUEST RIVALS Ace	2020-06-21	2552	38	28	2580	0.5544
人血馒头	2020-03-06	16	60	45	61	0.5539000000000001
Poker Club	2020-11-20	182	187	144	326	0.5536
脚本塔防 Massacre Tower	2020-06-20	51	30	22	73	0.5536
圣三国英杰传	2020-12-11	42	101	77	119	0.5533
Bite the Bullet	2020-08-13	46	44	33	79	0.5522
Synthetic Hazard	2020-11-18	4	18	13	17	0.5522
Werewolves Online	2020-10-20	26	14	10	36	0.5517000000000001
Streatham Hill Stories	2020-10-23	3	14	10	13	0.5517000000000001
Waifu Love	2020-11-27	4	14	10	14	0.5517000000000001
Gold Dust	2020-11-06	5	14	10	15	0.5517000000000001
Wordle 4	2020-12-09	10	58	44	54	0.5516
Dream Catcher	2020-07-24	17	49	37	54	0.5516
The Remission of Sins	2020-11-05	3	6	4	7	0.5514
Kastle Krush	2020-12-17	3	6	4	7	0.5514
Sokpop S05: Wamu Wamu 2	2020-01-17	1	6	4	5	0.5514
Kingdom Warrior	2020-03-14	3	6	4	7	0.5514
HellScape: Two Brothers	2020-01-23	2	6	4	6	0.5514
King of Volleyball	2020-02-16	5	6	4	9	0.5514
Rise & Fall	2020-08-14	6	6	4	10	0.5514
送外卖模拟器 Delivery Simulator	2020-07-09	2	6	4	6	0.5514
Obreno: Chapter One	2020-08-03	2	6	4	6	0.5514
成王败寇	2020-07-14	14	6	4	18	0.5514
Who Are You?	2020-09-11	4	6	4	8	0.5514
Royale Archer VR	2020-12-16	3	6	4	7	0.5514
Farm & Puzzle	2020-10-15	2	6	4	6	0.5514
Starshot	2020-11-12	3	6	4	7	0.5514
Psycho Wolf	2020-11-20	5	10	7	12	0.5513
GameDevVR	2020-05-14	3	10	7	10	0.5513
Neither Day nor Night	2020-08-27	3	10	7	10	0.5513
Cloudlands 2	2020-01-17	8	10	7	15	0.5513
The Savana	2020-12-10	9	10	7	16	0.5513
Mercenaries VR	2020-05-08	2	10	7	9	0.5513
Glory Horse Racing	2020-09-29	5	10	7	12	0.5513
INFINITY	2020-04-23	4	10	7	11	0.5513
Inconsistencies	2020-06-05	10	10	7	17	0.5513
Increase World	2020-11-04	4	10	7	11	0.5513
ANNOYING ball game	2020-08-25	2	10	7	9	0.5513
Zball	2020-09-03	3	10	7	10	0.5513
Fear in The Modern House CH2	2020-11-22	2	10	7	9	0.5513
Bakery Magnate: Online	2020-12-29	9	10	7	16	0.5513
This Is the Zodiac Speaking	2020-10-15	18	36	27	45	0.551
VR Home	2020-08-27	10	19	14	24	0.5496
The House in the Forest	2020-02-25	3	24	18	21	0.5484
7 Roses - A Darkness Rises	2020-08-01	6	24	18	24	0.5484
Blocks!: Hammer of the Scots	2020-07-20	7	15	11	18	0.5484
Best Friend	2020-05-05	4	15	11	15	0.5484
Another road	2020-09-07	4	15	11	15	0.5484
Be a Pirate	2020-11-09	2	15	11	13	0.5484
Loco Road	2020-06-01	37	29	22	59	0.5477000000000001
Today Is My Birthday	2020-10-30	18	53	41	59	0.5476
Dead GroundZ	2020-04-29	7	20	15	22	0.5471
Nuclear Arms Race	2020-01-09	7	11	8	15	0.5468999999999999
Mineirinho Shooter DC	2020-01-14	3	11	8	11	0.5468999999999999
Beyond The Underworld	2020-04-28	2	11	8	10	0.5468999999999999
Ancient World War	2020-05-21	4	11	8	12	0.5468999999999999
Wonder Cave	2020-12-12	9	11	8	17	0.5468999999999999
Pangeon	2020-03-30	4	30	23	27	0.5462
Biathlon Battle VR	2020-02-14	3	16	12	15	0.5455
Close Encounter VR	2020-05-12	2	16	12	14	0.5455
Zelter	2020-10-22	886	970	793	1679	0.5449
Opening Up	2020-06-04	4	7	5	9	0.5448
Escape from the death castle	2020-01-17	136	7	5	141	0.5448
神鬼降世	2020-02-19	7	7	5	12	0.5448
Soldier Matt Sowards	2020-03-27	4	7	5	9	0.5448
Tit Tap Tingle	2020-07-24	5	7	5	10	0.5448
BROTHER WAKE UP	2020-11-26	2	7	5	7	0.5448
Mystery Case Files: Cross Fade Collector's Edition	2020-11-26	9	7	5	14	0.5448
Arcane Eyes	2020-12-28	3	7	5	8	0.5448
Naval Battles Simulator	2020-02-25	14	36	28	42	0.5447
Imagination	2020-01-29	26	31	24	50	0.5447
Commandos 2 - HD Remaster	2020-01-24	848	1052	863	1711	0.5443
Paw Paw Paw	2020-11-13	85	177	143	228	0.5438000000000001
Wild Russia	2020-04-28	5	42	33	38	0.5437
Idle Warrior	2020-02-21	52	37	29	81	0.5435
HVOR	2020-07-10	8	32	25	33	0.5433
武林桃源乡 The Arcadia Of Wulin	2020-08-14	5	12	9	14	0.5433
Hot-air VR Balloon trip over Russian Primorye	2020-07-07	5	12	9	14	0.5433
In a search of a new home	2020-05-26	3	27	21	24	0.5431
About Gretel	2020-11-13	5	27	21	26	0.5431
Beyond Senses	2020-01-06	11	22	17	28	0.543
Zombie Road Rider	2020-03-30	3	22	17	20	0.543
Solar Cram School	2020-05-27	8	17	13	21	0.543
My Little Dog Adventure	2020-11-06	11	17	13	24	0.543
SKYHILL: Black Mist	2020-06-11	55	104	84	139	0.5422
三国志猛将传	2020-06-05	50	60	48	98	0.542
The Essence Reaper Ritual	2020-03-23	2	3	2	4	0.5417000000000001
Hope	2020-08-07	2	3	2	4	0.5417000000000001
Chief's Quest	2020-02-21	2	3	2	4	0.5417000000000001
Slashvival	2020-03-17	3	3	2	5	0.5417000000000001
Space Hockey	2020-05-02	7	3	2	9	0.5417000000000001
Knife Only	2020-10-18	3	3	2	5	0.5417000000000001
Aries	2020-10-15	3	3	2	5	0.5417000000000001
BornWild • Versus Season 1, Vol.1	2020-01-23	2	3	2	4	0.5417000000000001
DragonClash	2020-04-10	4	3	2	6	0.5417000000000001
Cross Country Express - An Oddfellows Mini	2020-04-10	132	3	2	134	0.5417000000000001
Bierwagen Rush	2020-02-28	2	3	2	4	0.5417000000000001
Chaos Theory - Pirates	2020-05-01	1	3	2	3	0.5417000000000001
MCAS Simulation	2020-12-07	2	3	2	4	0.5417000000000001
地狱酒馆 	2020-09-01	4	3	2	6	0.5417000000000001
Frostford	2020-01-27	2	3	2	4	0.5417000000000001
GORILLA TOWN	2020-02-07	2	3	2	4	0.5417000000000001
God's Challenge	2020-01-13	2	3	2	4	0.5417000000000001
The Lost Brewery	2020-01-24	1	3	2	3	0.5417000000000001
Patched world	2020-02-08	3	3	2	5	0.5417000000000001
Classic Card Game Euchre	2020-01-23	3	3	2	5	0.5417000000000001
双子树 TwinTrees	2020-03-02	2	3	2	4	0.5417000000000001
Ballavita	2020-03-25	2	3	2	4	0.5417000000000001
Flaming Friday Night	2020-03-13	2	3	2	4	0.5417000000000001
人格面具：陰影面積	2020-03-27	3	3	2	5	0.5417000000000001
Motor Mash	2020-08-07	3	3	2	5	0.5417000000000001
ENHANCE	2020-08-06	5	3	2	7	0.5417000000000001
Amendium	2020-04-14	3	3	2	5	0.5417000000000001
The Informant Chronicles- Chronicle 1: Riverside Danger	2020-08-17	2	3	2	4	0.5417000000000001
Math Puzzle Alpha Challenge	2020-04-23	3	3	2	5	0.5417000000000001
I-Exist: Consciousness VR	2020-05-18	2	3	2	4	0.5417000000000001
Desert attack	2020-05-05	2	3	2	4	0.5417000000000001
Vertical Runner	2020-05-08	3	3	2	5	0.5417000000000001
Rozalin and the Palace of Flowers	2020-07-15	2	3	2	4	0.5417000000000001
Pair Matching Puzzle Connect	2020-05-07	5	3	2	7	0.5417000000000001
Informatyka - zrozum i zaprogramuj komputer	2020-05-11	2	3	2	4	0.5417000000000001
Helwyr	2020-05-26	2	3	2	4	0.5417000000000001
Dreams Keeper Solitaire	2020-07-28	4	3	2	6	0.5417000000000001
Space Dogfight	2020-06-15	2	3	2	4	0.5417000000000001
Damn Endless Orcs	2020-10-06	3	3	2	5	0.5417000000000001
The Floating City	2020-08-06	8	3	2	10	0.5417000000000001
Overshadow	2020-06-13	4	3	2	6	0.5417000000000001
Santa's Toy Factory Nonograms	2020-08-07	5	3	2	7	0.5417000000000001
Proto Cuckoo 64	2020-08-08	3	3	2	5	0.5417000000000001
Sanatorium Anthropocene Retreat	2020-07-15	9	3	2	11	0.5417000000000001
Directional Isolation VR	2020-07-17	2	3	2	4	0.5417000000000001
Queen's Conquest	2020-07-17	2	3	2	4	0.5417000000000001
Over'n Over	2020-07-25	2	3	2	4	0.5417000000000001
The Place I Called Home	2020-07-15	2	3	2	4	0.5417000000000001
Drive or Die	2020-08-31	3	3	2	5	0.5417000000000001
Alien Cat 7	2020-08-21	1	3	2	3	0.5417000000000001
Hentai Jigsaw Emma	2020-08-04	2	3	2	4	0.5417000000000001
Commissar Catlov	2020-08-21	2	3	2	4	0.5417000000000001
Anime Desktop Girls	2020-12-20	3	3	2	5	0.5417000000000001
Shattering Obsidian	2020-09-29	2	3	2	4	0.5417000000000001
Physics Sandbox VR	2020-12-09	3	3	2	5	0.5417000000000001
Astronomy Lab on PC: Relativity, Lunar Landing, Space Flight, and Interstellar Travelling	2020-09-12	1	3	2	3	0.5417000000000001
Fugitive Criminal	2020-09-20	2	3	2	4	0.5417000000000001
Ancient Worlds: Egypt	2020-12-09	5	3	2	7	0.5417000000000001
Adventure Minesweeper	2020-10-09	2	3	2	4	0.5417000000000001
决奕Duel	2020-10-29	3	3	2	5	0.5417000000000001
Kittens of Fear	2020-12-26	2	3	2	4	0.5417000000000001
battleMETAL	2020-12-23	3	3	2	5	0.5417000000000001
Glitch Assassin	2020-10-31	1	3	2	3	0.5417000000000001
Cyber Badminton 2020	2020-11-13	2	3	2	4	0.5417000000000001
Soliterix	2020-12-05	1	3	2	3	0.5417000000000001
pinball	2020-12-29	2	3	2	4	0.5417000000000001
魔帝1 Magic Emperor1	2020-12-25	4	3	2	6	0.5417000000000001
Onryo | 怨霊	2020-04-25	120	78	63	183	0.5412
Warp Drive	2020-11-27	7	23	18	25	0.5412
No Place for the Dissident	2020-11-12	6	13	10	16	0.5402
Fission	2020-12-18	4	13	10	14	0.5402
Forgotten Trace: Thanatos in Nostalgia - Chapter 1 Complete Edition	2020-06-24	3	8	6	9	0.5398
Crash The Game	2020-02-22	2	8	6	8	0.5398
Royal Rescue	2020-05-22	5	8	6	11	0.5398
Dungeon Warriors	2020-10-01	2	8	6	8	0.5398
SBX 5K	2020-04-20	8	8	6	14	0.5398
The Old West Savior	2020-07-15	5	8	6	11	0.5398
Space Battle	2020-08-01	3	8	6	9	0.5398
Story	2020-07-02	3	8	6	9	0.5398
Blood War	2020-08-14	8	8	6	14	0.5398
CLASSIC TANKS 2020	2020-09-07	2	8	6	8	0.5398
Home Designer - Living Room	2020-08-26	4	8	6	10	0.5398
Save the Planet	2020-11-23	4	8	6	10	0.5398
Eudemons Online	2020-10-29	60	58	47	107	0.5395000000000001
小青	2020-12-22	5	41	33	38	0.5393
Alchemania	2020-10-02	3	30	24	27	0.5389
Invasion: Lost in Time	2020-09-25	7	19	15	22	0.5387
Drift Long Racing	2020-11-26	6	19	15	21	0.5387
Hippocampus	2020-02-20	6	25	20	26	0.538
生活模拟器	2020-10-28	293	123	102	395	0.5375
Eonica Chess Battle	2020-10-31	10	14	11	21	0.5375
RUNE II: Decapitation Edition	2020-11-13	316	233	195	511	0.5372
Medieval Engineers	2020-03-17	3984	3796	3242	7226	0.5366
hot and lovely	2020-01-08	16	114	95	111	0.5364
Grand Guilds	2020-03-26	104	51	42	146	0.5361
Psycho	2020-11-05	12	45	37	49	0.5359
Sokpop S01: Dr. Umgebung's School of Life	2020-01-17	5	9	7	12	0.5359
Hentai Darts	2020-05-05	7	9	7	14	0.5359
Libtard: The Satire Game	2020-05-08	3	9	7	10	0.5359
Dark Disharmony	2020-04-08	2	9	7	9	0.5359
Little Fire Girl	2020-10-31	4	9	7	11	0.5359
INSIDE LIGHT	2020-11-23	8	9	7	15	0.5359
Freya's Potion Shop	2020-10-29	8	9	7	15	0.5359
Project CARS 3	2020-08-27	1218	1720	1473	2691	0.5353
少女洛璃~危险但合法的初体验~（Fraulein Lolita~First Date With You~）	2020-09-26	29	21	17	46	0.5352
Taghia	2020-07-16	6	15	12	18	0.5352
Playing God	2020-09-07	5	15	12	17	0.5352
Mystical Lights	2020-10-13	2	15	12	14	0.5352
Isles of Adalar	2020-10-22	81	74	62	143	0.5341
Alien-911	2020-12-01	12	28	23	35	0.5341
Incident Commander	2020-07-16	8	42	35	43	0.5332
Escape Dead Earth	2020-02-02	2	4	3	5	0.5332
Within Whispers: The Fall	2020-03-20	4	4	3	7	0.5332
Essence of Illumination: The Beginning	2020-01-06	3	4	3	6	0.5332
Dumb As Wizards	2020-07-24	7	4	3	10	0.5332
Shuriken & Aliens	2020-02-20	2	4	3	5	0.5332
Börnies Journey	2020-09-16	1	4	3	4	0.5332
Koi Unleashed	2020-04-29	4	4	3	7	0.5332
Fateful End: True Case Files	2020-11-03	2	4	3	5	0.5332
A Percent of a Pirate	2020-01-17	2	4	3	5	0.5332
Sokpop S05: rook	2020-01-17	2	4	3	5	0.5332
Classic Card Game Canasta	2020-01-23	6	4	3	9	0.5332
Hentai Girl Seek	2020-02-12	2	4	3	5	0.5332
Lesbian Voyeur Simulator	2020-03-13	3	4	3	6	0.5332
Maze Slider	2020-03-08	2	4	3	5	0.5332
Snake Core	2020-04-21	3	4	3	6	0.5332
Detective March Forward - The Missing Will	2020-09-18	2	4	3	5	0.5332
Awe	2020-10-29	2	4	3	5	0.5332
Nevertales: Hearthbridge Cabinet Collector's Edition	2020-04-10	9	4	3	12	0.5332
The Magic Elevator	2020-06-11	2	4	3	5	0.5332
Kalidazkoph	2020-07-20	3	4	3	6	0.5332
Lost Alone	2020-06-09	3	4	3	6	0.5332
Kenbo	2020-06-24	2	4	3	5	0.5332
Naughty Memories	2020-07-09	2	4	3	5	0.5332
GALAXY CRISIS	2020-07-01	2	4	3	5	0.5332
Citadale - The Awakened Spirit	2020-08-21	2	4	3	5	0.5332
Hide and Shoot	2020-08-07	4	4	3	7	0.5332
EX_IFE	2020-11-11	3	4	3	6	0.5332
VR Travelling in the Roman Empire (Time machine travel in history)	2020-08-18	4	4	3	7	0.5332
Circle Tank	2020-09-07	2	4	3	5	0.5332
1001 Jigsaw World Tour Asia	2020-09-18	3	4	3	6	0.5332
Kingdom Of Force	2020-11-02	4	4	3	7	0.5332
The Civil War	2020-09-08	3	4	3	6	0.5332
剑与羁绊	2020-10-16	4	4	3	7	0.5332
The Survivor	2020-08-04	12	16	13	25	0.5331
Pocket Plants	2020-12-07	9	16	13	22	0.5331
Achievement Clicker	2020-02-11	3	29	24	27	0.533
Doodle Tanks	2020-03-13	5	10	8	13	0.5327000000000001
Illegal Race Tuning - Real car racing multiplayer	2020-09-13	5	10	8	13	0.5327000000000001
The Nightmare	2020-08-05	4	23	19	23	0.5323
Find Me: Horror Game	2020-01-25	8	30	25	33	0.5319
Sogo Vego	2020-09-16	136	17	14	150	0.5313
Blood Rage: Digital Edition	2020-05-27	502	387	335	837	0.531
War Identity	2020-12-03	32	69	59	91	0.53
Shapeshooter	2020-10-22	2	11	9	11	0.53
The mysterious Case of Dr. Jekyll and Mr. Hyde	2020-01-14	5	11	9	14	0.53
Bullet Art	2020-06-12	4	11	9	13	0.53
ピンボルアの勇者	2020-11-27	4	11	9	13	0.53
SUDOKU TIME	2020-09-22	5	11	9	14	0.53
Colored Shapes	2020-11-26	7	11	9	16	0.53
15 puzzle	2020-12-04	2	11	9	11	0.53
LineVox	2020-12-24	2	11	9	11	0.53
Realistic Tower Destruction	2020-02-16	8	18	15	23	0.5297
Idle Expanse	2020-09-07	214	70	60	274	0.5296000000000001
FIGHTWORLD	2020-10-09	41	19	16	57	0.5283
Blastworld	2020-05-12	15	27	23	38	0.5278
uVolley	2020-07-25	6	27	23	29	0.5278
Draft Day Sports: College Football 2020	2020-01-28	20	12	10	30	0.5278
Glitch Escape	2020-09-07	5	12	10	15	0.5278
Sexy Heroine! Part 2	2020-04-30	7	5	4	11	0.5278
Sokpop S02: Zoo Packs	2020-01-17	5	5	4	9	0.5278
Squirrel Legacy	2020-02-12	5	5	4	9	0.5278
A Moustache in the House	2020-01-15	2	5	4	6	0.5278
Zombie Towns	2020-02-21	3	5	4	7	0.5278
Great Alhcemist	2020-02-18	2	5	4	6	0.5278
Blue Fox	2020-03-13	2	5	4	6	0.5278
Escort Alia	2020-03-30	2	5	4	6	0.5278
King of Spies	2020-04-24	3	5	4	7	0.5278
BROTHER!!! - Hardcore Platformer	2020-05-15	2	5	4	6	0.5278
Mystery Tales: Til Death Collector's Edition	2020-04-24	6	5	4	10	0.5278
VE FPSO TOUR in VR	2020-09-11	2	5	4	6	0.5278
Arcadium	2020-07-27	2	5	4	6	0.5278
Carnage	2020-08-19	5	5	4	9	0.5278
Coronavirus - Nano Force	2020-06-25	2	5	4	6	0.5278
Bug Blast	2020-06-26	3	5	4	7	0.5278
Ronald's Run	2020-07-14	2	5	4	6	0.5278
亡命尸潮惊魂夜 Escape Zombies At Night	2020-09-06	1	5	4	5	0.5278
The Haunted Dolls	2020-09-21	3	5	4	7	0.5278
Bocce VR Simulator	2020-09-18	3	5	4	7	0.5278
Azlan: Rise of the Burlpups	2020-12-23	3	5	4	7	0.5278
梦幻江湖	2020-12-10	7	5	4	11	0.5278
Rosy Manga	2020-12-07	2	5	4	6	0.5278
DIRT 5	2020-11-05	1203	3002	2670	3873	0.5271
Waking	2020-06-18	19	60	52	71	0.5271
Escape2088	2020-10-21	8	20	17	25	0.527
Sign of Silence	2020-10-01	1283	1129	1004	2287	0.5264
末法时代	2020-04-30	25	37	32	57	0.5261
Tainted Fate	2020-10-29	6	13	11	17	0.5259
Fire Rescue Simulator	2020-04-16	4	13	11	15	0.5259
Scary Hospital Horror Game	2020-07-03	3	13	11	14	0.5259
My Universe - Fashion Boutique	2020-11-23	5	13	11	16	0.5259
GHOSTWINTER	2020-12-03	4	13	11	15	0.5259
Golf Ace	2020-05-15	15	38	33	48	0.5255
Deadliest Catch: The Game	2020-04-14	399	641	573	972	0.5246999999999999
逆光 Sunwards	2020-04-15	6	22	19	25	0.5246999999999999
Mr. Parkour	2020-11-05	5	22	19	24	0.5246999999999999
Freaky Clown : Town Mystery	2020-12-28	11	22	19	30	0.5246999999999999
Sweet Dungeon	2020-09-11	13	14	12	25	0.5242
Arthur's Revenge	2020-11-20	5	14	12	17	0.5242
P1R4T3S	2020-01-31	5	6	5	10	0.5239
Gin Rummy 3D Premium	2020-12-12	7	6	5	12	0.5239
Red Mercenary	2020-02-10	4	6	5	9	0.5239
Hentai Breaker	2020-01-22	7	6	5	12	0.5239
Sokpop S05: Bandapes	2020-01-17	2	6	5	7	0.5239
My Universe - School Teacher	2020-11-18	5	6	5	10	0.5239
Galactic Center VR	2020-03-24	2	6	5	7	0.5239
Personal Space	2020-05-13	3	6	5	8	0.5239
Project Senko	2020-06-29	3	6	5	8	0.5239
TENS!	2020-11-05	10	6	5	15	0.5239
万人割草塔防	2020-10-17	10	6	5	15	0.5239
12 Labours of Hercules XI: Painted Adventure	2020-11-18	19	6	5	24	0.5239
Iblis	2020-12-25	2	6	5	7	0.5239
Dungeon Lord	2020-10-21	133	78	69	202	0.5238
Tears of Avia	2020-10-15	45	41	36	81	0.5236999999999999
DragonFang - Drahn's Mystery Dungeon	2020-02-04	119	51	45	164	0.5234000000000001
DF-41 Simulator	2020-07-07	19	91	81	100	0.5229
Last Hope on Earth	2020-11-01	9	24	21	30	0.5228
8-Bit Attack	2020-07-15	4	15	13	17	0.5228
Remalmok	2020-10-14	5	15	13	18	0.5228
They Are Hundreds	2020-12-24	10	102	91	101	0.5227
Touhou Mechanical Scrollery | 幻想討幻経	2020-04-30	256	144	129	385	0.5224
3D Hentai Chess	2020-08-28	7	44	39	46	0.5222
Stone Rage	2020-08-28	94	85	76	170	0.5219
Redneck Ed: Astro Monsters Show	2020-09-10	29	35	31	60	0.5218
Subway Simulator	2020-01-30	15	117	105	120	0.5217
RoboArena	2020-06-11	25	16	14	39	0.5215
Outbreak: Epidemic	2020-02-11	112	46	41	153	0.5213
Saving You From Yourself	2020-05-14	3	36	32	35	0.5212
Yuuki's Party Night	2020-02-21	5	7	6	11	0.5211
Aegis Online	2020-11-02	7	7	6	13	0.5211
SteamCity Chronicles - Rise Of The Rose	2020-06-16	3	7	6	9	0.5211
ambr	2020-05-24	151	7	6	157	0.5211
Modest Hero	2020-07-14	4	7	6	10	0.5211
Zen Universe	2020-05-13	4	7	6	10	0.5211
Super Ultimatum Quiz	2020-11-16	3	7	6	9	0.5211
Girls on puzzle	2020-11-03	3	7	6	9	0.5211
Elrit Clover	2020-12-23	5	7	6	11	0.5211
VR Skydiving	2020-12-11	2	7	6	8	0.5211
Beat Me! - Puppetonia Tournament	2020-11-13	20	37	33	53	0.5207
Warlander	2020-02-26	55	38	34	89	0.5201
Police hot Tale	2020-08-21	3	38	34	37	0.5201
Crushed	2020-11-23	35	83	75	110	0.5197999999999999
Road Z : The Last Drive	2020-08-21	12	28	25	37	0.5197999999999999
Doom of the Clawn	2020-02-06	2	8	7	9	0.5189
Kessler Effect	2020-03-25	5	8	7	12	0.5189
武儒绘卷 - 启示录	2020-07-07	12	8	7	19	0.5189
Sokpop S05: The Hour of the Rat	2020-01-17	2	8	7	9	0.5189
Fever Cabin	2020-02-01	2	8	7	9	0.5189
Fight For Eden	2020-12-18	5	8	7	12	0.5189
Ultimate Disc Golf	2020-01-31	6	19	17	23	0.5184000000000001
Outlaws: Corwin's Treasure	2020-05-05	4	19	17	21	0.5184000000000001
丝袜测评师	2020-10-01	5	19	17	22	0.5184000000000001
Hero Puzzle	2020-11-19	132	42	38	170	0.5183
ONE PUNCH MAN: A HERO NOBODY KNOWS 	2020-02-27	586	676	623	1209	0.518
蜀山幻剑录 Sword of Shushan	2020-09-25	65	55	50	115	0.518
Siren Head: The Siren's Forest	2020-10-15	22	212	195	217	0.5175
Zero Killed	2020-09-04	16	32	29	45	0.5175
Dark Hope: A Puzzle Adventure	2020-01-17	9	9	8	17	0.5171
海上霸主：航空母舰之旅	2020-02-21	5	9	8	13	0.5171
三国梦之队	2020-02-24	8	9	8	16	0.5171
DENIAL	2020-05-04	4	9	8	12	0.5171
Test Tube Titans: Taster Trial	2020-05-25	11	9	8	19	0.5171
Horror Adventure VR	2020-07-04	5	9	8	13	0.5171
Queen's Garden 2	2020-08-31	5	9	8	13	0.5171
Torchance 6	2020-12-04	22	9	8	30	0.5171
7 Bones and 7 Stones - The Ritual	2020-10-20	18	33	30	48	0.517
Easy Shooter	2020-07-19	8	21	19	27	0.5168
Hasfax	2020-02-13	5	21	19	24	0.5168
Days of War	2020-01-30	796	1005	934	1730	0.5164
Bloodlines of Prima	2020-03-20	13	36	33	46	0.5157
House Flipper VR	2020-11-05	132	135	125	257	0.5156000000000001
GraFi Valentine	2020-02-13	2	10	9	11	0.5156000000000001
Grab the Beat	2020-03-27	5	10	9	14	0.5156000000000001
Son Savaşçı	2020-11-18	1	10	9	10	0.5156000000000001
HENTAI DANCE	2020-02-13	3	24	22	25	0.5149
Unicorn Dream	2020-07-04	2	11	10	12	0.5144
The Picture in The House	2020-12-30	22	55	51	73	0.5142
Gunspell 2	2020-12-11	31	56	52	83	0.514
Agricola	2020-04-13	57	72	67	124	0.5139
Paws and Soul	2020-07-16	19	58	54	73	0.5136000000000001
PST VR (Primary Surgical Treatment)	2020-04-20	6	12	11	17	0.5134000000000001
Battleground	2020-11-10	27	12	11	38	0.5134000000000001
Death Circus	2020-10-15	4	12	11	15	0.5134000000000001
The Yellow King	2020-02-06	55	110	103	158	0.5132
Android Hunter A	2020-11-26	3	13	12	15	0.5125
Sweet House Love	2020-08-13	6	13	12	18	0.5125
Duck Duck Goose	2020-04-30	4	14	13	17	0.5117
Infanticide | インファンティサイド	2020-09-24	7	15	14	21	0.511
BE HUNTED	2020-12-21	20	15	14	34	0.511
Hentai Monster Quiz 2	2020-07-20	4	16	15	19	0.5104
Starpoint Gemini 3	2020-11-05	215	378	361	576	0.5099
Prototype Zordi Mi Lé	2020-09-29	5	17	16	21	0.5099
Alien Shooter 2 - The Legend	2020-01-22	218	478	458	676	0.5093
Somnium Space	2020-02-20	479	41	39	518	0.5092
Black Butterfly	2020-02-07	3	19	18	21	0.509
Ultimate MMA	2020-03-05	8	67	64	72	0.5088
UNKNOWN REGION	2020-08-17	6	22	21	27	0.5079
Walking Girl: Dead Parking	2020-10-03	13	23	22	35	0.5075999999999999
Frostpoint VR: Proving Grounds	2020-12-01	29	24	23	52	0.5073
Dead Motherland: Zombie Co-op	2020-09-21	42	58	56	98	0.5067
锋芒录	2020-12-29	44	59	57	101	0.5065999999999999
Company of Crime	2020-08-08	323	95	92	415	0.5064
Zoo War: Tank Battle - Army & Military Games	2020-08-01	26	29	28	54	0.5062
Doug Flutie's Maximum Football 2020	2020-12-29	29	29	28	57	0.5062
封神纪OL	2020-01-13	21	33	32	53	0.5055
Mechstermination Force	2020-05-23	8	37	36	44	0.505
Hentai Roguelike	2020-05-22	6	48	47	53	0.5039
Drive By Hero	2020-04-14	49	119	118	167	0.5017
Madden NFL 21	2020-08-28	3226	2612	2598	5824	0.5012
SCP: The Foundation	2020-09-02	119	166	165	284	0.5012
Disintegration	2020-06-15	553	342	341	894	0.5006
Who Wants To Be A Millionaire	2020-10-29	57	116	116	173	0.5
Factory Runner	2020-07-28	12	49	49	61	0.5
Flirt	2020-02-13	29	31	31	60	0.5
Elden: Path of the Forgotten	2020-07-09	9	30	30	39	0.5
Mineirinho Wildtides DC	2020-02-04	4	25	25	29	0.5
Deadsiege	2020-01-23	9	23	23	32	0.5
Budo War Girl:maid of desire	2020-01-24	10	23	23	33	0.5
ENCODE	2020-07-17	9	21	21	30	0.5
EMBERZONE	2020-07-18	3	20	20	23	0.5
Dead Warrior Tribute	2020-11-20	4	19	19	23	0.5
Dark Room	2020-07-15	11	17	17	28	0.5
Parked In The Dark	2020-09-01	4	16	16	20	0.5
Dreamstate Racing	2020-05-15	11	16	16	27	0.5
Dezzan	2020-01-29	5	15	15	20	0.5
美少女格斗学院／Beautiful Girl Fight School	2020-03-05	4	15	15	19	0.5
Survival Africa	2020-04-17	15	14	14	29	0.5
Street Sniper	2020-05-13	31	14	14	45	0.5
Planta	2020-08-06	4	14	14	18	0.5
Stay Silent	2020-09-17	7	13	13	20	0.5
The Endless White	2020-05-29	10	13	13	23	0.5
Sokpop S06: Sproots	2020-01-17	9	12	12	21	0.5
Season Match 4	2020-02-20	5	12	12	17	0.5
CRYPTEX	2020-08-14	3	12	12	15	0.5
Chickens Madness	2020-09-09	4	11	11	15	0.5
From The Grave	2020-07-02	4	11	11	15	0.5
Kidnapped! A Royal Birthday	2020-08-20	45	11	11	56	0.5
Bombrigade: Battlegrounds	2020-03-13	34	10	10	44	0.5
Schizophrenia	2020-05-01	3	10	10	13	0.5
Journey To Planet Earth	2020-05-07	8	10	10	18	0.5
Premier Manager 10	2020-04-17	11	10	10	21	0.5
Double Turn	2020-11-06	4	9	9	13	0.5
People	2020-03-07	5	9	9	14	0.5
Little Terror	2020-06-07	3	9	9	12	0.5
Matt's Project Zombies: Open World	2020-12-07	4	9	9	13	0.5
Damned Hand	2020-11-06	2	9	9	11	0.5
UniverCity	2020-02-01	5	8	8	13	0.5
Realms of Darkness	2020-01-30	9	8	8	17	0.5
Foam Dart Frenzy	2020-02-14	5	8	8	13	0.5
Cannabis Farmer Strain Master	2020-11-11	5	8	8	13	0.5
经天纪	2020-08-23	18	8	8	26	0.5
Nostalgiarian	2020-01-05	2	7	7	9	0.5
核能步枪 	2020-04-17	2	7	7	9	0.5
Eagles Expedition	2020-04-28	3	7	7	10	0.5
Guilded	2020-05-27	6	7	7	13	0.5
Honor and Duty: D-Day	2020-07-23	5	7	7	12	0.5
The battle of Visby	2020-08-07	3	7	7	10	0.5
San Diablos	2020-07-22	2	7	7	9	0.5
JungleKnight	2020-10-16	2	7	7	9	0.5
Circle Up	2020-10-14	2	6	6	8	0.5
OMEGA: The Beginning	2020-01-10	2	6	6	8	0.5
Out of Frame / ノベルゲームの枠組みを変えるノベルゲーム。	2020-10-15	22	6	6	28	0.5
Paraiso Island	2020-06-06	6	6	6	12	0.5
Deer Hunter xTreme Focal Plane	2020-07-10	3	6	6	9	0.5
Finding Fido: The Journey	2020-05-22	4	6	6	10	0.5
The Disappearance of the Mitchells	2020-06-03	2	6	6	8	0.5
KOJOUJI	2020-06-08	3	6	6	9	0.5
TheLastWulin	2020-11-16	5	6	6	11	0.5
Castle Grimholt	2020-11-16	2	6	6	8	0.5
Faraway Islands	2020-12-13	5	5	5	10	0.5
Epic Battles of History	2020-08-27	5	5	5	10	0.5
Junk on Wheels	2020-11-02	4	5	5	9	0.5
Sparkle 4 Tales	2020-08-24	3	5	5	8	0.5
The Maze VR	2020-03-19	5	5	5	10	0.5
Web Spice Purple World	2020-03-10	2	5	5	7	0.5
The Tower Of TigerQiuQiu	2020-09-02	2	5	5	7	0.5
Bride for the Princess	2020-10-26	3	5	5	8	0.5
Country Road VR	2020-03-12	2	5	5	7	0.5
4X4 OFF-ROAD CHALLENGE	2020-01-24	1	5	5	6	0.5
Spider Fear	2020-02-04	2	5	5	7	0.5
The Aegis Saga	2020-04-02	21	5	5	26	0.5
What The Bear?	2020-03-06	6	5	5	11	0.5
【救世计划】红衣	2020-08-18	3	5	5	8	0.5
Happy Birthday, Adolf!	2020-05-09	2	5	5	7	0.5
The Game of The Playful	2020-07-16	11	5	5	16	0.5
起源之塔〜地底的欲望探险之旅〜	2020-08-11	4	5	5	9	0.5
Singularity	2020-12-21	2	5	5	7	0.5
Chesnakisnak	2020-10-19	3	5	5	8	0.5
XIBALBA	2020-11-14	2	5	5	7	0.5
Simply Parkour	2020-12-11	1	5	5	6	0.5
White Dandelion	2020-11-20	3	5	5	8	0.5
Shadow Lost	2020-12-16	2	5	5	7	0.5
Punishment Darkness Online	2020-01-28	5	4	4	9	0.5
Another Dawn	2020-01-31	3	4	4	7	0.5
Sokpop S02: huts	2020-01-17	3	4	4	7	0.5
CRUEL WORLD	2020-03-18	2	4	4	6	0.5
The Sentinel	2020-01-10	2	4	4	6	0.5
Position	2020-02-25	2	4	4	6	0.5
Shotgun n Zombies	2020-02-13	3	4	4	7	0.5
Juice Mania	2020-02-07	2	4	4	6	0.5
Tower of the Approval	2020-03-12	6	4	4	10	0.5
Castle of Lust - Hentai Fantasy Game	2020-04-24	3	4	4	7	0.5
Cubecois	2020-06-17	2	4	4	6	0.5
Space Sergeants	2020-03-24	2	4	4	6	0.5
Run!!!	2020-06-23	2	4	4	6	0.5
Axiom Alternative	2020-10-14	1	4	4	5	0.5
Sbeve	2020-06-05	2	4	4	6	0.5
Realms of Eternity	2020-10-30	3	4	4	7	0.5
GOD GAME	2020-06-23	4	4	4	8	0.5
The Rooster's Chess	2020-09-28	4	4	4	8	0.5
Illuminati Simulator VR	2020-07-17	3	4	4	7	0.5
'Member the Alamo?	2020-10-30	2	4	4	6	0.5
Gangster Empire: Vendetta	2020-08-17	6	4	4	10	0.5
Space Monster	2020-08-24	2	4	4	6	0.5
Party Parkade	2020-12-01	5	4	4	9	0.5
The Arena Guy	2020-12-03	3	4	4	7	0.5
Randomlands	2020-09-09	2	4	4	6	0.5
Mint Works	2020-10-09	5	4	4	9	0.5
怪物传奇	2020-09-11	3	4	4	7	0.5
凡人修仙传	2020-10-10	8	4	4	12	0.5
Space Empires I	2020-10-08	1	4	4	5	0.5
The Fishery	2020-10-14	2	4	4	6	0.5
Space Empires II	2020-10-13	4	4	4	8	0.5
Absinth China	2020-11-10	4	4	4	8	0.5
Bloody Sand : The Gods Of Assyria	2020-11-25	2	4	4	6	0.5
Plunker	2020-09-21	2	3	3	5	0.5
Bare Boob Brawlerz Visual Novel: Vol 01	2020-07-10	2	3	3	5	0.5
Survival Hell	2020-09-18	2	3	3	5	0.5
Shopkeepers Tale	2020-04-05	3	3	3	6	0.5
Smart Girl : Christmas	2020-02-02	2	3	3	5	0.5
Naughty Girl	2020-02-04	3	3	3	6	0.5
Zip! Speedster of Valiant City	2020-02-20	7	3	3	10	0.5
Dreamtopia	2020-02-25	2	3	3	5	0.5
Battle of Brains	2020-02-15	3	3	3	6	0.5
PLUGMAX	2020-03-12	19	3	3	22	0.5
Space Redemption	2020-03-03	2	3	3	5	0.5
Forsaken Spire	2020-08-06	2	3	3	5	0.5
SWISCAPE	2020-03-12	2	3	3	5	0.5
Victorian Admirals Panama Crisis 1885	2020-03-09	2	3	3	5	0.5
BallClimbing	2020-03-24	4	3	3	7	0.5
Warehouse attack	2020-05-05	2	3	3	5	0.5
Super Bounce Ball	2020-04-20	2	3	3	5	0.5
Extra Terrestrial Nation	2020-07-31	1	3	3	4	0.5
不二臣	2020-06-17	3	3	3	6	0.5
Music Ball	2020-06-19	2	3	3	5	0.5
Olympus Griddlers	2020-08-05	4	3	3	7	0.5
Born to Kill	2020-06-26	1	3	3	4	0.5
Silenthead: ducks hunt	2020-07-28	2	3	3	5	0.5
Cosmic Zephyr DX	2020-06-24	1	3	3	4	0.5
Flying Fish	2020-07-01	2	3	3	5	0.5
Sharks of Mars: Prologue	2020-07-16	2	3	3	5	0.5
100-Level Dungeon	2020-07-23	2	3	3	5	0.5
Planet Zeta	2020-08-05	2	3	3	5	0.5
Endurance - space shooter	2020-08-30	2	3	3	5	0.5
Super Marble Brothers	2020-08-26	4	3	3	7	0.5
Fill and Cross World Contest	2020-09-18	4	3	3	7	0.5
FireSurvival	2020-11-02	2	3	3	5	0.5
Beat 'Em Up	2020-10-06	2	3	3	5	0.5
MahJong - Medieval Fantasy	2020-10-19	1	3	3	4	0.5
Bring Back The Sun by Daniel da Silva	2020-11-18	2	3	3	5	0.5
GridMath	2020-11-05	7	3	3	10	0.5
Black Lilies - Eternal Summer	2020-12-14	4	3	3	7	0.5
Warring States: Guest Edition	2020-12-23	5	3	3	8	0.5
Lovehammer 400 000	2020-03-27	4	2	2	6	0.5
NOXIAM -miserable sinners-	2020-02-13	3	2	2	5	0.5
Pew Pew Puzzle Defense	2020-02-12	2	2	2	4	0.5
WizardCraft Colonies	2020-09-30	3	2	2	5	0.5
Path Of Aurora	2020-04-08	3	2	2	5	0.5
Cartoon Kreedz	2020-11-25	1	2	2	3	0.5
Later	2020-01-03	2	2	2	4	0.5
TriangleWingXXXX	2020-03-06	2	2	2	4	0.5
Toy Killer	2020-03-13	2	2	2	4	0.5
Tower of Arcana	2020-01-10	3	2	2	5	0.5
Frontier - TRS	2020-01-18	2	2	2	4	0.5
Dark Zone	2020-02-01	1	2	2	3	0.5
Betrayal	2020-03-10	2	2	2	4	0.5
There a no Armadillos in this game	2020-02-14	2	2	2	4	0.5
Apocalypse Age : DESTRUCTION	2020-03-23	2	2	2	4	0.5
Escape From Violet Institute	2020-04-16	2	2	2	4	0.5
One More Shot	2020-04-29	2	2	2	4	0.5
Di[c]E	2020-06-01	3	2	2	5	0.5
Surviving Isolation	2020-06-02	3	2	2	5	0.5
Knife Quest	2020-10-06	2	2	2	4	0.5
FOREST OF THE DEAD	2020-05-13	2	2	2	4	0.5
Motel Murder	2020-06-12	2	2	2	4	0.5
The Hostage	2020-05-16	2	2	2	4	0.5
Einsteins Riddle	2020-06-02	4	2	2	6	0.5
Big City Rigs: Garbage Truck Driver	2020-07-03	3	2	2	5	0.5
Big City Rigs: Bus Driver	2020-07-03	2	2	2	4	0.5
Sunset 20 Drone Racer	2020-06-15	1	2	2	3	0.5
Kingdom of Bees	2020-06-29	1	2	2	3	0.5
Story in the Dream World 2 -Water Gods and Spirits-	2020-10-09	1	2	2	3	0.5
Hakoniwa Sumo	2020-06-27	4	2	2	6	0.5
Hellbreachers	2020-07-28	2	2	2	4	0.5
Corona Kombat	2020-07-29	1	2	2	3	0.5
刷怪模拟器	2020-07-31	3	2	2	5	0.5
Anetona	2020-07-28	2	2	2	4	0.5
《Curse of disaster spirit : Anecdotes of mansion》	2020-08-11	4	2	2	6	0.5
Swordian Hero	2020-08-25	2	2	2	4	0.5
Arwinia	2020-11-04	2	2	2	4	0.5
The logic inside	2020-08-28	1	2	2	3	0.5
MonsterSoft	2020-10-30	6	2	2	8	0.5
VR Time Machine Travelling in history: Visit ancient Egypt, Babylon and Greece in B.C. 400	2020-08-31	2	2	2	4	0.5
Museum Of Extravagance	2020-10-09	3	2	2	5	0.5
Forklift & Box	2020-10-04	1	2	2	3	0.5
Nice to NO you	2020-10-01	2	2	2	4	0.5
Beyond Polaris Guardian	2020-12-01	2	2	2	4	0.5
Oraiah	2020-10-01	5	2	2	7	0.5
Fast Food Simulator	2020-11-11	2	2	2	4	0.5
Knights of Grumthorr	2020-10-21	1	2	2	3	0.5
Ayu - The Dream Soul -	2020-12-25	1	2	2	3	0.5
Obey The Law	2020-11-02	2	2	2	4	0.5
Laser Skirmish	2020-11-22	2	2	2	4	0.5
The Purification	2020-11-20	2	2	2	4	0.5
Paper Tales - Catch Up Games	2020-11-27	2	2	2	4	0.5
The King of the Oceans	2020-12-10	1	2	2	3	0.5
VR Museum Tour Grand Collection	2020-12-08	2	2	2	4	0.5
Ultimate Battle	2020-12-16	3	2	2	5	0.5
Destinata FULL RED	2020-12-23	2	2	2	4	0.5
Demon Killer VR	2020-12-23	1	2	2	3	0.5
Urban Street Fighter	2020-12-24	2	2	2	4	0.5
Havoc Runner	2020-08-04	2	1	1	3	0.5
Order：VR	2020-08-04	1	1	1	2	0.5
Green Dragon	2020-10-20	1	1	1	2	0.5
Homestead	2020-05-05	3	1	1	4	0.5
Terramancer	2020-02-24	2	1	1	3	0.5
Muspell	2020-04-20	3	1	1	4	0.5
Pythagorean Complex	2020-02-05	4	1	1	5	0.5
Simple Fear	2020-03-16	1	1	1	2	0.5
Dinosaur Shakespeare: To Date or Not To Date?	2020-02-13	1	1	1	2	0.5
Madhouse	2020-03-02	2	1	1	3	0.5
Lumen	2020-05-16	1	1	1	2	0.5
[it's possible]	2020-01-06	3	1	1	4	0.5
Euro NumismatCy! Coin Collector	2020-07-06	2	1	1	3	0.5
Victim Cache the RPG	2020-02-12	1	1	1	2	0.5
Radial	2020-02-06	3	1	1	4	0.5
Typing with Sharks	2020-07-20	2	1	1	3	0.5
Bock Bock	2020-04-15	6	1	1	7	0.5
Minigame Blast	2020-03-24	7	1	1	8	0.5
Sea Salt	2020-09-02	3	1	1	4	0.5
THE UNIVERSE	2020-12-17	2	1	1	3	0.5
Luxar	2020-01-08	2	1	1	3	0.5
Cyberception	2020-04-25	2	1	1	3	0.5
Basic Warfare	2020-01-15	2	1	1	3	0.5
ACCEL-X	2020-01-12	4	1	1	5	0.5
Banana for Scale	2020-02-25	1	1	1	2	0.5
Brimhelm	2020-03-31	1	1	1	2	0.5
Little Tennis	2020-01-29	3	1	1	4	0.5
Feeling Square?	2020-11-26	1	1	1	2	0.5
sotas/时空幽灵	2020-02-29	2	1	1	3	0.5
Parameter	2020-02-10	1	1	1	2	0.5
Star Escape	2020-05-22	2	1	1	3	0.5
Men Busters	2020-02-11	2	1	1	3	0.5
Enemy Gates Stealth War	2020-03-27	1	1	1	2	0.5
LilyDeux 警告の黒き百合	2020-02-22	3	1	1	4	0.5
INVISIBLE MAN	2020-06-19	3	1	1	4	0.5
JumPlose	2020-03-05	1	1	1	2	0.5
Belote - Play & Learn	2020-03-08	3	1	1	4	0.5
Fantasy Memory Card Game	2020-03-13	2	1	1	3	0.5
Shinobi no Okite	2020-03-26	1	1	1	2	0.5
Scrolor	2020-03-20	1	1	1	2	0.5
Naturalist Stories	2020-08-02	2	1	1	3	0.5
Squatch	2020-04-08	1	1	1	2	0.5
Spy Story. The Elusive Evidence	2020-09-21	5	1	1	6	0.5
DockYard	2020-03-26	2	1	1	3	0.5
Goofy Golf Remastered Steam Edition	2020-04-01	1	1	1	2	0.5
Legend of Orion: Adventure	2020-05-16	2	1	1	3	0.5
Premier Manager 04/05	2020-07-17	5	1	1	6	0.5
Fire for Effect	2020-04-13	2	1	1	3	0.5
Pandoria	2020-06-26	2	1	1	3	0.5
evolution for beginners	2020-04-27	2	1	1	3	0.5
Discreet	2020-06-04	4	1	1	5	0.5
Tales of Kongfu	2020-07-16	2	1	1	3	0.5
Dangerous Lands 2 - Evil Ascension	2020-10-19	1	1	1	2	0.5
Batu Ta Batu	2020-09-18	4	1	1	5	0.5
Eternal Vortex	2020-06-25	2	1	1	3	0.5
[NTRPG] Xiu Lu Ji 修绿记	2020-05-14	2	1	1	3	0.5
Poly Party	2020-09-01	2	1	1	3	0.5
Late Stage Inferno	2020-09-13	2	1	1	3	0.5
Bikini Alert	2020-10-22	3	1	1	4	0.5
What a Cluster Fight	2020-05-27	1	1	1	2	0.5
Tap-A-Zombie	2020-05-12	1	1	1	2	0.5
Fantasy Mosaics 34: Zen Garden	2020-05-11	7	1	1	8	0.5
Valiantia	2020-06-30	2	1	1	3	0.5
Virus Madness - Dungeons of your Body	2020-05-31	1	1	1	2	0.5
The Rogue Cavern	2020-06-02	2	1	1	3	0.5
The Adventurer - Episode 2: New Dreams	2020-11-16	1	1	1	2	0.5
Lauras Tierklinik	2020-08-06	2	1	1	3	0.5
The Maze	2020-06-13	2	1	1	3	0.5
Nowhere New	2020-07-18	2	1	1	3	0.5
The Oort Cloud 2020	2020-06-12	2	1	1	3	0.5
Cybershow	2020-06-27	3	1	1	4	0.5
Argy Bargy	2020-07-17	1	1	1	2	0.5
Space Fat: To the Core	2020-09-01	1	1	1	2	0.5
MV Mazes	2020-06-18	1	1	1	2	0.5
迷宫：消灭机器人	2020-08-01	2	1	1	3	0.5
CORGIX	2020-07-18	1	1	1	2	0.5
Mad Mosh	2020-08-14	1	1	1	2	0.5
Gude! Jump n Run	2020-08-16	1	1	1	2	0.5
Counter Operation Online	2020-11-02	2	1	1	3	0.5
Dwarven Forge	2020-08-31	3	1	1	4	0.5
Quiz Pro - Guess Pictures	2020-07-22	2	1	1	3	0.5
Dark Farm	2020-07-27	2	1	1	3	0.5
Laedomanes	2020-12-29	1	1	1	2	0.5
Space Soldier	2020-11-11	1	1	1	2	0.5
Ant Force	2020-08-07	1	1	1	2	0.5
This Game Might Improve Your Memory	2020-08-08	4	1	1	5	0.5
Grand Prix Racing On Line	2020-07-30	4	1	1	5	0.5
TCSTRIKERS2	2020-10-06	1	1	1	2	0.5
XOL	2020-10-01	1	1	1	2	0.5
Ants	2020-09-07	3	1	1	4	0.5
Luise and Secret Basement Rooms	2020-08-20	3	1	1	4	0.5
HANG IN ! MONKEY BARS ROBOT	2020-09-15	5	1	1	6	0.5
VIETNAM WAR PLATOON 越战排	2020-09-18	1	1	1	2	0.5
Road Tripper	2020-09-22	1	1	1	2	0.5
人类VS怪物(Human vs Monster)	2020-09-17	2	1	1	3	0.5
Biscuitts 2	2020-12-02	2	1	1	3	0.5
Village businessman	2020-09-28	1	1	1	2	0.5
Buzzle	2020-10-01	2	1	1	3	0.5
High School of Memories	2020-10-07	3	1	1	4	0.5
Zombie's Cool	2020-12-21	2	1	1	3	0.5
DEUS EX MACHINA	2020-11-24	2	1	1	3	0.5
Human Constructor VR	2020-10-12	2	1	1	3	0.5
Nosferatu's Butler	2020-10-09	2	1	1	3	0.5
Abiko The Miko 2	2020-10-08	2	1	1	3	0.5
DON'T WAKE THE NIGHT	2020-10-28	4	1	1	5	0.5
Whiskey Island	2020-12-17	2	1	1	3	0.5
The Pacifist's Great and Final Nightmare 	2020-10-29	1	1	1	2	0.5
ZendoVR	2020-11-09	1	1	1	2	0.5
MUZEGATE	2020-10-28	1	1	1	2	0.5
The Trap: Remastered	2020-11-10	1	1	1	2	0.5
Safe Squares	2020-11-21	1	1	1	2	0.5
Brick Breaker Premium 2	2020-11-11	2	1	1	3	0.5
Snakenpon	2020-11-02	1	1	1	2	0.5
International Tennis Open	2020-11-16	2	1	1	3	0.5
Pixel Game Maker Series STEOS -Sorrow song of Bounty hunter-	2020-11-07	3	1	1	4	0.5
VITATIO 3	2020-12-19	2	1	1	3	0.5
Mythlands: Flappy Dragon	2020-11-10	2	1	1	3	0.5
Simulators2021	2020-11-16	2	1	1	3	0.5
TOKYO LOVE +	2020-11-26	2	1	1	3	0.5
Snow Strike	2020-12-11	1	1	1	2	0.5
Rise of the samurai in VR	2020-11-30	2	1	1	3	0.5
The Santa Paradox	2020-12-07	1	1	1	2	0.5
Adventures of Sadukar - Chapter I	2020-12-04	2	1	1	3	0.5
Lasertron	2020-12-28	1	1	1	2	0.5
Something Strange in the Woods	2020-12-16	2	1	1	3	0.5
ARENIX	2020-12-30	1	1	1	2	0.5
Project RTD: Random Tower Defense PvP	2020-02-18	1331	449	453	1784	0.49810000000000004
Heat	2020-06-26	1422	1424	1449	2871	0.49600000000000005
Pro Basketball Manager 2021	2020-11-04	76	60	62	138	0.49369999999999997
Aquanox Deep Descent	2020-10-16	1248	292	301	1549	0.49350000000000005
Luster	2020-03-13	16	26	27	43	0.49340000000000006
Evolution	2020-11-13	34	26	27	61	0.49340000000000006
Smartphone Tycoon - Lite	2020-04-14	12	25	26	38	0.4932
Atlas Rogues	2020-11-18	231	114	118	349	0.49310000000000004
1971 PROJECT HELIOS	2020-06-09	20	24	25	45	0.4929
Love Puzzle	2020-12-11	1980	137	142	2122	0.4927
Project Existence - Multiplayer Sandbox	2020-10-30	20	23	24	44	0.4927
My Name is Sarah	2020-04-20	5	22	23	28	0.4924
Krakatoa	2020-11-11	5	20	21	26	0.4918
Crafting Idle Clicker	2020-06-04	640	294	306	946	0.4915
Just Chatting	2020-02-14	81	16	17	98	0.4901
Elite Commander	2020-12-01	4	16	17	21	0.4901
Courage and Honor	2020-02-07	7	15	16	23	0.48960000000000004
AKAI NOROI	2020-07-24	6	14	15	21	0.489
the fairytale of DEATH	2020-01-11	4	14	15	19	0.489
Aeternitas	2020-05-28	20	13	14	34	0.4883
Gallic Wars: Battle Simulator	2020-10-30	20	13	14	34	0.4883
Deceased	2020-12-09	2	13	14	16	0.4883
Windy Kingdom	2020-08-11	108	63	67	175	0.4882
Blood Metal	2020-07-17	21	43	46	67	0.4875
Andromeda One	2020-01-20	2	12	13	15	0.4875
F.U.B.A.R	2020-07-05	6	12	13	19	0.4875
Age of ilcoin VR : Retribution	2020-12-07	4	12	13	17	0.4875
BLOCK Multiplayer RPG	2020-03-16	52	88	94	146	0.48700000000000004
Voidspace	2020-07-10	11	11	12	23	0.4866
Galaxy Warfighter	2020-04-16	6	11	12	18	0.4866
Sex Wheel - An Erotic Game	2020-06-26	3	11	12	15	0.4866
WestLand Adventure	2020-07-06	4	11	12	16	0.4866
A Very Bad Christmas Eve	2020-12-18	4	11	12	16	0.4866
黑色沙漠(失效)	2020-06-23	2910	204	218	3128	0.48610000000000003
Astra Exodus	2020-01-30	49	24	26	75	0.48610000000000003
Freight Simulator 	2020-05-22	12	24	26	38	0.48610000000000003
Comic Book Tycoon	2020-03-19	12	23	25	37	0.48560000000000003
Xenociders	2020-04-22	4	10	11	15	0.48560000000000003
The Spirits of Kelley Family	2020-01-31	4	10	11	15	0.48560000000000003
DOUDY	2020-04-28	3	10	11	14	0.48560000000000003
Impossible Mission Remastered	2020-11-09	3	10	11	14	0.48560000000000003
Mask of Sanity	2020-10-23	5	22	24	29	0.4851
DaMing	2020-06-15	379	245	263	642	0.485
Beatdown Brawler	2020-07-30	3	9	10	13	0.4844
界仙 The World Of Xian	2020-07-15	4	9	10	14	0.4844
Cascading Failure	2020-07-17	6	9	10	16	0.4844
Milkyway Funland	2020-12-15	8	9	10	18	0.4844
美足按摩师	2020-11-13	14	20	22	36	0.4839
战神七魄	2020-02-04	14	8	9	23	0.4829
Femdom Stories: Findom Simulator Sex Game	2020-02-26	10	8	9	19	0.4829
Encore Classic Casino Games	2020-10-05	8	8	9	17	0.4829
Bloodwych	2020-03-26	4	8	9	13	0.4829
Sleeping Beauty	2020-06-29	2	8	9	11	0.4829
ヴァルキリーコネクト	2020-04-10	341	8	9	350	0.4829
Cursed Mummies	2020-07-03	3	8	9	12	0.4829
Phoenix Squadron	2020-12-23	3	8	9	12	0.4829
Cyber Fight Challenge	2020-09-10	5	18	20	25	0.48240000000000005
Cyber Ops	2020-05-21	48	48	53	101	0.4814
Brunswick Pro Billiards	2020-10-14	7	7	8	15	0.4811
ENEFN	2020-07-23	3	7	8	11	0.4811
Juicy Memory Card	2020-07-02	2	7	8	10	0.4811
Stealthy ninja	2020-08-13	6	7	8	14	0.4811
The Wednesday	2020-11-30	75	57	63	138	0.48090000000000005
Questinarium	2020-04-17	7	16	18	25	0.4807
Half-Life 2: Genry's Great Escape From City 13	2020-06-23	17	382	418	435	0.4805
PANIC STATION	2020-08-25	12	25	28	40	0.4802
Infestation: Battle Royale	2020-03-04	176	136	150	326	0.48
Heavens Tournament	2020-10-17	4	15	17	21	0.4797
RC Flight Simulator 2020 VR	2020-05-11	8	15	17	25	0.4797
6th Dimension	2020-09-25	4	15	17	21	0.4797
Empire of Sin	2020-12-01	9229	2598	2838	12067	0.4796
The Horus Heresy: Betrayal At Calth	2020-05-28	18	52	58	76	0.4793
Darkness Rollercoaster - Ultimate Shooter Edition	2020-07-24	3	6	7	10	0.4789
傲剑情缘	2020-11-13	6	6	7	13	0.4789
Intelligence Operation	2020-12-25	3	6	7	10	0.4789
传奇世界之仗剑天涯H5	2020-12-15	90	41	46	136	0.47869999999999996
Shuttle Commander	2020-11-30	7	14	16	23	0.47850000000000004
Ultimo Reino 2	2020-04-13	15	14	16	31	0.47850000000000004
Agoraphobia	2020-09-30	6	14	16	22	0.47850000000000004
Is It Wrong to Try to Pick Up Girls in a Dungeon? Infinite Combate	2020-08-10	117	143	159	276	0.4783
武侠乂	2020-04-28	5075	1673	1841	6916	0.4781
Death World	2020-05-24	7	22	25	32	0.478
General War Memories	2020-08-01	21	13	15	36	0.4772
Guns Boy	2020-10-15	4	13	15	19	0.4772
Sufoco	2020-02-13	3	5	6	9	0.4761
Pakicetus	2020-08-07	3	5	6	9	0.4761
Think_	2020-12-24	2	5	6	8	0.4761
Vicious Gambling Agreement	2020-03-06	3	5	6	9	0.4761
Sea Fishing Simulator	2020-02-20	5	5	6	11	0.4761
Obelisk	2020-02-28	3	5	6	9	0.4761
The Last Bee	2020-05-02	5	5	6	11	0.4761
Little machines world	2020-03-22	2	5	6	8	0.4761
Get Out...	2020-03-26	4	5	6	10	0.4761
Freakshow	2020-04-30	5	5	6	11	0.4761
Rary	2020-04-24	2	5	6	8	0.4761
Devil's dream	2020-05-23	4	5	6	10	0.4761
logiCally	2020-05-26	5	5	6	11	0.4761
Factory of Sweets	2020-07-08	2	5	6	8	0.4761
The Falling Tower	2020-07-15	3	5	6	9	0.4761
Sokpop S09: Rock Paper Sock	2020-09-16	4	5	6	10	0.4761
The first confrontation	2020-09-20	2	5	6	8	0.4761
Sweet Tooth 3	2020-09-04	2	5	6	8	0.4761
Truck Truck	2020-09-24	2	5	6	8	0.4761
Paranormal Stories	2020-09-28	3	5	6	9	0.4761
DARK MAGIC	2020-11-03	2	5	6	8	0.4761
Ambient Channels	2020-10-25	3	5	6	9	0.4761
Panic Attack	2020-11-20	2	5	6	8	0.4761
Pretty Girls and Dark Witch. A simple story	2020-12-25	3	5	6	9	0.4761
Aggressive Robot Vacuum	2020-12-25	3	5	6	9	0.4761
ESCAPE POINT	2020-05-22	7	12	14	21	0.4758
FAST & FURIOUS CROSSROADS	2020-08-06	54	72	82	136	0.4746
Terracosmic	2020-05-27	4	11	13	17	0.47409999999999997
Cube Worlds Survival	2020-09-16	3	11	13	16	0.47409999999999997
Apocalypse: 2.0 Edition	2020-05-11	5	17	20	25	0.473
Under Domain	2020-10-22	24	37	43	67	0.47250000000000003
ROBOTIX: The Escape	2020-01-31	4	10	12	16	0.4722
小镇放置修仙	2020-02-22	17	10	12	29	0.4722
SEX Office Story	2020-06-20	6	10	12	18	0.4722
Raygun Commando VR 2	2020-01-05	3	4	5	8	0.4722
Pixelfence	2020-02-01	2	4	5	7	0.4722
PROXY	2020-04-02	5	4	5	10	0.4722
EscapeVr	2020-09-01	2	4	5	7	0.4722
Escape Room VR: Inner Voices	2020-07-10	4	4	5	9	0.4722
SIGNAL	2020-07-21	2	4	5	7	0.4722
MBHL20	2020-08-21	3	4	5	8	0.4722
Just Old	2020-11-18	3	4	5	8	0.4722
Schoolmates: The Mystery of the Magical Bracelet	2020-12-11	2	4	5	7	0.4722
JunkYard Prologue	2020-09-03	356	211	241	597	0.4721
Raidfield 2	2020-11-19	8	36	42	50	0.4719
魅魔的冒险生活	2020-11-18	11	16	19	30	0.4717
AIR WARS	2020-11-30	4	9	11	15	0.47000000000000003
Aim Master H	2020-06-25	2	9	11	13	0.47000000000000003
Desirable	2020-08-13	4	9	11	15	0.47000000000000003
Torchlight III	2020-10-13	5692	4953	5636	11328	0.4697
WWII: Rising	2020-10-16	16	32	38	54	0.469
6 PEOPLE	2020-03-27	5	20	24	29	0.469
VALHALL: Harbinger	2020-10-23	44	146	170	214	0.4687
Сон	2020-09-08	4	14	17	21	0.4687
人工智能 阿尔法猫-AI Alpha Cat	2020-04-09	100	48	57	157	0.46770000000000006
READY AIM FIRE	2020-09-15	5	8	10	15	0.4673
Strip Black Jack - In The Pub	2020-10-23	10	8	10	20	0.4673
Broken Ecchi Gallery	2020-12-04	2	8	10	12	0.4673
Ash Asylum	2020-05-23	5	13	16	21	0.4669
Fasaria World: Ancients of Moons	2020-02-03	2	3	4	6	0.4668
The Mars Agenda	2020-07-27	3	3	4	7	0.4668
Planet	2020-08-20	3	3	4	7	0.4668
Sokpop S03: Hoppa	2020-01-17	2	3	4	6	0.4668
THE VR CANYON	2020-01-07	2	3	4	6	0.4668
Automaton	2020-08-03	6	3	4	10	0.4668
Kowi Ishto: Battle of Akonoli	2020-06-01	1	3	4	5	0.4668
Forest monster	2020-02-29	2	3	4	6	0.4668
Hentai Warfare	2020-03-11	2	3	4	6	0.4668
猎魔战纪	2020-03-21	6	3	4	10	0.4668
Choco Pixel 4	2020-04-07	3	3	4	7	0.4668
Smelted Kin	2020-08-07	2	3	4	6	0.4668
Corona Find Us	2020-06-11	5	3	4	9	0.4668
Keyboard Piano-ist	2020-07-01	27	3	4	31	0.4668
MORTE	2020-10-23	2	3	4	6	0.4668
Survive	2020-07-19	138	3	4	142	0.4668
Catch It	2020-07-12	2	3	4	6	0.4668
Abyss of Death	2020-08-24	2	3	4	6	0.4668
Stormblades	2020-09-08	2	3	4	6	0.4668
Electioneering	2020-10-21	3	3	4	7	0.4668
Tale of an Apocalypse	2020-10-14	4	3	4	8	0.4668
幻刃录	2020-10-16	3	3	4	7	0.4668
Indiecalypse	2020-05-29	11	18	22	33	0.46630000000000005
Drawn to Life: Two Realms	2020-12-07	174	103	122	296	0.466
Picross Love	2020-01-17	8	23	28	36	0.46590000000000004
Christmas Adventures: A Winter Night's Dream	2020-12-22	11	23	28	39	0.46590000000000004
Live Empire	2020-11-13	938	124	147	1085	0.4654
A Year Of Rain	2020-03-13	244	283	333	577	0.46530000000000005
尸灾-生还者	2020-03-26	136	17	21	157	0.4648
Mist of the Undead	2020-09-29	2	12	15	17	0.4648
平妖奇谭 Kungfu & Monster	2020-07-20	14	22	27	41	0.4647
Emily Archer and the Curse of Tutankhamun	2020-01-23	5	7	9	14	0.46409999999999996
Pinball Lockdown	2020-04-17	3	7	9	12	0.46409999999999996
Dimensions VIP	2020-02-06	25	21	26	51	0.46340000000000003
My Lil Horror	2020-07-22	9	16	20	29	0.4632
暗黑MU	2020-02-17	47	11	14	61	0.4625
Hentai Demon	2020-04-04	3	11	14	17	0.4625
Porn Star Island	2020-04-26	5	11	14	19	0.4625
Fox's Holiday / 狐の假期	2020-12-03	5	11	14	19	0.4625
Mr. Parkour 3	2020-11-17	5	11	14	19	0.4625
Hentai Monster Quiz	2020-06-12	4	20	25	29	0.462
ANAREA Battle Royale	2020-08-14	5547	842	1004	6551	0.4607
Descent of Man	2020-10-22	5	6	8	13	0.46020000000000005
Advancity	2020-04-22	7	6	8	15	0.46020000000000005
Secret House	2020-03-20	6	6	8	14	0.46020000000000005
Software House Simulator	2020-05-06	4	6	8	12	0.46020000000000005
LiveOnIdol	2020-07-21	4	6	8	12	0.46020000000000005
2048 art	2020-11-15	3	6	8	11	0.46020000000000005
Era of Survival	2020-02-17	5	10	13	18	0.4598
Mr. Parkour 2	2020-11-13	7	10	13	20	0.4598
World Process	2020-09-09	31	14	18	49	0.4593
White Wings ホワイトウィングス	2020-07-17	33	59	73	106	0.45909999999999995
Kung Fu All-Star VR	2020-01-20	2	2	3	5	0.4583
Hero Swing VR	2020-11-12	2	2	3	5	0.4583
Storms	2020-02-12	2	2	3	5	0.4583
Castra	2020-02-20	2	2	3	5	0.4583
The Missing Few	2020-10-30	2	2	3	5	0.4583
Adams Ascending	2020-11-23	2	2	3	5	0.4583
Sokpop S02: Botanik	2020-01-17	2	2	3	5	0.4583
Alexis Almighty: Daughter of Hercules	2020-05-28	8	2	3	11	0.4583
you are pig sitter	2020-01-23	2	2	3	5	0.4583
Iveri: The 1.000 Story	2020-03-14	1	2	3	4	0.4583
Tanks 2020	2020-01-29	2	2	3	5	0.4583
Nonogram Animal Griddlers	2020-02-21	3	2	3	6	0.4583
Blendy 2 Dolls Factory	2020-02-20	1	2	3	4	0.4583
Seek Girl 2	2020-02-18	2	2	3	5	0.4583
GOBS - Game Of Battle Simulation	2020-04-02	2	2	3	5	0.4583
Victorian Admirals Samoan Crisis 1889	2020-03-09	2	2	3	5	0.4583
Chessmates	2020-04-21	1	2	3	4	0.4583
Prisoner Breaker	2020-04-14	6	2	3	9	0.4583
Two Bit Hero	2020-05-22	2	2	3	5	0.4583
Bubble With Djealy	2020-08-06	2	2	3	5	0.4583
Apollo Lunar Mission	2020-06-04	2	2	3	5	0.4583
Road To Death	2020-05-20	3	2	3	6	0.4583
City Sniper	2020-08-04	2	2	3	5	0.4583
Rider's World: I Want To Ride!	2020-07-31	3	2	3	6	0.4583
Slams City. Hitler's Escape.	2020-07-14	1	2	3	4	0.4583
Cell Defender	2020-06-17	3	2	3	6	0.4583
画江湖之杯莫停	2020-07-03	6	2	3	9	0.4583
Spirit of dungeon	2020-07-15	4	2	3	7	0.4583
Child of Abyss	2020-08-03	2	2	3	5	0.4583
Lucid Steam	2020-09-15	4	2	3	7	0.4583
Family Quiz	2020-07-31	2	2	3	5	0.4583
Data mining X	2020-07-31	2	2	3	5	0.4583
Escape From Monsterland	2020-10-12	2	2	3	5	0.4583
Halloween world	2020-08-28	3	2	3	6	0.4583
Forever Night	2020-12-22	2	2	3	5	0.4583
Arc Wizards	2020-09-22	1	2	3	4	0.4583
travelsolar	2020-10-03	2	2	3	5	0.4583
Geometry Rocket	2020-10-01	1	2	3	4	0.4583
Stars Force	2020-09-29	2	2	3	5	0.4583
Zone of Death	2020-10-12	3	2	3	6	0.4583
Air Gun Fighter	2020-10-05	3	2	3	6	0.4583
Super Match	2020-11-13	2	2	3	5	0.4583
Street Massacre	2020-11-01	1	2	3	4	0.4583
Temptations X	2020-11-10	2	2	3	5	0.4583
Break Sky	2020-12-31	3	2	3	6	0.4583
VR Bike Tour/Exercise in 22nd Century World	2020-12-21	1	2	3	4	0.4583
Fun Christmas Santa VR	2020-12-23	4	2	3	7	0.4583
Lustful Valley	2020-04-28	15	93	115	130	0.45770000000000005
The Viking Way	2020-10-11	95	148	182	277	0.4575
Café Rouge	2020-07-01	17	21	27	44	0.4569
Mushroom Challenge	2020-07-23	3	21	27	30	0.4569
Sokpop S01: Moeras	2020-01-17	4	9	12	16	0.45670000000000005
Book of Beasts	2020-11-19	8	9	12	20	0.45670000000000005
Clicker Age	2020-01-13	2	9	12	14	0.45670000000000005
Mod and Play	2020-04-20	656	747	910	1566	0.4561
Gleamlight	2020-08-20	54	49	62	116	0.4556
Andromeda One Zombies	2020-07-15	4	24	31	35	0.45530000000000004
On Target VR Darts	2020-12-23	3	5	7	10	0.45520000000000005
Space Avengers	2020-09-21	3	5	7	10	0.45520000000000005
Fantastic Fishing	2020-04-16	15	5	7	22	0.45520000000000005
Dark Space	2020-05-08	4	5	7	11	0.45520000000000005
欢乐消消乐	2020-06-09	4	5	7	11	0.45520000000000005
Beauty Shooter	2020-07-13	2	5	7	9	0.45520000000000005
Milky Strike	2020-08-27	3	5	7	10	0.45520000000000005
余烬	2020-10-03	4	5	7	11	0.45520000000000005
Hover Ship	2020-12-31	2	5	7	9	0.45520000000000005
Gone: Survival	2020-10-20	14	60	76	90	0.4546
Hollywood Hero	2020-12-08	4	12	16	20	0.4545
LURE	2020-07-24	37	27	35	72	0.454
Unsung Story	2020-12-17	61	23	30	91	0.45380000000000004
Coloniam	2020-01-25	5	11	15	20	0.4516
深海	2020-03-06	390	280	353	743	0.45060000000000006
Aeronautica Imperialis: Flight Command	2020-05-28	142	82	106	248	0.44930000000000003
Orange Cast: Prologue	2020-12-24	15	45	59	74	0.44930000000000003
幻想小镇危机	2020-03-23	3	7	10	13	0.4487
VR0GU3	2020-05-01	4	4	6	10	0.4486
Jinga Online	2020-02-17	8	4	6	14	0.4486
The Curse of Zigoris	2020-04-02	4	4	6	10	0.4486
Captive	2020-05-10	2	4	6	8	0.4486
Divinest Light	2020-11-11	2	4	6	8	0.4486
ElementalsFight	2020-12-30	3	4	6	9	0.4486
Park The Car	2020-12-01	3	4	6	9	0.4486
The Skylia Prophecy	2020-11-20	2	4	6	8	0.4486
Your way	2020-11-17	2	4	6	8	0.4486
Fiendish Thieves	2020-12-22	2	4	6	8	0.4486
Street Power Football	2020-08-25	26	30	40	66	0.4484
Under Shelter	2020-05-29	16	10	14	30	0.4483
Total Dark	2020-08-10	5	10	14	19	0.4483
The Walking Dead Onslaught	2020-09-29	653	420	538	1191	0.4462
Curse Lsland	2020-08-26	3	12	17	20	0.4448
Tennis World Tour 2	2020-09-24	120	114	150	270	0.44450000000000006
FukTopia	2020-08-11	2	6	9	11	0.4434
Zombie World Apocalypse VR	2020-04-03	3	6	9	12	0.4434
匿名信：失心者 / Stayer	2020-01-02	3	6	9	12	0.4434
Firefighters - Airport Heroes	2020-09-29	5	6	9	14	0.4434
Boston AInamics	2020-05-18	3	6	9	12	0.4434
SkyLife: VoxelSurvival	2020-11-09	3	6	9	12	0.4434
Dato of Srivijaya	2020-12-14	2	6	9	11	0.4434
Zball V	2020-11-17	5	6	9	14	0.4434
Young Archaeologist	2020-11-22	4	6	9	13	0.4434
SnowBall FPS	2020-03-03	4	1	2	6	0.44310000000000005
Tootinis	2020-11-29	2	1	2	4	0.44310000000000005
Tall Order	2020-12-04	2	1	2	4	0.44310000000000005
Run	2020-05-01	3	1	2	5	0.44310000000000005
What The Fork	2020-10-15	5	1	2	7	0.44310000000000005
Wild Cats of Wasteland	2020-01-30	1	1	2	3	0.44310000000000005
SushiVR	2020-07-10	3	1	2	5	0.44310000000000005
Taboos: Flower	2020-01-06	2	1	2	4	0.44310000000000005
Layers Of The Machine	2020-07-16	2	1	2	4	0.44310000000000005
The Tree	2020-11-12	3	1	2	5	0.44310000000000005
WELCOME	2020-02-12	3	1	2	5	0.44310000000000005
Light Trail Rush	2020-07-13	6	1	2	8	0.44310000000000005
Galactic Management	2020-01-03	2	1	2	4	0.44310000000000005
遠古大陸外傳-古道的盡頭	2020-05-14	3	1	2	5	0.44310000000000005
GameBook	2020-03-15	1	1	2	3	0.44310000000000005
Kontrol Flow	2020-12-14	2	1	2	4	0.44310000000000005
The Game We All Have To Play	2020-02-03	2	1	2	4	0.44310000000000005
Prens Cavid The Game	2020-01-02	1	1	2	3	0.44310000000000005
Kamtris	2020-05-12	1	1	2	3	0.44310000000000005
Better Boyfriend	2020-03-14	1	1	2	3	0.44310000000000005
Mompreneur: Pizza Cooking Life Sim	2020-01-03	3	1	2	5	0.44310000000000005
Xylith	2020-03-07	2	1	2	4	0.44310000000000005
Strings	2020-01-06	1	1	2	3	0.44310000000000005
Network E.L.E.	2020-03-13	1	1	2	3	0.44310000000000005
Underground Miner	2020-02-03	1	1	2	3	0.44310000000000005
Where's Home?	2020-04-23	1	1	2	3	0.44310000000000005
Invaden	2020-07-27	3	1	2	5	0.44310000000000005
Corporated Robots Wars	2020-02-13	1	1	2	3	0.44310000000000005
TheWandererVR	2020-02-20	1	1	2	3	0.44310000000000005
Me and (My) Cat's Castle	2020-02-21	1	1	2	3	0.44310000000000005
UNNAMED	2020-03-02	1	1	2	3	0.44310000000000005
Death courier	2020-05-13	2	1	2	4	0.44310000000000005
Wire up!	2020-05-19	136	1	2	138	0.44310000000000005
SUPERHERO-X [Alpha Edition]	2020-06-15	2	1	2	4	0.44310000000000005
Skitt	2020-08-24	2	1	2	4	0.44310000000000005
Day and Night	2020-04-12	5	1	2	7	0.44310000000000005
Elva the Eco Dragon	2020-12-18	2	1	2	4	0.44310000000000005
Catovania	2020-06-03	2	1	2	4	0.44310000000000005
A Rabbit and the Mystic Fog	2020-09-15	1	1	2	3	0.44310000000000005
Aldroy - Chapter 1	2020-05-01	2	1	2	4	0.44310000000000005
TCSTRIKERS3	2020-05-27	1	1	2	3	0.44310000000000005
Vaporwave Road VR	2020-05-18	2	1	2	4	0.44310000000000005
Parabolus Two	2020-08-28	1	1	2	3	0.44310000000000005
Nightmare Simulator 2 Rebirth	2020-06-03	2	1	2	4	0.44310000000000005
Time Of Special Team(T.O.S.T)	2020-06-02	1	1	2	3	0.44310000000000005
话术	2020-07-18	2	1	2	4	0.44310000000000005
CHV: VR Trunk Escape	2020-08-07	3	1	2	5	0.44310000000000005
Space Castle	2020-11-17	1	1	2	3	0.44310000000000005
Zombie School Survival	2020-07-13	2	1	2	4	0.44310000000000005
The Horrors at Castle Wülhein	2020-07-13	2	1	2	4	0.44310000000000005
회사 키우기	2020-09-28	4	1	2	6	0.44310000000000005
Snake In The Cube	2020-12-17	2	1	2	4	0.44310000000000005
Zombie Frenzy	2020-08-31	2	1	2	4	0.44310000000000005
Pac vs Ghosts	2020-07-14	1	1	2	3	0.44310000000000005
Spirit Messages	2020-07-28	1	1	2	3	0.44310000000000005
Kaiju Krashers	2020-08-15	1	1	2	3	0.44310000000000005
Hunted	2020-09-05	1	1	2	3	0.44310000000000005
The Call Centre	2020-08-22	2	1	2	4	0.44310000000000005
Grand Father ISLAND	2020-08-19	2	1	2	4	0.44310000000000005
Hate Wave	2020-09-03	1	1	2	3	0.44310000000000005
Hentai Babe Buffy	2020-08-31	3	1	2	5	0.44310000000000005
Galaxy in Peril: Time Trouble	2020-10-01	2	1	2	4	0.44310000000000005
EPEJSODION Dodgeball Defense	2020-09-03	2	1	2	4	0.44310000000000005
ODDITYGIRLs: Virtual World	2020-10-23	8	1	2	10	0.44310000000000005
RENEGADE	2020-10-02	83	1	2	85	0.44310000000000005
Silence in the Dark	2020-11-10	1	1	2	3	0.44310000000000005
Sweet Time	2020-11-19	2	1	2	4	0.44310000000000005
Traveler of Artcaster	2020-09-21	2	1	2	4	0.44310000000000005
VR Maze	2020-10-10	1	1	2	3	0.44310000000000005
Heart World	2020-12-25	2	1	2	4	0.44310000000000005
MVorpheus	2020-10-22	2	1	2	4	0.44310000000000005
The Summoner	2020-10-08	2	1	2	4	0.44310000000000005
Divide & Conquer	2020-12-22	1	1	2	3	0.44310000000000005
Jigsaw Tour	2020-11-23	3	1	2	5	0.44310000000000005
Jump Again!	2020-10-23	2	1	2	4	0.44310000000000005
Too Different	2020-10-09	14	1	2	16	0.44310000000000005
Puzzle Bowling	2020-11-27	2	1	2	4	0.44310000000000005
Terra Bomber	2020-10-28	1	1	2	3	0.44310000000000005
Vortex Escape	2020-11-24	1	1	2	3	0.44310000000000005
Construction Playground	2020-12-08	2	1	2	4	0.44310000000000005
Orlando the Fireman	2020-11-05	1	1	2	3	0.44310000000000005
Auto Island	2020-11-29	2	1	2	4	0.44310000000000005
jetPIN	2020-11-20	1	1	2	3	0.44310000000000005
Kris Kringle's Christmas Village VR	2020-12-15	5	1	2	7	0.44310000000000005
The Lost Shrine - Escape Room	2020-11-18	3	1	2	5	0.44310000000000005
Eugenes Dream The Daily Ins And Outs Of A Sane Robot In An Insane World	2020-11-28	1	1	2	3	0.44310000000000005
Lantern Light VR	2020-12-01	1	1	2	3	0.44310000000000005
Model City	2020-11-08	2	1	2	4	0.44310000000000005
Shotgun, Dungeons, Laser Traps	2020-11-23	1	1	2	3	0.44310000000000005
X遊戲	2020-12-02	1	1	2	3	0.44310000000000005
Variable	2020-12-14	2	1	2	4	0.44310000000000005
Brutality club	2020-12-11	2	1	2	4	0.44310000000000005
Cafe Simulator	2020-12-22	1	1	2	3	0.44310000000000005
RunningMarty	2020-12-13	2	1	2	4	0.44310000000000005
Pixelum	2020-10-01	7	23	32	39	0.4425
CODE SHIFTER	2020-01-30	27	22	31	58	0.44060000000000005
War Saber	2020-05-06	3	8	12	15	0.44
Sokpop S07: Uniseas	2020-02-23	9	8	12	21	0.44
Fast Typing Master	2020-10-28	3	8	12	15	0.44
Mushroom Picker Simulator	2020-08-19	11	16	23	34	0.43979999999999997
Manipulate: Sacrifice	2020-08-12	2	3	5	7	0.43950000000000006
SexyHub ❤️	2020-04-06	2	3	5	7	0.43950000000000006
Reconstruction	2020-03-10	2	3	5	7	0.43950000000000006
HENTAI RESORT - Dream Paradise	2020-03-05	5	3	5	10	0.43950000000000006
Live To Win	2020-02-13	1	3	5	6	0.43950000000000006
BloodRelation_Part1	2020-03-03	5	3	5	10	0.43950000000000006
War for Magincia	2020-06-04	28	3	5	33	0.43950000000000006
Help Me Now	2020-03-27	2	3	5	7	0.43950000000000006
Chronicles of Honor	2020-04-17	3	3	5	8	0.43950000000000006
Shoot Covid-19	2020-09-03	1	3	5	6	0.43950000000000006
INVASION	2020-04-16	2	3	5	7	0.43950000000000006
Undead Run	2020-05-28	3	3	5	8	0.43950000000000006
Drive & Drift	2020-05-22	3	3	5	8	0.43950000000000006
Viking Idle	2020-09-04	5	3	5	10	0.43950000000000006
Damien	2020-10-29	2	3	5	7	0.43950000000000006
Jump With Dragons	2020-11-24	2	3	5	7	0.43950000000000006
Relax Memory Game	2020-12-16	3	3	5	8	0.43950000000000006
Beat The Moles	2020-12-26	3	3	5	8	0.43950000000000006
VELUCITY	2020-06-16	42	41	57	99	0.4388
Fallen Region	2020-11-02	11	46	64	75	0.438
Bellatia	2020-05-07	10	18	26	36	0.438
Zombie Crisis	2020-02-24	3	5	8	11	0.4368
Aeioth	2020-06-21	8	5	8	16	0.4368
Saturn Quest: Shadow of Planetus	2020-04-14	2	5	8	10	0.4368
My Isekai After Life is a romantic comedy RPG game!?	2020-07-17	2	5	8	10	0.4368
Throw It	2020-11-24	6	5	8	14	0.4368
Our Way	2020-08-16	5	5	8	13	0.4368
Hentai Fighter	2020-10-07	4	5	8	12	0.4368
Chill IV	2020-12-04	2	5	8	10	0.4368
Nerved	2020-05-28	3	7	11	14	0.4347
War of the Barrenlands	2020-09-01	3	7	11	14	0.4347
炎黄大陆	2020-02-27	8	7	11	19	0.4347
Hanapon Princess	2020-07-20	3	7	11	14	0.4347
Sex Quest	2020-12-04	8	7	11	19	0.4347
Pripyat-3	2020-12-03	4	7	11	15	0.4347
Crucible	2020-05-21	25145	4713	6237	31382	0.43460000000000004
Pizza Delivery Boy	2020-05-30	4	9	14	18	0.43310000000000004
Hentai Girls VR	2020-08-15	4	9	14	18	0.43310000000000004
Sokpop S06: sokbots	2020-01-17	13	11	17	30	0.43170000000000003
Kingdom of Corrupts	2020-06-17	2	11	17	19	0.43170000000000003
Witching Tower: Heroes	2020-04-29	3	6	10	13	0.4283
Boston Nursing Home	2020-09-16	5	6	10	15	0.4283
TITAN HUNTER	2020-02-17	3	4	7	10	0.4282
Gun Chain	2020-05-01	2	4	7	9	0.4282
Broken of Darkness	2020-02-09	5	4	7	12	0.4282
WWII Partisanen	2020-07-13	3	4	7	10	0.4282
The Benjamins	2020-09-06	12	4	7	19	0.4282
Curling On Line	2020-07-29	3	4	7	10	0.4282
The Beast of Stormy Forest	2020-09-29	2	4	7	9	0.4282
Zball II	2020-09-09	4	4	7	11	0.4282
Interactive Empathy	2020-12-04	2	4	7	9	0.4282
Sweet Honey	2020-11-25	6	4	7	13	0.4282
A letter to you	2020-09-24	4	8	13	17	0.4279
Art of Boxing	2020-03-09	9	28	42	51	0.4277
Explore Girl · Rope Sprite / 探险少女·缚姬索	2020-08-07	11	10	16	27	0.4274
Warsworn: DRAGON OF JAPAN - EMPIRE EDITION	2020-05-25	7	12	19	26	0.4269
PORN Handyman VR	2020-07-17	4	14	22	26	0.4264
The Seeker	2020-08-20	4	2	4	8	0.4261
Colonies End	2020-08-03	2	2	4	6	0.4261
Next Hand Master	2020-01-16	2	2	4	6	0.4261
Demolition Expert - The Simulation	2020-11-24	4	2	4	8	0.4261
Treasure Tomb VR	2020-07-31	4	2	4	8	0.4261
SEN: Seven Eight Nine	2020-02-06	4	2	4	8	0.4261
Arktrum	2020-10-15	1	2	4	5	0.4261
Terra Incognita	2020-01-28	1	2	4	5	0.4261
Economica	2020-03-02	1	2	4	5	0.4261
長星 Long Star	2020-02-26	2	2	4	6	0.4261
VE GSIM Overhead Crane Simulator	2020-02-24	4	2	4	8	0.4261
Quick Trivia	2020-03-17	4	2	4	8	0.4261
Cyber Driver VR	2020-03-27	2	2	4	6	0.4261
Planet 2000	2020-04-30	3	2	4	7	0.4261
Color Crush	2020-04-22	3	2	4	7	0.4261
EPICA	2020-12-10	2	2	4	6	0.4261
Mobocratic	2020-04-30	3	2	4	7	0.4261
Hidden	2020-07-13	3	2	4	7	0.4261
THE Z LAND : FPS SURVIVAL	2020-06-07	2	2	4	6	0.4261
Angkor: Celebrations	2020-07-22	3	2	4	7	0.4261
Super Huey III	2020-10-16	2	2	4	6	0.4261
My Mind Ghost	2020-07-03	2	2	4	6	0.4261
Adventure Farm VR	2020-07-01	2	2	4	6	0.4261
Discovery Yard Investigation	2020-08-21	2	2	4	6	0.4261
Picross Beach Paradise	2020-09-04	5	2	4	9	0.4261
Astrotour VR	2020-09-23	2	2	4	6	0.4261
Factorization	2020-10-06	6	2	4	10	0.4261
Solicitude Wake-up	2020-11-09	2	2	4	6	0.4261
Arcade games collection	2020-11-26	2	2	4	6	0.4261
The Legend of Arcadieu 2	2020-11-02	1	2	4	5	0.4261
Wicked Rails VR	2020-12-10	2	2	4	6	0.4261
BoatMan	2020-12-16	2	2	4	6	0.4261
VR Luxury Life (Be a Billionaire)	2020-12-29	2	2	4	6	0.4261
Rebirth Online	2020-08-04	178	120	173	351	0.42590000000000006
Loco Parentis VR	2020-03-13	7	13	21	28	0.4227
Emerald Lake	2020-07-27	6	11	18	24	0.4227
T.A.R.S	2020-03-02	5	9	15	20	0.42240000000000005
Hentai Splash	2020-03-26	3	9	15	18	0.42240000000000005
InvaderSwarm	2020-12-16	3	9	15	18	0.42240000000000005
Dragon and Weed: Origins - Prologue	2020-08-28	4	7	12	16	0.4218
Spartan Commander Realtime	2020-03-31	3	5	9	12	0.4204
去死吧蝙蝠	2020-03-02	2	5	9	11	0.4204
Rip Them Off	2020-09-24	8	5	9	17	0.4204
Gun Master	2020-06-04	2	5	9	11	0.4204
Perv Simulator VR	2020-07-10	4	5	9	13	0.4204
Wolf Territory	2020-07-15	2	5	9	11	0.4204
Aeon blood	2020-08-31	3	5	9	12	0.4204
DIG THE GROUND	2020-10-15	5	5	9	14	0.4204
Hollywood Hero: Comeback	2020-12-10	2	5	9	11	0.4204
街机金蟾捕鱼2	2020-10-12	42	22	35	77	0.41960000000000003
THE INSIDER	2020-05-26	6	18	29	35	0.41950000000000004
NBA 2K21	2020-09-04	31826	16300	22893	54719	0.4194
Underfire	2020-07-19	4	10	17	21	0.4179
SpyHack	2020-12-04	5	3	6	11	0.4167
Life Hutch VR	2020-05-02	2	3	6	8	0.4167
Hot steel	2020-02-28	2	3	6	8	0.4167
A Squire's Tale	2020-05-14	27	3	6	33	0.4167
Digital Dungeon Tiles	2020-04-13	6	3	6	12	0.4167
DJIGULI	2020-04-28	2	3	6	8	0.4167
Robo Terror	2020-07-04	3	3	6	9	0.4167
Skinwalkers	2020-12-24	2	3	6	8	0.4167
Chill X	2020-12-22	2	3	6	8	0.4167
The Dark Eye : Book of Heroes	2020-06-10	450	77	118	568	0.41630000000000006
Galaxy in Turmoil	2020-05-23	215	116	176	391	0.4158
Magnificent 5	2020-01-23	55	49	77	132	0.4147
Beyond Enemy Lines 2 Online	2020-07-07	8	6	11	19	0.41450000000000004
Guardians Of Rings	2020-01-06	3	6	11	14	0.41450000000000004
Cemetery War	2020-06-08	11	6	11	22	0.41450000000000004
Server is Down	2020-09-25	5	6	11	16	0.41450000000000004
Number One Rich	2020-11-11	26	6	11	37	0.41450000000000004
捕鱼炸翻天	2020-10-27	16	20	33	49	0.4143
Humans V Zombies	2020-07-29	12	9	16	28	0.41250000000000003
Achievement Killer	2020-10-11	2	12	21	23	0.4108
Intro Maker	2020-06-04	2	4	8	10	0.4103
Sokpop S01: New Colony	2020-01-17	2	4	8	10	0.4103
Pandemic: The Virus Outbreak	2020-06-04	2	4	8	10	0.4103
Goblin Rush	2020-06-24	2	4	8	10	0.4103
Truck Crash	2020-07-02	2	4	8	10	0.4103
Borderus: Angels & Demons	2020-11-23	2	4	8	10	0.4103
Virus Buster	2020-03-14	3	7	13	16	0.41000000000000003
Long Car Journey - A road trip game	2020-06-04	6	7	13	19	0.41000000000000003
Living in the Ending World	2020-09-22	14	7	13	27	0.41000000000000003
Strip Black Jack - Manga Edition	2020-04-09	15	10	18	33	0.409
FPV Speed Drone	2020-12-07	16	13	23	39	0.4079
Gun Brothers	2020-08-18	6	36	60	66	0.4065
Warhawks	2020-07-10	1	0	1	2	0.4058
Nerepis	2020-03-03	2	0	1	3	0.4058
Furious Drivers	2020-02-04	6	0	1	7	0.4058
Dairy Farm Simulator	2020-12-15	1	0	1	2	0.4058
Blue Time	2020-04-15	1	0	1	2	0.4058
Survive Together	2020-08-25	2	0	1	3	0.4058
SpaceFrog VR	2020-10-16	2	0	1	3	0.4058
Aye Aye, Captain	2020-08-04	2	0	1	3	0.4058
REPTOMOM	2020-09-10	1	0	1	2	0.4058
四国志でらっくす ～酒池肉うどん戦記～	2020-08-01	2	0	1	3	0.4058
pepeizq's Cities	2020-06-02	2	0	1	3	0.4058
Back Home	2020-03-26	2	0	1	3	0.4058
Sine Wave City	2020-02-16	1	0	1	2	0.4058
Rogue Production Facility	2020-12-11	1	0	1	2	0.4058
Spirit Fighters	2020-03-26	2	0	1	3	0.4058
Shark Castle	2020-09-22	1	0	1	2	0.4058
Buggy Bump	2020-11-05	1	0	1	2	0.4058
MindLess	2020-02-13	1	0	1	2	0.4058
Daraney - Guardian's Rise	2020-01-03	4	0	1	5	0.4058
Dragon Little Fighters 2	2020-05-24	3	0	1	4	0.4058
Battle Mage : Card Caster	2020-05-11	2	0	1	3	0.4058
UFO穿越 UFO Cross	2020-03-22	2	0	1	3	0.4058
Colossal Saga	2020-07-01	2	0	1	3	0.4058
SpaceVibes	2020-01-16	1	0	1	2	0.4058
Gateball VR	2020-06-05	1	0	1	2	0.4058
Braverz	2020-01-14	4	0	1	5	0.4058
Fright	2020-01-05	1	0	1	2	0.4058
ZombieBusters	2020-01-07	1	0	1	2	0.4058
Arabian Treasures: Midnight Match	2020-09-08	3	0	1	4	0.4058
CaveBugBoy	2020-01-19	2	0	1	3	0.4058
Last in Orbit	2020-01-27	1	0	1	2	0.4058
DragonScales 3: Eternal Prophecy of Darkness	2020-01-20	2	0	1	3	0.4058
Suppressor	2020-06-24	1	0	1	2	0.4058
Xecute	2020-04-20	2	0	1	3	0.4058
No Game No LIFE	2020-09-09	1	0	1	2	0.4058
Skull's Solitude	2020-01-16	1	0	1	2	0.4058
PARADOX	2020-06-06	3	0	1	4	0.4058
The Last Turret	2020-04-07	2	0	1	3	0.4058
Sky Pirates of Actorius	2020-01-23	3	0	1	4	0.4058
Desert of Doitjma	2020-02-08	1	0	1	2	0.4058
The Tide Intro	2020-03-04	1	0	1	2	0.4058
Vigil of Glory - Part I	2020-03-02	1	0	1	2	0.4058
Mister Shizz: Don't Let The Shizz Hit The Fan!	2020-02-13	1	0	1	2	0.4058
Mission Indeed 2.0 FPS	2020-04-08	1	0	1	2	0.4058
The Search for DEEP Loving	2020-08-18	1	0	1	2	0.4058
愛情限時批	2020-08-07	2	0	1	3	0.4058
Witchsword Remake	2020-02-22	1	0	1	2	0.4058
Classic Card Game Pinochle	2020-01-24	2	0	1	3	0.4058
Goblin treasure	2020-02-21	1	0	1	2	0.4058
infection point	2020-03-21	1	0	1	2	0.4058
Xyla and the 'Shrooms of Doom	2020-02-21	2	0	1	3	0.4058
Cubic Juice	2020-03-19	1	0	1	2	0.4058
Réel Futur	2020-03-07	1	0	1	2	0.4058
Pirate Island Mini Golf VR	2020-06-08	2	0	1	3	0.4058
Bubble Bounce	2020-08-28	4	0	1	5	0.4058
DragonScales 6: Love and Redemption	2020-03-16	2	0	1	3	0.4058
Elemental Echos	2020-07-21	2	0	1	3	0.4058
Keep the Balance	2020-05-28	1	0	1	2	0.4058
CHAR01 VR	2020-03-29	1	0	1	2	0.4058
Space Force	2020-04-04	1	0	1	2	0.4058
Seven Horns From Tilt	2020-03-28	1	0	1	2	0.4058
人狼の仔	2020-04-24	2	0	1	3	0.4058
Gan'S Matchstick Men：Deadly Rhythm	2020-06-27	2	0	1	3	0.4058
The Sickle Upon Sekigahara	2020-06-22	1	0	1	2	0.4058
Cryptic Rooms	2020-04-17	2	0	1	3	0.4058
异界大陆	2020-04-26	2	0	1	3	0.4058
Shuffled Nightmares	2020-04-29	1	0	1	2	0.4058
Robot Paradise VR	2020-05-13	1	0	1	2	0.4058
ThinkFast	2020-05-09	1	0	1	2	0.4058
Zac Zac adventure	2020-06-09	1	0	1	2	0.4058
Nigel's Journey : A Working Day	2020-11-30	1	0	1	2	0.4058
异数OS MR Lab	2020-08-10	1	0	1	2	0.4058
Realm of the hero	2020-05-23	2	0	1	3	0.4058
DodgeBall VR	2020-10-28	1	0	1	2	0.4058
Halloween Horrors Deluxe Steam Edition	2020-05-18	1	0	1	2	0.4058
Infinity Imperium	2020-05-28	1	0	1	2	0.4058
深入敵境 Behind Enemy Line	2020-05-27	1	0	1	2	0.4058
Buddy's Creative Quest!	2020-11-11	1	0	1	2	0.4058
Gogoo	2020-06-24	1	0	1	2	0.4058
Rogue Bots	2020-07-08	1	0	1	2	0.4058
Tactical Suppression	2020-06-15	1	0	1	2	0.4058
Fractured Voyage	2020-06-18	1	0	1	2	0.4058
Monster Tower	2020-06-30	1	0	1	2	0.4058
Invaliens	2020-06-19	2	0	1	3	0.4058
Bad Apples	2020-12-12	1	0	1	2	0.4058
Xendless	2020-06-30	2	0	1	3	0.4058
mojica	2020-08-01	1	0	1	2	0.4058
Rollfall: Quest of Acceleration	2020-07-16	2	0	1	3	0.4058
Dinosaur Hunting Patrol 3D Jurassic VR	2020-07-04	2	0	1	3	0.4058
Spell Karts	2020-10-16	4	0	1	5	0.4058
Bomber	2020-07-04	1	0	1	2	0.4058
Hoplichess	2020-07-08	2	0	1	3	0.4058
War Machine	2020-07-21	1	0	1	2	0.4058
Color Buster!	2020-07-17	1	0	1	2	0.4058
Flap Demon	2020-10-30	2	0	1	3	0.4058
_OUR_Defense	2020-09-06	3	0	1	4	0.4058
Turbo Machines Mini Racing	2020-07-12	4	0	1	5	0.4058
Take Me Home	2020-12-01	1	0	1	2	0.4058
Insulated at the bottom	2020-07-23	1	0	1	2	0.4058
Tome Rush	2020-10-05	2	0	1	3	0.4058
Space Cube Racers	2020-08-29	1	0	1	2	0.4058
Watch Your Helmet	2020-08-11	1	0	1	2	0.4058
Monsterwolf	2020-08-11	1	0	1	2	0.4058
POLAR	2020-08-31	4	0	1	5	0.4058
RX Racing 2020 Pro	2020-08-12	1	0	1	2	0.4058
Lucky Burst	2020-08-18	1	0	1	2	0.4058
Timber Jump VR	2020-09-04	3	0	1	4	0.4058
Sainthum 圣颂	2020-09-29	1	0	1	2	0.4058
Kanały' 44	2020-10-16	1	0	1	2	0.4058
a Story of Merchant	2020-09-14	2	0	1	3	0.4058
Robot Female Hero 3	2020-11-12	1	0	1	2	0.4058
Surabaya Inferno	2020-09-20	2	0	1	3	0.4058
Outer Frontier	2020-09-03	1	0	1	2	0.4058
Pass to Hell	2020-09-03	1	0	1	2	0.4058
The Hardest Thing Ever	2020-09-13	2	0	1	3	0.4058
Savage Tower Defense	2020-11-20	1	0	1	2	0.4058
Television Trivia	2020-11-07	2	0	1	3	0.4058
Shot of Rhythm	2020-09-24	1	0	1	2	0.4058
Halloween Rhythm	2020-09-25	2	0	1	3	0.4058
Memory Card Monsters	2020-09-15	2	0	1	3	0.4058
Angry Rock	2020-09-15	1	0	1	2	0.4058
Early Quest	2020-09-24	3	0	1	4	0.4058
Three Kingdoms 21	2020-09-26	2	0	1	3	0.4058
Crazy Engineer	2020-12-03	1	0	1	2	0.4058
ThrustWorks	2020-10-22	1	0	1	2	0.4058
Space Defense	2020-10-20	1	0	1	2	0.4058
My Empire	2020-10-23	2	0	1	3	0.4058
ANTE	2020-12-10	2	0	1	3	0.4058
RagDoll MadDoll	2020-10-19	1	0	1	2	0.4058
Halloween Decoration Sandbox	2020-10-26	2	0	1	3	0.4058
Knuckers Test Fight	2020-10-30	1	0	1	2	0.4058
Punch the Potus	2020-10-31	1	0	1	2	0.4058
Desolation - End of Days	2020-11-04	2	0	1	3	0.4058
Darklight: Origin	2020-12-11	1	0	1	2	0.4058
Into the Abyss	2020-12-04	3	0	1	4	0.4058
Labyrinth	2020-11-14	2	0	1	3	0.4058
Cybergeist	2020-11-13	1	0	1	2	0.4058
Distorted	2020-11-14	1	0	1	2	0.4058
Updive	2020-11-29	1	0	1	2	0.4058
Speyarranoth	2020-11-23	1	0	1	2	0.4058
Urban Basketball VR	2020-12-01	1	0	1	2	0.4058
Fly Away Baseball	2020-12-07	1	0	1	2	0.4058
The Thought Police Hotline: Episode 1	2020-12-03	1	0	1	2	0.4058
The king is gone	2020-12-15	1	0	1	2	0.4058
Golems TD	2020-12-09	1	0	1	2	0.4058
Tank Firing	2020-12-05	1	0	1	2	0.4058
极限挑战（The Challenge Of Limits）	2020-12-22	1	0	1	2	0.4058
Maze Escape	2020-12-18	1	0	1	2	0.4058
Plataformabranca	2020-12-29	1	0	1	2	0.4058
Penelope	2020-12-15	1	0	1	2	0.4058
Drying Paint Simulator VR	2020-01-24	2	5	10	12	0.4057
Kebab House	2020-08-13	3	5	10	13	0.4057
Air Wars	2020-07-30	3	14	25	28	0.4054
Six Temples	2020-04-17	5	1	3	8	0.40399999999999997
Victorian Admirals Caroline Crisis 1885	2020-03-09	2	1	3	5	0.40399999999999997
Lethal Tempting Girls	2020-02-28	3	1	3	6	0.40399999999999997
Steamliner	2020-02-19	2	1	3	5	0.40399999999999997
Classic Card Game Spades	2020-01-20	4	1	3	7	0.40399999999999997
Angry food	2020-01-14	2	1	3	5	0.40399999999999997
LastShot	2020-01-17	1	1	3	4	0.40399999999999997
Classic Card Game Gin Rummy	2020-01-24	3	1	3	6	0.40399999999999997
Classic Card Game Poker Pack	2020-02-03	2	1	3	5	0.40399999999999997
Come on-be with you	2020-02-13	1	1	3	4	0.40399999999999997
Peg Solitaire Adventure	2020-02-17	2	1	3	5	0.40399999999999997
PancakeHouse	2020-07-06	1	1	3	4	0.40399999999999997
Race Maniacs	2020-04-09	3	1	3	6	0.40399999999999997
Resistance TD	2020-04-18	1	1	3	4	0.40399999999999997
30 days of plague	2020-04-29	2	1	3	5	0.40399999999999997
Dark Side	2020-04-17	2	1	3	5	0.40399999999999997
Enchantress	2020-06-02	3	1	3	6	0.40399999999999997
ノンビリア(Nonvilia)	2020-08-10	12	1	3	15	0.40399999999999997
GUNPIG: Firepower For Hire	2020-07-17	2	1	3	5	0.40399999999999997
Alien's Armageddon	2020-07-17	2	1	3	5	0.40399999999999997
Speechless	2020-08-29	5	1	3	8	0.40399999999999997
异界浮尘录	2020-08-21	3	1	3	6	0.40399999999999997
Funanigans	2020-09-28	3	1	3	6	0.40399999999999997
Fill and Cross Royal Riddles	2020-09-18	3	1	3	6	0.40399999999999997
Starship Renata	2020-09-04	1	1	3	4	0.40399999999999997
Way Walkers: University 2	2020-10-22	6	1	3	9	0.40399999999999997
Beat the Nightmare – Evil Dreams Simulator VR	2020-11-13	2	1	3	5	0.40399999999999997
SamuraiZero	2020-11-23	3	1	3	6	0.40399999999999997
Ancient Warriors Casino Jackpot	2020-11-21	1	1	3	4	0.40399999999999997
The Legend of HyperStar	2020-08-29	10	12	22	32	0.40340000000000004
Commander '85	2020-09-30	12	9	17	29	0.4032
Another_World	2020-03-06	4	9	17	21	0.4032
Castle Creator	2020-03-24	8	6	12	20	0.402
Forbidden Pleasure	2020-05-09	4	6	12	16	0.402
The secret of the stone	2020-10-08	4	6	12	16	0.402
Paladin Duty - Knights and Blades	2020-01-28	3	27	47	50	0.4017
Population Zero	2020-05-05	2170	467	737	2907	0.4011
Vikings Wars	2020-01-31	1	2	5	6	0.40030000000000004
Isle Of Spirits	2020-06-10	3	2	5	8	0.40030000000000004
Panic Timing	2020-08-10	3	2	5	8	0.40030000000000004
Alone Journey	2020-05-07	2	2	5	7	0.40030000000000004
Cybercube battle	2020-10-16	2	2	5	7	0.40030000000000004
Dominium Mundi	2020-11-10	3	2	5	8	0.40030000000000004
Pack Per Duck	2020-12-29	2	2	5	7	0.40030000000000004
A.V.I.	2020-11-30	3	7	14	17	0.39909999999999995
驱魔道人2 BROKEN SPELL	2020-02-12	16	43	74	90	0.399
Don't Look	2020-08-07	2	11	21	23	0.3983
Time Tenshi	2020-09-25	7	3	7	14	0.3972
Sunflower	2020-02-12	2	3	7	9	0.3972
Herbalist simulator	2020-01-22	2	3	7	9	0.3972
Tinieblas Jr's Adventures	2020-02-12	2	3	7	9	0.3972
Phalanx of Resistance	2020-03-31	4	3	7	11	0.3972
VE GSIM Tower Crane Simulator	2020-03-17	2	3	7	9	0.3972
Timestop Volleyball	2020-03-07	2	3	7	9	0.3972
抵抗组织	2020-05-13	2	3	7	9	0.3972
泡泡三国	2020-04-23	2	3	7	9	0.3972
Tankfight	2020-06-16	2	3	7	9	0.3972
Feylin	2020-05-22	4	3	7	11	0.3972
Desolate Roads	2020-10-30	2	3	7	9	0.3972
Murder Hornets	2020-10-30	2	3	7	9	0.3972
Solenars Edge II: Champions	2020-07-31	4	3	7	11	0.3972
The Episodic	2020-10-21	2	3	7	9	0.3972
HANAMI	2020-12-02	2	3	7	9	0.3972
What We Pretend To Be	2020-12-29	2	3	7	9	0.3972
ESCAPE ROOM VR	2020-01-01	8	12	23	31	0.39630000000000004
Still Light	2020-11-16	40	19	35	75	0.3962
Summon And Fusion	2020-12-05	45	26	47	92	0.39549999999999996
Gene Rain	2020-05-22	4	4	9	13	0.3946
Sokpop S02: Tomscape	2020-01-17	3	4	9	12	0.3946
Gifted	2020-01-04	4	4	9	13	0.3946
Human Delusion	2020-01-24	3	4	9	12	0.3946
The Casebook of Arkady Smith	2020-04-14	2	4	9	11	0.3946
约拍女神2 / Beautiful Model2	2020-07-10	7	4	9	16	0.3946
Korean Adventures in Russia	2020-08-11	2	4	9	11	0.3946
成仙	2020-10-23	15	4	9	24	0.3946
Sex Poker	2020-11-06	8	9	18	26	0.3945
20,000 Miles Under the Sea	2020-07-27	14	37	66	80	0.394
YourToy	2020-02-28	7	5	11	18	0.3924
Evil Ritual - Horror Escape	2020-10-03	3	5	11	14	0.3924
Titanfall™	2020-11-20	266	708	1163	1429	0.391
Clerk hot Tale	2020-12-04	3	6	13	16	0.39049999999999996
Agents: Biohunters	2020-04-07	211	102	177	388	0.39020000000000005
Omnibion War	2020-02-06	3	7	15	18	0.3889
Grey Skies: A War of the Worlds Story	2020-11-05	13	37	68	81	0.3886
Ultimo Reino	2020-02-09	7	8	17	24	0.3875
The Haunting	2020-12-23	3	4	10	13	0.3805
Jane Westlake Adventures - The Mystery Train	2020-01-10	2	4	10	12	0.3805
Zombies Don't Drive	2020-05-08	2	4	10	12	0.3805
Craft city	2020-08-28	2	4	10	12	0.3805
SEX Cruise VR	2020-07-25	5	4	10	15	0.3805
Metal Strike	2020-10-20	2	4	10	12	0.3805
Mr Dirt Poor	2020-02-07	7	5	12	19	0.3804
Boot : Game Dev Sim	2020-02-20	3	5	12	15	0.3804
DarkLight	2020-01-14	3	5	12	15	0.3804
Deep Ocean Rush	2020-01-04	3	3	8	11	0.3803
Grand horse attraction	2020-08-06	3	3	8	11	0.3803
Parking Attendant	2020-07-06	2	3	8	10	0.3803
Puzzle Angry Cat	2020-08-24	3	3	8	11	0.3803
Sokpop S09: Woodland Saga	2020-09-16	3	3	8	11	0.3803
Deep Space Banana	2020-03-04	14	6	14	28	0.38
Silent World	2020-03-19	3	6	14	17	0.38
Handball 21	2020-11-12	46	23	46	92	0.3797
BELLING COINS	2020-12-27	3	8	18	21	0.379
Fates Call: A New Beginning	2020-12-01	3	2	6	9	0.379
The Devil's Garden	2020-07-08	2	2	6	8	0.379
Sokpop S03: Oh Crab!	2020-01-17	2	2	6	8	0.379
东方幻昼梦~ Touhou Fantasy Day	2020-01-16	5	2	6	11	0.379
Skin Witch	2020-05-29	3	2	6	9	0.379
Pinball universe	2020-01-13	2	2	6	8	0.379
HENTAI SEEK	2020-02-01	2	2	6	8	0.379
Devil fight	2020-03-10	1	2	6	7	0.379
The Prodigal Soul	2020-03-11	2	2	6	8	0.379
The Valley of Super Flowers	2020-03-27	2	2	6	8	0.379
STRAIGHT ON 8	2020-09-30	3	2	6	9	0.379
Demetria Spirit	2020-07-22	3	2	6	9	0.379
Zball IV	2020-09-22	3	2	6	9	0.379
Allotropy	2020-10-29	2	2	6	8	0.379
The Day They Came	2020-12-16	3	2	6	9	0.379
Fuck The Police	2020-10-20	3	9	20	23	0.3785
All Time Battle	2020-10-24	25	9	20	45	0.3785
EDGE OF DAWN	2020-07-17	12	13	28	40	0.3765
Mana Maker	2020-12-01	28	14	30	58	0.376
Space Farm	2020-10-17	3	1	4	7	0.3749
Space Journey	2020-02-28	1	1	4	5	0.3749
Sokpop S03: Frog struggles	2020-01-17	1	1	4	5	0.3749
Infferno	2020-01-02	2	1	4	6	0.3749
World War 2 Zombie Attack VR Simulator	2020-02-04	2	1	4	6	0.3749
Virage Rally	2020-02-24	3	1	4	7	0.3749
Impulse Control	2020-04-14	2	1	4	6	0.3749
The Last Day of Adolf	2020-04-22	2	1	4	6	0.3749
Axizon Labs: Zombies	2020-05-08	1	1	4	5	0.3749
OLD SKOOL RACER	2020-07-08	5	1	4	9	0.3749
Awoken: Chapter One of Reverie	2020-09-04	5	1	4	9	0.3749
Snack clearing	2020-05-11	2	1	4	6	0.3749
Waifu Collector	2020-10-01	3	1	4	7	0.3749
My First Date RPG (Presented by: ExecuteCode.com)	2020-09-08	2	1	4	6	0.3749
Electrify	2020-10-10	3	1	4	7	0.3749
Fury Knight	2020-09-16	2	1	4	6	0.3749
Gump	2020-09-09	1	1	4	5	0.3749
LostInTime	2020-10-24	1	1	4	5	0.3749
Secret of Harrow Manor 2	2020-10-06	2	1	4	6	0.3749
Tech Madness	2020-10-27	2	1	4	6	0.3749
Rifle Dodger	2020-11-06	2	1	4	6	0.3749
Text Twisted Pro	2020-12-09	2	1	4	6	0.3749
VikingStory	2020-12-16	2	1	4	6	0.3749
Fast Wings	2020-12-29	2	1	4	6	0.3749
Sokpop S06: Good Goods Incorporated	2020-01-17	11	9	21	32	0.3711
Sex Prison VR	2020-08-21	6	8	19	25	0.371
Bounty Battle	2020-09-10	23	17	37	60	0.37020000000000003
Sokpop S08: dead run	2020-07-10	4	5	13	17	0.3694
SuperNatural Duels	2020-08-20	6	5	13	19	0.3694
Mini Warriors: Brawler Army	2020-09-10	14	5	13	27	0.3694
Space Love Delta	2020-10-19	3	5	13	16	0.3694
Princess Guard	2020-03-21	7	4	11	18	0.3679
Fatal Evidence: Art of Murder Collector's Edition	2020-08-28	6	4	11	17	0.3679
Balloon Saga	2020-09-21	3	4	11	14	0.3679
Breeze of Death	2020-04-30	7	3	9	16	0.3655
那美克星人	2020-02-02	2	3	9	11	0.3655
Roller Stars	2020-06-12	2	3	9	11	0.3655
Floor 13: Deep State	2020-11-02	14	9	22	36	0.3642
Aura Kingdom 2	2020-06-17	241	84	170	411	0.3626
Lost Roads	2020-01-05	2	2	7	9	0.3611
Skeleton Warrior	2020-02-22	2	2	7	9	0.3611
Boom slayer	2020-05-19	3	2	7	10	0.3611
模拟练枪	2020-07-16	2	2	7	9	0.3611
The Lightbringers	2020-08-28	4	0	2	6	0.3592
Kalling Kingdom	2020-01-18	1	0	2	3	0.3592
Midnight's Curse	2020-09-03	3	0	2	5	0.3592
Epic Food Fight VR	2020-12-20	2	0	2	4	0.3592
Dark Space Conqueror	2020-03-17	1	0	2	3	0.3592
Covid 2069	2020-06-13	2	0	2	4	0.3592
Exsys	2020-02-22	2	0	2	4	0.3592
HVAC Simulator	2020-01-07	1	0	2	3	0.3592
NEON SPACE WAR	2020-01-28	1	0	2	3	0.3592
Uterine Supremacy	2020-12-20	5	0	2	7	0.3592
Overrun	2020-03-20	2	0	2	4	0.3592
Knockout Bowling vr	2020-08-10	1	0	2	3	0.3592
Disgrâce	2020-10-15	4	0	2	6	0.3592
LRRL or RLLR	2020-06-30	1	0	2	3	0.3592
Cecil Run	2020-02-15	1	0	2	3	0.3592
Journey to New Atlantis	2020-01-06	2	0	2	4	0.3592
Maiden and Swordsman	2020-03-06	3	0	2	5	0.3592
Jump Boy	2020-02-02	2	0	2	4	0.3592
Empty Universe	2020-03-06	1	0	2	3	0.3592
Nice Try!	2020-02-12	2	0	2	4	0.3592
Car Tuner 2020	2020-02-12	2	0	2	4	0.3592
SPACE EXODUS	2020-02-15	1	0	2	3	0.3592
FatCat with Hat - Reload the Powergun	2020-03-17	1	0	2	3	0.3592
Parallel Catastrophes Chronicles	2020-02-29	1	0	2	3	0.3592
Zombie Defense Shelter	2020-04-17	2	0	2	4	0.3592
"Adventures of JQ Jones: ""Isle of the Serpent Empress"""	2020-07-20	1	0	2	3	0.3592
Victorian Admirals Marianas Incident 1887	2020-03-09	1	0	2	3	0.3592
Infinite Way	2020-11-04	2	0	2	4	0.3592
Fire Guild	2020-03-25	1	0	2	3	0.3592
QUIZ PRO! - General Knowledge	2020-03-28	2	0	2	4	0.3592
Premier Manager 03/04	2020-07-24	3	0	2	5	0.3592
Fingertips mountain sea- paradise island（指尖山海-天堂岛）	2020-12-04	2	0	2	4	0.3592
Zerowood	2020-06-30	1	0	2	3	0.3592
Oddest Sea	2020-05-28	3	0	2	5	0.3592
Aquarium Life	2020-04-14	1	0	2	3	0.3592
Thrice in a row	2020-04-14	2	0	2	4	0.3592
Virtual Presenter Pro	2020-05-22	2	0	2	4	0.3592
不思議の鎮守府	2020-04-29	1	0	2	3	0.3592
In The Search For : Revenge	2020-04-29	1	0	2	3	0.3592
WC	2020-05-07	1	0	2	3	0.3592
Finger Guessing King	2020-10-22	2	0	2	4	0.3592
Cute Triplets	2020-06-17	1	0	2	3	0.3592
Queerskins: a love story	2020-11-30	1	0	2	3	0.3592
Spooky Spins Deluxe Steam Edition	2020-06-05	2	0	2	4	0.3592
Fright Chasers: Thrills, Chills and Kills Collector's Edition	2020-05-17	5	0	2	7	0.3592
ValiVictorian	2020-06-05	1	0	2	3	0.3592
Futbolín Revolution	2020-06-12	2	0	2	4	0.3592
Demon Tamer	2020-06-30	2	0	2	4	0.3592
Tusk of Spirit	2020-08-25	1	0	2	3	0.3592
Alias	2020-08-31	4	0	2	6	0.3592
Conjurer Andy's Repeatable Dungeon	2020-09-07	3	0	2	5	0.3592
Olympic Boxing	2020-07-09	2	0	2	4	0.3592
BlueBete	2020-08-03	1	0	2	3	0.3592
Killstreak	2020-10-14	8	0	2	10	0.3592
Electronic World Z	2020-09-11	1	0	2	3	0.3592
Onder	2020-09-29	2	0	2	4	0.3592
Sphere Invasion	2020-10-30	1	0	2	3	0.3592
Riot At World	2020-09-07	2	0	2	4	0.3592
Sweet Tooth 2	2020-09-07	2	0	2	4	0.3592
Legend of Xion: Royal Story	2020-09-10	3	0	2	5	0.3592
The Adventures Of Maximus	2020-09-10	1	0	2	3	0.3592
Adventures of Megara: Demeter's Cat-astrophe	2020-11-03	6	0	2	8	0.3592
Spooky Speedrun	2020-10-08	3	0	2	5	0.3592
SIDE	2020-12-15	1	0	2	3	0.3592
Christmas Rampage	2020-12-03	2	0	2	4	0.3592
Phantast	2020-12-28	1	0	2	3	0.3592
Parking Сar	2020-12-31	1	0	2	3	0.3592
Hope of humanity	2020-06-10	136	9	23	159	0.3576
Paycheck: City RPG	2020-02-07	28	9	23	51	0.3576
Battle Baseball	2020-05-11	2	4	12	14	0.3565
Filmmaker Tycoon	2020-11-13	101	24	56	157	0.3533
SYNAPTIC DRIVE	2020-05-28	432	24	56	488	0.3533
Bust a date	2020-05-28	22	6	17	39	0.3527
Carnival Games	2020-11-19	5	3	10	15	0.35240000000000005
The Hunted	2020-02-04	2	1	5	7	0.3522
Without A Roof (W.A.R.)	2020-01-24	7	1	5	12	0.3522
KANNA	2020-02-15	3	1	5	8	0.3522
Contract Killers	2020-07-08	2	1	5	7	0.3522
My Secret Girlfriends ;)	2020-03-14	4	1	5	9	0.3522
Street Racing 2020	2020-03-31	2	1	5	7	0.3522
Tactical Warfare Simulator	2020-12-21	3	1	5	8	0.3522
Scorched Islands	2020-03-21	4	1	5	9	0.3522
Colorful3D II	2020-03-07	2	1	5	7	0.3522
SECTOR 40: The Soviet Legacy	2020-03-20	2	1	5	7	0.3522
Snow Apocalypse	2020-11-12	2	1	5	7	0.3522
TCVR	2020-06-19	2	1	5	7	0.3522
Risky Floors	2020-05-13	1	1	5	6	0.3522
First Floor	2020-07-19	1	1	5	6	0.3522
Shark Attack	2020-09-29	3	1	5	8	0.3522
Lost Patrol	2020-09-02	2	1	5	7	0.3522
LemWars	2020-10-15	2	1	5	7	0.3522
Forest Problems	2020-10-06	2	1	5	7	0.3522
Fabulous place	2020-11-23	3	1	5	8	0.3522
Rest House	2020-03-10	1623	9	24	1647	0.35130000000000006
Wilderness	2020-12-24	22	24	57	79	0.3504
Warehouse Simulator	2020-07-17	10	11	29	39	0.3486
Beach anime day	2020-02-17	2	2	8	10	0.3458
Box Nation [ ]	2020-04-06	2	2	8	10	0.3458
Top Billiards	2020-07-24	5	2	8	13	0.3458
Heroes of Dungeon	2020-08-22	2	2	8	10	0.3458
Berries Challenge	2020-09-26	3	6	18	21	0.34490000000000004
VEGTERIA	2020-07-15	5	10	28	33	0.3418
Cake Shop Simulator	2020-12-07	4	5	16	20	0.34140000000000004
Supermarket Simulator	2020-02-11	5	3	11	16	0.3407
Evil Manor	2020-10-28	4	3	11	15	0.3407
Paralax Vr Aim Trainer	2020-08-01	2	3	11	13	0.3407
After The War	2020-12-04	4	6	19	23	0.3375
Flower Challenge	2020-09-24	3	6	19	22	0.3375
Fury Captain	2020-07-02	2	4	14	16	0.3367
Sokpop S01: driftwood	2020-01-17	1	1	6	7	0.33380000000000004
Street Jam: The Rise	2020-01-09	20	1	6	26	0.33380000000000004
Babel Climbers	2020-03-01	9	1	6	15	0.33380000000000004
CORVUS	2020-02-08	1	1	6	7	0.33380000000000004
Tower Blitz	2020-05-14	2	1	6	8	0.33380000000000004
Brothers in Blood: WW2 Co-op	2020-10-28	2	1	6	8	0.33380000000000004
花千骨	2020-05-22	12	1	6	18	0.33380000000000004
Uranus	2020-06-12	2	1	6	8	0.33380000000000004
忘川	2020-08-22	4	1	6	10	0.33380000000000004
Zball VI	2020-11-19	3	1	6	9	0.33380000000000004
Zombrio	2020-12-17	2	1	6	8	0.33380000000000004
Soul Saga	2020-02-28	16	13	37	53	0.3335
经典扫雷	2020-02-06	5	2	9	14	0.33240000000000003
Yoren	2020-05-25	5	2	9	14	0.33240000000000003
TYPICAL RUSSIAN QUARANTINE	2020-06-25	1	2	9	10	0.33240000000000003
Dangerous Zone	2020-07-08	2	2	9	11	0.33240000000000003
Pulse Forge VR	2020-03-10	4	8	25	29	0.3315
Cinnamon fight	2020-08-20	2	0	3	5	0.32939999999999997
Singaria - Prologue	2020-01-24	9	0	3	12	0.32939999999999997
Virus L	2020-01-13	2	0	3	5	0.32939999999999997
SCIENCE SHOW VR : THE ABYSS	2020-01-13	1	0	3	4	0.32939999999999997
MEDAL OF LEGENDS	2020-02-06	2	0	3	5	0.32939999999999997
Classic Card Game Hearts	2020-01-24	4	0	3	7	0.32939999999999997
Class Kingdom	2020-02-22	1	0	3	4	0.32939999999999997
Send them to the sky	2020-03-02	1	0	3	4	0.32939999999999997
ABSOLUTE	2020-05-11	2	0	3	5	0.32939999999999997
Knockdown the Ball Twice	2020-03-30	1	0	3	4	0.32939999999999997
Frag Grounds	2020-06-29	5	0	3	8	0.32939999999999997
Weapons Genius VR	2020-06-12	1	0	3	4	0.32939999999999997
CreatorAdventureLegend	2020-04-27	1	0	3	4	0.32939999999999997
COVID-19 (CORONA VIRUS)	2020-07-30	2	0	3	5	0.32939999999999997
Rubble Bubble	2020-06-25	2	0	3	5	0.32939999999999997
Dayscream	2020-10-13	1	0	3	4	0.32939999999999997
Gems of Fate: the Charmed King	2020-05-14	2	0	3	5	0.32939999999999997
Way Far Home	2020-05-28	1	0	3	4	0.32939999999999997
Fear the Dark Unknown: James	2020-12-18	2	0	3	5	0.32939999999999997
Brain Sanguo	2020-06-30	1	0	3	4	0.32939999999999997
50 Level Survival	2020-06-22	1	0	3	4	0.32939999999999997
The importance of choosing: second chance	2020-07-15	1	0	3	4	0.32939999999999997
Return to Earth 2130	2020-07-13	1	0	3	4	0.32939999999999997
Fleeting World	2020-07-29	1	0	3	4	0.32939999999999997
神王之王者之心	2020-07-24	8	0	3	11	0.32939999999999997
Coffee with Prescilla	2020-08-28	2	0	3	5	0.32939999999999997
Fancy Skiing Ⅲ Pro	2020-08-18	3	0	3	6	0.32939999999999997
Taivas	2020-11-20	1	0	3	4	0.32939999999999997
Sweet Tooth	2020-09-07	2	0	3	5	0.32939999999999997
Bob Mazzolini Racing	2020-09-11	1	0	3	4	0.32939999999999997
门 The Door	2020-10-06	3	0	3	6	0.32939999999999997
BROKEN MEMORIES	2020-11-13	1	0	3	4	0.32939999999999997
侠行天下	2020-12-25	6	0	3	9	0.32939999999999997
Dragon Storm	2020-04-15	2	4	16	18	0.32
Battlestage	2020-09-11	4	1	7	11	0.3185
Proxy Air Force	2020-05-29	2	1	7	9	0.3185
Carom Billiards	2020-07-03	2	1	7	9	0.3185
MotoRun	2020-08-06	3	1	7	10	0.3185
FRONTIERS	2020-01-01	61	88	235	296	0.3124
Space Station Continuum	2020-06-24	15	8	29	44	0.31120000000000003
AVABEL ONLINE	2020-01-08	85	47	133	218	0.3111
Chill Z	2020-11-09	2	2	11	13	0.3103
LOGA: Unexpected Adventure	2020-02-17	2	0	4	6	0.308
Topfold	2020-01-14	1	0	4	5	0.308
Mistaker	2020-02-28	1	0	4	5	0.308
Exhaust	2020-03-09	3	0	4	7	0.308
Void Monsters 2: The Blight	2020-02-26	2	0	4	6	0.308
Elian, Elisa, ChatAid	2020-03-30	1	0	4	5	0.308
Land of Zympaia	2020-07-19	2	0	4	6	0.308
The Ball Adventure	2020-04-21	4	0	4	8	0.308
Murk	2020-05-25	1	0	4	5	0.308
Magic Forms	2020-05-27	1	0	4	5	0.308
patter warrior	2020-07-15	2	0	4	6	0.308
Reality End	2020-10-27	2	0	4	6	0.308
Tales of Lagoona 3: Frauds, Forgeries, and Fishsticks	2020-12-16	4	0	4	8	0.308
Heroic Adventures	2020-12-09	4	5	21	25	0.3064
Game Localization	2020-12-07	2	4	18	20	0.3056
Fourthy	2020-01-02	1	1	8	9	0.3056
Hentai Seek Girl	2020-02-03	2	1	8	10	0.3056
Audio Drive 2 VR	2020-06-26	2	1	8	10	0.3056
Prairie survival	2020-10-16	2	1	8	10	0.3056
Aunt Bessie's House	2020-11-03	1	1	8	9	0.3056
Hentai Queens	2020-12-30	2	1	8	10	0.3056
CivilContract	2020-04-04	7	5	22	29	0.3006
The Jungle	2020-09-01	5	5	22	27	0.3006
Blob From Space	2020-07-04	1187	36	114	1301	0.2974
World Puzzle	2020-07-02	2	3	16	18	0.2967
Waves Of Death VR	2020-04-18	3	1	9	12	0.2943
Seven Wonders of St. Clementine	2020-10-31	4	1	9	13	0.2943
Trasta	2020-02-01	2	1	9	11	0.2943
Cybernetica	2020-02-25	2	1	9	11	0.2943
80S escape	2020-05-05	2	1	9	11	0.2943
The Adventures of Fatman: Intergalactic Indigestion	2020-05-15	2	1	9	11	0.2943
Hiddenverse: Ominous Opus	2020-12-10	4	1	9	13	0.2943
THE SKIES REBORN	2020-11-12	93	34	111	204	0.2937
Hobo Living VR	2020-04-04	4	2	13	17	0.2925
Darklands:Awakening	2020-09-23	4	2	13	17	0.2925
WildIsland	2020-01-04	1	0	5	6	0.2916
New King	2020-04-16	3	0	5	8	0.2916
Knight Arena	2020-09-07	2	0	5	7	0.2916
Escaping maze	2020-10-07	2	0	5	7	0.2916
Skate Forever	2020-10-06	2	0	5	7	0.2916
Zinuru The Great	2020-12-02	1	0	5	6	0.2916
XIII	2020-11-10	566	278	785	1351	0.2908
Computer Physics Simulators 2020	2020-03-31	3	3	17	20	0.29
Abst Clicker Farm	2020-02-11	2	2	14	16	0.2848
Undead Souls	2020-08-25	2	1	10	12	0.2845
REFUGE	2020-01-08	2	1	10	12	0.2845
The Orphan A Tale of An Errant Ghost - Hidden Object Game	2020-01-06	3	3	18	21	0.2837
Golf Masters	2020-07-14	3	0	6	9	0.2783
Colouration	2020-03-06	2	0	6	8	0.2783
Berry mayhem	2020-03-20	2	0	6	8	0.2783
Anime Play Life: Unlimited	2020-12-04	3	0	6	9	0.2783
Monster Shooter	2020-07-04	2	1	11	13	0.2758
The Wicked Sorceress	2020-09-04	2	1	11	13	0.2758
Knights of Light: The Prologue	2020-02-29	9	6	31	40	0.2752
Jumperbird	2020-07-18	3	4	24	27	0.2725
Schlag den Star - Das 2. Spiel	2020-10-29	11	1	12	23	0.2681
The Moon Relax	2020-09-01	7	1	12	19	0.2681
HEDE Game Engine	2020-06-10	2	0	7	9	0.26739999999999997
The Deepest	2020-12-20	2	0	7	9	0.26739999999999997
Stop the War	2020-12-25	2	2	17	19	0.2655
Orlando Theme Park VR - Roller Coaster and Rides	2020-08-21	6	6	34	40	0.2644
Covid-19 - Corona Clicker	2020-07-05	8	3	22	30	0.2625
Last Fantasy Hentai	2020-06-25	3	2	18	21	0.26
Inexplicable Deaths In Damipolis	2020-12-10	3	0	8	11	0.2581
Macro golf	2020-12-14	2	0	8	10	0.2581
Bhop PRO	2020-07-05	6	36	150	156	0.257
Desert Mystery	2020-12-28	2	1	14	16	0.2547
Undead zombies	2020-01-08	2	0	9	11	0.25
zombie variant	2020-02-29	2	0	9	11	0.25
Get Over Blood	2020-05-18	2	1	15	17	0.249
Restricted Area	2020-07-01	2	2	21	23	0.24559999999999998
Isolated Life	2020-08-26	4	0	10	14	0.2429
Cybernetica: fallen city	2020-10-13	2	0	10	12	0.2429
TRACK	2020-12-01	3	0	10	13	0.2429
A Siren's Call	2020-04-26	2	0	11	13	0.2366
Archeologist Simulator	2020-12-16	3	0	11	14	0.2366
Triple X Tycoon®	2020-06-25	5	1	18	23	0.23420000000000002
Robot Invasion	2020-07-03	2	0	12	14	0.231
Borderus	2020-03-19	3	1	22	25	0.2189
MiniFarm 2020	2020-11-11	4	0	26	30	0.18539999999999998
People Playground	2019-07-23	15026	175076	2086	17112	0.9754
Slay the Spire	2019-01-23	33086	127191	2745	35831	0.965
A Short Hike	2019-07-30	229	12841	97	326	0.9640000000000001
Katana ZERO	2019-04-18	1575	54842	1024	2599	0.9637000000000001
Resident Evil 2	2019-01-25	74227	124514	3640	77867	0.9579000000000001
Grimm's Hollow	2019-10-30	221	10744	150	371	0.9566
Baba Is You	2019-03-13	1533	17152	340	1873	0.9551999999999999
Phoenix Wright: Ace Attorney Trilogy	2019-04-09	3611	18223	446	4057	0.9515000000000001
Oxygen Not Included	2019-07-30	27486	95243	3368	30854	0.9512
Kind Words	2019-09-12	362	7996	137	499	0.951
Tales of the Black Forest	2019-09-26	237	9178	183	420	0.9498000000000001
Touhou Luna Nights	2019-02-26	1368	11831	268	1636	0.9496
Gravitas	2019-08-24	209	5890	117	326	0.9455
Unheard	2019-03-29	7754	25904	926	8680	0.9439000000000001
Beat Saber	2019-05-21	4472	65303	2758	7230	0.9434
Aokana - Four Rhythms Across the Blue	2019-09-27	484	3898	70	554	0.9425
Sekiro™: Shadows Die Twice	2019-03-22	125315	217051	10811	136126	0.9415000000000001
Zup! F	2019-12-11	769	7716	219	988	0.9407
Devil May Cry 5	2019-03-08	88894	95364	4527	93421	0.9405
Kindergarten 2	2019-07-30	1060	3243	65	1125	0.9385
Sayonara Wild Hearts	2019-12-12	180	6916	208	388	0.9381999999999999
WolfQuest: Anniversary Edition	2019-07-26	2253	5569	154	2407	0.9381
Streets of Rogue	2019-07-12	4320	17232	676	4996	0.938
Bug Fables: The Everlasting Sapling	2019-11-21	325	3956	94	419	0.9377
My Friend Pedro	2019-06-20	7117	24351	1041	8158	0.9373
FIVE NIGHTS AT FREDDY'S: HELP WANTED	2019-05-28	785	9091	321	1106	0.9362
missed messages.	2019-05-30	184	13261	528	712	0.9355
Mindustry	2019-09-26	3012	13629	551	3563	0.9352
异化之恶〇Abnormal Treatment	2019-08-02	501	2855	63	564	0.9351
Master Of Pottery	2019-11-11	782	2465	49	831	0.935
Age of Empires II: Definitive Edition	2019-11-14	38725	114061	6283	45008	0.9346
Monster Girl Island: Prologue	2019-06-19	1538	15759	671	2209	0.9344
Nova Drift	2019-03-27	1309	9244	352	1661	0.934
Backbone: Prologue	2019-04-24	565	4003	113	678	0.934
Hypnospace Outlaw	2019-03-12	307	3084	77	384	0.9336
NGU IDLE	2019-10-01	8032	9405	365	8397	0.9335
Tsukikage no Simulacre: Kaihou no Hane	2019-07-26	163	2611	59	222	0.9335
Muse Dash	2019-06-20	11478	80222	4664	16142	0.9304000000000001
Fluffy Store	2019-08-15	397	2879	82	479	0.9297
Dream Ending	2019-07-23	62	2454	66	128	0.929
TouHou Makuka Sai ~ Fantastic Danmaku Festival Part II	2019-03-18	656	2021	48	704	0.9289000000000001
Neon Beats	2019-05-03	210	5845	229	439	0.9287000000000001
One Finger Death Punch 2	2019-04-15	1027	3919	135	1162	0.9284
Acting Lessons	2019-07-25	263	4546	168	431	0.9279999999999999
We Become What We Behold	2019-07-09	443	3184	102	545	0.9279999999999999
Don't Escape: 4 Days to Survive	2019-03-11	150	1657	36	186	0.9277
Bloodstained: Ritual of the Night	2019-06-18	26934	31962	1812	28746	0.927
SpaceEngine	2019-06-11	596	7219	316	912	0.9269
AVICII Invector	2019-12-10	146	2727	85	231	0.9268000000000001
Yakuza Kiwami 2	2019-05-09	3229	11538	564	3793	0.9266
ISLANDERS	2019-04-04	1783	13944	709	2492	0.9265000000000001
像素男友	2019-12-24	250	940	11	261	0.9265000000000001
Pikuniku	2019-01-24	2123	6132	263	2386	0.9261
9-nine-:Episode 2	2019-08-16	59	995	14	73	0.9255
Supraland	2019-04-05	1403	9998	490	1893	0.9254000000000001
The Coin Game	2019-02-22	224	4151	161	385	0.9254000000000001
STAR WARS™ Battlefront (Classic, 2004)	2019-05-02	548	3340	122	670	0.9248000000000001
异常 | Exception	2019-07-04	317	1636	41	358	0.9247
Cat Quest II	2019-09-24	610	3753	145	755	0.9244
Smile For Me	2019-05-31	102	2060	63	165	0.9235
Blood: Fresh Supply	2019-05-09	592	5406	241	833	0.9234
Spyro™ Reignited Trilogy	2019-09-03	4198	15915	892	5090	0.923
PC Building Simulator	2019-01-29	3884	44365	2825	6709	0.9229
東方紺珠伝 ～ Legacy of Lunatic Kingdom.	2019-04-02	47	1005	18	65	0.9225
A Dance of Fire and Ice	2019-01-25	9330	48115	3120	12450	0.9223
Agent A: A puzzle in disguise	2019-08-29	319	3702	155	474	0.9215000000000001
RED HOT VENGEANCE	2019-07-11	245	2746	103	348	0.9215000000000001
Later Alligator	2019-09-18	255	1862	58	313	0.9215000000000001
Pilgrims	2019-10-07	124	2814	109	233	0.9208
Disco Elysium	2019-10-15	8081	69695	4872	12953	0.9198000000000001
I wanna be the Creator	2019-11-15	520	2285	84	604	0.9198000000000001
A Plague Tale: Innocence	2019-05-13	4058	48343	3301	7359	0.9195000000000001
AMID EVIL	2019-06-20	352	5249	262	614	0.9186
Reventure	2019-06-04	1309	7509	408	1717	0.9184000000000001
Descenders	2019-05-07	1954	12830	771	2725	0.9181
Yuppie Psycho	2019-04-25	339	5654	291	630	0.9181
EARTH DEFENSE FORCE 5	2019-07-11	8416	7537	419	8835	0.9174
Project Arrhythmia	2019-06-14	110	1734	62	172	0.9167000000000001
東方鬼形獣 〜 Wily Beast and Weakest Creature.	2019-09-09	387	913	21	408	0.9166
BirdGut	2019-05-09	255	3885	189	444	0.9165000000000001
沉睡的法则 Things as They Are	2019-06-18	261	950	23	284	0.9163
Necesse	2019-12-12	3894	5574	299	4193	0.9161
Halo: The Master Chief Collection	2019-12-03	161024	188075	14861	175885	0.9159999999999999
What Never Was	2019-01-11	181	4368	223	404	0.9158
STEINS;GATE: My Darling's Embrace	2019-12-10	57	872	20	77	0.9158
No Time	2019-04-15	92	1182	35	127	0.9157
The Thrill of the Fight	2019-10-24	69	3262	154	223	0.9156000000000001
Tiny Snow	2019-02-28	87	3325	159	246	0.9154000000000001
MX Bikes	2019-10-07	2661	10946	681	3342	0.9151
The Good Time Garden	2019-12-19	73	2086	86	159	0.9148000000000001
Otaku's Adventure	2019-05-20	2792	6230	354	3146	0.9146
Mushroom Cats	2019-06-10	115	1389	48	163	0.9143000000000001
祈風 Inorikaze	2019-02-13	50	348	0	50	0.9142
Enderal: Forgotten Stories	2019-02-14	5983	10649	678	6661	0.9136
FrostRunner	2019-01-01	360	3056	150	510	0.9133
Tangle Tower	2019-10-22	345	2814	135	480	0.9131999999999999
There is No GreenDam	2019-11-11	41	1563	61	102	0.9125
GORN	2019-07-18	479	7354	452	931	0.9123000000000001
The Jackbox Party Pack 6	2019-10-17	6630	2428	116	6746	0.9115000000000001
Gato Roboto	2019-05-30	915	3157	165	1080	0.9111
60 Seconds! Reatomized	2019-07-25	1251	9989	663	1914	0.9109
Hentai Girl Karen	2019-04-12	525	4125	233	758	0.9107
人间 The Lost We Lost	2019-04-30	233	2156	101	334	0.9107
Yakuza Kiwami	2019-02-19	3474	14659	1057	4531	0.9091
旅燕归航 Swallow Homing	2019-02-13	16	587	13	29	0.9086
The Political Process	2019-11-22	310	1406	59	369	0.9085
Hentai Girl Fantasy	2019-10-29	269	3746	219	488	0.908
Touhou Fantasia	2019-07-20	103	1356	57	160	0.9079
Fantasy Girl	2019-06-20	204	4570	282	486	0.9075
沙雕之路	2019-09-26	52	907	31	83	0.9075
My Time At Portia	2019-01-15	13299	36624	2994	16293	0.9069
Kao the Kangaroo: Round 2	2019-05-31	3667	7011	474	4141	0.9069
Zup! 9	2019-06-24	390	1406	62	452	0.9068
STEINS;GATE: Linear Bounded Phenogram	2019-02-19	454	560	13	467	0.9068
Perspective	2019-10-10	46	493	10	56	0.9064
Symbiotic Love	2019-03-21	95	1198	51	146	0.9055
Spring Falls	2019-11-17	65	632	18	83	0.9051
APE OUT	2019-02-28	128	2478	140	268	0.9048
ASTRONEER	2019-02-06	17986	96746	8691	26677	0.9047000000000001
Baldr Sky	2019-12-20	189	1029	42	231	0.9044
LOVE³ -Love Cube-	2019-07-25	380	2250	126	506	0.9039
Voxelgram	2019-11-07	75	379	6	81	0.9037999999999999
Shotgun Farmers	2019-03-08	486	8769	652	1138	0.9034000000000001
Mutazione	2019-09-19	49	781	28	77	0.9034000000000001
The Expression Amrilato	2019-06-21	91	569	16	107	0.9033
DATE A LIVE: Rio Reincarnation	2019-07-23	890	2574	152	1042	0.9032
BONEWORKS	2019-12-10	8717	30624	2624	11341	0.9027
Don't Escape Trilogy	2019-07-29	15	255	1	16	0.9027
Hello Neighbor Alpha 2	2019-10-15	103	2145	122	225	0.9026000000000001
Splitgate	2019-05-24	67724	99390	9228	76952	0.9024
Hot Lava	2019-09-19	1030	4654	320	1350	0.9020999999999999
DARQ	2019-08-15	154	3269	209	363	0.9020999999999999
I'm on Observation Duty	2019-04-03	163	1213	58	221	0.9015000000000001
Aircar	2019-08-09	73	1873	105	178	0.9014
Shipped	2019-03-28	66	563	17	83	0.9014
Ultra Fight Da Kyanta 2	2019-05-08	46	790	31	77	0.9009
Derail Valley	2019-01-25	1159	2821	179	1338	0.9008
Pizza Game	2019-09-06	110	284	3	113	0.9005
逝去的回忆3：四叶草之梦	2019-08-16	27	563	18	45	0.9
Frog Detective 2: The Case of the Invisible Wizard	2019-12-09	55	1291	66	121	0.8998999999999999
東方輝針城 〜 Double Dealing Character	2019-06-19	21	276	3	24	0.8995000000000001
Heart of the Woods	2019-02-15	67	682	26	93	0.8991
The World is Your Weapon	2019-06-28	81	535	17	98	0.8991
Clea	2019-07-10	40	355	7	47	0.8991
Trailmakers	2019-09-18	2132	13990	1182	3314	0.8987999999999999
Winds of Change	2019-08-21	61	480	14	75	0.8987999999999999
Deep Sleep Trilogy	2019-10-25	8	290	4	12	0.8986000000000001
Terminator: Resistance	2019-11-14	1392	10597	874	2266	0.8984000000000001
Zueirama	2019-08-06	60	956	45	105	0.8982
Unsung Warriors - Prologue	2019-01-15	113	1293	70	183	0.8976000000000001
Assetto Corsa Competizione	2019-05-29	7223	23053	2080	9303	0.8975
Seen	2019-06-21	1244	7891	641	1885	0.897
Minion Masters	2019-05-24	10329	54920	5340	15669	0.8964
Fate/EXTELLA LINK	2019-03-19	3118	3600	261	3379	0.8964
Swords & Souls: Neverseen	2019-07-22	2137	3507	254	2391	0.8962000000000001
雨的恋记	2019-04-19	26	549	20	46	0.8959999999999999
Explore Fushimi Inari	2019-10-11	80	1336	76	156	0.8959
Escape Lala	2019-02-14	16	289	5	21	0.8958
When the Darkness comes	2019-03-01	684	7342	603	1287	0.8956999999999999
Arcade Spirits	2019-02-12	136	447	14	150	0.8956000000000001
I Love You, Colonel Sanders! A Finger Lickin’ Good Dating Simulator	2019-09-24	4372	10917	943	5315	0.8955
The Lar	2019-06-10	82	877	43	125	0.8952
Super Jigsaw Puzzle: Generations	2019-04-04	233	732	33	266	0.895
Pistol Whip	2019-11-07	213	3180	231	444	0.8948999999999999
Pathologic 2	2019-05-23	1422	7490	625	2047	0.8948
MageQuit	2019-10-10	222	910	47	269	0.8937999999999999
The Long Drive	2019-09-25	3151	18854	1776	4927	0.8931
The Last Sovereign	2019-02-15	72	439	15	87	0.893
CHAOS;CHILD	2019-01-23	137	2069	142	279	0.8929
Hotel Sowls	2019-12-31	84	469	17	101	0.8928
Sakura no Mori † Dreamers 2	2019-03-15	65	373	11	76	0.8928
Red Dead Redemption 2	2019-12-05	70914	352985	38777	109691	0.8926999999999999
ΔV: Rings of Saturn	2019-08-12	360	1365	84	444	0.8926000000000001
Trap Shrine	2019-03-29	184	1436	90	274	0.8925000000000001
I Walk Among Zombies Vol. 2 (Adult Version)	2019-08-12	35	208	2	37	0.8925000000000001
コイカツ / Koikatsu Party	2019-06-10	398	4776	389	787	0.8923000000000001
ALIA’s CARNIVAL！	2019-11-15	94	477	18	112	0.8921
Coloring Game	2019-04-12	593	3383	264	857	0.8914
The Song of Saya	2019-08-13	429	3785	302	731	0.8912000000000001
9-nine-:Episode 1	2019-02-01	64	1012	58	122	0.8912000000000001
EverStopped	2019-09-27	47	392	13	60	0.8912000000000001
ChronoBreach	2019-04-29	28	258	5	33	0.8912000000000001
Timeflow	2019-01-19	646	1307	82	728	0.891
Planet Zoo	2019-11-05	38630	60767	6365	44995	0.8909
Rock Simulator	2019-11-27	125	989	57	182	0.8906000000000001
AI: The Somnium Files	2019-09-18	998	5864	508	1506	0.8902
Onimusha: Warlords	2019-01-15	526	1771	123	649	0.8902
Tree Simulator 2020	2019-03-26	15	445	17	32	0.8902
Eve of Souls: Static Pod	2019-06-05	46	430	16	62	0.8902
Fishy	2019-09-20	27	1240	79	106	0.8895000000000001
Mr. Hopp's Playhouse	2019-11-15	88	1165	73	161	0.8893000000000001
while True: learn()	2019-01-17	844	5854	517	1361	0.8889
MO:Astray	2019-10-25	492	4112	345	837	0.8889
绮罗四时谭	2019-11-06	17	372	13	30	0.8886000000000001
Whispers of a Machine	2019-04-17	118	1428	97	215	0.8884000000000001
Shepherd of Light	2019-09-04	55	700	37	92	0.8882
Forager	2019-04-18	13438	30907	3222	16660	0.8881
DRAGON QUEST BUILDERS™ 2	2019-12-10	3358	5346	472	3830	0.8881
Digimon Story Cyber Sleuth: Complete Edition	2019-10-17	2404	7234	667	3071	0.8876999999999999
Tailor Tales	2019-01-10	186	612	31	217	0.8873000000000001
SENRAN KAGURA Burst Re:Newal	2019-01-22	334	1685	123	457	0.8868
Wilmot's Warehouse	2019-08-29	60	343	12	72	0.8867
Workers & Resources: Soviet Republic	2019-03-15	3891	11728	1157	5048	0.8865000000000001
Snakeybus	2019-05-10	519	1877	142	661	0.8862000000000001
Tracks - The Train Set Game	2019-11-14	104	1086	71	175	0.8862000000000001
Open World Game: the Open World Game	2019-11-19	133	2139	167	300	0.886
Drift86	2019-11-19	592	4577	408	1000	0.8859
Mutilate-a-Doll 2	2019-03-01	108	1408	100	208	0.8858
Golden Treasure: The Great Green	2019-06-17	53	423	18	71	0.8858
I hate this game	2019-03-07	84	1494	108	192	0.8856999999999999
Coloring Game: Little City	2019-08-16	289	903	56	345	0.8856999999999999
Glass Masquerade 2: Illusions	2019-02-28	932	2377	191	1123	0.8856
TheoTown	2019-06-05	97	1406	101	198	0.8852
Higurashi When They Cry Hou - Ch.7 Minagoroshi	2019-07-18	49	333	12	61	0.8852
Legend of Keepers: Prologue	2019-10-10	803	2175	174	977	0.8848
pact with a witch	2019-06-25	207	1421	103	310	0.8848
DEMON'S TILT	2019-12-13	32	673	38	70	0.8847
Blasphemous	2019-09-10	3247	26935	2905	6152	0.8845000000000001
Barrage Musical ~ Basic Danmaku Tutorial ~ / 弹幕音乐绘 ~ 基础教学篇 ~	2019-12-14	13	168	2	15	0.8844
某1种青春	2019-02-18	65	342	13	78	0.8843000000000001
Swords and Sandals Classic Collection	2019-04-19	179	1641	125	304	0.8840000000000001
Lords Of The Lockerroom	2019-05-17	10	281	9	19	0.8840000000000001
MicroTown	2019-08-30	50	394	17	67	0.8837999999999999
NekoMiko	2019-01-25	33	394	17	50	0.8837999999999999
Hashihime of the Old Book Town	2019-09-26	44	265	8	52	0.8837999999999999
A Fisherman's Tale	2019-01-22	47	1046	71	118	0.8837
Breeders of the Nephelym: Alpha	2019-10-18	2702	7515	737	3439	0.8835
Shovel Knight: Shovel of Hope	2019-12-10	39	610	34	73	0.8834000000000001
Lovers of Aether	2019-04-01	651	1375	102	753	0.8831
Himno	2019-04-26	320	4910	462	782	0.8828
The Room Syndrome	2019-11-02	108	289	10	118	0.8828
Vectronom	2019-05-29	25	243	7	32	0.8826
The Last 47 Hours	2019-03-01	36	655	39	75	0.8819
Pretty Angel	2019-12-13	255	3158	283	538	0.8818000000000001
When The Past Was Around - Prologue	2019-11-04	14	594	34	48	0.8818000000000001
Tamashii	2019-03-05	10	269	9	19	0.8818000000000001
Lingua Fleur: Lily	2019-03-30	19	192	4	23	0.8818000000000001
Escape Lala 2	2019-07-18	8	139	1	9	0.8818000000000001
STAR WARS Jedi: Fallen Order™ 	2019-11-15	46550	109765	13113	59663	0.8817
Mars Power Industries Deluxe	2019-11-04	120	495	26	146	0.8817
Blaster Master Zero	2019-06-14	90	708	44	134	0.8814000000000001
美少年梦工厂3：重生	2019-05-09	92	265	9	101	0.881
Air Marty	2019-11-18	16	293	11	27	0.8809
Little Misfortune	2019-09-18	750	6958	701	1451	0.8808
Trine 4: The Nightmare Prince	2019-10-08	1744	9626	1009	2753	0.8803000000000001
Astrologaster	2019-05-09	32	368	17	49	0.88
Synth Riders	2019-10-31	144	1212	92	236	0.8799
Ion Fury	2019-08-15	1471	6129	617	2088	0.8798
No Time to Relax	2019-08-21	1649	1179	89	1738	0.8798
ULTIMATE HARDBASS DEFENCE	2019-04-12	533	1961	167	700	0.8795999999999999
JermaSlots	2019-04-07	22	499	28	50	0.8792
Premium Bowling	2019-10-18	34	336	15	49	0.8790000000000001
F1 2019	2019-06-27	12736	19783	2233	14969	0.8789
Spice&Wolf VR	2019-06-03	144	975	71	215	0.8788
Granny Simulator	2019-04-17	172	3741	359	531	0.8787
Jump King	2019-05-03	858	8716	924	1782	0.8786
Little Mouse's Encyclopedia	2019-02-25	21	162	3	24	0.8784000000000001
Trover Saves the Universe	2019-06-04	951	2564	234	1185	0.8782
NinNinDays	2019-08-08	240	685	45	285	0.8781
Lonely Mountains: Downhill	2019-10-23	277	1766	151	428	0.878
La Rana	2019-01-01	36	391	20	56	0.8776999999999999
China: Mao's legacy	2019-05-24	2225	743	51	2276	0.8774
Fight of Animals	2019-12-19	109	426	23	132	0.8774
Elsinore	2019-07-23	46	246	9	55	0.8772
Sandwich Sudoku	2019-08-19	62	141	2	64	0.8771
食用系少女 Food Girls	2019-06-06	138	398	21	159	0.8769
NITE Team 4	2019-02-27	209	1036	80	289	0.8765000000000001
Children of Morta	2019-09-03	4381	14438	1641	6022	0.8764000000000001
If My Heart Had Wings -Flight Diary-	2019-02-28	83	419	23	106	0.8764000000000001
Hello Neighbor Alpha 1	2019-10-12	149	1806	159	308	0.8763
DEEP SPACE WAIFU: WORLD	2019-04-24	105	600	39	144	0.8762000000000001
Minotaur	2019-09-05	49	307	14	63	0.8761
Dealer's Life	2019-01-31	200	1047	82	282	0.8759
弾幕アマノジャク 〜 Impossible Spell Card.	2019-04-02	18	137	2	20	0.8759
Hentai Mosaique Fix-IT Shoppe	2019-07-29	334	774	56	390	0.8754000000000001
Hello Lady! -New Division-	2019-04-19	48	289	13	61	0.8751000000000001
eSail Sailing Simulator	2019-03-26	51	490	30	81	0.875
Football Manager 2020	2019-11-19	189464	28272	3436	192900	0.8743000000000001
Dicey Dungeons	2019-08-13	2994	8285	922	3916	0.8742000000000001
Gachi Finder 3000	2019-01-08	7	163	4	11	0.8742000000000001
Serious Sam Classics: Revolution	2019-08-30	175	2815	277	452	0.8739
Heave Ho	2019-08-29	289	1871	172	461	0.8739
Love, Sam	2019-06-04	20	355	19	39	0.8738
Wurroom	2019-11-09	14	535	35	49	0.8737
Coloring Game: Pixel	2019-10-25	32	161	4	36	0.8736
Micro Mages	2019-05-01	28	305	15	43	0.8734000000000001
Anodyne 2: Return to Dust	2019-08-12	95	531	35	130	0.8732
Tetra Project - 原石计划	2019-09-23	133	520	34	167	0.8732
SiNKR 2	2019-05-09	76	188	6	82	0.8732
SuperSmash	2019-10-01	48	739	55	103	0.873
macdows 95	2019-09-06	1254	529	35	1289	0.8729000000000001
Cricket 19	2019-07-30	649	2620	259	908	0.8728
Hedon Bloodrite	2019-05-16	212	1405	124	336	0.8728
Seven Days	2019-12-14	17	143	3	20	0.8727
Paunch	2019-12-04	384	9267	1064	1448	0.8724
Epido	2019-05-06	321	891	71	392	0.8723000000000001
Intruder	2019-03-01	1421	4892	529	1950	0.8722
Detective Girl of the Steam City	2019-07-19	591	1413	126	717	0.8722
Heroine of the Sniper	2019-05-30	49	311	16	65	0.8722
Transport Fever 2	2019-12-11	24308	18130	2197	26505	0.8721
Prologue For A Vacant Kingdom	2019-04-18	30	224	9	39	0.8721
Fear & Hunger	2019-01-21	201	1285	113	314	0.8718000000000001
Unlock The King	2019-11-20	35	248	11	46	0.8717
Space Engineers	2019-02-28	23888	105273	13956	37844	0.8715999999999999
Not For Broadcast: Prologue	2019-12-11	31	693	52	83	0.8715
Wally and the FANTASTIC PREDATORS	2019-09-03	16	182	6	22	0.8715
LAMUNATION! -international-	2019-11-22	111	527	36	147	0.8713
Drunken Wrestlers 2	2019-04-01	1045	9353	1092	2137	0.8711
Kyle is Famous	2019-11-18	108	1171	102	210	0.8711
Out of the Park Baseball 20	2019-03-22	1445	1002	84	1529	0.8711
Man of the House	2019-10-01	1061	2266	225	1286	0.8708
IL DIVINO - Michelangelo's Sistine Ceiling in VR	2019-11-18	11	152	4	15	0.8708
Escape Mind	2019-10-25	4	106	1	5	0.8708
東方神霊廟 〜 Ten Desires	2019-06-19	21	267	13	34	0.8704999999999999
HorrorVale	2019-07-28	7	120	2	9	0.87
Sumatra: Fate of Yandi	2019-05-14	8	119	2	10	0.8695999999999999
Newfound Courage	2019-03-22	15	285	15	30	0.8693000000000001
Hop Step Sing! Astral Piece	2019-12-12	5	84	0	5	0.8687
SYNTHETIK: Arena	2019-01-21	317	1977	198	515	0.8684999999999999
Starcom: Nexus	2019-12-12	554	1507	144	698	0.8684000000000001
Virgo Versus the Zodiac	2019-12-12	112	732	59	171	0.8684000000000001
ZACH-LIKE	2019-06-17	58	130	3	61	0.8681000000000001
A Gay's Life	2019-11-20	17	313	18	35	0.868
Final Assault	2019-05-16	43	419	28	71	0.8677
Sky Racket	2019-10-22	13	156	5	18	0.8676
DoraKone	2019-04-23	9	156	5	14	0.8676
Monster Boy And The Cursed Kingdom	2019-07-25	359	1817	182	541	0.8675
Train Valley 2	2019-04-15	448	2062	211	659	0.8674
Hyper Jam	2019-02-12	139	406	27	166	0.8673000000000001
Chrono Ark	2019-12-20	1560	4605	526	2086	0.8671
HOME	2019-05-12	102	2976	323	425	0.867
FluidLander	2019-05-10	14	167	6	20	0.8669
Zelle	2019-10-04	10	307	18	28	0.8667
Wolfpack	2019-03-15	384	1423	138	522	0.8666
Glad Valakas: Cyberban	2019-06-29	23	126	3	26	0.8666
Miss Neko	2019-08-13	308	3129	344	652	0.8665
Eliza	2019-08-12	113	1299	124	237	0.8665
Russian Life Simulator	2019-05-17	2901	5602	660	3561	0.8662000000000001
Duck Season PC	2019-06-17	70	712	60	130	0.8652
A Bewitching Revolution	2019-04-09	9	256	14	23	0.8652
枕边少女 MOE Hypnotist - share dreams with you	2019-01-28	66	627	51	117	0.8651000000000001
圣女战旗 Banner of the Maid	2019-05-28	3737	5906	709	4446	0.865
GRANDIA HD Remaster	2019-10-15	301	1024	95	396	0.865
我的纸片人女友/Make butter together!	2019-07-10	93	588	47	140	0.865
STEINS;GATE ELITE	2019-02-19	103	1056	99	202	0.8647
Nurse Love Syndrome	2019-04-19	29	173	7	36	0.8647
Vanishing Realms	2019-08-23	149	2314	250	399	0.8645999999999999
Eastshade	2019-02-13	440	4104	478	918	0.8644
Talk to Strangers	2019-04-19	16	253	14	30	0.8644
Nauticrawl	2019-09-16	49	263	15	64	0.8642000000000001
Sophie's Dice	2019-06-17	18	106	2	20	0.8642000000000001
Depraved Awakening	2019-08-30	127	466	35	162	0.8640000000000001
Neon Boost	2019-05-20	107	2231	242	349	0.8639
Autonauts	2019-10-17	3598	3792	442	4040	0.8636
BEARS, VODKA, BALALAIKA! 🐻	2019-11-06	505	1721	180	685	0.8636
Deliver Us The Moon	2019-10-10	469	5505	669	1138	0.8633
The Leopard Catgirl in Miaoli	2019-12-14	28	169	7	35	0.8633
Whimsy	2019-12-22	7	104	2	9	0.8633
Sheaf - Together EP	2019-07-23	7	143	5	12	0.8628
Fell Seal: Arbiter's Mark	2019-04-30	1791	4681	566	2357	0.8623999999999999
OXXO	2019-08-07	14	201	10	24	0.8623999999999999
Love Thyself - A Horatio Story	2019-04-01	101	503	40	141	0.8623000000000001
M.A.S.S. Builder	2019-09-13	481	3017	348	829	0.8622
Rise to Ruins	2019-10-14	1469	6316	790	2259	0.8619
Button Button Up!	2019-08-09	32	165	7	39	0.8619
英雄群侠传II	2019-07-16	77	1722	185	262	0.8615
Spirit Hunter: NG	2019-10-10	30	187	9	39	0.8615
Sankaku Renai: Love Triangle Trouble	2019-05-31	114	209	11	125	0.8614
SWINE HD Remaster	2019-05-23	364	867	82	446	0.8611
巅峰骑士团	2019-08-27	87	1076	107	194	0.8609
天降锦鲤 ~ My Lucky Koi	2019-11-23	11	291	19	30	0.8608
Flappatron	2019-07-25	39	125	4	43	0.8606
How to Raise a Wolf Girl	2019-10-11	45	300	20	65	0.8605
Factory Balls	2019-05-07	14	98	2	16	0.8604
Some Distant Memory	2019-11-14	9	215	12	21	0.8599
Pesterquest	2019-09-04	772	1104	112	884	0.8598
Antenna Dilemma	2019-04-24	11	182	9	20	0.8598
Vacation Simulator	2019-04-09	426	774	73	499	0.8595
Unroaded	2019-03-06	17	255	16	33	0.8593999999999999
SUPER ROBOT WARS V	2019-10-02	1322	1209	126	1448	0.8591
Monobeno-HAPPY END-	2019-01-25	27	362	27	54	0.8591
Demons Never Lie	2019-10-22	160	399	31	191	0.8590000000000001
LuGame: Lunchtime Games Club!	2019-06-20	18	168	8	26	0.8589
绽于枝垂樱下~Flowering Across the Hakugyokurou	2019-07-13	13	133	5	18	0.8588
妖精大戦争 〜 東方三月精	2019-08-02	10	81	1	11	0.8588
NABOKI	2019-11-12	7	272	18	25	0.8586
Wanna Survive	2019-08-13	51	241	15	66	0.8583
Knights and Bikes	2019-08-27	57	422	34	91	0.8581000000000001
Mortal Kombat 11	2019-04-23	35147	64323	9552	44699	0.858
Nanairo Reincarnation	2019-09-27	33	143	6	39	0.858
Killer Queen Black	2019-10-11	258	493	42	300	0.8579000000000001
Earthlingo	2019-10-17	26	131	5	31	0.8579000000000001
Pacify	2019-02-22	3173	31784	4598	7771	0.8578
Love Esquire	2019-10-08	528	908	91	619	0.8578
A Street Cat's Tale	2019-09-06	18	208	12	30	0.8577
The Last Companion	2019-10-18	7	165	8	15	0.8577
SAMURAI SHODOWN V SPECIAL / サムライスピリッツ零スペシャル	2019-06-18	59	409	33	92	0.8573999999999999
英雄群侠传	2019-06-27	16	434	36	52	0.8570000000000001
Shisensho Solitaire	2019-10-09	13	63	0	13	0.8570000000000001
Girls Free	2019-01-18	44	971	100	144	0.8569
Shadow Corridor	2019-03-08	250	1372	151	401	0.8567
MXGP 2019 - The Official Motocross Videogame	2019-08-27	307	921	94	401	0.8567
Talesshop Puzzle	2019-10-07	32	284	20	52	0.8566
Lost Ember	2019-11-22	590	3792	479	1069	0.8565
PerfectLover	2019-11-21	179	917	94	273	0.8563
NEKO-NIN exHeart 3	2019-10-18	49	193	11	60	0.8562000000000001
Chippy	2019-06-14	97	841	85	182	0.856
Hello Neighbor Pre-Alpha	2019-10-10	145	984	103	248	0.8559000000000001
Green Hell	2019-09-05	20003	49032	7369	27372	0.8556
Walking Zombie 2	2019-10-11	964	9065	1247	2211	0.8556
ACE COMBAT™ 7: SKIES UNKNOWN	2019-01-31	13758	29436	4343	18101	0.8553000000000001
瓶中精灵 - Fairy in a Jar	2019-03-07	26	180	10	36	0.8553000000000001
UNDEFEATED	2019-08-02	716	5092	672	1388	0.8551000000000001
Sister Travel	2019-01-25	137	467	41	178	0.8551000000000001
Ciconia When They Cry - Phase 1 For You, the Replaceable Ones	2019-10-04	265	334	26	291	0.8551000000000001
Stone Story RPG	2019-08-08	739	594	56	795	0.855
Gibbous - A Cthulhu Adventure	2019-08-07	297	1650	192	489	0.8545999999999999
Zombotron	2019-04-22	195	2114	256	451	0.8542000000000001
Youth Feather	2019-08-30	503	613	59	562	0.8542000000000001
Astrox Imperium	2019-03-22	231	735	74	305	0.8541
Niplheim's Hunter - Branded Azel	2019-01-07	171	670	66	237	0.8541
Gladiabots	2019-05-22	284	734	74	358	0.8540000000000001
Hell is Other Demons	2019-05-20	28	274	20	48	0.8540000000000001
Toran	2019-04-18	12	205	13	25	0.8534
Rehtona	2019-01-23	28	132	6	34	0.8532
Spark the Electric Jester 2	2019-05-16	72	456	41	113	0.8531000000000001
Tropico 6	2019-03-29	15294	19946	2961	18255	0.8527
Moko's Advice	2019-12-10	9	131	6	15	0.8527
It Stares Back	2019-06-25	6	84	2	8	0.8525
Catherine Classic	2019-01-10	1265	7039	982	2247	0.8523999999999999
Art Plunge	2019-09-11	6	108	4	10	0.8523999999999999
Detective Jackie - Mystic Case	2019-11-07	15	108	4	19	0.8523999999999999
Lurk in the Dark : Prologue	2019-11-09	101	1588	189	290	0.8523000000000001
Secret Neighbor	2019-10-24	5174	13802	2024	7198	0.8519
Tick Tock: A Tale for Two	2019-03-07	1213	7819	1104	2317	0.8519
Edna & Harvey: The Breakout - Anniversary Edition	2019-12-04	55	407	36	91	0.8519
DiRT Rally 2.0	2019-02-26	3533	28283	4305	7838	0.8518000000000001
Funbag Fantasy	2019-01-31	36	150	8	44	0.8517
Fururu Project : Ruby	2019-02-18	13	118	5	18	0.8517
FOCUS on YOU	2019-07-05	52	522	50	102	0.8516
Cat Burglar: A Tail of Purrsuit	2019-03-06	899	319	26	925	0.8516
The Orville - Interactive Fan Experience	2019-07-23	61	821	88	149	0.8513
Rabisco	2019-09-10	5	55	0	5	0.8512000000000001
Night of the Full Moon	2019-07-26	1768	6865	969	2737	0.851
Detective Di: The Silk Rose Murders	2019-05-01	140	931	103	243	0.8509000000000001
Burning Daylight	2019-04-19	204	2579	333	537	0.8506999999999999
Monkey GO Happy	2019-12-29	6	116	5	11	0.8506999999999999
Classic Sudoku	2019-11-25	125	341	29	154	0.8506
隐形守护者 The Invisible Guardian	2019-01-23	82345	42266	6615	88960	0.8505
Feel The Snow	2019-12-12	365	2468	318	683	0.8504
Quake II RTX	2019-06-06	886	3519	473	1359	0.8501000000000001
ToeJam & Earl: Back in the Groove	2019-03-01	480	877	97	577	0.85
Strategic Command: World War I	2019-12-05	145	295	24	169	0.8499
The Princess, the Stray Cat, and Matters of the Heart 2	2019-11-08	21	125	6	27	0.8498000000000001
Cat Lady - The Card Game	2019-12-12	16	213	15	31	0.8495999999999999
Wizard And Minion Idle	2019-02-07	729	563	57	786	0.8492000000000001
Super Cane Magic ZERO	2019-05-30	84	394	36	120	0.8492000000000001
Titans of Space PLUS	2019-12-19	23	174	11	34	0.8492000000000001
ef - the first tale.	2019-10-17	8	79	2	10	0.8492000000000001
Brass Brigade	2019-11-22	32	418	39	71	0.8491
The Lord of the Rings: Journeys in Middle-earth	2019-04-18	332	585	60	392	0.8490000000000001
Funbag Fantasy: Sideboob Story	2019-03-28	12	52	0	12	0.8487
Total Party Kill	2019-07-03	8	133	7	15	0.8486
War Selection	2019-10-08	2026	14901	2266	4292	0.8484999999999999
The Language of Love	2019-05-28	11	112	5	16	0.8484999999999999
Warfork	2019-08-16	363	1398	171	534	0.8483
Atma	2019-07-10	35	525	53	88	0.8481000000000001
Banter Schooldays!!三〇一室无一人	2019-11-22	113	647	69	182	0.8479000000000001
Break Arcade Games Out	2019-09-20	20	180	12	32	0.8478
Aka Manto | 赤マント	2019-09-24	19	638	68	87	0.8477
Lorelai	2019-04-26	253	1045	123	376	0.8476
HYPERFIGHT	2019-03-07	49	751	83	132	0.8476
Cats are Liquid - A Better Place	2019-12-14	13	179	12	25	0.8473999999999999
Foundation	2019-02-01	4088	11310	1713	5801	0.8472
Pool 2D - Poolians	2019-12-11	773	5575	804	1577	0.8472
The Devil's Calculator	2019-02-18	34	99	4	38	0.8472
Dungeon Dreams	2019-02-20	40	187	13	53	0.8469
Devolver Bootleg	2019-06-10	768	956	112	880	0.8467
Basketball Classics	2019-12-18	9	139	8	17	0.8466
Airranger	2019-08-02	21	119	6	27	0.8466
食用系少女：美食內戰 Food Girls：Civil War	2019-12-13	29	87	3	32	0.8466
Dawn of Man	2019-03-01	23864	12975	1993	25857	0.8465
CODE VEIN	2019-09-26	33895	41272	6692	40587	0.8464
Heaven's Vault	2019-04-16	261	1544	196	457	0.8464
Natsu no Iro no Nostalgia	2019-12-06	76	373	35	111	0.8464
MotoGP™19	2019-06-06	962	1333	166	1128	0.8462000000000001
Aperture Hand Lab	2019-06-25	92	1051	126	218	0.8462000000000001
Life Tastes Like Cardboard	2019-09-23	7	185	13	20	0.8461
UBERMOSH:OMEGA	2019-11-08	14	157	10	24	0.846
Dies irae ~Interview with Kaziklu Bey~	2019-02-28	33	49	0	33	0.846
Ideology in Friction	2019-06-14	918	1314	164	1082	0.8458
The Defender: Farm and Castle	2019-05-16	356	911	107	463	0.8458
Gunvolt Chronicles: Luminous Avenger iX	2019-09-25	192	580	62	254	0.8458
Mr. Pumpkin 2: Kowloon walled city	2019-11-13	49	263	22	71	0.8458
Muv-Luv photonflowers*	2019-08-02	35	166	11	46	0.8458
Odd Realm	2019-01-11	96	669	74	170	0.8456999999999999
Ord.	2019-06-05	14	184	13	27	0.8456999999999999
Battle Realms: Zen Edition	2019-12-03	834	2285	308	1142	0.8455
Atelier Lulua ~The Scion of Arland~	2019-05-21	516	440	44	560	0.8455
Princess & Conquest	2019-10-10	212	1645	213	425	0.8454
Blazing Chrome	2019-07-11	119	1246	155	274	0.8454
Fun with Ragdolls: The Game	2019-09-17	490	3537	500	990	0.8453
Girl and Goblin	2019-01-05	264	1704	222	486	0.8453
GLAD VALAKAS TOWER DEFENCE 2	2019-03-07	24	96	4	28	0.8453
AI War 2	2019-10-22	310	1207	150	460	0.8451000000000001
Tzar: The Burden of the Crown	2019-06-06	39	343	32	71	0.8451000000000001
OCTOPATH TRAVELER	2019-06-07	6177	10850	1681	7858	0.8445
The Dandelion Girl: Don't You Remember Me?	2019-07-11	7	115	6	13	0.8444
Touhou Shoujo Tale of Beautiful Memories / 東方少女綺想譚	2019-08-23	43	153	10	53	0.8442000000000001
The 13th Doll: A Fan Game of The 7th Guest	2019-10-31	77	162	11	88	0.8441
尼諾的異世界物語	2019-10-16	24	171	12	36	0.8440000000000001
Answer Knot	2019-05-31	16	553	60	76	0.8439
Mythic Ocean: Prologue	2019-10-07	13	83	3	16	0.8439
Atelier Ryza: Ever Darkness & the Secret Hideout	2019-10-29	4616	5996	899	5515	0.8438
Fisher Online	2019-10-27	1954	2505	347	2301	0.8438
Bomb Chicken	2019-04-16	30	240	20	50	0.8438
Songbird Symphony	2019-07-25	29	404	41	70	0.8429000000000001
Worbital	2019-01-31	151	350	34	185	0.8429000000000001
Borderlands GOTY Enhanced	2019-04-03	26446	15029	2408	28854	0.8428
Hand Simulator: Survival	2019-12-17	985	8479	1314	2299	0.8428
Suite 776	2019-12-06	22	524	57	79	0.8428
Changeling	2019-01-30	45	131	8	53	0.8425
The Pilgrim	2019-08-16	6	102	5	11	0.8425
Grand Brix Shooter	2019-08-29	10	70	2	12	0.8423999999999999
The Cursed Forest	2019-02-26	32	652	75	107	0.8423
Sanator: Scarlet Scarf	2019-06-06	15	355	35	50	0.8422000000000001
Sea Bubble	2019-09-27	10	58	1	11	0.8422000000000001
Unitied	2019-11-27	6	45	0	6	0.8421
Cliff Empire	2019-08-06	3099	3357	488	3587	0.8420000000000001
Project Cappuccino	2019-11-15	24	111	6	30	0.8420000000000001
YumeUtsutsu Re:Master	2019-06-13	47	267	24	71	0.8419
Macrotis: A Mother's Journey	2019-02-08	22	166	12	34	0.8418000000000001
3dSenVR	2019-06-04	8	148	10	18	0.8418000000000001
The Designer's Curse	2019-07-29	34	634	73	107	0.8417
King Rabbit - Puzzle	2019-01-25	62	298	28	90	0.8416
Legends of Amberland	2019-08-01	32	183	14	46	0.8416
Dungeon Scavenger	2019-08-21	19	100	5	24	0.8412999999999999
Grisaia Phantom Trigger Vol.6	2019-04-26	54	90	4	58	0.8412999999999999
Super Life (RPG)	2019-07-18	145	434	46	191	0.8412000000000001
We Need To Go Deeper	2019-08-01	879	4520	680	1559	0.8411
EarthX	2019-07-12	159	594	68	227	0.8411
Acron: Attack of the Squirrels!	2019-08-29	41	146	10	51	0.8408
Rabbit Burn	2019-05-17	90	590	68	158	0.8404
Pandamonia	2019-04-30	8	127	8	16	0.8403
Wet Girl	2019-01-30	644	4688	714	1358	0.8402
AHEGAL SEASONS	2019-09-23	19	300	29	48	0.84
Danger Crew	2019-05-06	6	43	0	6	0.84
Lust from Beyond: Prologue	2019-10-31	225	1286	171	396	0.8399
BDSM: Big Drunk Satanic Massacre	2019-10-11	78	925	117	195	0.8399
ef - the latter tale.	2019-10-17	5	67	2	7	0.8399
Lovely Planet 2: April Skies	2019-06-18	26	135	9	35	0.8397
Hello Neighbor Alpha 4	2019-10-19	145	2553	371	516	0.8394
TOK 2	2019-03-28	6	116	7	13	0.8393
Hentai Mosaique Vip Room	2019-04-10	842	770	95	937	0.8392000000000001
YORG.io	2019-05-23	357	439	48	405	0.8392000000000001
Phucker in the Woods	2019-08-19	12	134	9	21	0.8392000000000001
Tiny Dangerous Dungeons	2019-03-01	5	66	2	7	0.8390000000000001
Apsulov: End of Gods	2019-08-08	120	1168	155	275	0.8389
Pigeons Attack	2019-02-21	36	151	11	47	0.8388
我是渣男-dishonest	2019-07-27	75	257	24	99	0.8387000000000001
Galaxy Trucker: Extended Edition	2019-03-07	72	159	12	84	0.8386
Blaster Master Zero 2	2019-11-29	37	354	37	74	0.8382
Neptunia Shooter	2019-05-21	95	617	74	169	0.838
Palmyra Orphanage	2019-09-24	47	547	64	111	0.838
SENRAN KAGURA Peach Ball	2019-08-14	133	511	59	192	0.8378
Redneck Kentucky and the Next Generation Chickens	2019-03-11	7	75	3	10	0.8377
文字獄	2019-03-14	110	269	26	136	0.8376000000000001
Death Crown	2019-08-23	20	388	42	62	0.8375
ダブルスポイラー 〜 東方文花帖	2019-08-02	7	53	1	8	0.8373999999999999
Shadow Brawlers	2019-12-13	6	64	2	8	0.8372
Fit For a King	2019-09-05	22	64	2	24	0.8372
Fireboy & Watergirl: Elements	2019-01-24	118	542	64	182	0.8371
ALILIA	2019-04-05	11	139	10	21	0.8371
Lenin - The Lion	2019-09-27	22	94	5	27	0.8371
They Are Billions	2019-06-18	22395	36124	6320	28715	0.8369
GENSOU Skydrift	2019-12-11	172	511	60	232	0.8365
FULFILLMENT	2019-11-12	181	235	22	203	0.8365
Devader	2019-09-02	10	52	1	11	0.8362999999999999
Hellbound: Survival Mode	2019-11-22	136	1694	243	379	0.8362
Self-Reliance 自我性赖	2019-02-08	57	612	75	132	0.8362
Phucker in the Gulag	2019-05-13	9	187	16	25	0.8362
Remnant: From the Ashes	2019-08-20	48289	37597	6632	54921	0.8361000000000001
Karate Cat	2019-10-11	4	83	4	8	0.8361000000000001
Nobodies	2019-09-30	36	264	26	62	0.836
JUMPGRID	2019-02-12	9	73	3	12	0.836
SteamWorld Quest: Hand of Gilgamech	2019-05-31	1061	1356	190	1251	0.8358
Jenny LeClue - Detectivu	2019-09-19	105	921	122	227	0.8358
MOLEK-SYNTEZ	2019-11-19	260	514	61	321	0.8358
Bloons Adventure Time TD	2019-01-16	268	2603	393	661	0.8357
Still There	2019-11-20	90	940	125	215	0.8357
Dredgers	2019-10-23	312	387	43	355	0.8356
Paper Dolls Original	2019-04-19	654	3293	509	1163	0.8355
ZUSI 3 - Aerosoft Edition	2019-06-18	149	351	38	187	0.8355
XOXO Blood Droplets	2019-10-30	35	209	19	54	0.8355
Game Soup	2019-02-11	17	101	6	23	0.8355
Lilitales	2019-10-11	248	449	52	300	0.8353
Owyn's Adventure	2019-04-03	4	51	1	5	0.8353
Lost Flame	2019-08-02	9	39	0	9	0.8353
Familia	2019-12-09	3	39	0	3	0.8353
Tales of the Neon Sea	2019-04-30	691	2476	374	1065	0.8351000000000001
TOK HARDCORE	2019-04-11	6	100	6	12	0.8348000000000001
Angry Birds VR: Isle of Pigs	2019-02-07	49	275	28	77	0.8347
Bugs Must Die	2019-04-06	8	126	9	17	0.8346
Void Bastards	2019-05-29	2886	4047	643	3529	0.8344
TAISHO x ALICE episode 1	2019-11-28	117	707	91	208	0.8343
Freedom Finger	2019-09-27	15	117	8	23	0.8343
东方华彩乱战 ~ Touhou Blooming Chaos	2019-10-01	64	317	34	98	0.8341
Fujii	2019-06-27	11	90	5	16	0.8341
Super Naughty Maid 2	2019-06-21	93	1096	152	245	0.8340000000000001
Roof Rage	2019-10-16	150	532	65	215	0.8340000000000001
TribeXR DJ School	2019-03-25	12	174	15	27	0.8340000000000001
Thrusty Ship	2019-01-23	9	38	0	9	0.8340000000000001
Seeker	2019-01-01	20	564	70	90	0.8338
We Were Here Together	2019-10-10	2930	9135	1543	4473	0.8337000000000001
Clam Man	2019-05-23	7	116	8	15	0.8337000000000001
SD GUNDAM G GENERATION CROSS RAYS	2019-11-27	10415	5903	971	11386	0.8336
Try To Fall Asleep	2019-03-08	13	141	11	24	0.8336
GOAT OF DUTY	2019-07-10	3018	3441	544	3562	0.8334999999999999
Beat Hazard 2	2019-10-16	439	1816	270	709	0.8334
Calm Down, Stalin - VR	2019-09-12	7	60	2	9	0.8334
Paranormal Detective: Escape from the 80's	2019-12-12	5	70	3	8	0.8333
Totally Reliable Delivery Service Beta	2019-06-24	823	3184	502	1325	0.8331000000000001
Super Arcade Racing	2019-10-15	7	79	4	11	0.8328
Undead Horde	2019-05-15	683	1077	151	834	0.8327
Exception	2019-08-13	5	37	0	5	0.8327
The Curious Tale of the Stolen Pets	2019-11-14	15	239	24	39	0.8325
Skirmish Line	2019-03-21	43	304	33	76	0.8323999999999999
Drowning Cross	2019-06-07	20	163	14	34	0.8323999999999999
Armored Brigade	2019-10-31	87	253	26	113	0.8322
Age of Fear: The Undead King GOLD	2019-06-11	18	78	4	22	0.8319
Space Smash	2019-03-07	3	48	1	4	0.8319
CounterAttack	2019-03-12	70	237	24	94	0.8317
HRDINA	2019-06-26	54	459	56	110	0.8316
Raindancer	2019-10-30	19	273	29	48	0.8316
NEKO-NIN exHeart 2 Love +PLUS	2019-04-26	22	104	7	29	0.8314
Winter Polaris	2019-12-12	8	68	3	11	0.8314
Super Crome: Bullet Purgatory	2019-03-19	5	36	0	5	0.8314
Dreamland Solitaire	2019-09-19	8	36	0	8	0.8314
Gunkid 99	2019-03-13	11	58	2	13	0.8312999999999999
Death Live	2019-09-13	44	536	68	112	0.8311000000000001
Crying Suns	2019-09-19	1479	3082	494	1973	0.831
Hentai Crush	2019-03-14	1166	2364	370	1536	0.831
Funbag Fantasy 2	2019-11-21	31	47	1	32	0.8307
小林正雪复仇之密室重制版	2019-01-30	70	270	29	99	0.8306
Lilycle Rainbow Stage!!!	2019-03-15	17	111	8	25	0.8304
Mini Words	2019-10-24	13	111	8	21	0.8304
Police Stories	2019-09-19	998	5776	977	1975	0.8303
Snakebird Primer	2019-02-20	14	151	13	27	0.8303
Stones of Solace	2019-08-20	9	119	9	18	0.8301999999999999
CODE CRACKER 代码破译者	2019-03-26	73	135	11	84	0.8301000000000001
The Answer is 42	2019-12-12	21	127	10	31	0.8301000000000001
咕啾！文鸟恋爱物语 Love Story of Sparrow	2019-02-01	24	261	28	52	0.8300000000000001
REMOTE LIFE	2019-10-04	7	196	19	26	0.8300000000000001
Giant Bear Rampage!	2019-06-19	5	35	0	5	0.8300000000000001
Dream Flash	2019-05-15	6	35	0	6	0.8300000000000001
State of War : Warmonger / 蓝色警戒 (Classic 2000)	2019-01-17	75	418	51	126	0.8299
Under One Wing	2019-02-28	65	102	7	72	0.8299
Onirism	2019-04-26	29	274	30	59	0.8296
Wizard Warfare	2019-12-13	10	46	1	11	0.8295
Poggers	2019-03-13	5	75	4	9	0.8292
Mystic Vale	2019-01-31	58	307	35	93	0.8291
The Terrible Old Man	2019-10-10	26	452	57	83	0.8286
National Park Girls	2019-03-14	17	148	13	30	0.8286
Investi-Gator: The Case of the Big Crime	2019-07-01	7	34	0	7	0.8285
Cartoon Network Journeys VR	2019-10-01	9	108	8	17	0.8283
Vision Soft Reset	2019-01-16	9	74	4	13	0.8283
Last Epoch	2019-04-30	40591	16109	2932	43523	0.8281999999999999
A Legionary's Life	2019-09-25	362	1647	255	617	0.8281999999999999
The Sapling	2019-12-12	90	398	49	139	0.8281999999999999
Space Pilgrim Academy: Reunion	2019-03-29	15	55	2	17	0.828
They Came From the Sky	2019-05-20	6	55	2	8	0.828
TAKANARIA	2019-01-15	36	220	23	59	0.8279000000000001
The Princess, the Stray Cat, and Matters of the Heart	2019-06-18	37	227	24	61	0.8278
Ni no Kuni Wrath of the White Witch™ Remastered	2019-09-19	1170	2848	468	1638	0.8276000000000001
Gensokyo Defenders	2019-04-24	58	107	8	66	0.8275
Hentai Secrets	2019-01-31	20	466	60	80	0.8273999999999999
Nocked! True Tales of Robin Hood	2019-07-17	15	64	3	18	0.8273999999999999
Deadly Days	2019-09-19	447	1029	152	599	0.8272
Un Pas Fragile	2019-06-24	4	130	11	15	0.8271
StarWheels	2019-06-19	26	33	0	26	0.8270000000000001
MineRalph	2019-08-05	10	33	0	10	0.8270000000000001
Ballex	2019-08-13	36	373	46	82	0.8269
Sakura MMO 3	2019-06-07	19	145	13	32	0.8269
vApe Escape	2019-03-15	7	98	7	14	0.8269
Serious Scramblers	2019-11-11	6	44	1	7	0.8269
Waltz of the Wizard: Natural Magic	2019-07-10	55	210	22	77	0.8266
Zeliria Sanctuary	2019-01-07	113	606	83	196	0.8265000000000001
Football Manager 2020 Touch	2019-11-19	4641	879	128	4769	0.8264
Electronic Super Joy 2	2019-08-09	200	599	82	282	0.8262999999999999
Mr Husky	2019-07-25	35	89	6	41	0.8262999999999999
Globesweeper	2019-02-12	107	223	24	131	0.8262
Alluris	2019-10-11	144	151	14	158	0.826
反现实症候群γ - Counterrealstic Syndrome γ	2019-11-17	9	136	12	21	0.826
Blacksad	2019-11-14	264	3943	675	939	0.8259000000000001
Sinking Simulator	2019-10-23	325	3022	507	832	0.8259000000000001
6.0	2019-11-25	9	242	27	36	0.8255
Professor Lupo and his Horrible Pets	2019-07-11	7	43	1	8	0.8255
Ghost Grab 3000	2019-11-08	5	43	1	6	0.8255
KiKiMiMi/ 听能力搜查官	2019-07-11	4	43	1	5	0.8255
Power Gunner	2019-05-17	9	32	0	9	0.8255
Necrolepsy	2019-10-11	9	32	0	9	0.8255
她2 : 我还想再见到你 Her2 : I Want To See You Again	2019-02-16	47	135	12	59	0.8254000000000001
Destiny 2	2019-10-01	316750	445447	90251	407001	0.8253
Classic Racers	2019-03-26	15	393	50	65	0.8253
Stranger Things 3: The Game	2019-07-04	95	493	66	161	0.8251000000000001
Cooking Simulator	2019-06-06	3500	13119	2429	5929	0.8250000000000001
Guard Duty	2019-05-02	25	206	22	47	0.8249
House of 1000 Doors: Family Secrets	2019-09-05	16	95	7	23	0.8245
東方逆妙乱 ~ Ephemeral Unnatural Balance	2019-08-16	6	70	4	10	0.8244
Vestaria Saga I: War of the Scions	2019-12-27	204	762	111	315	0.8243
7 Sexy Sins	2019-04-26	67	427	56	123	0.8243
Towertale	2019-07-30	9	61	3	12	0.8242
WarriOrb: Prologue	2019-12-11	55	337	42	97	0.8240999999999999
YOU CAN'T FUCK ON AN EMPTY STOMACH	2019-05-15	10	42	1	11	0.8240999999999999
Marbles on Stream	2019-11-06	1202	1339	211	1413	0.8240000000000001
Idle Wizard	2019-01-24	1544	1017	155	1699	0.8239000000000001
Monsters of Little Haven	2019-07-09	9	258	30	39	0.8239000000000001
The Witch's Love Diary	2019-07-26	26	78	5	31	0.8239000000000001
Space Mayhem	2019-01-17	5	31	0	5	0.8239000000000001
Jack-In-A-Castle	2019-07-12	4	31	0	4	0.8239000000000001
Bloodholic	2019-11-21	4	31	0	4	0.8239000000000001
Overpass	2019-08-15	25	102	8	33	0.8238
場外人生	2019-08-06	36	264	31	67	0.8237000000000001
Stamp Boy	2019-09-09	7	86	6	13	0.8237000000000001
Gensokyo Night Festival	2019-10-14	1333	3580	621	1954	0.8236
Re.Poly	2019-12-12	15	69	4	19	0.8233
Lofi Ping Pong	2019-03-12	35	819	122	157	0.8231999999999999
Jasmine Summer	2019-01-17	22	109	9	31	0.8231999999999999
Conscious Existence - A Journey Within	2019-06-15	11	508	70	81	0.8231
A Sceptic's Guide to Magic	2019-08-16	8	51	2	10	0.8231
Darkness and Flame: Enemy in Reflection	2019-12-25	21	60	3	24	0.823
Castle Break	2019-02-19	9	77	5	14	0.8229000000000001
Tactical Nexus	2019-11-11	37	77	5	42	0.8229000000000001
Tribes of Midgard - Open Beta	2019-07-22	1083	433	58	1141	0.8228
Game Of Puzzles: Animals	2019-05-17	23	93	7	30	0.8228
Age of Empires: Definitive Edition	2019-08-19	2708	9134	1692	4400	0.8227
FISHERY	2019-09-26	25	281	34	59	0.8227
Jey's Empire	2019-10-15	8	41	1	9	0.8227
Hanaby the Witch	2019-10-18	30	41	1	31	0.8227
THE DEVIL HAUNTS ME	2019-01-07	19	152	15	34	0.8225
When Ski Lifts Go Wrong 	2019-01-23	181	625	90	271	0.8224
Breach: The Archangel Job	2019-11-14	46	68	4	50	0.8223
West Sweety	2019-12-13	388	2653	455	843	0.8222
Million to One Hero	2019-07-23	7	30	0	7	0.8222
Them Bombs	2019-07-11	14	30	0	14	0.8222
Monster Hunting... For Love!	2019-03-15	5	30	0	5	0.8222
Tank Maniacs	2019-12-05	7	30	0	7	0.8222
Oh Jeez, Oh No, My Rabbits Are Gone!	2019-12-20	7	30	0	7	0.8222
变量 - Variables	2019-07-30	1541	845	128	1669	0.8220000000000001
Raccoo Venture	2019-12-11	10	76	5	15	0.8220000000000001
Rift Racoon	2019-11-01	5	59	3	8	0.8219
Exodemon	2019-08-03	10	50	2	12	0.8219
Particle Wars	2019-10-01	16	50	2	18	0.8219
Feria d'Arles	2019-12-06	4	50	2	6	0.8219
Boxing School	2019-01-10	476	347	45	521	0.8214
Cthulhu Saves Christmas	2019-12-23	82	205	23	105	0.8214
Raiders of the North Sea	2019-07-30	60	171	18	78	0.8214
Forgotten Hill Disillusion	2019-11-20	29	136	13	42	0.8214
Genius! NAZI-GIRL GoePPels-Chan ep1	2019-03-20	8	67	4	12	0.8212
Hypnocult	2019-08-23	5	40	1	6	0.8212
Disney's Hercules	2019-05-17	68	346	45	113	0.8211
Hellsplit: Arena	2019-09-09	147	2508	433	580	0.8209000000000001
Hunt: Showdown	2019-08-27	38802	132593	27212	66014	0.8208
Hobs	2019-08-19	722	1078	171	893	0.8207
Madorica Real Estate	2019-02-26	23	58	3	26	0.8207
Crawlco Block Knockers	2019-08-01	6	49	2	8	0.8205
Roombo: First Blood - JUSTICE SUCKS	2019-08-08	74	268	33	107	0.8204000000000001
Invasher	2019-01-25	4	29	0	4	0.8204000000000001
GhostGame	2019-04-19	4	29	0	4	0.8204000000000001
Militia 2	2019-08-08	6	29	0	6	0.8204000000000001
Golden Rails: Tales of the Wild West	2019-12-12	9	29	0	9	0.8204000000000001
The Jolly Gang's Misadventures in Africa	2019-03-25	8	90	7	15	0.8201999999999999
The Eternal Castle [REMASTERED]	2019-01-05	49	565	82	131	0.8201
Big Dipper	2019-01-07	12	141	14	26	0.8201
Corpse Party: Sweet Sachiko's Hysteric Birthday Bash	2019-04-10	55	134	13	68	0.8201
Akash: Path of the Five	2019-10-01	20	105	9	29	0.8201
Zup! XS	2019-04-17	306	998	158	464	0.8199
Applewood	2019-09-23	4	39	1	5	0.8197
Singled Out	2019-09-04	3	39	1	4	0.8197
FlowScape	2019-08-15	379	1068	171	550	0.8196
Dead or School	2019-06-03	624	2234	387	1011	0.8194
Réussir : Code de la Route	2019-11-29	77	271	34	111	0.8192
Magnibox	2019-03-26	4	48	2	6	0.8192
Katana Soul	2019-03-25	4	48	2	6	0.8192
Glitch Arena	2019-06-02	7	48	2	9	0.8192
Active Neurons	2019-10-15	4	48	2	6	0.8192
Rising Kingdoms	2019-07-23	17	153	16	33	0.8190000000000001
Ravva and the Cyclops Curse	2019-01-15	8	81	6	14	0.8190000000000001
Chameleon Run Deluxe Edition	2019-08-29	21	81	6	27	0.8190000000000001
Kaede the Eliminator / Eliminator 小枫	2019-10-01	92	459	65	157	0.8189000000000001
ETHEREAL	2019-03-07	9	118	11	20	0.8189000000000001
Feud	2019-05-21	21	173	19	40	0.8188
River City Girls	2019-09-05	496	2303	403	899	0.8186
Jamestown+	2019-12-12	57	166	18	75	0.8186
Once'	2019-01-18	6	103	9	15	0.8185
Little Big Workshop	2019-10-17	2774	2436	429	3203	0.8184
Creme de la Creme	2019-11-27	45	88	7	52	0.8184
Volcanoids	2019-01-29	2783	5266	981	3764	0.8183
Constructor Plus	2019-05-27	83	312	41	124	0.8183
Shovel Knight: King of Cards	2019-12-10	28	145	15	43	0.8183
阿津	2019-03-30	26	110	10	36	0.8183
Power Rangers: Battle for the Grid	2019-09-24	363	1131	185	548	0.8181
Dress-up Traveller	2019-09-06	110	414	58	168	0.8181
Toki	2019-06-07	24	348	47	71	0.8181
Shattered Lights	2019-06-11	30	336	45	75	0.8181
Soulscape	2019-07-26	6	38	1	7	0.8181
Bundle Kitt	2019-11-08	2	38	1	3	0.8181
Rise of Liberty	2019-05-30	74	1502	254	328	0.8179000000000001
Alien Squatter	2019-09-30	4	64	4	8	0.8178000000000001
Heroes of Hellas Origins: Part One	2019-10-10	12	47	2	14	0.8178000000000001
GUN GODZ	2019-12-09	40	524	77	117	0.8177
Battle Grounds III	2019-06-30	298	2709	485	783	0.8175
Sakura Fox Adventure	2019-10-25	19	157	17	36	0.8173
Fishing Adventure	2019-11-01	46	1134	187	233	0.8172
Pogostuck: Rage With Your Friends	2019-02-28	1018	4279	795	1813	0.8170000000000001
The Dungeon of Lulu Farea	2019-01-08	75	163	18	93	0.8169
Courier of the Crypts	2019-04-18	10	55	3	13	0.8169
Oik Memory: Endgame	2019-05-28	3	55	3	6	0.8169
Wraithslayer	2019-05-08	15	71	5	20	0.8168000000000001
FutureGrind	2019-01-22	11	63	4	15	0.8167
Dogurai	2019-05-27	11	63	4	15	0.8167
Grisaia Phantom Trigger Vol.5.5	2019-04-26	76	63	4	80	0.8167
Sunless Skies	2019-01-31	2344	2505	449	2793	0.8166
Trinoline	2019-04-18	21	86	7	28	0.8166
PyroMind	2019-08-27	4	27	0	4	0.8166
BOMBFEST	2019-01-31	7	27	0	7	0.8166
Brother Brother	2019-11-08	7	27	0	7	0.8166
SpellForce 3: Soul Harvest	2019-05-28	1550	1746	304	1854	0.8163
The logic of the miniature garden	2019-06-19	176	395	56	232	0.8162
It Lurks Below	2019-05-29	875	1037	171	1046	0.8161
Valfaris	2019-10-10	148	1606	278	426	0.816
中华三国志	2019-03-31	439	1074	178	617	0.816
Shine's Adventures 2 (Zombie Attack)	2019-09-27	19	107	10	29	0.8159000000000001
Psychedelica of the Ashen Hawk	2019-08-30	36	417	60	96	0.8158
ARIDA: Backland's Awakening	2019-08-16	25	486	72	97	0.8157
Vignettes	2019-03-06	16	70	5	21	0.8157
Blazing Beaks	2019-05-10	428	1746	306	734	0.8156
Dissolving	2019-06-14	14	321	44	58	0.8153
Beat Aim	2019-11-01	15	147	16	31	0.8153
Irony Curtain: From Matryoshka with Love	2019-05-16	63	303	41	104	0.8151999999999999
Plunge	2019-08-23	13	120	12	25	0.8151999999999999
Storm Chasers	2019-06-28	66	1363	234	300	0.8151
Sticks And Bones	2019-03-29	5	113	11	16	0.8151
Hentai Jigsaw Puzzle 2	2019-11-01	10	45	2	12	0.8148000000000001
Alternate DiMansion Diary	2019-05-24	85	337	47	132	0.8147
RPG Fighter League	2019-03-15	9	26	0	9	0.8146
Ragtag	2019-03-13	6	26	0	6	0.8146
Sordwin: The Evertree Saga	2019-03-07	19	26	0	19	0.8146
Super Pig X	2019-06-20	6	26	0	6	0.8146
We Met in May	2019-09-30	4	26	0	4	0.8146
Wargroove	2019-02-01	5065	3907	737	5802	0.8144
Ain Dodo	2019-09-11	5	139	15	20	0.8144
HALF DEAD 2	2019-08-02	394	1836	327	721	0.8143000000000001
Flandre's dream. - 36000 ft deep -	2019-08-09	13	53	3	16	0.8142
Project Winter	2019-05-23	38794	15081	3059	41853	0.8140999999999999
Ballade2: the Celestial Promise / 叙事曲2：星空下的诺言	2019-05-24	10	76	6	16	0.8140000000000001
3rd eye	2019-09-30	85	257	34	119	0.8138
Dota Underlords	2019-06-20	202334	74074	15823	218157	0.8135
Cartonfall	2019-02-27	16	104	10	26	0.8135
Rainbow Reactor	2019-05-16	11	90	8	19	0.8135
Skybolt Zack	2019-11-07	23	90	8	31	0.8135
First Person Tennis - The Real Tennis Simulator	2019-04-11	15	286	39	54	0.8134
Darkness and Flame: The Dark Side	2019-04-11	14	44	2	16	0.8133
Hellink	2019-03-08	6	44	2	8	0.8133
Mundus - Impossible Universe 2	2019-05-18	12	44	2	14	0.8133
Hellsinker.	2019-07-19	75	163	19	94	0.8131999999999999
Darksiders Genesis	2019-12-05	6433	8785	1753	8186	0.8131
Jump Off The Bridge	2019-05-01	338	188	23	361	0.813
Marble Trap	2019-09-02	7	60	4	11	0.813
Mars Underground	2019-03-14	10	35	1	11	0.813
Shrine of the God-Ape	2019-07-16	5	35	1	6	0.813
STARDROP	2019-02-14	27	206	26	53	0.8127
Volleyball Fever	2019-06-19	14	82	7	21	0.8126000000000001
The Donnerwald Experiment	2019-10-31	3	25	0	3	0.8125
持猫少女凯蒂/Kaidi, armed with a cat	2019-01-13	3	25	0	3	0.8125
Snake vs Snake	2019-03-29	5	25	0	5	0.8125
Last Shark Standing	2019-10-28	10	25	0	10	0.8125
Forbidden Love With The Ghost Girl	2019-11-19	72	168	20	92	0.8124
1 Screen Platformer	2019-03-07	12	351	51	63	0.8118000000000001
Putin Life	2019-11-13	8	264	36	44	0.8118000000000001
Tunche: Arena	2019-01-18	67	293	41	108	0.8117000000000001
Its Simple, SHOOT	2019-03-14	13	59	4	17	0.8117000000000001
Spark and The Digital Daydream	2019-05-07	11	59	4	15	0.8117000000000001
Ballade: with Memories / 叙事曲：难忘的回忆	2019-10-15	7	43	2	9	0.8117000000000001
SENRAN KAGURA Reflexions	2019-06-24	94	356	52	146	0.8116
孙悟空大战机器金刚 / Sun Wukong VS Robot	2019-01-20	12	81	7	19	0.8116
At Home Alone II	2019-08-09	9	179	22	31	0.8115000000000001
VR Paradise	2019-12-23	971	1044	180	1151	0.8114
Depixtion	2019-06-17	13	51	3	16	0.8114
Something for Someone Else	2019-09-03	19	338	49	68	0.8113
Slapshot	2019-03-08	553	2201	409	962	0.8112
Rogue Empire	2019-01-25	340	309	44	384	0.8112
Eldervale	2019-10-20	8	108	11	19	0.8111
Colorgrid	2019-11-21	31	108	11	42	0.8111
Voltron: Cubes of Olkarion	2019-08-29	8	34	1	9	0.8111
A NIGHTMARE'S TRIP	2019-10-07	3	34	1	4	0.8111
Polyroll	2019-10-29	7	66	5	12	0.8109999999999999
DEAD OR ALIVE Xtreme Venus Vacation	2019-03-26	11284	20052	4208	15492	0.8109000000000001
AFTERBURN	2019-12-11	25	255	35	60	0.8106
Rainswept	2019-02-01	19	207	27	46	0.8103
Winter's Empty Mask - Visual novel	2019-03-04	3	24	0	3	0.8103
5Leaps (Space Tower Defense)	2019-05-15	6	24	0	6	0.8103
Colloc	2019-07-19	6	24	0	6	0.8103
Big Brother Is Shaping You	2019-04-12	91	698	116	207	0.81
Perspectives: Paradise	2019-09-10	21	139	16	37	0.81
Argonus and the Gods of Stone	2019-10-08	12	100	10	22	0.81
Ninja Legends	2019-10-24	10	50	3	13	0.81
Storm Tale	2019-07-26	13	50	3	16	0.81
Definitely Sneaky But Not Sneaky	2019-02-06	6	42	2	8	0.81
Rashlander	2019-08-06	9	42	2	11	0.81
Armajet	2019-10-08	81	559	90	171	0.8099
Space War: Infinity	2019-05-28	4	93	9	13	0.8097
They Came From a Communist Planet	2019-11-11	14	132	15	29	0.8095
Starfighter: Infinity	2019-07-16	29	106	11	40	0.8094
Azure Reflections	2019-09-20	29	138	16	45	0.8093000000000001
A Summer with the Shiba Inu	2019-08-23	3	33	1	4	0.8092
Snow Island	2019-09-25	4	33	1	5	0.8092
Spooky Station	2019-10-29	35	320	47	82	0.8090999999999999
It Moves	2019-02-21	28	240	33	61	0.8090999999999999
Backspace Bouken	2019-12-13	10	57	4	14	0.809
The Beast Inside	2019-10-17	794	6595	1341	2135	0.8088
stikir	2019-10-23	10	180	23	33	0.8087000000000001
Steam Prison	2019-02-15	117	279	40	157	0.8086
The Takeover	2019-11-10	24	731	124	148	0.8085
Dead Wishes	2019-02-01	8	64	5	13	0.8085
Shovel Knight Showdown	2019-12-10	22	71	6	28	0.8084
Knights of the Temple: Infernal Crusade	2019-12-25	5	71	6	11	0.8084
House of 1000 Doors: The Palm of Zoroaster	2019-10-24	13	49	3	16	0.8084
Red Island	2019-07-25	7	41	2	9	0.8083
Dusk Diver 酉閃町	2019-10-23	87	588	97	184	0.8081999999999999
Симулятор Сидения у Подъезда	2019-04-25	10	464	74	84	0.8079000000000001
The Spell	2019-01-15	4	23	0	4	0.8079000000000001
Virtual Debating Chamber	2019-06-25	6	23	0	6	0.8079000000000001
Nekour	2019-09-03	2	23	0	2	0.8079000000000001
Super Cucho	2019-09-23	5	23	0	5	0.8079000000000001
Koo & Yuu	2019-12-26	4	23	0	4	0.8079000000000001
Horizon Beyond	2019-08-31	10	148	18	28	0.8077
Command: Modern Operations	2019-11-14	316	859	150	466	0.8076000000000001
Wequer	2019-04-23	64	56	4	68	0.8076000000000001
The Backrooms Game FREE Edition	2019-07-25	116	2699	525	641	0.8075
Warplanes: WW2 Dogfight	2019-04-06	195	1117	201	396	0.8075
Hentai Bad Girls	2019-07-11	23438	500	81	23519	0.8075
TOKYO CHRONOS	2019-03-20	53	253	36	89	0.8073
Oik 5	2019-01-24	9	110	12	21	0.8073
Cyberdrome	2019-01-01	23	195	26	49	0.8072
Eye of the Owl	2019-07-18	4	70	6	10	0.8072
IMMURE	2019-05-09	25	70	6	31	0.8072
Friday 星期五部门	2019-11-27	3	32	1	4	0.8072
Degrees of Separation	2019-02-14	102	692	118	220	0.8070999999999999
Seek Girl Ⅲ	2019-12-06	503	2302	445	948	0.8068000000000001
Fur the Game	2019-01-03	13	122	14	27	0.8068000000000001
The Settlers : Heritage of Kings - History Edition	2019-01-22	189	475	77	266	0.8066
I got a cat maid！	2019-08-09	41	610	103	144	0.8064
Celtic Kings: Rage of War	2019-09-05	20	109	12	32	0.8064
SUPER DRAGON BALL HEROES WORLD MISSION	2019-04-04	1970	1250	230	2200	0.8063
bit Dungeon	2019-08-12	7	121	14	21	0.8059999999999999
CROSSNIQ+	2019-10-04	18	69	6	24	0.8059999999999999
Salting the Earth	2019-10-31	11	69	6	17	0.8059999999999999
Photos	2019-12-21	93	181	24	117	0.8059000000000001
Bestiary of Sigillum	2019-01-23	15	62	5	20	0.8059000000000001
Within the blade	2019-08-17	1433	294	44	1477	0.8058
Nelly Cootalot: Spoonbeaks Ahoy! HD	2019-05-22	11	139	17	28	0.8057
Yellow & Yangtze	2019-12-12	18	82	8	26	0.8054000000000001
Beyond a Total Loss	2019-06-18	5	22	0	5	0.8054000000000001
Super Mega Space Blaster Special	2019-06-17	5	22	0	5	0.8054000000000001
Roman Adventures - Britons. Season 2	2019-11-28	16	22	0	16	0.8054000000000001
Brukel	2019-11-03	8	180	24	32	0.8053
Steambirds Alliance Open Beta	2019-05-24	425	231	33	458	0.8051
赫炎的印加诺克 Fullvoice ReBORN	2019-03-15	21	126	15	36	0.8051
Bubbles the Cat	2019-04-11	6	31	1	7	0.8051
LOST:SMILE memories	2019-08-07	20	31	1	21	0.8051
REDO!	2019-08-20	10	138	17	27	0.805
Perdition	2019-08-21	6	132	16	22	0.805
She and The Light Bearer	2019-01-17	13	225	32	45	0.8049
The Devil's Womb	2019-09-10	9	39	2	11	0.8048000000000001
Into The Core	2019-05-24	11	39	2	13	0.8048000000000001
ZooKeeper Simulator	2019-12-12	73	313	48	121	0.8047
Secret Neighbor Beta	2019-08-02	3779	2396	473	4252	0.8046
There's a Butcher Around	2019-05-17	21	318	49	70	0.8046
Tank Royale	2019-04-02	14	61	5	19	0.8046
Dig Deep	2019-03-08	13	61	5	18	0.8046
LYSER	2019-06-06	4	61	5	9	0.8046
Zeminator	2019-08-01	7	61	5	12	0.8046
Juicy Hentai	2019-04-25	11	172	23	34	0.8041
Pew Dew Redemption	2019-05-17	120	1405	267	387	0.8039000000000001
Our world has not decayed	2019-10-26	366	305	47	413	0.8038
Infected Shelter	2019-11-11	34	267	40	74	0.8038
Robot Wants It All	2019-04-05	21	106	12	33	0.8038
By Moonlight	2019-02-20	20	106	12	32	0.8038
Yooka-Laylee and the Impossible Lair	2019-10-08	265	837	151	416	0.8036
War of Omens	2019-02-18	209	545	93	302	0.8036
Hello Neighbor: Hide and Seek	2019-12-10	37	462	77	114	0.8034
Mighty Switch Force! Collection	2019-07-25	11	67	6	17	0.8034
Ultimate Coaster X	2019-03-10	42	159	21	63	0.8031999999999999
Game Of Puzzles: Dragons	2019-05-09	3	60	5	8	0.8031999999999999
Pulstario	2019-12-23	55	30	1	56	0.8029999999999999
Session Seven	2019-03-01	26	170	23	49	0.8028000000000001
Invasion	2019-04-26	1	21	0	1	0.8028000000000001
Radiant Arc	2019-05-31	6	21	0	6	0.8028000000000001
Miss Cat	2019-05-18	2	21	0	2	0.8028000000000001
Incredible Dracula 3: Family Secret	2019-05-20	8	21	0	8	0.8028000000000001
Josie's Tank	2019-09-21	2	21	0	2	0.8028000000000001
Incredible Dracula: Witches' Curse	2019-11-14	12	21	0	12	0.8028000000000001
Hermes: Rescue Mission	2019-11-21	5	21	0	5	0.8028000000000001
Neo Cab	2019-10-03	157	1642	320	477	0.8025
FALLBACK	2019-10-11	53	296	46	99	0.8024
R.I.C.A	2019-02-15	45	192	27	72	0.8024
Hentai Asmodeus	2019-10-24	676	1563	304	980	0.8023
Production Line	2019-03-07	631	2611	529	1160	0.8022
Fight of Gods	2019-03-28	273	674	120	393	0.8020999999999999
Re-O-Ri	2019-11-27	12	66	6	18	0.8020999999999999
Exertus	2019-08-26	16	230	34	50	0.802
Devil Engine	2019-02-21	20	104	12	32	0.802
Globesweeper: Hex Puzzler	2019-11-15	14	104	12	26	0.802
CUSTOM ORDER MAID 3D2 It's a Night Magic	2019-07-31	311	1126	213	524	0.8019
Erannorth Reborn	2019-10-17	53	305	48	101	0.8018000000000001
游离大陆 Uniland	2019-12-06	17	59	5	22	0.8018000000000001
Energy Shock	2019-09-26	15	59	5	20	0.8018000000000001
The Final Boss	2019-06-13	9	59	5	14	0.8018000000000001
Forgetful Dictator	2019-09-19	21	52	4	25	0.8017000000000001
Mostly Intense Monster Defense	2019-09-02	5	52	4	9	0.8017000000000001
Barro 2020	2019-11-01	1510	1107	210	1720	0.8014
Microsoft Maquette	2019-01-15	206	72	7	213	0.8014
KIDS	2019-05-28	75	1377	267	342	0.8013
Gordon Streaman	2019-09-26	18	133	17	35	0.8013
My Name is You and it's the only unusual thing in my life	2019-12-26	27	608	108	135	0.8009000000000001
Baby Walking Simulator	2019-08-31	25	78	8	33	0.8009000000000001
Amatarasu Riddle Star	2019-10-10	13	37	2	15	0.8009000000000001
Flynguin Station	2019-09-24	11	37	2	13	0.8009000000000001
Argonauts Agency: Golden Fleece	2019-02-22	11	37	2	13	0.8009000000000001
Block in the Lock	2019-09-06	7	37	2	9	0.8009000000000001
SINNERS	2019-07-09	2	29	1	3	0.8007
RoboVirus	2019-08-30	241	29	1	242	0.8007
Alluna and Brie	2019-04-10	9	29	1	10	0.8007
The Flower on Christmas Eve	2019-09-20	5	29	1	6	0.8007
Apostle	2019-11-08	427	385	64	491	0.8006000000000001
Fantasia of the Wind 2 风之幻想曲 第二部	2019-04-05	40	84	9	49	0.8005
Amber's Airline - 7 Wonders	2019-04-18	25	71	7	32	0.8001
HATCH	2019-09-16	4	51	4	8	0.8001
Senna and the Forest	2019-08-07	4	20	0	4	0.8
Rampage Miami	2019-12-05	7	154	21	28	0.7998999999999999
TinkerQuarry	2019-09-13	43	77	8	51	0.7997
Real Scary	2019-05-11	3	64	6	9	0.7995000000000001
Trickster VR	2019-01-15	48	391	66	114	0.7994
Sakura MMO 2	2019-01-25	22	142	19	41	0.7994
The Dreadful Whispers	2019-09-05	39	142	19	58	0.7994
Type Knight	2019-10-25	19	101	12	31	0.7992
Druidstone: The Secret of the Menhir Forest	2019-05-15	566	1050	202	768	0.7991
HARDCORE MECHA	2019-06-26	1770	2033	415	2185	0.7989
Tanzia	2019-03-28	11	57	5	16	0.7989
SmartyTale 2D	2019-02-05	11	57	5	16	0.7989
Veer	2019-11-15	8	36	2	10	0.7989
初恋日记	2019-10-05	813	1196	234	1047	0.7986
Tales of Vesperia: Definitive Edition	2019-01-10	3450	3034	639	4089	0.7985
Walden, a game	2019-03-18	11	76	8	19	0.7985
KAMIKO	2019-06-27	12	135	18	30	0.7984
MORDHAU	2019-04-29	60204	85840	20434	80638	0.7983
The Forestale	2019-04-11	4	28	1	5	0.7983
Locomotion	2019-05-10	5	28	1	6	0.7983
社稷终于幻想 ~ A Finality with Sheji	2019-02-08	11	28	1	12	0.7983
12 Labours of Hercules IX: A Hero's Moonwalk	2019-10-24	26	28	1	27	0.7983
Killjoy Hunter Yuuko	2019-10-17	4	28	1	5	0.7983
Wanderlust: Travel Stories	2019-09-26	14	88	10	24	0.7981999999999999
Demon Hunter 5: Ascendance	2019-04-04	39	157	22	61	0.7981
Oik Memory 3	2019-02-14	6	63	6	12	0.7981
Battle Planet - Judgement Day	2019-10-17	18	63	6	24	0.7981
RKN Block Me: Telegram	2019-02-19	7	117	15	22	0.7977
Maelstrom	2019-09-20	1327	2017	416	1743	0.7976000000000001
Neon Tail	2019-10-04	24	69	7	31	0.7976000000000001
White Dove 白雀	2019-02-02	52	283	46	98	0.7973
Hentai Pussy 2	2019-05-16	1282	643	119	1401	0.7972
Misadventures of Laura Silver	2019-08-14	52	215	33	85	0.7972
Clocker	2019-02-15	37	199	30	67	0.7972
TetraLogical	2019-06-17	4	19	0	4	0.7970999999999999
Cuboid Keeper	2019-01-10	4	19	0	4	0.7970999999999999
Deathless Dungeon	2019-07-29	3	19	0	3	0.7970999999999999
Nightshade	2019-03-07	3	19	0	3	0.7970999999999999
Nowhere Station	2019-03-29	3	19	0	3	0.7970999999999999
Foreign Frugglers	2019-06-26	2	19	0	2	0.7970999999999999
Viking Sisters	2019-04-30	7	19	0	7	0.7970999999999999
Hentai energy II	2019-06-07	29	133	18	47	0.7968999999999999
CASE 2: Animatronics Survival	2019-02-28	72	1902	393	465	0.7968000000000001
Crumple Zone	2019-05-31	6	49	4	10	0.7968000000000001
My Light In The Dark	2019-08-23	136	49	4	140	0.7968000000000001
Dark Hill Museum of Death	2019-01-21	3	35	2	5	0.7968000000000001
The Underground Watcher	2019-04-22	5	35	2	7	0.7968000000000001
Rogue Stache	2019-01-24	11	42	3	14	0.7965000000000001
Buzludzha VR	2019-11-20	3	42	3	6	0.7965000000000001
Yang2020 Path To Presidency	2019-12-29	24	121	16	40	0.7963
UBOAT	2019-04-30	5755	12265	2812	8567	0.7962
Resistance Element	2019-05-27	8	265	43	51	0.7962
Song Beater: Quite My Tempo!	2019-10-18	8	68	7	15	0.7962
Tabletop Gods	2019-05-16	59	86	10	69	0.7959999999999999
GUILTY GEAR	2019-05-16	60	325	55	115	0.7959
SUPER BUILD	2019-08-31	29	202	31	60	0.7959
How to Sing to Open Your Heart	2019-01-17	29	27	1	30	0.7958
Gorilla Unko	2019-04-09	5	27	1	6	0.7958
ORTHOISO	2019-06-16	10	27	1	11	0.7958
Climb With Wheelbarrow	2019-08-05	14	164	24	38	0.7955
纸境英雄 Papercraft	2019-04-12	210	258	42	252	0.7954000000000001
樱雪集～Yuyuko's Butterfly Dream	2019-02-27	31	97	12	43	0.7952
《鬼畜战记：金坷垃传说》	2019-07-26	38	97	12	50	0.7952
Winter Worm, Summer Grass	2019-12-09	10	48	4	14	0.795
Red Eclipse	2019-12-19	103	503	92	195	0.7948999999999999
AUDICA: Rhythm Shooter	2019-11-05	145	479	87	232	0.7948999999999999
Mobler	2019-06-07	18	125	17	35	0.7948999999999999
Rats, Bats, and Bones	2019-10-28	10	67	7	17	0.7948999999999999
【SCP】器関ノ彷徨 -The will of a single Tale- 本編：第１部	2019-02-15	11	67	7	18	0.7948999999999999
Caveblazers Together	2019-03-07	199	152	22	221	0.7947
Neon Noodles	2019-11-29	8	34	2	10	0.7946
Diggerman	2019-06-14	5	34	2	7	0.7946
hoVRboard	2019-09-13	4	34	2	6	0.7946
Np Problems: Vertex Coloring	2019-11-19	3	34	2	5	0.7946
Hentai Halloween	2019-10-28	8	141	20	28	0.7945000000000001
Mage's Initiation: Reign of the Elements	2019-01-30	61	119	16	77	0.7945000000000001
Dream Rose	2019-02-27	6	41	3	9	0.7945000000000001
Goddess of Math 数学女神	2019-03-26	12	41	3	15	0.7945000000000001
Knight Swap	2019-10-22	8	96	12	20	0.7942
Hello, Goodbye	2019-04-18	15	54	5	20	0.7942
Lakeview Valley	2019-10-22	103	518	96	199	0.7939
UBERMOSH Vol.7	2019-04-30	15	151	22	37	0.7939
You're Not Special	2019-02-11	5	18	0	5	0.7939
My Fair Princess	2019-11-08	30	18	0	30	0.7939
hack.88	2019-07-19	3	18	0	3	0.7939
UNFAIR	2019-10-22	4	18	0	4	0.7939
Incredible Dracula: The Ice Kingdom	2019-10-31	7	18	0	7	0.7939
Fat Prisoner Simulator	2019-03-12	9	344	60	69	0.7938
Gorytale	2019-07-19	7	60	6	13	0.7937000000000001
Evolution	2019-02-12	123	313	54	177	0.7933
PUSSY 3	2019-04-29	10	313	54	64	0.7933
Duke of Defense	2019-04-04	11	47	4	15	0.7931999999999999
蝶生梦影-Butterfly dream shadow	2019-02-03	5	26	1	6	0.7931999999999999
Artificial Mansion	2019-04-24	5	26	1	6	0.7931999999999999
Run! Bunny~绿绿小先生	2019-08-10	5	26	1	6	0.7931999999999999
Power	2019-11-15	8	26	1	9	0.7931999999999999
Mini Island	2019-11-15	5	26	1	6	0.7931999999999999
Fap Queen 2	2019-12-02	2380	833	165	2545	0.7928000000000001
this was for you.	2019-08-15	9	106	14	23	0.7928000000000001
-KLAUS-	2019-01-24	6	89	11	17	0.7928000000000001
Knightin'+	2019-07-26	86	201	32	118	0.7925
The Itch	2019-09-02	15	83	10	25	0.7925
Protein for Muscle	2019-09-02	8	83	10	18	0.7925
兽耳攻略 - TFK Faculty	2019-08-29	10	53	5	15	0.7925
Lie In My Heart	2019-10-04	5	53	5	10	0.7925
Krystopia: A Puzzle Journey	2019-10-16	7	53	5	12	0.7925
Boet Fighter	2019-10-08	52	100	13	65	0.7924
RealFlight 9.5S	2019-09-03	425	535	101	526	0.7923
Why Is There A Girl In My House?!	2019-10-18	5	77	9	14	0.7923
Risk System	2019-05-14	8	33	2	10	0.7923
勇者と魔法使いとおとぎの絵本 / Fairy Picturebook of Hero and Sorceress	2019-02-02	10	33	2	12	0.7923
ThreatGEN: Red vs. Blue	2019-09-04	19	59	6	25	0.7922
BANZAI ROYALE	2019-06-13	26	71	8	34	0.7920999999999999
Dairy Princess	2019-11-30	56	71	8	64	0.7920999999999999
彼岸画廊/Nether Gallery	2019-04-26	164	174	27	191	0.7917000000000001
I (DON'T) HATE HENTAI PUZZLES	2019-11-13	11	174	27	38	0.7917000000000001
The Legend of Bum-Bo	2019-11-12	8131	4461	1012	9143	0.7915000000000001
Fantasy General II	2019-09-05	634	874	176	810	0.7915000000000001
Nice Jumper	2019-08-09	41	254	43	84	0.7913
Blood Memery	2019-02-15	8	82	10	18	0.7913
PAGUI	2019-10-08	385	750	149	534	0.7911
Never Give Up	2019-08-13	29	115	16	45	0.7909999999999999
Metal Wolf Chaos XD	2019-08-06	410	515	98	508	0.7909
The Secret Order 7: Shadow Breach	2019-02-28	23	131	19	42	0.7909
Let's Learn Japanese! Hiragana	2019-01-03	6	70	8	14	0.7908
PiiSim	2019-05-20	5	52	5	10	0.7908
Night of the Blood Moon	2019-01-21	7	58	6	13	0.7906000000000001
Dandy Dungeon - Legend of Brave Yamada -	2019-11-28	29	58	6	35	0.7906000000000001
The Disguiser Of Fate	2019-12-19	5	58	6	11	0.7906000000000001
Koral	2019-05-16	23	272	47	70	0.7905
Next Stop 3	2019-03-09	16	17	0	16	0.7905
Galak Zed	2019-04-14	4	17	0	4	0.7905
Genius! NAZI-GIRL GoePPels-Chan ep2	2019-05-18	3	17	0	3	0.7905
Balance Breakers	2019-09-27	6	17	0	6	0.7905
Memody: Sindrel Song	2019-12-06	4	17	0	4	0.7905
Biolab Wars	2019-08-23	4	98	13	17	0.7904000000000001
The Gun Knight	2019-08-09	7	25	1	8	0.7904000000000001
KiKiMiMi2 / 听能力搜查官2	2019-10-12	4	25	1	5	0.7904000000000001
Pizza Time Explosion	2019-12-18	4	25	1	5	0.7904000000000001
"Resident Evil 2 ""R.P.D. Demo"""	2019-12-12	368	1599	343	711	0.7903
Lost	2019-10-01	1074	6081	1413	2487	0.7902
Rise of Legions	2019-08-30	497	1350	286	783	0.7901
Monster Energy Supercross - The Official Videogame 2	2019-02-08	530	498	95	625	0.7901
Flower	2019-02-14	171	2856	639	810	0.79
The Story of Henry Bishop	2019-11-07	20	399	74	94	0.7898000000000001
Marble Skies	2019-07-04	95	246	42	137	0.7898000000000001
Mekabolt	2019-08-23	6	135	20	26	0.7898000000000001
Love In Drawing	2019-01-08	32	196	32	64	0.7896
Summer Meetings	2019-08-28	8	45	4	12	0.7895000000000001
Shoot, push, portals	2019-12-09	4	45	4	8	0.7895000000000001
Valakas Story	2019-12-03	826	1186	250	1076	0.7894
Dark Roll	2019-08-01	23	190	31	54	0.789
Before Arriving at the Terminal	2019-10-31	10	57	6	16	0.789
Elon Simulator 2019	2019-10-18	15	396	74	89	0.7888
GOD EATER 3	2019-02-07	9549	6326	1488	11037	0.7887000000000001
TETRUX: Online	2019-01-07	14	91	12	26	0.7887000000000001
Familiar Travels	2019-08-19	24	91	12	36	0.7887000000000001
Hentai Girl Division	2019-08-16	371	770	157	528	0.7884000000000001
You Died but a Necromancer revived you	2019-04-19	5	38	3	8	0.7883
Endless Fables 4: Shadow Within	2019-10-03	21	96	13	34	0.7881999999999999
Travis Strikes Again: No More Heroes Complete Edition	2019-10-17	39	337	62	101	0.7879
Age of Fear: The Free World	2019-01-18	146	309	56	202	0.7879
Rec Center Tycoon	2019-09-06	108	208	35	143	0.7879
Minoria	2019-08-27	343	1685	370	713	0.7878000000000001
Teeth Brushing Simulator	2019-05-11	8	198	33	41	0.7878000000000001
DORAEMON STORY OF SEASONS	2019-10-10	1478	1636	359	1837	0.7876000000000001
Havocado	2019-04-25	335	438	84	419	0.7876000000000001
Comet Crasher	2019-02-13	16	62	7	23	0.7876000000000001
SlipSlop	2019-06-28	114	1448	315	429	0.7875
Church Era	2019-05-24	17	44	4	21	0.7875
In The Ember 余烬之中	2019-01-19	5	24	1	6	0.7875
Dark Data	2019-09-05	5	24	1	6	0.7875
ReThink | Evolved 3	2019-05-13	5	24	1	6	0.7875
Overboard	2019-09-20	4	24	1	5	0.7875
Chemically Bonded	2019-11-30	12	56	6	18	0.7874
Fragile Fighter	2019-03-01	3	31	2	5	0.7874
Brave Hero Yuusha EX	2019-01-11	4	31	2	6	0.7874
AlienAfterlife	2019-02-11	3	31	2	5	0.7874
Let's Learn Japanese! Katakana	2019-03-13	4	31	2	6	0.7874
Mystery Case Files: Key to Ravenhearst Collector's Edition	2019-05-17	12	31	2	14	0.7874
三国时代2	2019-10-01	12	31	2	14	0.7874
Poker Championship	2019-09-25	265	1241	267	532	0.7873000000000001
Interstellar Space: Genesis	2019-07-25	198	523	103	301	0.7872
Blooming Nightshade	2019-09-06	41	172	28	69	0.7870999999999999
Hentai Zodiac Puzzle 2	2019-10-24	7	116	17	24	0.787
Rituals in the Dark	2019-11-20	7	84	11	18	0.787
Phucker in the Rome	2019-10-25	13	84	11	24	0.787
Retro Vision	2019-02-05	2	16	0	2	0.7869
1-Bit Revival: The Residuals of Null	2019-03-20	3	16	0	3	0.7869
灵界 Sprites（测试版）	2019-04-26	8	16	0	8	0.7869
Singaria	2019-08-02	6	16	0	6	0.7869
Halloween Chronicles: Evil Behind a Mask Collector's Edition	2019-10-25	8	16	0	8	0.7869
Yuletide Legends: Who Framed Santa Claus	2019-12-12	39	126	19	58	0.7867000000000001
Evoland Legendary Edition	2019-02-07	283	1594	352	635	0.7865000000000001
Hardware Engineers	2019-04-22	111	244	43	154	0.7865000000000001
Free Running	2019-12-03	6	67	8	14	0.7865000000000001
Trapped	2019-12-28	4	78	10	14	0.7863
Grotesque Beauty - A Horror Visual Novel	2019-10-03	4	37	3	7	0.7859999999999999
Magicolors	2019-12-14	5	37	3	8	0.7859999999999999
Bloody Trapland 2: Curiosity	2019-02-01	118	629	128	246	0.7859
Leanna's Slice of Life	2019-03-08	401	557	112	513	0.7857
Down Ward	2019-11-10	7	55	6	13	0.7857
東方龍隱談 ~ Chaos of black loong	2019-08-16	41	135	21	62	0.7856000000000001
Night Lights	2019-06-07	9	49	5	14	0.7855
Disco Destruction	2019-12-12	503	49	5	508	0.7855
Super gamebear with its three girlfriends你想知道关于超级喜欢游戏的一头黑色矮小的游戏熊是如何与它的“三个后宫团女朋友”购买到GBC游戏机的吗？	2019-01-22	5	43	4	9	0.7855
Courage for a Kiss	2019-06-13	5	43	4	9	0.7855
DownStream : VR Whitewater Kayaking	2019-08-28	5	43	4	9	0.7855
Tricky Cat	2019-03-16	5	43	4	9	0.7855
Alex Hunter: Lord of the Mind	2019-07-18	8	43	4	12	0.7855
The Textorcist: The Story of Ray Bibbia	2019-02-14	385	956	204	589	0.7854000000000001
Hentai energy	2019-05-06	11	189	32	43	0.7854000000000001
Tina: Swordswoman of the Scarlet Prison	2019-08-02	448	344	65	513	0.7853
Xeno Crisis	2019-10-28	12	109	16	28	0.7853
Black Survival	2019-03-20	1739	4179	990	2729	0.785
Daylife in Japan - Animated Jigsaw Puzzle Series	2019-10-26	8	77	10	18	0.785
5.0	2019-08-17	5	154	25	30	0.7848999999999999
Morels: The Hunt	2019-10-15	19	139	22	41	0.7848
Data Defense	2019-06-21	9	30	2	11	0.7848
Bound Up & Squirming!	2019-04-25	11	30	2	13	0.7848
Seek Girl Ⅱ	2019-10-01	318	2008	457	775	0.7846
Super Dodgeball Beats	2019-09-12	6	23	1	7	0.7844
Aeronaut	2019-09-12	4	23	1	5	0.7844
The Pepper Prince: Seasoning 1	2019-01-03	3	23	1	4	0.7844
Unishroom	2019-05-21	4	23	1	5	0.7844
Argonauts Agency: Pandora's Box	2019-04-18	7	23	1	8	0.7844
Simple Dot	2019-05-17	6	23	1	7	0.7844
A Night at the Races	2019-12-13	4	23	1	5	0.7844
Musasabi	2019-10-16	2	23	1	3	0.7844
Bomb Bowling	2019-08-22	8	23	1	9	0.7844
The Castle	2019-08-26	5	23	1	6	0.7844
Hentai Fantasy	2019-04-12	15	148	24	39	0.7841
BoneCraft	2019-06-02	98	239	43	141	0.784
ImageStriker	2019-11-06	5	54	6	11	0.784
Bear With Me: The Lost Robots	2019-07-31	12	92	13	25	0.7837999999999999
Progress Bar Simulator	2019-04-04	6	76	10	16	0.7837000000000001
DON'T GIVE UP: A Cynical Tale	2019-09-16	14	76	10	24	0.7837000000000001
XEYYEX	2019-08-22	2	36	3	5	0.7837000000000001
Queen's Wish: The Conqueror	2019-09-11	399	280	52	451	0.7836
Eternal Journey: New Atlantis	2019-03-07	7	48	5	12	0.7836
Quest Hunter	2019-03-08	549	1672	379	928	0.7835
The Long Return	2019-10-02	20	97	14	34	0.7835
Celaria	2019-10-12	16	97	14	30	0.7835
Mojo 2	2019-01-25	12	42	4	16	0.7834000000000001
Disc Creatures	2019-10-17	34	147	24	58	0.7833
The Treehouse Man	2019-02-13	26	107	16	42	0.7831999999999999
Field of Glory: Empires	2019-07-11	471	620	129	600	0.7831
Wellington's Victory	2019-08-21	5	15	0	5	0.783
DASH: Danger Action Speed Heroes	2019-06-06	5	15	0	5	0.783
BLASK	2019-01-15	3	15	0	3	0.783
The Other: Airi's Adventure	2019-09-30	3	15	0	3	0.783
Luminos	2019-04-11	6	15	0	6	0.783
Makeover Desire - HENSHIN GANBO	2019-11-15	3	15	0	3	0.783
Mystery of the Ancients: Three Guardians Collector's Edition	2019-04-19	5	15	0	5	0.783
INSANE WEST	2019-05-21	5	15	0	5	0.783
Ruine	2019-05-16	3	15	0	3	0.783
Isotiles 2	2019-07-12	3	15	0	3	0.783
HAM-MASTER	2019-11-08	3	15	0	3	0.783
Santa's Christmas Solitaire 2	2019-12-14	8	15	0	8	0.783
Tokyo Warfare Turbo	2019-10-18	62	333	64	126	0.7829
TTV3	2019-07-18	9	86	12	21	0.7829
Bouncing DVD : The Game	2019-02-10	16	161	27	43	0.7828
Cowpocalypse	2019-05-29	19	161	27	46	0.7828
Flux Caves	2019-06-11	5	59	7	12	0.7828
World of Myths	2019-05-30	94	250	46	140	0.7825
CRSED	2019-12-12	12266	29886	7720	19986	0.7824
Becalm	2019-01-17	16	291	55	71	0.7824
Hentai energy: Halloween	2019-10-21	7	75	10	17	0.7823000000000001
Unity of Command II	2019-11-12	614	1241	278	892	0.7820999999999999
Pixelarium	2019-05-16	18	29	2	20	0.7820999999999999
Dandy & Randy	2019-09-02	4	29	2	6	0.7820999999999999
Moonrise Fall	2019-05-31	3	29	2	5	0.7820999999999999
Awakening: The Dreamless Castle	2019-04-05	5	29	2	7	0.7820999999999999
Dreamland Solitaire: Dragon's Fury	2019-10-03	8	29	2	10	0.7820999999999999
KillStreak.tv	2019-04-12	88	330	64	152	0.7818
MAN STANDING	2019-12-11	21	321	62	83	0.7817000000000001
Anno 1800	2019-04-16	25302	6802	1687	26989	0.7815000000000001
Late For Work	2019-06-28	9	69	9	18	0.7814
Legend of Cenama	2019-07-19	10	41	4	14	0.7813
Hookbots	2019-08-28	5	22	1	6	0.7811
The Dragons' Twilight II	2019-08-02	5	22	1	6	0.7811
孤岛(Isolated Island)	2019-01-14	3	22	1	4	0.7811
Something is wrong/有毛病	2019-02-14	4	22	1	5	0.7811
Mystery Case Files: Moths to a Flame Collector's Edition	2019-08-23	9	22	1	10	0.7811
Weedcraft Inc	2019-04-11	1609	1103	247	1856	0.7808
Aurora Dusk: Steam Age	2019-03-08	357	242	45	402	0.7808
Age of Wonders: Planetfall	2019-08-06	10462	4625	1134	11596	0.7807
GLOWCOMA: chapter 1	2019-11-23	12	172	30	42	0.7805
Territory Idle	2019-09-10	1597	1190	269	1866	0.7804000000000001
Spirit Hunter: Death Mark	2019-04-04	30	250	47	77	0.7802
everybody's sad	2019-02-05	7	109	17	24	0.7801
Divination	2019-12-13	5	99	15	20	0.7801
Mighty Gunvolt Burst	2019-07-31	26	138	23	49	0.7798999999999999
STAB STAB STAB!	2019-04-02	16	68	9	25	0.7798999999999999
Retimed	2019-12-05	115	267	51	166	0.7797000000000001
Strange Telephone	2019-01-21	102	258	49	151	0.7797000000000001
FREEDIVER: Triton Down	2019-05-30	12	249	47	59	0.7797000000000001
Stop Sign VR	2019-12-17	20	46	5	25	0.7796
House of 1000 Doors: Serpent Flame	2019-05-23	17	73	10	27	0.7795000000000001
SAVAGE: The Shard of Gosen	2019-08-30	20	57	7	27	0.7794
Shards of Infinity	2019-05-06	22	118	19	41	0.7793000000000001
Butterfly	2019-02-21	3	28	2	5	0.7792
Dragon Castle: The Board Game	2019-12-12	8	28	2	10	0.7792
Dry Drowning	2019-08-02	76	354	71	147	0.7791
Hello Neighbor Alpha 3	2019-10-17	85	756	166	251	0.779
LeapII	2019-11-04	3	14	0	3	0.7787000000000001
Riftwalker	2019-03-29	4	14	0	4	0.7787000000000001
Ancient lands: the Tsar awakening	2019-04-30	3	14	0	3	0.7787000000000001
Pocoman	2019-09-03	4	14	0	4	0.7787000000000001
Muscles And Bullets	2019-09-17	2	14	0	2	0.7787000000000001
Over My Dead Pixel	2019-04-12	2	14	0	2	0.7787000000000001
Tiki Trials	2019-04-30	8	14	0	8	0.7787000000000001
Lantern of Worlds - The Story of Layla	2019-04-10	19	14	0	19	0.7787000000000001
Ducks in Space	2019-11-01	3	14	0	3	0.7787000000000001
The Real Man Summer Championship 2019	2019-09-20	4	14	0	4	0.7787000000000001
Ann Achronist: Many Happy Returns	2019-09-27	3	14	0	3	0.7787000000000001
The Eye of Borrack	2019-10-17	2	14	0	2	0.7787000000000001
RetroVamp	2019-11-22	3	14	0	3	0.7787000000000001
Caves and Castles: Underworld	2019-11-07	3	14	0	3	0.7787000000000001
XO	2019-12-02	29	77	11	40	0.7779
Hentai Waifu	2019-03-25	3020	298	59	3079	0.7777
Captain MaCaw	2019-01-17	3	21	1	4	0.7777
Drag Star!	2019-03-14	12	21	1	13	0.7777
Digital Diamond Baseball V8	2019-04-15	10	21	1	11	0.7777
Super Indie Square	2019-10-07	2	21	1	3	0.7777
Null Drifter	2019-10-18	3	21	1	4	0.7777
Gachi Heroes 2: Flexboll	2019-12-19	29	227	43	72	0.7776000000000001
Fabulous - Angela's True Colors	2019-01-24	28	45	5	33	0.7775
Photographs	2019-04-03	24	130	22	46	0.7770999999999999
OmniFootman	2019-05-24	24	106	17	41	0.777
NASCAR Heat 4	2019-09-13	941	1317	308	1249	0.7769
Stigmatized Property | 事故物件	2019-10-25	52	719	160	212	0.7767000000000001
Jetstream	2019-04-02	6	39	4	10	0.7767000000000001
Moo Moo Move	2019-10-18	4	39	4	8	0.7767000000000001
Ultimate Fishing Simulator VR	2019-11-15	61	432	91	152	0.7765000000000001
Cosmonator	2019-01-21	9	76	11	20	0.7765000000000001
Mistress of Maids: First Castle	2019-04-05	21	76	11	32	0.7765000000000001
Deathbloom: Chapter 1	2019-05-16	5	76	11	16	0.7765000000000001
Lighter	2019-09-09	6	50	6	12	0.7765000000000001
Jewel Match Solitaire L'Amour	2019-02-14	12	50	6	18	0.7765000000000001
Ninja Girl and the Mysterious Army of Urban Legend Monsters! ~Hunt of the Headless Horseman~	2019-06-24	13	50	6	19	0.7765000000000001
FLATLAND Vol.1	2019-10-22	6	50	6	12	0.7765000000000001
Hentai exotica 2	2019-10-04	5	50	6	11	0.7765000000000001
Earthshine	2019-12-09	4	50	6	10	0.7765000000000001
Castlevania Anniversary Collection	2019-05-16	129	1024	236	365	0.7762000000000001
Battleheart Legacy	2019-10-11	9	33	3	12	0.7762000000000001
Too Loud	2019-07-10	6	27	2	8	0.7762000000000001
AvoCuddle	2019-07-12	3	27	2	5	0.7762000000000001
Chernobyl: Road of Death	2019-09-27	3	27	2	5	0.7762000000000001
Shine's Adventures 6 (Go! Girls)	2019-11-26	7	27	2	9	0.7762000000000001
Under What?	2019-08-05	15	464	99	114	0.7759999999999999
My Burning Heart	2019-07-23	16	119	20	36	0.7757
Sinister Halloween	2019-10-31	18	100	16	34	0.7757
Firestone: Online Idle RPG	2019-09-26	2814	3730	941	3755	0.7751000000000001
Tank Operations: European Campaign	2019-08-08	31	70	10	41	0.7751000000000001
Red Embrace: Hollywood	2019-08-31	148	231	45	193	0.775
Feather	2019-04-05	34	496	108	142	0.7745000000000001
Ports of Call Classic	2019-05-31	17	49	6	23	0.7745000000000001
Hadaka Shitsuji - Naked Butlers	2019-02-28	18	94	15	33	0.7744
Naked Story	2019-07-13	13	94	15	28	0.7744
Muscle Magic	2019-04-26	5	38	4	9	0.7743000000000001
Kyle Simulator	2019-06-27	6	108	18	24	0.7741
The Penguin Factory	2019-06-07	5	13	0	5	0.7741
PlanTechtor	2019-02-27	11	13	0	11	0.7741
Treasure Stack	2019-03-01	9	13	0	9	0.7741
Present for Manager	2019-01-22	4	13	0	4	0.7741
普通家庭/OrdinaryFamily	2019-11-28	2	13	0	2	0.7741
Hexa	2019-01-30	2	13	0	2	0.7741
Perchang	2019-07-23	4	13	0	4	0.7741
Kadath	2019-02-05	3	13	0	3	0.7741
Electric Sleep	2019-02-22	3	13	0	3	0.7741
Hei	2019-04-04	3	13	0	3	0.7741
CREEP RIDES	2019-05-30	3	13	0	3	0.7741
Yet Another Hero Legend	2019-06-14	3	13	0	3	0.7741
Dots: Revamped!	2019-07-23	4	13	0	4	0.7741
uniTower	2019-09-12	4	13	0	4	0.7741
Drawn Down Abyss	2019-10-02	3	13	0	3	0.7741
Witch Loraine's Death Game	2019-10-31	2	13	0	2	0.7741
Santa Challenge	2019-12-22	3	13	0	3	0.7741
Beast Pets	2019-02-21	13	20	1	14	0.774
Differently Fast	2019-09-06	3	20	1	4	0.774
Quench	2019-08-07	5	20	1	6	0.774
Hopper Rabbit	2019-05-30	2	20	1	3	0.774
Hot Squat 2: New Glory	2019-09-20	4	20	1	5	0.774
Hermes: War of the Gods	2019-12-05	9	20	1	10	0.774
BAYANI	2019-06-12	13	59	8	21	0.7737
Late City Riders	2019-05-07	13	74	11	24	0.7736000000000001
Post Soviet Zombies	2019-07-26	8	74	11	19	0.7736000000000001
Knights of the Chalice	2019-08-23	20	64	9	29	0.7736000000000001
Winds of Change - The Opening Act	2019-05-31	26	64	9	35	0.7736000000000001
Hentai Killer	2019-09-27	949	2350	585	1534	0.7735
Staxel	2019-04-11	2644	3529	898	3542	0.7734000000000001
Mr.Hack Jack: Robot Detective	2019-05-11	5	32	3	8	0.7734000000000001
Wolflord - Werewolf Online	2019-08-31	2233	153	28	2261	0.7732
Endless Jade Sea -Midori no Umi-	2019-01-24	194	296	61	255	0.7731
Adventure Land - The Code MMORPG	2019-01-28	53	107	18	71	0.773
Flappy Flappy VR	2019-05-02	9	26	2	11	0.773
Singularity: Tactics Arena	2019-12-17	5	26	2	7	0.773
Trash Time	2019-03-08	8	26	2	10	0.773
Copperbell	2019-07-31	3	26	2	5	0.773
Asteroid Run: No Questions Asked	2019-06-20	20	26	2	22	0.773
Memory leak: Cyberpunk hentai	2019-08-26	22	148	27	49	0.7728
Warplanes: WW1 Sky Aces	2019-09-23	138	436	95	233	0.7726000000000001
Devious Dungeon	2019-08-16	35	303	63	98	0.7724
1000 days to escape	2019-07-25	99	286	59	158	0.7724
Blood and Lust	2019-08-03	18	174	33	51	0.7723000000000001
Delivery From The Pain	2019-06-13	376	752	174	550	0.7722
Alt-Frequencies	2019-05-16	11	120	21	32	0.7721
The Fog Knows Your Name	2019-10-24	26	53	7	33	0.7721
Hentai Pazu	2019-12-04	4	53	7	11	0.7721
Oval	2019-08-11	14	37	4	18	0.7718
Hyperspace Delivery Service	2019-06-05	17	37	4	21	0.7718
An Occurrence at Owl Creek Bridge	2019-11-08	3	37	4	7	0.7718
Steel Division 2	2019-06-20	2260	5530	1453	3713	0.7716
The Blackout Club	2019-07-30	475	2091	524	999	0.7716
Elf Enchanter: Arousing Anima	2019-08-01	1363	133	24	1387	0.7715000000000001
Death Park	2019-11-26	42	101	17	59	0.7715000000000001
How To Date A Magical Girl!	2019-02-01	68	342	73	141	0.7713
Hentai Zodiac Puzzle	2019-05-10	14	203	40	54	0.7713
Epics of Distant Realm: Remastered Edition	2019-01-04	11	82	13	24	0.7712000000000001
DemonCrawl	2019-11-05	305	863	204	509	0.7709999999999999
The World Next Door	2019-03-28	34	228	46	80	0.7709
Tahko Alpine Ski	2019-02-25	11	42	5	16	0.7709
Witch Halloween	2019-10-31	36	202	40	76	0.7706999999999999
Rocwood Academy	2019-12-14	11	72	11	22	0.7706999999999999
The Scream	2019-06-19	52	114	20	72	0.7706000000000001
Punchline!!	2019-12-19	4	31	3	7	0.7706000000000001
Kitten'd	2019-06-20	10	67	10	20	0.7704000000000001
Tidal Tribe	2019-07-18	32	67	10	42	0.7704000000000001
Dragon Star Varnir	2019-10-08	318	376	82	400	0.7702
Faulty Apprentice	2019-11-13	52	136	25	77	0.7702
ZeroZone2020	2019-08-07	16	109	19	35	0.7702
Westworld Awakening	2019-08-20	25	277	58	83	0.7701000000000001
Pantsu Hunter: Back to the 90s	2019-01-17	33	171	33	66	0.7701000000000001
The StoryTale	2019-08-15	30	57	8	38	0.7701000000000001
局外人 L'Etranger	2019-07-17	53	285	60	113	0.77
Memorise'n'run	2019-02-20	3	19	1	4	0.77
おわかれのほし	2019-05-24	7	19	1	8	0.77
Hero Express	2019-07-05	3	19	1	4	0.77
Zeke's Peak	2019-10-11	4	19	1	5	0.77
3x64	2019-10-31	4	19	1	5	0.77
ReThink 3	2019-08-26	4	19	1	5	0.77
R.U.B.Y.寻常交织的日常	2019-10-15	2	19	1	3	0.77
Monstrüous	2019-12-15	4	19	1	5	0.77
Ghetto Conspiracy	2019-12-16	2	19	1	3	0.77
One-Eyed Lee and the Dinner Party	2019-12-18	3	19	1	4	0.77
铁道物语：陆王（Railway Saga:Land King）	2019-05-16	255	375	82	337	0.7698999999999999
Castle Woodwarf	2019-10-03	43	131	24	67	0.7697
VASARA Collection	2019-08-13	20	104	18	38	0.7697
愚者地牢-UP主的消失	2019-06-18	19	166	32	51	0.7696
LOST EGG	2019-06-26	14	113	20	34	0.7696
Exogen VR Experience	2019-04-26	10	36	4	14	0.7692
ATTACK OF THE EVIL POOP	2019-07-10	4	36	4	8	0.7692
Warhammer 40,000: Inquisitor - Prophecy	2019-07-30	1298	1853	469	1767	0.7691
Iron Marines	2019-05-15	498	1146	281	779	0.7691
oldbI tyt ?	2019-01-11	6	108	19	25	0.7691
World of DASM: DASM Spell Quest	2019-06-06	416	12	0	416	0.7690000000000001
Typing of the Undead	2019-11-27	2	12	0	2	0.7690000000000001
Byte Driver	2019-05-28	2	12	0	2	0.7690000000000001
Armoured Alliance	2019-02-08	5	12	0	5	0.7690000000000001
The Demon Crystal	2019-03-29	6	12	0	6	0.7690000000000001
Insanus Express	2019-02-09	4	12	0	4	0.7690000000000001
HopSquash!	2019-11-30	6	12	0	6	0.7690000000000001
Plaguepunk Justice	2019-04-11	2	12	0	2	0.7690000000000001
Land War	2019-03-29	5	12	0	5	0.7690000000000001
Mad Princess: The Great Gladiators	2019-03-15	5	12	0	5	0.7690000000000001
Static	2019-04-05	2	12	0	2	0.7690000000000001
Uriel’s Chasm 3: Gelshock	2019-03-29	3	12	0	3	0.7690000000000001
Resistance is Fruitile	2019-07-31	4	12	0	4	0.7690000000000001
Feels	2019-11-13	2	12	0	2	0.7690000000000001
Soul Island	2019-04-25	3	12	0	3	0.7690000000000001
无奇刀 Wookie's Blade	2019-09-27	2	12	0	2	0.7690000000000001
Terracotta - Shards of Doom	2019-08-07	2	12	0	2	0.7690000000000001
EMMA: Lost in Memories	2019-08-16	5	12	0	5	0.7690000000000001
Fantasy Little Jobs	2019-09-06	3	12	0	3	0.7690000000000001
Wizhood: The Epic of Freedom	2019-09-04	2	12	0	2	0.7690000000000001
Hope; or How We Survived	2019-11-01	2	12	0	2	0.7690000000000001
Blooding Runner X	2019-10-14	2	12	0	2	0.7690000000000001
Travel Mosaics 10: Spooky Halloween	2019-10-28	9	12	0	9	0.7690000000000001
Hades' Star	2019-02-27	771	1626	409	1180	0.7687999999999999
Sydney Hunter and the Curse of the Mayan	2019-09-12	7	66	10	17	0.7687999999999999
Interrogation: You will be deceived	2019-12-05	29	224	46	75	0.7686000000000001
The Wanderer: Frankenstein's Creature	2019-10-30	9	143	27	36	0.7686000000000001
Indie Dream	2019-07-26	13	80	13	26	0.7685
Psyvariar Delta	2019-01-30	15	41	5	20	0.7685
Christmas Time 2019	2019-01-09	4	41	5	9	0.7685
Bleep Bloop	2019-01-31	18	41	5	23	0.7685
Rescue HQ - The Tycoon	2019-05-28	1209	624	146	1355	0.7684000000000001
RagDollJoe	2019-12-08	12	138	26	38	0.768
Peekaboo	2019-08-07	1499	2563	667	2166	0.7676999999999999
Corpse Party: Blood Drive	2019-10-10	54	214	44	98	0.7676000000000001
TINY METAL: FULL METAL RUMBLE	2019-07-11	52	120	22	74	0.7676000000000001
TwinCop	2019-05-10	7	30	3	10	0.7676000000000001
Infinite Art Museum	2019-04-05	10	30	3	13	0.7676000000000001
Beach Body Bros	2019-09-25	3	30	3	6	0.7676000000000001
Pro Cycling Manager 2019	2019-06-27	3467	553	129	3596	0.7673000000000001
Ludo Online	2019-10-30	117	267	57	174	0.7673000000000001
The spy who shot me™	2019-01-29	9	226	47	56	0.7673000000000001
Press F to pay respects	2019-02-28	13	180	36	49	0.7673000000000001
Kunoichi Botan	2019-01-04	121	355	79	200	0.7669
Seek Girl	2019-03-14	735	3710	989	1724	0.7668
Die Young	2019-09-12	192	1363	344	536	0.7667
Dizzy Hearts	2019-12-05	8	35	4	12	0.7665000000000001
Knight Swap 2	2019-12-14	4	35	4	8	0.7665000000000001
Balls!🤬🍆	2019-11-28	7	55	8	15	0.7664
Crystar	2019-08-28	215	790	192	407	0.7662000000000001
Hentai Cowgirl	2019-05-20	4	123	23	27	0.7662000000000001
Vanguard Knights	2019-01-10	3	24	2	5	0.7662000000000001
Dragonview	2019-01-21	4	24	2	6	0.7662000000000001
Dis Pontibus	2019-01-07	6	24	2	8	0.7662000000000001
biorhythm	2019-08-23	136	24	2	138	0.7662000000000001
Human Rights	2019-04-04	6	24	2	8	0.7662000000000001
NOTES	2019-07-11	3	24	2	5	0.7662000000000001
The Floor Is Really Cheap Lava	2019-02-15	15	92	16	31	0.7661
Dreadborne Drifters	2019-10-28	9	40	5	14	0.7661
Sad :')	2019-08-14	4	40	5	9	0.7661
Gekraxel	2019-08-30	18	18	1	19	0.7658
Cherry Creek	2019-03-15	3	18	1	4	0.7658
Adventure in Russia: Road to Harvetsky	2019-05-09	2	18	1	3	0.7658
Arsenal Demon	2019-10-11	5	18	1	6	0.7658
XenoRaptor	2019-12-24	31	131	25	56	0.7656000000000001
Winter Resort Simulator	2019-12-12	668	695	168	836	0.7654000000000001
Endless World Idle RPG	2019-12-06	2312	3243	868	3180	0.7653
Six Ages: Ride Like the Wind	2019-10-17	175	311	69	244	0.7652
Never Again	2019-05-09	124	564	134	258	0.7651000000000001
Blood Card	2019-05-24	209	529	125	334	0.765
Naughty Girl	2019-06-14	5	160	32	37	0.765
Fort Sumter	2019-05-21	19	59	9	28	0.7648999999999999
Faerie Solitaire Harvest	2019-04-22	47	147	29	76	0.7647
Partial Control	2019-06-15	24	29	3	27	0.7645000000000001
Armortale	2019-11-15	6	29	3	9	0.7645000000000001
Blood Trail	2019-03-27	154	2785	744	898	0.7644
Super Phantom Cat	2019-04-25	20	176	36	56	0.7644
BOXVR	2019-05-21	64	1265	323	387	0.7643000000000001
SteamDolls - Order Of Chaos - Free	2019-11-07	9	95	17	26	0.7643000000000001
SONG OF HORROR	2019-10-31	224	1795	469	693	0.7642
Aeon's End	2019-09-17	71	273	60	131	0.7642
Root Letter Last Answer	2019-09-02	12	121	23	35	0.7642
Reanimation Inc.	2019-11-01	28	86	15	43	0.7641
恋爱总动员	2019-06-17	30	86	15	45	0.7641
Nemo Dungeon	2019-07-13	11	49	7	18	0.7640000000000001
Ironsight	2019-12-18	1359	4303	1177	2536	0.7639
PAGAN PEAK VR	2019-10-30	7	146	29	36	0.7637999999999999
Great Toilet Simulator	2019-08-23	9	339	77	86	0.7637
uuu so smislom	2019-03-22	5	44	6	11	0.7637
Driven Out	2019-10-18	39	187	39	78	0.7635
Double	2019-03-15	8	154	31	39	0.7635
Love in the Limelight	2019-07-19	56	39	5	61	0.7635
Nyasha	2019-03-06	32033	354	81	32114	0.7634000000000001
Eczema Angel Orifice	2019-04-10	2	11	0	2	0.7634000000000001
Supralympic Runners	2019-02-06	5	11	0	5	0.7634000000000001
Origami Flight	2019-04-01	2	11	0	2	0.7634000000000001
Super Realistic Autocross	2019-08-07	5	11	0	5	0.7634000000000001
Chrono Ghost	2019-01-04	5	11	0	5	0.7634000000000001
Hand of Horzasha	2019-01-31	2	11	0	2	0.7634000000000001
Fold	2019-03-05	2	11	0	2	0.7634000000000001
Monovert DX	2019-03-20	2	11	0	2	0.7634000000000001
International Affairs	2019-04-01	3	11	0	3	0.7634000000000001
Stupid Quest	2019-04-10	4	11	0	4	0.7634000000000001
Narwhal Heist	2019-07-10	3	11	0	3	0.7634000000000001
Star Impact	2019-05-14	4	11	0	4	0.7634000000000001
Easy puzzle: Animals	2019-04-05	3	11	0	3	0.7634000000000001
Dark Miasma	2019-10-17	6	11	0	6	0.7634000000000001
Neckbeardia	2019-08-14	3	11	0	3	0.7634000000000001
Zebra Logic Master	2019-09-14	3	11	0	3	0.7634000000000001
Kings Of Wings	2019-11-08	2	11	0	2	0.7634000000000001
Remember	2019-12-20	1	11	0	1	0.7634000000000001
The Bunker 69	2019-11-01	52	211	45	97	0.7632
BIOHAZARD RE:2 Z Version	2019-01-25	2344	207	44	2388	0.7632
Sakura Gamer 2	2019-12-12	21	120	23	44	0.7632
Light Fairytale Episode 1	2019-05-13	22	182	38	60	0.7628
Accel	2019-02-12	13	76	13	26	0.7626000000000001
Miracle Mia	2019-08-23	3	23	2	5	0.7625000000000001
Trancelation	2019-03-12	5	23	2	7	0.7625000000000001
Unblock Gridlock	2019-01-30	4	23	2	6	0.7625000000000001
淫魔ネムのChuChu精液探検記	2019-02-05	16	23	2	18	0.7625000000000001
PUZZLETIME: Lovely Girls	2019-06-12	7	23	2	9	0.7625000000000001
后遗症／Sequela	2019-05-13	4	23	2	6	0.7625000000000001
Trials of Guinevere	2019-12-31	4	23	2	6	0.7625000000000001
Gobligeddon	2019-08-13	8	23	2	10	0.7625000000000001
Animal Up!	2019-08-30	3	23	2	5	0.7625000000000001
Taboos: Cracks	2019-05-02	219	1303	338	557	0.7624
Escape the Ayuwoki	2019-11-26	83	579	141	224	0.7622
贫穷少年与校园名人的生死对决	2019-06-20	9	89	16	25	0.7622
GreedFall	2019-09-09	16345	13305	3824	20169	0.762
DreamWorks Dragons: Dawn of New Riders	2019-02-15	28	106	20	48	0.7619
Strength of the Sword ULTIMATE	2019-08-22	8	93	17	25	0.7618
Tip of the Spear: Task Force Elite	2019-12-18	79	220	48	127	0.7613
Hentai Jigsaw Puzzle	2019-02-16	73	114	22	95	0.7613
Kids of Hellas: Back to Olympus	2019-02-22	14	43	6	20	0.7613
OMNIMUS	2019-09-26	6	43	6	12	0.7613
Tractor Cargo Driving Simulator	2019-08-28	3	43	6	9	0.7613
Aqua Lungers	2019-08-09	3	17	1	4	0.7613
T.A.P.	2019-01-31	8	17	1	9	0.7613
Manna for our Malices	2019-02-11	2	17	1	3	0.7613
LocoMotives	2019-07-24	6	17	1	7	0.7613
Tipping Point	2019-04-11	4	17	1	5	0.7613
Glitch Puzzle	2019-07-27	2	17	1	3	0.7613
Aftermoor	2019-08-26	2	17	1	3	0.7613
Markov Alg	2019-11-26	5	17	1	6	0.7613
Smith and Winston	2019-08-27	4	28	3	7	0.7612000000000001
Last Summer	2019-09-27	3	28	3	6	0.7612000000000001
探灵笔記/拾遗记-1v5(Notes of Soul)	2019-01-17	2968	16080	4670	7638	0.7611
Dance Collider	2019-11-01	9	143	29	38	0.7611
ぶんまわしヒーロー	2019-05-02	14	57	9	23	0.7611
Loser Reborn	2019-09-13	8	57	9	17	0.7611
My Stunt Life	2019-05-02	10	155	32	42	0.7609
Capsular	2019-07-25	13	66	11	24	0.7609
Space Hole 2018	2019-01-24	5	38	5	10	0.7609
Planetary Dustoff	2019-12-16	11	38	5	16	0.7609
Adapt or Perish	2019-02-11	9	38	5	14	0.7609
Wings of Glass -玻璃の羽-	2019-02-11	6	38	5	11	0.7609
幻想异乡曲 Butterfly~Rin	2019-08-17	16	38	5	21	0.7609
Evospace	2019-02-14	56	227	50	106	0.7608
03.04	2019-01-01	8	223	49	57	0.7608
Gunpowder on The Teeth: Arcade	2019-02-23	2	33	4	6	0.7608
Super Neptunia RPG	2019-06-20	707	765	193	900	0.7606999999999999
Shoot Them	2019-12-04	8	126	25	33	0.7606999999999999
Nordlicht	2019-09-27	5	105	20	25	0.7606999999999999
Discolored	2019-11-11	34	362	85	119	0.7605
告死天使之言 Death angel	2019-08-10	74	277	63	137	0.7603
Public Enemy: Revolution Simulator	2019-08-20	4	52	8	12	0.7603
Geometry May. I swear it's a nice free game	2019-04-17	85	463	112	197	0.7602
Koi	2019-02-22	26	113	22	48	0.7602
Fenimore Fillmore: 3 Skulls of the Toltecs	2019-03-15	12	61	10	22	0.76
Infinity: Battlescape	2019-09-27	227	477	116	343	0.7599
Fission Superstar X	2019-05-21	50	121	24	74	0.7599
猎魔者战纪	2019-05-13	43	83	15	58	0.7599
Blair Witch	2019-08-30	1716	4388	1235	2951	0.7595000000000001
egg is broken. heart is too.	2019-04-05	19	104	20	39	0.7595000000000001
Under Pressure	2019-06-15	13	74	13	26	0.7595000000000001
Wildbus	2019-08-30	5	47	7	12	0.7595000000000001
Shera and the Three Treasures	2019-12-14	268	213	47	315	0.7594
Fight Angel	2019-08-28	40	205	45	85	0.7594
Figure Simulator War	2019-10-26	12	78	14	26	0.7589
Successor of the Moon	2019-03-15	65	95	18	83	0.7587999999999999
Morningdew Farms: A Gay Farming Game	2019-09-18	71	95	18	89	0.7587999999999999
五日大逃亡	2019-06-02	5	42	6	11	0.7587999999999999
Eleven Eleven	2019-05-22	10	22	2	12	0.7586
Ritual: Sorcerer Angel	2019-06-14	9	22	2	11	0.7586
Uncharted Tides: Port Royal	2019-08-29	26	132	27	53	0.7585
RDS - The Official Drift Videogame	2019-06-06	147	860	223	370	0.7582
Flashback	2019-02-28	41	326	77	118	0.7582
Crystal core	2019-10-27	4	51	8	12	0.7582
Ball Out	2019-12-02	6	37	5	11	0.7582
Chook & Sosig: Walk the Plank	2019-06-17	11	86	16	27	0.7581
Terrible Laboratory	2019-03-29	105	276	64	169	0.7579000000000001
Life is Pointless	2019-02-04	11	73	13	24	0.7579000000000001
PROJECT: RUN	2019-12-31	8	73	13	21	0.7579000000000001
Animal Fight Club	2019-04-19	122	226	51	173	0.7578
Dance of Death: Du Lac & Fey	2019-04-05	14	119	24	38	0.7578
Battlefleet Gothic: Armada 2	2019-01-24	8960	6248	1802	10762	0.7576999999999999
Summer Catchers	2019-07-16	35	175	38	73	0.7576999999999999
More dark	2019-11-07	3	32	4	7	0.7576999999999999
Alien Escape	2019-07-18	5	27	3	8	0.7576999999999999
Now You See	2019-09-30	7	131	27	34	0.7576
Puyo Puyo Champions	2019-05-07	355	575	145	500	0.7574
Horace	2019-07-18	56	480	119	175	0.7574
London Detective Mysteria	2019-07-31	37	98	19	56	0.7573000000000001
Xenomarine	2019-04-24	19	46	7	26	0.7572
League of Pixels	2019-12-26	22	102	20	42	0.7571
Robo Instructus	2019-07-16	46	55	9	55	0.7571
Wheelbarrow Warrior	2019-01-22	2	10	0	2	0.7571
1248	2019-03-07	2	10	0	2	0.7571
Combo Postage	2019-07-06	4	10	0	4	0.7571
Glo Phlox	2019-08-02	3	10	0	3	0.7571
Bouncing Hero	2019-09-01	5	10	0	5	0.7571
在末日前夕等待放晴	2019-02-26	4	10	0	4	0.7571
Speedrun Squad	2019-05-14	5	10	0	5	0.7571
Ambidangerous	2019-08-08	2	10	0	2	0.7571
The Sword and the Slime	2019-10-04	3	10	0	3	0.7571
Pixamal Zoo	2019-10-30	3	10	0	3	0.7571
Pixel Sentry	2019-09-13	3	10	0	3	0.7571
Cucumber Defense VR	2019-10-27	3	10	0	3	0.7571
Time of the Moon	2019-11-01	5	10	0	5	0.7571
MouseWars	2019-12-05	9	10	0	9	0.7571
Impossiball - Gamers Challenge	2019-12-17	7	10	0	7	0.7571
Budget Cuts 2: Mission Insolvency	2019-12-12	43	360	87	130	0.7568000000000001
Hentai Sweet Girls	2019-06-14	11905	300	71	11976	0.7567
BatMUD	2019-11-19	69	122	25	94	0.7565999999999999
She Sees Red	2019-07-11	155	2191	610	765	0.7564000000000001
Bitlogic	2019-04-30	3	16	1	4	0.7564000000000001
Trio Adventures	2019-02-14	3	16	1	4	0.7564000000000001
Battle Shapes	2019-01-04	4	16	1	5	0.7564000000000001
Laser Maze	2019-01-04	3	16	1	4	0.7564000000000001
Revenge on the Streets	2019-06-24	2	16	1	3	0.7564000000000001
Planaris 2+	2019-07-09	4	16	1	5	0.7564000000000001
Death and Progress	2019-08-02	3	16	1	4	0.7564000000000001
N.a.N Industry VR	2019-09-20	7	16	1	8	0.7564000000000001
Zombie Panic In Wonderland DX	2019-11-06	4	16	1	5	0.7564000000000001
Soccer Player Simulator	2019-03-27	7	177	39	46	0.7562000000000001
Rose Garden at the World's End	2019-06-19	7	41	6	13	0.7562000000000001
Plasticity	2019-05-24	38	490	123	161	0.756
Sexy Breakout	2019-05-07	11	50	8	19	0.756
H Chan	2019-06-14	21	101	20	41	0.7559
Morphies Law	2019-07-30	20	76	14	34	0.7559
Put In - Run Out	2019-06-11	6	76	14	20	0.7559
ClickCells: Office Lady	2019-12-12	9	76	14	23	0.7559
Far Cry New Dawn	2019-02-15	16975	19068	5756	22731	0.7554000000000001
Blanket Heavy With Nightmares	2019-04-17	4	36	5	9	0.7553000000000001
我是键盘侠	2019-10-24	14	36	5	19	0.7553000000000001
Hentai Quilm	2019-10-28	3	36	5	8	0.7553000000000001
BUS SIMULATOR	2019-11-18	2	36	5	7	0.7553000000000001
Horny Girl	2019-03-28	13	160	35	48	0.7551000000000001
Bokuten - Why I Became an Angel	2019-12-20	17	67	12	29	0.755
Zen Chess: Mate in Two	2019-04-30	6	67	12	18	0.755
Ultra Savage	2019-04-26	1357	333	81	1438	0.7548
Killer Chambers	2019-04-05	15	45	7	22	0.7548
Now I Am There	2019-09-11	4	45	7	11	0.7548
Monster X Monster	2019-05-17	57	132	28	85	0.7545999999999999
DRAW CHILLY	2019-11-12	33	128	27	60	0.7545999999999999
Cat Lady	2019-10-17	11	31	4	15	0.7545999999999999
Blacklist Brigade	2019-05-28	5	31	4	9	0.7545999999999999
Legendary gun	2019-10-11	5	31	4	9	0.7545999999999999
伊勢志摩ミステリー案内 偽りの黒真珠－ISESHIMA STORY	2019-07-25	15	31	4	19	0.7545999999999999
Death end re;Quest	2019-05-16	522	902	241	763	0.7544
Metaverse Keeper	2019-04-11	490	617	160	650	0.7544
Precipice	2019-05-01	61	243	57	118	0.7544
Mowin' & Throwin'	2019-05-31	16	21	2	18	0.7544
Snow Battle Princess SAYUKI | 雪ん娘大旋風	2019-03-20	3	21	2	5	0.7544
CD-RUN	2019-10-24	8	21	2	10	0.7544
Homeward Duck	2019-05-07	11	21	2	13	0.7544
Ms. Holmes: The Monster of the Baskervilles Collector's Edition	2019-05-31	5	21	2	7	0.7544
Foodie Bear	2019-09-03	3	21	2	5	0.7544
River Legends: A Fly Fishing Adventure	2019-08-27	3	21	2	5	0.7544
Journey For Elysium	2019-10-31	4	75	14	18	0.7543000000000001
My Train Arrives	2019-09-10	21	75	14	35	0.7543000000000001
ViSP - Virtual Space Port	2019-02-28	7	26	3	10	0.7541
Real Al's Humanity Academy	2019-04-01	12	26	3	15	0.7541
Elemental Girls	2019-05-15	28636	246	58	28694	0.7540000000000001
Sea Salt	2019-10-17	92	465	118	210	0.7539
Roadclub: League Racing	2019-01-08	145	49	8	153	0.7537
WWTSTB: Streamer	2019-05-30	25	162	36	61	0.7535
Dark Fantasy 2: Jigsaw Puzzle	2019-05-17	14	103	21	35	0.7534000000000001
Island Marauder	2019-11-29	10	150	33	43	0.7532
The Surge 2	2019-09-23	3719	5291	1561	5280	0.7531
Black Squad	2019-06-26	15939	60909	19054	34993	0.753
Moons of Madness	2019-10-22	519	1755	495	1014	0.7526
Woven	2019-11-15	175	126	27	202	0.7525000000000001
Vile	2019-10-17	5	35	5	10	0.7524
散歩するキーボード使い	2019-11-21	17	35	5	22	0.7524
Visionarium	2019-01-03	4	57	10	14	0.7523000000000001
Lanternium	2019-04-22	119	44	7	126	0.7523000000000001
Ashes of the Night	2019-08-01	6	44	7	13	0.7523000000000001
Chibi Volleyball	2019-07-20	5	44	7	12	0.7523000000000001
Bomber Bother	2019-10-09	10	44	7	17	0.7523000000000001
Brume	2019-10-30	11	86	17	28	0.7522
Overdungeon	2019-08-22	2205	2201	631	2836	0.7519
We. The Revolution	2019-03-21	822	1362	381	1203	0.7517
Cockwork Industries Complete	2019-11-07	245	619	164	409	0.7515000000000001
The Mystery Of Woolley Mountain	2019-04-10	8	48	8	16	0.7514000000000001
Extricate	2019-08-12	23	48	8	31	0.7514000000000001
New York Mysteries: The Outbreak	2019-12-02	18	48	8	26	0.7514000000000001
Supraball	2019-02-08	3329	2517	729	4058	0.7513
Cyber Driver	2019-08-16	11	121	26	37	0.7513
皓月空华	2019-01-01	48	69	13	61	0.7512000000000001
Otokomizu～漢水～	2019-02-28	15	30	4	19	0.7512000000000001
Nyanco Project	2019-08-01	12	109	23	35	0.751
Star Girls	2019-07-11	8	15	1	9	0.751
Tranzient	2019-06-03	3	15	1	4	0.751
Madievals	2019-07-17	4	15	1	5	0.751
Neon Junctions	2019-06-07	3	15	1	4	0.751
Mission Critical	2019-01-28	3	15	1	4	0.751
Galaxy Forces VR	2019-08-31	3	15	1	4	0.751
Viking Brothers 5	2019-04-10	7	15	1	8	0.751
OFFSIDE	2019-09-18	4	15	1	5	0.751
Eidolon	2019-11-19	3	15	1	4	0.751
Doll	2019-11-14	2	15	1	3	0.751
DeadShotZ	2019-11-05	3	15	1	4	0.751
Love Language Japanese	2019-01-11	72	136	30	102	0.7509
Marginalia	2019-10-01	3	39	6	9	0.7509
Booby And The Booby Trap	2019-08-07	6	39	6	12	0.7509
Dinosaur Hunting Patrol 3D Multiplayer Online	2019-10-07	7	89	18	25	0.7506999999999999
OUTWORLD BATTLEGROUNDS	2019-08-01	13	52	9	22	0.7506999999999999
Hurtworld	2019-12-10	13333	23684	7386	20719	0.7506
Thea 2: The Shattering	2019-05-13	1349	1529	434	1783	0.7505
Anime Artist	2019-07-25	32	124	27	59	0.7504000000000001
Fate Hunters	2019-07-18	301	628	168	469	0.7503000000000001
Inunaki Tunnel | 犬鳴トンネル	2019-11-20	58	305	76	134	0.7503000000000001
MANIC	2019-12-03	3	25	3	6	0.7503000000000001
Knight Eternal	2019-11-05	4	25	3	7	0.7503000000000001
VR Sand	2019-02-07	3	9	0	3	0.75
RetroWar	2019-06-17	2	9	0	2	0.75
Esper - Make You Live Again	2019-05-31	2	9	0	2	0.75
VOiD	2019-02-19	2	9	0	2	0.75
Fantasy Ball	2019-07-16	3	9	0	3	0.75
Mahjong Magic Journey 3	2019-03-18	6	9	0	6	0.75
Inside Grass	2019-11-15	2	9	0	2	0.75
Game Master Plus	2019-01-01	3	9	0	3	0.75
新世勇者传	2019-06-26	3	9	0	3	0.75
Akabeth Tactics	2019-04-11	2	9	0	2	0.75
Smoking Snakes	2019-04-30	5	9	0	5	0.75
The Elementalist	2019-05-27	3	9	0	3	0.75
Dungeons of Legend: Cast Within	2019-02-22	5	9	0	5	0.75
Emoji Charades	2019-07-10	8	9	0	8	0.75
Dead Quest	2019-04-23	4	9	0	4	0.75
ESKO	2019-04-02	5	9	0	5	0.75
D20 Dungeons	2019-11-12	3	9	0	3	0.75
Backpack Twins	2019-08-16	2	9	0	2	0.75
Bunker - Nightmare Begins	2019-04-18	2	9	0	2	0.75
Zunius	2019-10-18	3	9	0	3	0.75
Fatty Space	2019-05-24	4	9	0	4	0.75
Caliper 2	2019-05-22	3	9	0	3	0.75
Come Back: Chapter 1	2019-07-08	3	9	0	3	0.75
fishman	2019-08-11	2	9	0	2	0.75
The Tower 2	2019-08-23	2	9	0	2	0.75
Hyperplex 3D	2019-08-16	4	9	0	4	0.75
Railroads	2019-08-28	2	9	0	2	0.75
Mustache or Revenge	2019-11-07	3	9	0	3	0.75
Plunder	2019-09-20	3	9	0	3	0.75
Tech Support 2077	2019-10-18	2	9	0	2	0.75
Bomb Bowling 2	2019-10-22	3	9	0	3	0.75
Wardens of the Amber Cage	2019-03-01	5	20	2	7	0.7499
Feathery Ears 羽耳	2019-11-10	4	20	2	6	0.7499
NashBored	2019-01-02	8	20	2	10	0.7499
STUMPER	2019-04-28	9	20	2	11	0.7499
Fool!	2019-05-23	31	20	2	33	0.7499
BonVoyage!	2019-06-20	5	20	2	7	0.7499
Everybody Loves Skeletons	2019-09-06	3	20	2	5	0.7499
To the Hell	2019-08-02	4	20	2	6	0.7499
CAPCOM GO! Apollo VR Planetarium	2019-08-23	7	60	11	18	0.7498
Sometimes to Deal with the Difficulty of Being Alive, I Need to Believe There Is a Possibility That Life Is Not Real.	2019-05-22	10	68	13	23	0.7494
Flowers in Dark	2019-01-03	10	68	13	23	0.7494
Fast and Low	2019-06-20	42	430	112	154	0.7493000000000001
Hentai Clouds	2019-08-21	5	88	18	23	0.7493000000000001
Oliver's Adventures in the Fairyland	2019-02-18	5	34	5	10	0.7493000000000001
XANARTHRAXIA	2019-11-17	3	34	5	8	0.7493000000000001
看不见的爱	2019-08-06	5	34	5	10	0.7493000000000001
James Town Courier Frog MD	2019-12-25	4	34	5	9	0.7493000000000001
World War Zero	2019-12-03	6	80	16	22	0.7492000000000001
Heroes Of Maidan 2	2019-01-22	14	76	15	29	0.7492000000000001
Medieval Kingdom Wars	2019-01-03	549	1952	567	1116	0.7489
MarZ: Tactical Base Defense	2019-04-04	392	599	162	554	0.7482
Dead Monarchy	2019-06-18	17	55	10	27	0.7481
WRATH: Aeon of Ruin	2019-11-22	275	1262	360	635	0.748
be you	2019-02-04	13	163	38	51	0.748
Unlock Me	2019-01-03	14	38	6	20	0.748
WoozyHero 乌贼英雄	2019-09-07	8	38	6	14	0.748
Blonde	2019-06-19	10	133	30	40	0.7479000000000001
Foreskin Fury	2019-10-14	69	59	11	80	0.7478
Grizzland	2019-07-17	6	29	4	10	0.7478
Waves of the Atlantide	2019-03-26	7	29	4	11	0.7478
Artifact Adventure Gaiden DX	2019-07-31	26	29	4	30	0.7478
10-4	2019-04-15	24	67	13	37	0.7476
Kimono Girls	2019-08-23	4	67	13	17	0.7476
FURRY GIRL PUZZLE	2019-06-24	921	473	126	1047	0.7474
Tornado!	2019-05-22	24	106	23	47	0.7474
ONE PIECE World Seeker	2019-03-14	1233	3007	901	2134	0.7471
USAGIRI	2019-12-11	3	42	7	10	0.7471
Love Rhythm	2019-11-20	59	443	118	177	0.7465999999999999
Shio And Mysterious Forest	2019-09-12	38	46	8	46	0.7465
STORM AREA 51: AYY LMAO EDITION	2019-09-20	1977	693	192	2169	0.7464000000000001
LOST ORBIT: Terminal Velocity	2019-07-16	60	24	3	63	0.7463
Ladybug Quest	2019-02-11	10	24	3	13	0.7463
Little Square Things	2019-09-28	665	50	9	674	0.7462000000000001
Eagle Island	2019-07-11	46	168	40	86	0.7461
Streets of Red : Devil's Dare Deluxe	2019-02-22	61	168	40	101	0.7461
Game Studio Simulator	2019-03-06	120	146	34	154	0.7461
Mystery Case Files: Black Crown Collector's Edition	2019-11-27	14	33	5	19	0.7461
Moves	2019-12-20	2	33	5	7	0.7461
Never Split the Party	2019-05-03	782	3198	968	1750	0.7459
No-brainer Heroes	2019-11-29	1591	1223	353	1944	0.7459
Zanki Zero: Last Beginning	2019-04-10	371	451	121	492	0.7458
Hikari! Love Potion	2019-08-30	17	66	13	30	0.7458
LAB2-UndeR GrounD-	2019-02-14	23	58	11	34	0.7458
Plutocracy	2019-11-21	173	720	201	374	0.7456999999999999
Soko Loco Deluxe	2019-11-13	19	62	12	31	0.7456999999999999
And All Would Cry Beware!	2019-06-24	4	62	12	16	0.7456999999999999
PlanetSide 2 - Test	2019-05-13	797	62	12	809	0.7456999999999999
Lilly Knight	2019-12-06	40	178	43	83	0.7454000000000001
Rogue Singularity	2019-08-15	4	14	1	5	0.7453000000000001
Possession	2019-07-18	6	14	1	7	0.7453000000000001
To Light: Ex Umbra	2019-03-01	6	14	1	7	0.7453000000000001
Beast Agenda 2030	2019-11-26	2	14	1	3	0.7453000000000001
Stunt Kite Party	2019-06-07	4	14	1	5	0.7453000000000001
Magician of Fire	2019-05-17	3	14	1	4	0.7453000000000001
Tsumi	2019-04-12	4	14	1	5	0.7453000000000001
Yuki's Tale	2019-04-05	5	14	1	6	0.7453000000000001
Mahjong Solitaire Refresh	2019-09-12	13	14	1	14	0.7453000000000001
Phantasmata	2019-04-06	2	14	1	3	0.7453000000000001
Chronoraptor	2019-04-29	3	14	1	4	0.7453000000000001
Sack of Bots	2019-06-06	2	14	1	3	0.7453000000000001
BLAST-AXIS	2019-07-30	3	14	1	4	0.7453000000000001
Beyond	2019-08-22	3	14	1	4	0.7453000000000001
Cures & Curios	2019-08-27	5	14	1	6	0.7453000000000001
Shiki	2019-11-05	3	14	1	4	0.7453000000000001
YU-NO: A girl who chants love at the bound of this world	2019-10-02	60	167	40	100	0.7452
Citizen of Rome - Dynasty Ascendant	2019-05-16	34	156	37	71	0.7452
Delicious - Emily's Road Trip	2019-06-04	71	89	19	90	0.7451000000000001
1001stHyperTower	2019-11-07	8	37	6	14	0.7451000000000001
Lover Bands	2019-04-19	6	19	2	8	0.7451000000000001
All World Pro Wrestling	2019-12-02	12	19	2	14	0.7451000000000001
Holy Knight Luviria	2019-11-15	195	195	48	243	0.7447
Hentai: Memory leak	2019-09-26	9	81	17	26	0.7447
Fractured Minds	2019-11-14	7	248	63	70	0.7445999999999999
OhShape	2019-12-13	12	216	54	66	0.7444
放逐之地：牢笼	2019-10-04	26	77	16	42	0.7444
Cuties Dungeon	2019-10-11	10	28	4	14	0.7441
The North Pole	2019-12-18	5	28	4	9	0.7441
In the Pause Between the Ringing	2019-04-23	12	92	20	32	0.7440000000000001
死亡旅店	2019-06-28	18	45	8	26	0.7440000000000001
Mojo XXX	2019-01-22	31	201	50	81	0.7439
Jewel Match Atlantis Solitaire - Collector's Edition	2019-11-07	25	65	13	38	0.7439
Catgirl & Doggirl Cafe	2019-08-30	11	65	13	24	0.7439
GACHIMUCHI REBIRTH	2019-01-31	4	49	9	13	0.7438
Sky Link	2019-08-16	90	57	11	101	0.7437
Conqueror's Blade	2019-05-30	15008	20466	6633	21641	0.7434000000000001
Princess Project	2019-08-30	293	325	86	379	0.7433
Adolf Hitler Humiliation Simulator	2019-05-09	5	99	22	27	0.7433
星礼研究所 | Sighchology Research Lab	2019-12-31	112	99	22	134	0.7433
Deuterium Wars	2019-10-10	198	470	129	327	0.7431
Huusuienbu - Chapter Spring and Summer 	2019-05-28	25	80	17	42	0.7431
Kritika:REBOOT	2019-11-12	3788	3563	1102	4890	0.743
Drinks With Abbey	2019-12-25	33	314	83	116	0.7429000000000001
Crome: Before Purgatory	2019-01-29	4	32	5	9	0.7428
The Great Perhaps	2019-08-14	24	471	130	154	0.7424
Heretic Operative	2019-02-18	31	68	14	45	0.7422
Dungeon Dreams (Female Protagonist)	2019-12-24	26	36	6	32	0.742
Space Cows	2019-09-05	7	23	3	10	0.742
Blind Date	2019-02-14	4	23	3	7	0.742
Bandits	2019-07-26	5	23	3	8	0.742
Royal Gems	2019-04-01	8	23	3	11	0.742
Game Of Puzzles: Nature	2019-04-11	4	23	3	7	0.742
The Cult: Marduk's Longest Night	2019-12-10	4	23	3	7	0.742
Frontline: The Great Patriotic War	2019-12-20	6	23	3	9	0.742
Metal Division	2019-01-15	2	8	0	2	0.7419
One Hundred Times Me	2019-02-19	2	8	0	2	0.7419
Farragnarok	2019-02-15	8	8	0	8	0.7419
To Catch a Monkey	2019-11-22	5	8	0	5	0.7419
Critter Kart	2019-09-13	4	8	0	4	0.7419
Angry Punisher	2019-01-15	3	8	0	3	0.7419
Symploké: La Leyenda de Gustavo Bueno (Capítulo 3)	2019-03-07	2	8	0	2	0.7419
The HARDEST BrickBreaker	2019-01-17	5	8	0	5	0.7419
Xander the Monster Morpher: Universe Breaker	2019-08-02	4	8	0	4	0.7419
Qubes	2019-03-15	2	8	0	2	0.7419
PuppetShow: Porcelain Smile Collector's Edition	2019-02-23	4	8	0	4	0.7419
Catch the Head	2019-08-29	4	8	0	4	0.7419
Feed A Titanosaur	2019-04-18	4	8	0	4	0.7419
Funny Bunny: Adventures	2019-04-24	3	8	0	3	0.7419
Only After	2019-10-22	3	8	0	3	0.7419
Hentai Babes - Fantasy	2019-06-03	4	8	0	4	0.7419
Grim Facade: Hidden Sins Collector's Edition	2019-04-26	4	8	0	4	0.7419
Asdivine Menace	2019-08-08	4	8	0	4	0.7419
Fatal Evidence: Cursed Island Collector's Edition	2019-05-24	3	8	0	3	0.7419
Fables of Talumos	2019-09-02	2	8	0	2	0.7419
Houdini Redux	2019-09-27	4	8	0	4	0.7419
Genius! NAZI-GIRL GoePPels-Chan ep3	2019-08-09	2	8	0	2	0.7419
SAWars	2019-11-01	3	8	0	3	0.7419
Guildmaster Story	2019-11-05	2	8	0	2	0.7419
Meu	2019-08-14	3	8	0	3	0.7419
Let's See What You Got	2019-11-20	8	8	0	8	0.7419
Affinity	2019-09-19	2	8	0	2	0.7419
TheMovingMaze	2019-08-24	3	8	0	3	0.7419
Depixtion: Halloween	2019-10-03	4	8	0	4	0.7419
Escape Zolstar	2019-10-09	2	8	0	2	0.7419
Wetpants	2019-08-23	4	8	0	4	0.7419
Column on the Sea	2019-09-27	3	8	0	3	0.7419
PuPaiPo Space Deluxe	2019-12-19	3	8	0	3	0.7419
Harakatsu 2 / はらかつ 2	2019-11-01	4	8	0	4	0.7419
NUVAVULT	2019-11-25	5	8	0	5	0.7419
魂之大陆 Soultia	2019-11-02	4	8	0	4	0.7419
Deathbound	2019-12-13	5	8	0	5	0.7419
Legend of the 9 Swords: Side Story	2019-11-28	2	8	0	2	0.7419
The Hong Kong Massacre	2019-01-22	263	683	195	458	0.7418000000000001
Taimanin Asagi 1: Trial／対魔忍アサギ・体験版	2019-12-10	41	109	25	66	0.7418000000000001
Krampus is Home	2019-03-22	28	145	35	63	0.7417
BUGDAS	2019-01-21	29	60	12	41	0.7417
Creepy Vision	2019-02-15	5	40	7	12	0.7415999999999999
Worldwide Sports Fishing	2019-05-06	12	40	7	19	0.7415999999999999
The Settlers : Rise of an Empire - History Edition	2019-01-22	140	358	97	237	0.7414000000000001
€100	2019-03-18	5	105	24	29	0.7414000000000001
Legion 51	2019-11-20	15	79	17	32	0.7414000000000001
Age of Defense	2019-05-27	21	431	119	140	0.7412000000000001
Project Zero Deaths	2019-06-12	154	421	116	270	0.7412000000000001
Spinnortality	2019-02-01	426	218	56	482	0.7411
Lulu & Ennoi - Sacred Suit Girls	2019-12-18	48	190	48	96	0.7409
Shortest Trip to Earth	2019-08-15	1786	1013	299	2085	0.7408
Cubico	2019-08-14	18	126	30	48	0.7404999999999999
The Cinema Rosa	2019-04-08	4	27	4	8	0.7403000000000001
World of relish	2019-12-16	4	27	4	8	0.7403000000000001
Ayni Fairyland	2019-01-22	3	18	2	5	0.74
My Heart Grows Fonder	2019-11-11	10	18	2	12	0.74
Sougetsu Ninja: Kikyou	2019-06-20	4	18	2	6	0.74
Alpha Lyrae Discovery	2019-08-08	3	18	2	5	0.74
Floaty Fighters	2019-12-06	6	18	2	8	0.74
Rescue Team: Evil Genius	2019-09-12	15	18	2	17	0.74
Viking Brothers 6	2019-09-25	12	18	2	14	0.74
The Christmas Spirit: Grimm Tales Collector's Edition	2019-12-13	12	18	2	14	0.74
Alice in Stardom	2019-04-05	14	100	23	37	0.7397
Hentai exotica	2019-07-12	5	59	12	17	0.7395999999999999
∀kashicforce	2019-03-29	10	31	5	15	0.7393000000000001
Fairy Knights	2019-02-01	7	31	5	12	0.7393000000000001
NIGHTSTAR: Alliance	2019-02-28	5	51	10	15	0.7390000000000001
Abode 2	2019-11-07	14	121	29	43	0.7389
YOOMURJAK'S RING	2019-05-21	6	35	6	12	0.7389
The Indie Game Legend 3D	2019-06-27	2	13	1	3	0.7389
Keepers Dungeon	2019-04-08	5	13	1	6	0.7389
Frigusİnferos	2019-03-14	1	13	1	2	0.7389
Drumpf 2: Lost, But Not Forgotten!	2019-07-15	5	13	1	6	0.7389
Horizon Shift '81	2019-06-11	2	13	1	3	0.7389
Random War	2019-06-01	3	13	1	4	0.7389
Witches' Legacy: The Charleston Curse Collector's Edition	2019-05-03	4	13	1	5	0.7389
Spirit Arena	2019-09-18	5	13	1	6	0.7389
World left Behind	2019-09-13	3	13	1	4	0.7389
救赎抉择Resurrection	2019-09-24	3	13	1	4	0.7389
Thy Kingdom Crumble	2019-09-26	3	13	1	4	0.7389
四季 The Four Seasons	2019-09-21	4	13	1	5	0.7389
OrbusVR	2019-04-23	337	922	274	611	0.7388
Downtown Drift	2019-05-23	22	103	24	46	0.7388
Romancing SaGa 3™	2019-11-11	1336	292	79	1415	0.7387
Double Cross	2019-01-10	11	92	21	32	0.7387
Bow to Blood: Last Captain Standing	2019-04-03	141	43	8	149	0.7387
Worse Than Death	2019-10-08	6	43	8	14	0.7387
Necro Mutex	2019-02-08	5	39	7	12	0.7387
Potata	2019-12-17	11	66	14	25	0.7384000000000001
Dark Devotion	2019-04-25	512	1581	486	998	0.7383
False Front	2019-05-30	947	321	88	1035	0.7383
CATGIRL LOVER	2019-06-28	316	712	209	525	0.7381000000000001
Self Shot	2019-06-01	9	62	13	22	0.738
Violet rE:-The Final reExistence-	2019-07-30	35	113	27	62	0.7379000000000001
Million Arthur: Arcana Blood	2019-06-20	85	203	53	138	0.7378
Game Of Puzzles: Furry	2019-06-08	4	95	22	26	0.7378
罪業狂襲FrenzyRetribution	2019-11-08	416	1091	330	746	0.7377
The 7th Guest: 25th Anniversary Edition	2019-04-02	34	134	33	67	0.7377
Sigma Theory	2019-11-21	315	962	289	604	0.7376
Freud Gate	2019-12-04	38	303	83	121	0.7376
PION	2019-01-18	5	22	3	8	0.7375
Eight Dragons	2019-11-13	5	22	3	8	0.7375
Murder Diaries: Ankara	2019-03-26	3	22	3	6	0.7375
Ikao The Lost Souls	2019-02-06	3	22	3	6	0.7375
JQ: cosmos	2019-04-18	3	22	3	6	0.7375
Gear	2019-05-10	5	22	3	8	0.7375
Detective Kobayashi	2019-10-24	5	22	3	8	0.7375
Cooking Trip: Back on the road	2019-07-17	8	22	3	11	0.7375
Shadow Legend VR	2019-03-07	85	391	110	195	0.7373000000000001
Islet Online	2019-02-12	145	368	103	248	0.7372
The Bard's Tale IV: Director's Cut	2019-08-27	292	804	240	532	0.7368000000000001
My Little Blacksmith Shop	2019-12-22	105	627	184	289	0.7368000000000001
Cathedral	2019-10-31	41	255	69	110	0.7367
Between the Stars	2019-05-28	429	1409	435	864	0.7366
Blink: Rogues	2019-12-16	4	26	4	8	0.7363
FRACTER	2019-09-05	6	26	4	10	0.7363
Mech Chip	2019-02-01	6	26	4	10	0.7363
Furry Shakespeare: Dashing Dinosaurs & Sexy Centaurs: Winter's Tale	2019-12-03	3	26	4	7	0.7363
Nosferatu Lilinor	2019-11-26	7	26	4	11	0.7363
AVARIAvs	2019-05-09	28	46	9	37	0.7362000000000001
SNK 40th Anniversary Collection	2019-06-07	74	160	41	115	0.7361
Swarm Simulator: Evolution	2019-02-25	440	365	103	543	0.736
Farmington County	2019-10-26	18	83	19	37	0.736
PUSSY 2	2019-03-22	7	170	44	51	0.7359
Super Tennis Blast	2019-05-24	8	61	13	21	0.7359
Ruthless Conquest	2019-11-27	19	61	13	32	0.7359
Hentai Block Breaker	2019-02-04	4	42	8	12	0.7359
The Perfectionist	2019-01-11	23	42	8	31	0.7359
One Synth	2019-02-16	13	42	8	21	0.7359
Commander Babes	2019-06-14	11	42	8	19	0.7359
Haunted Gas Station	2019-10-16	31	861	260	291	0.7356999999999999
Aisu Paradise	2019-05-24	8	38	7	15	0.7356999999999999
Alucinod	2019-08-30	5	30	5	10	0.7356999999999999
Knights of Tartarus	2019-04-19	8	30	5	13	0.7356999999999999
Court of Ashes	2019-10-10	136	30	5	141	0.7356999999999999
The Luminist	2019-07-26	3	30	5	8	0.7356999999999999
Super Lolicon Puzzle Simulator 2019	2019-11-04	4	34	6	10	0.7356
Jewel Match Solitaire 2 Collector's Edition	2019-04-18	12	34	6	18	0.7356
Keeper of the Sun and Moon	2019-08-08	32	34	6	38	0.7356
Sticky Paws	2019-11-01	5	34	6	11	0.7356
Rogue Reaper	2019-02-01	101	312	87	188	0.7354999999999999
Dungeon Of Dragon Knight	2019-07-10	59	233	63	122	0.7354
Ghost Files 2: Memory of a Crime	2019-11-14	23	111	27	50	0.7354
The Far Rings: A Space Opera Visual Novella	2019-10-06	9	57	12	21	0.7353000000000001
Franchise Hockey Manager 6	2019-10-11	285	259	71	356	0.7352
I will eat you	2019-12-06	45	226	61	106	0.7352
Castle Legend：Devil Awakening	2019-04-25	106	152	39	145	0.735
Incubo	2019-02-01	26	162	42	68	0.7349
Ring of Elysium	2019-06-24	63435	74576	25878	89313	0.7348
BLOCKADE 	2019-05-21	1149	7897	2629	3778	0.7348
Flotsam	2019-09-26	2075	1809	572	2647	0.7348
Door in the Woods	2019-12-04	75	182	48	123	0.7347
Once10	2019-01-24	12	64	14	26	0.7345
Santa Girls	2019-12-06	21	17	2	23	0.7345
CHOP	2019-09-13	6	17	2	8	0.7345
Breathe Peace World	2019-01-29	6	17	2	8	0.7345
Tokyo Snap	2019-08-01	3	17	2	5	0.7345
The Abbey - Director's cut	2019-03-07	5	17	2	7	0.7345
Mystery Solitaire The Black Raven	2019-05-06	8	17	2	10	0.7345
The Lost VR	2019-09-06	3	17	2	5	0.7345
Bandit the game	2019-08-28	4	17	2	6	0.7345
DeltaBlade 2700	2019-09-03	4	17	2	6	0.7345
Chill	2019-01-18	984	178	47	1031	0.7342000000000001
7'scarlet	2019-03-13	46	478	140	186	0.7340000000000001
Aliens Attack VR	2019-06-07	14	60	13	27	0.7338
Story of a Gladiator	2019-11-27	26	137	35	61	0.7337
Nyasha Valkyrie	2019-04-19	5	56	12	17	0.7331000000000001
Shark Attack Deathmatch 2	2019-07-26	91	1417	448	539	0.7329000000000001
The Death of Erin Myers	2019-04-26	11	109	27	38	0.7329000000000001
Hamsterdam	2019-08-01	19	95	23	42	0.7327
King's League II	2019-11-07	49	81	19	68	0.7327
Hentai Waifu II	2019-05-30	3	81	19	22	0.7327
Don't Look Down	2019-04-18	7	21	3	10	0.7327
Trivia Throwdown	2019-06-18	4	21	3	7	0.7327
TECHNOSPHERE RELOAD	2019-05-15	4	21	3	7	0.7327
Paul's World	2019-11-18	3	21	3	6	0.7327
Fight Angel Special Edition	2019-12-21	130	1101	344	474	0.7326
Volcano Tower	2019-02-16	5	7	0	5	0.7326
Escape Architect VR	2019-08-19	2	7	0	2	0.7326
Spinball	2019-10-02	3	7	0	3	0.7326
The Wizard's Tower	2019-01-17	2	7	0	2	0.7326
Epic Food Fight	2019-02-07	2	7	0	2	0.7326
Myths of the World: Black Rose Collector's Edition	2019-02-08	5	7	0	5	0.7326
Final_SIM	2019-03-22	2	7	0	2	0.7326
Fist Of Heaven & Hell	2019-06-28	2	7	0	2	0.7326
Space Rabbits in Space	2019-02-19	5	7	0	5	0.7326
Beekyr	2019-01-24	2	7	0	2	0.7326
Mage	2019-07-15	3	7	0	3	0.7326
Magic Combat VR	2019-02-22	10	7	0	10	0.7326
Creation and Conquest：The Future War	2019-06-10	4	7	0	4	0.7326
Push Pull	2019-03-08	3	7	0	3	0.7326
Spellcasting Collection	2019-03-18	2	7	0	2	0.7326
Dark Romance: Hunchback of Notre-Dame Collector's Edition	2019-03-09	4	7	0	4	0.7326
Gravitura	2019-05-17	4	7	0	4	0.7326
New Yankee 6: In Pharaoh's Court	2019-04-03	9	7	0	9	0.7326
The Nine Lives of Nim: Fortune's Fool	2019-05-31	3	7	0	3	0.7326
The Prophecy Lies!	2019-07-05	4	7	0	4	0.7326
Ancient knowledge	2019-09-20	2	7	0	2	0.7326
Space Dance	2019-07-10	2	7	0	2	0.7326
Super Hero League of Hoboken	2019-07-03	3	7	0	3	0.7326
Final Crash Demo	2019-08-04	3	7	0	3	0.7326
Highlight	2019-07-14	1	7	0	1	0.7326
Wizards of Brandel	2019-11-06	4	7	0	4	0.7326
Just Another Memory	2019-08-07	2	7	0	2	0.7326
Dark Tales: Edgar Allan Poe's Ligeia Collector's Edition	2019-07-26	5	7	0	5	0.7326
Rezist: Tower Defense	2019-09-26	2	7	0	2	0.7326
Gred	2019-11-11	8	7	0	8	0.7326
Grim Tales: Guest From The Future Collector's Edition	2019-08-30	5	7	0	5	0.7326
Annals of Rome	2019-09-19	3	7	0	3	0.7326
Timmy's adventures : VerbMon	2019-12-14	1	7	0	1	0.7326
Pumpkin Smasher VR	2019-10-24	3	7	0	3	0.7326
Crazy Shopping	2019-10-18	3	7	0	3	0.7326
Detective Solitaire. Butler Story	2019-10-15	5	7	0	5	0.7326
Myths of the World: The Heart of Desolation Collector's Edition	2019-10-05	5	7	0	5	0.7326
Dangerous Blaster	2019-11-29	3	7	0	3	0.7326
Santa's Holiday	2019-12-11	4	7	0	4	0.7326
Staden under Gamlestaden	2019-06-19	13	63	14	27	0.7325
Gerty	2019-12-19	29	37	7	36	0.7325
Lichtspeer: Double Speer Edition	2019-08-15	38	37	7	45	0.7325
The Walsingham Files - Chapter 1	2019-03-25	13	37	7	20	0.7325
Beats Warrior: Nian	2019-07-17	5	37	7	12	0.7325
Ded Inside	2019-07-25	2	37	7	9	0.7325
Deez	2019-01-02	3	52	11	14	0.7323999999999999
DUSTNET	2019-07-16	10	33	6	16	0.7321
Piczle Lines DX+α	2019-03-21	11	33	6	17	0.7321
Bax	2019-04-29	5	33	6	11	0.7321
Rebel Cops	2019-09-17	537	1015	317	854	0.7320000000000001
Nova-Life: Amboise	2019-04-23	267	469	139	406	0.7320000000000001
Freakout : Calamity TV Show	2019-06-25	3	25	4	7	0.7320000000000001
Only One Burn	2019-09-02	3	25	4	7	0.7320000000000001
Santa's Big Sack	2019-12-20	4	25	4	8	0.7320000000000001
 Sin Chess	2019-12-18	3	25	4	7	0.7320000000000001
Death Jump	2019-05-22	8	84	20	28	0.7319
Serpent Fusion	2019-09-27	9	29	5	14	0.7319
Project Hastur	2019-05-23	5	12	1	6	0.7319
MatchyGotchy Z	2019-03-04	4	12	1	5	0.7319
Privateers	2019-04-18	5	12	1	6	0.7319
Runa's School Story	2019-02-01	2	12	1	3	0.7319
Psycho Boys	2019-08-30	10	12	1	11	0.7319
Circle Rally Party	2019-04-10	4	12	1	5	0.7319
X-POINT	2019-02-26	5	12	1	6	0.7319
Hexa Path	2019-04-02	2	12	1	3	0.7319
Crunch	2019-06-15	3	12	1	4	0.7319
Rose Riddle 2: Werewolf Shadow	2019-12-19	4	12	1	5	0.7319
Wintercearig	2019-08-05	2	12	1	3	0.7319
Dark Elf's Adventure	2019-09-04	5	12	1	6	0.7319
Jigsaw Puzzle - Pro Edition	2019-09-02	5	12	1	6	0.7319
Football: The Hardest Job	2019-10-03	3	12	1	4	0.7319
Dark City: Vienna Collector's Edition	2019-09-13	6	12	1	7	0.7319
The Chronicles of Joseph of Egypt	2019-10-18	4	12	1	5	0.7319
Space Climber	2019-12-12	3	12	1	4	0.7319
Farmer's Dynasty	2019-11-21	1044	2547	832	1876	0.7318000000000001
Pathway	2019-04-11	1952	1477	471	2423	0.7318000000000001
Strategic Mind: The Pacific	2019-10-25	151	443	131	282	0.7316
Sparklite	2019-11-14	110	355	103	213	0.7316
BLOCKPOST	2019-04-25	2381	11686	4006	6387	0.7314
Phantom Rose	2019-08-08	403	588	178	581	0.7314
Legal Dungeon	2019-05-06	192	326	94	286	0.7314
Creature in the Well	2019-09-06	88	243	68	156	0.7314
Eternal Dread 2	2019-12-13	34	73	17	51	0.7311
Incoming Evil	2019-10-05	3	44	9	12	0.7308
Little Brother Jim	2019-09-06	3	44	9	12	0.7308
ToGather:Island	2019-12-04	15	44	9	24	0.7308
Croixleur Sigma - Deluxe Edition	2019-11-19	47	97	24	71	0.7306
Tower Hunter: Erza's Trial	2019-10-12	288	1200	382	670	0.7304
Skyland: Heart of the Mountain	2019-01-17	24	107	27	51	0.7303000000000001
心塞男孩 Sadboy	2019-01-23	7	100	25	32	0.73
The Padre	2019-04-18	7	40	8	15	0.73
Lighthouse of guiding flames	2019-08-28	4	40	8	12	0.73
Galactic Rangers VR	2019-11-05	23	51	11	34	0.7299
XP Girls	2019-11-22	333	140	37	370	0.7298
Tree.Bonsai	2019-11-14	14	120	31	45	0.7298
Rain of Reflections	2019-10-04	21	243	69	90	0.7293999999999999
Cubicity: Slide puzzle	2019-03-21	6	36	7	13	0.7293000000000001
Frontline: Western Front	2019-09-13	9	36	7	16	0.7293000000000001
Kawaii girls puzzle	2019-12-06	3	36	7	10	0.7293000000000001
War for the West	2019-11-14	49	47	10	59	0.7290000000000001
Steambirds Alliance	2019-08-22	1460	940	298	1758	0.7289
Unruly Heroes	2019-01-23	188	645	200	388	0.7287
Bloody Chronicles - New Cycle of Death	2019-08-01	24	82	20	44	0.7286
War Solution - Casual Math Game	2019-10-17	4	32	6	10	0.7286
Tale of Enki: Pilgrimage	2019-01-29	5	16	2	7	0.7286
Brief Battles	2019-05-07	5	16	2	7	0.7286
祭品的逆襲 The Counterattack OF Sacrifice	2019-04-21	2	16	2	4	0.7286
Overcome	2019-02-27	4	16	2	6	0.7286
Rainbow Hunter	2019-05-13	2	16	2	4	0.7286
Tricky Fox	2019-05-23	3	16	2	5	0.7286
Voxel Bot	2019-06-11	3	16	2	5	0.7286
Super Pig	2019-07-22	3	16	2	5	0.7286
DarkSpace	2019-08-23	5	16	2	7	0.7286
Atomorf2	2019-09-17	3	16	2	5	0.7286
Ages of Mages : The last keeper	2019-02-13	45	142	38	83	0.7284999999999999
Tactical Control	2019-03-21	14	54	12	26	0.7284
Weeping Willow	2019-10-04	6	54	12	18	0.7284
Stormhill Mystery: Family Shadows	2019-01-29	13	92	23	36	0.7283
CRAZY DRIVER	2019-08-25	14	112	29	43	0.7281000000000001
Lewd & Nude | Anime Collector	2019-11-16	21	102	26	47	0.7281000000000001
Contra Anniversary Collection	2019-06-11	48	597	185	233	0.728
Emberlight	2019-08-13	9	43	9	18	0.728
Lodestone - The crazy cave adventures of mad Stony Tony and his encounter with the exploding rolling stones	2019-10-30	5	28	5	10	0.7279000000000001
Tale's Casino Escape	2019-09-20	4	28	5	9	0.7279000000000001
Rise of Industry	2019-05-02	1388	2816	946	2334	0.7277
Kaz Ball	2019-06-07	29	20	3	32	0.7276
Zero Strain	2019-06-20	3	20	3	6	0.7276
Dune Sea	2019-10-10	3	20	3	6	0.7276
The Legend of Dark Witch Renovation	2019-11-14	5	20	3	8	0.7276
Sea King	2019-12-24	10	20	3	13	0.7276
PUSSY	2019-01-21	11	218	62	73	0.7275
Letzte Worte VR	2019-01-30	5	24	4	9	0.7275
Infinite Chili Sauce	2019-04-09	18	24	4	22	0.7275
Bucket Knight	2019-09-27	7	24	4	11	0.7275
Choco Pixel	2019-12-11	3	24	4	7	0.7275
Hentai Chicks	2019-07-01	7	271	79	86	0.7273000000000001
The White Laboratory	2019-03-29	143	246	71	214	0.7273000000000001
198X	2019-06-20	77	1374	449	526	0.7272
Hentai Demon	2019-06-15	9	57	13	22	0.7272
Easy Hentai	2019-12-16	3	39	8	11	0.7270000000000001
The Rising of the Shield Hero : Relive The Animation	2019-09-24	68	182	51	119	0.7267
The Dark Pictures Anthology: Man of Medan	2019-08-29	4518	6726	2336	6854	0.7266
Hold The Fort	2019-06-06	7	46	10	17	0.7263
Serment - Contract with a Devil	2019-02-01	68	60	14	82	0.7261
Battlerite Royale	2019-02-19	9441	5967	2074	11515	0.7259000000000001
In Passing	2019-10-24	24	107	28	52	0.7259000000000001
Riverbond	2019-06-09	15	77	19	34	0.7259000000000001
The Lighthouse	2019-10-31	6	35	7	13	0.7259000000000001
DON'T DIE!	2019-05-16	5	35	7	12	0.7259000000000001
Monsters' Den Chronicles	2019-08-08	13	35	7	20	0.7259000000000001
Lovecraft's Untold Stories	2019-01-31	123	610	192	315	0.7258
Castles of Burgundy	2019-02-28	37	133	36	73	0.7258
Gamecraft	2019-05-10	457	660	209	666	0.7256999999999999
Draugen	2019-05-29	240	1312	432	672	0.7256
JUMP FORCE	2019-02-14	9885	16486	5882	15767	0.7254
Achievement Simulator	2019-08-21	11	63	15	26	0.7251000000000001
Ellen and the Degenerates RPG	2019-02-07	7	42	9	16	0.7251000000000001
Yet Another Hero Story	2019-07-09	11	42	9	20	0.7251000000000001
DoomAI	2019-05-03	11	49	11	22	0.7248
Duncan and the Wisp	2019-06-10	49	31	6	55	0.7248
Supremacy 1914	2019-07-16	842	1775	596	1438	0.7247
Little Dungeon Stories	2019-12-06	12	83	21	33	0.7245999999999999
Outward	2019-03-26	11296	16636	5965	17261	0.7245
Shadow Fencer Theatre	2019-06-26	4	11	1	5	0.7242000000000001
Warships 3D	2019-01-28	3	11	1	4	0.7242000000000001
Furry Shakespeare: To Date Or Not To Date Cat Girls?	2019-04-26	2	11	1	3	0.7242000000000001
Theseus: Journey to Athens	2019-02-28	3	11	1	4	0.7242000000000001
MIDNIGHT Remastered	2019-05-08	2	11	1	3	0.7242000000000001
Franchise Wars	2019-04-15	2	11	1	3	0.7242000000000001
Zeus Begins	2019-08-15	2	11	1	3	0.7242000000000001
Wood 'n Stones	2019-11-27	5	11	1	6	0.7242000000000001
Endless Ski	2019-12-17	3	11	1	4	0.7242000000000001
The Secrets of Jesus	2019-11-07	4	11	1	5	0.7242000000000001
Voxel Scavenger	2019-12-19	2	11	1	3	0.7242000000000001
KuniTure	2019-11-19	40	11	1	41	0.7242000000000001
TAL: Wizard's Adventures	2019-12-11	3	11	1	4	0.7242000000000001
WarForwards	2019-08-02	8	38	8	16	0.7238
NOYO-!	2019-07-02	9	27	5	14	0.7238
Synthesis Universe -Episode 00-	2019-11-12	2	27	5	7	0.7238
Sniper Ghost Warrior Contracts	2019-11-22	3923	7436	2634	6557	0.7236
Signal Decay	2019-09-20	25	52	12	37	0.7236
Nyanco	2019-07-12	4	52	12	16	0.7236
To Battle!: Hell's Crusade	2019-07-25	10	45	10	20	0.7234999999999999
All Day Dying: Redux Edition	2019-12-05	4	45	10	14	0.7234999999999999
Outscape	2019-10-22	260	321	98	358	0.7229000000000001
Action Arcade Wrestling	2019-10-15	46	108	29	75	0.7229000000000001
Your Future Self	2019-03-08	5	72	18	23	0.7228
The Adventures of Jason and the Argonauts	2019-02-08	9	23	4	13	0.7228
Claude Monet - The Water Lily obsession	2019-06-19	13	23	4	17	0.7228
DEAD OR ALIVE 6	2019-03-01	2107	5854	2073	4180	0.7225
They Can't Stop All Of Us	2019-11-01	307	1243	416	723	0.7225
PLANES ATTACK	2019-05-06	19	284	86	105	0.7225
Die Young: Prologue	2019-06-15	135	281	85	220	0.7225
Nasty Rogue	2019-12-26	15	85	22	37	0.7225
Nelke & the Legendary Alchemists ~Ateliers of the New World~	2019-03-26	260	180	52	312	0.7223999999999999
PUZZLE: ANIMALS	2019-02-12	4	34	7	11	0.7223999999999999
Online Simulator	2019-06-13	4	34	7	11	0.7223999999999999
Hentai Shiri	2019-10-24	3	34	7	10	0.7223999999999999
Lovely Hentai	2019-11-21	4	34	7	11	0.7223999999999999
Bassline Sinker	2019-03-06	3	15	2	5	0.7222
Tsukumono / つくもの	2019-01-04	5	15	2	7	0.7222
Nine Hentai Babes	2019-01-15	3	15	2	5	0.7222
Santa in search of toys	2019-01-19	4	15	2	6	0.7222
Diorama Dungeoncrawl	2019-09-19	2	15	2	4	0.7222
The Grim and I	2019-08-08	7	15	2	9	0.7222
Rose Riddle: Fairy Tale Detective	2019-08-22	6	15	2	8	0.7222
Arkan: The dog adventurer	2019-10-03	3	15	2	5	0.7222
Beetle Hunter	2019-10-15	9	15	2	11	0.7222
Blink	2019-12-18	2	15	2	4	0.7222
The Puppet of Tersa	2019-03-28	12	19	3	15	0.7221
Pixel Noir	2019-06-07	6	19	3	9	0.7221
Bookend	2019-03-06	2	19	3	5	0.7221
Dodge Diego	2019-02-22	6	19	3	9	0.7221
Bunny Parking	2019-03-23	7	19	3	10	0.7221
Christmas Stories: Enchanted Express Collector's Edition	2019-12-06	17	19	3	20	0.7221
Your Island -KIMI NO SIMA-	2019-10-17	65	78	20	85	0.7217
Monsters of Kanji	2019-06-14	2	6	0	2	0.7217
Subcube	2019-10-18	2	6	0	2	0.7217
The Legend Of Vraz	2019-01-28	2	6	0	2	0.7217
Zombiotik	2019-05-10	7	6	0	7	0.7217
Slime Research	2019-01-02	4	6	0	4	0.7217
Cope Island: Adrift	2019-05-01	2	6	0	2	0.7217
Cotrio	2019-01-22	2	6	0	2	0.7217
Sea Birds: End of an Age	2019-01-01	2	6	0	2	0.7217
Meadow Fun!!	2019-01-07	2	6	0	2	0.7217
CoderBear	2019-06-10	3	6	0	3	0.7217
Gamepad Massage	2019-01-04	4	6	0	4	0.7217
Cube Defender	2019-01-06	2	6	0	2	0.7217
Cantrip Cafe	2019-02-14	4	6	0	4	0.7217
Retromancer	2019-06-06	3	6	0	3	0.7217
SZEN	2019-01-31	3	6	0	3	0.7217
Trikumax	2019-06-01	2	6	0	2	0.7217
Catalyst	2019-05-30	2	6	0	2	0.7217
答题英雄——细胞生物学	2019-02-23	2	6	0	2	0.7217
Dupli_City	2019-11-15	3	6	0	3	0.7217
DEEP HOLE	2019-02-28	2	6	0	2	0.7217
Solitaire Bliss Collection	2019-04-15	10	6	0	10	0.7217
LOGistICAL 2: USA - Nevada	2019-02-22	11	6	0	11	0.7217
Magic Gun	2019-05-21	3	6	0	3	0.7217
4DSnake	2019-04-04	3	6	0	3	0.7217
Bashed.os	2019-03-01	3	6	0	3	0.7217
Ladderhead	2019-12-13	2	6	0	2	0.7217
Even For Eternia	2019-04-08	6	6	0	6	0.7217
Die Bloody Nazi Die!	2019-09-26	4	6	0	4	0.7217
Ride with The Reaper	2019-05-08	2	6	0	2	0.7217
Churchgoers	2019-09-13	7	6	0	7	0.7217
Looking Back	2019-08-07	3	6	0	3	0.7217
失落的地下城 Lost Dungeon	2019-07-19	3	6	0	3	0.7217
Elpida: Crônicas de uma guerreira	2019-06-16	3	6	0	3	0.7217
Gabbuchi	2019-07-18	2	6	0	2	0.7217
ACardShooter	2019-08-16	4	6	0	4	0.7217
Hyper Bit Chasm	2019-06-03	3	6	0	3	0.7217
Unknown Castle	2019-08-19	3	6	0	3	0.7217
Mystery Solitaire: Grimm's tales 2	2019-09-24	6	6	0	6	0.7217
Uh Oh Bartender	2019-07-25	3	6	0	3	0.7217
Bulletorium	2019-08-13	1	6	0	1	0.7217
Gods of Havoc: Into the Void	2019-08-08	3	6	0	3	0.7217
Asdivine Kamura	2019-10-10	4	6	0	4	0.7217
Color Slayer	2019-08-12	2	6	0	2	0.7217
REFLASER	2019-08-30	3	6	0	3	0.7217
Mystery at Stonyford Bridge	2019-10-21	1	6	0	1	0.7217
tri.Attack();	2019-10-04	2	6	0	2	0.7217
Auto Factory	2019-10-02	2	6	0	2	0.7217
HyperStorm	2019-10-04	3	6	0	3	0.7217
Super Korotama	2019-12-18	2	6	0	2	0.7217
Shadows of time	2019-12-17	3	6	0	3	0.7217
Paper - A Game of Folding	2019-10-07	2	6	0	2	0.7217
Find The Treasure	2019-10-18	3	6	0	3	0.7217
Pine	2019-10-10	1630	1242	418	2048	0.7216
Ultimate Logic Puzzle Collection	2019-03-01	37	58	14	51	0.7216
Last Labyrinth	2019-11-12	58	68	17	75	0.7215
Spaceland	2019-09-30	126	279	85	211	0.7214
Arizona Derby	2019-07-22	15	468	149	164	0.7212000000000001
Magebuster: Amorous Augury	2019-01-28	4990	81	21	5011	0.7212000000000001
100$	2019-02-01	5	135	38	43	0.721
Fabulous - New York to LA	2019-10-01	17	30	6	23	0.7209000000000001
Mini Gal4Xy	2019-05-07	6	30	6	12	0.7209000000000001
Monster Girl Fantasy	2019-04-23	10	30	6	16	0.7209000000000001
DEEP SPACE ANOMALY	2019-06-24	5	84	22	27	0.7208
SHiRO 011	2019-03-25	23	61	15	38	0.7208
Titan Outpost	2019-08-09	8	61	15	23	0.7208
Touring Karts	2019-12-12	13	100	27	40	0.7206999999999999
Endless RPG	2019-12-04	10	37	8	18	0.7205
Freeman: Guerrilla Warfare	2019-10-05	2127	8290	3001	5128	0.7201000000000001
ANONYMOUS || AGONY - Serial Killer Prologue	2019-06-13	8	54	13	21	0.7201000000000001
Come on Baby!	2019-09-06	8	54	13	21	0.7201000000000001
奇幻与砍杀 Fantasy & Blade	2019-06-06	162	171	50	212	0.7199
Tools Up!	2019-12-03	259	665	219	478	0.7195
Ottoman Empire: Spectacular Millennium	2019-01-28	2	26	5	7	0.7194
MarineVerse Cup	2019-08-21	6	26	5	11	0.7194
Magic Farm 2: Fairy Lands (Premium Edition)	2019-04-08	7	26	5	12	0.7194
Power Brain Trainer	2019-08-20	7	26	5	12	0.7194
Toy Robot	2019-11-26	5	26	5	10	0.7194
Break the Game	2019-07-15	165	460	148	313	0.7193
Racing Classics: Drag Race Simulator	2019-05-20	62	413	132	194	0.7191
ШХД: ЗИМА / IT'S WINTER	2019-03-07	87	534	174	261	0.7190000000000001
Magic Realm: Online	2019-11-22	10	40	9	19	0.7189
Myha: Return to the Lost Island	2019-04-14	10	40	9	19	0.7189
汉末求生	2019-03-28	27	40	9	36	0.7189
Hentai Girls	2019-06-07	6	40	9	15	0.7189
Blautopf VR - Geheimnis der Lau	2019-06-05	10	40	9	19	0.7189
Onset	2019-12-13	526	562	184	710	0.7188
Fated Kingdom	2019-11-04	44	233	71	115	0.7188
Trainz Railroad Simulator 2019	2019-01-08	623	1336	459	1082	0.7187
Oculto	2019-03-08	4	33	7	11	0.7187
Let's Learn Japanese! Vocabulary	2019-12-24	5	33	7	12	0.7187
Mahjong Strip Solitaire: Harem Guild	2019-01-25	9	50	12	21	0.7184
Sniper Elite V2 Remastered	2019-05-13	575	1686	587	1162	0.7182
Subdivision Infinity	2019-08-07	15	76	20	35	0.7181000000000001
Radio Commander	2019-10-10	660	1136	389	1049	0.718
Beautiful Bricks	2019-11-06	4	22	4	8	0.7178
Hold Your Ground	2019-11-13	5	22	4	9	0.7178
Speedway Challenge 2019	2019-08-09	13	22	4	17	0.7178
幸存者	2019-09-30	9	22	4	13	0.7178
Home Sweet Home EP2	2019-09-25	775	672	224	999	0.7177
RAD	2019-08-19	580	638	212	792	0.7177
Nightwolf: Survive the Megadome	2019-06-11	9	53	13	22	0.7176
Our World Is Ended.	2019-05-29	20	53	13	33	0.7176
Don't Die, Minerva!	2019-12-05	10	53	13	23	0.7176
Legend of GBC Tycoon	2019-03-15	9	43	10	19	0.7176
Drill Down	2019-10-14	16	43	10	26	0.7176
Takelings House Party	2019-07-25	31	228	70	101	0.7173999999999999
Hentai Cosplay Elf	2019-09-27	4	66	17	21	0.7173999999999999
Reign of Darkness	2019-11-20	100	216	66	166	0.7173
Ymir	2019-03-16	564	743	250	814	0.7172
Dungeons of Betrayal	2019-06-21	1008	36	8	1016	0.7170000000000001
Queen's Quest 5: Symphony of Death	2019-07-18	42	88	24	66	0.7169
Catch a Duck	2019-08-30	6	56	14	20	0.7169
Voidrun	2019-06-05	8	29	6	14	0.7169
Rumia in the darkness	2019-08-01	6	29	6	12	0.7169
Dark Zone Defense	2019-10-30	4	29	6	10	0.7169
Bewitched	2019-10-31	6	29	6	12	0.7169
American Fugitive	2019-05-21	920	1733	609	1529	0.7168000000000001
SE VR World Demo	2019-09-08	6	46	11	17	0.7166
SCP022	2019-02-02	25	557	185	210	0.7164
ZAMB! Endless Extermination	2019-01-16	6	18	3	9	0.7162999999999999
Coffee VendoR	2019-01-30	9	18	3	12	0.7162999999999999
Soft cookie	2019-02-20	5	18	3	8	0.7162999999999999
Chipmonk!	2019-11-21	3	18	3	6	0.7162999999999999
Romans from Mars (Free-to-Play)	2019-03-19	36	18	3	39	0.7162999999999999
Mage Mania	2019-12-13	10	18	3	13	0.7162999999999999
Sound Slide	2019-01-24	92	385	125	217	0.7159000000000001
7th Sector	2019-03-05	68	447	147	215	0.7156
Archeo: Shinar	2019-09-11	30	81	22	52	0.7156
Olimdal	2019-10-25	3	10	1	4	0.7155
Pixel Fish	2019-01-08	3	10	1	4	0.7155
Zombie Scrapper	2019-04-05	3	10	1	4	0.7155
Rhythm Overdrive	2019-02-25	2	10	1	3	0.7155
The Revenge of Johnny Bonasera: Episode 3	2019-02-04	4	10	1	5	0.7155
Leowald	2019-08-09	8	10	1	9	0.7155
Eldritch Academy	2019-03-22	4	10	1	5	0.7155
Hotdog Man	2019-03-20	2	10	1	3	0.7155
Tropia	2019-04-17	2	10	1	3	0.7155
New Yankee 7: Deer Hunters	2019-04-17	8	10	1	9	0.7155
Hexelectric	2019-06-25	4	10	1	5	0.7155
Fairytale Solitaire: Red Riding Hood	2019-07-01	7	10	1	8	0.7155
Polyrun	2019-08-01	3	10	1	4	0.7155
The Cube	2019-07-10	3	10	1	4	0.7155
Snares of Ruin 2	2019-07-26	4	10	1	5	0.7155
Pictures of Life	2019-07-29	3	10	1	4	0.7155
Symmetry	2019-10-03	4	10	1	5	0.7155
Mousegun	2019-09-20	2	10	1	3	0.7155
URO2	2019-10-28	3	10	1	4	0.7155
TAPSONIC BOLD	2019-03-26	128	868	298	426	0.7153
Gravity Vector	2019-06-28	77	14	2	79	0.7152
The Spook Inspectors	2019-01-26	3	14	2	5	0.7152
Tactic Code	2019-03-05	3	14	2	5	0.7152
mini PVP	2019-05-16	4	14	2	6	0.7152
Ethanol in dungeon	2019-06-22	4	14	2	6	0.7152
Gourmet Warriors	2019-07-03	3	14	2	5	0.7152
Ironsight	2019-06-20	4669	14375	5411	10080	0.715
Armored Evolution	2019-02-01	191	52	13	204	0.715
The Savior's Gang	2019-03-02	8	32	7	15	0.7149
ZIC - Zombies in City	2019-05-23	6	32	7	13	0.7149
GlassSmash	2019-04-16	5	32	7	12	0.7149
The Red Prison	2019-05-20	99	32	7	106	0.7149
The Lord of the Rings: Adventure Card Game - Definitive Edition	2019-08-29	619	1072	373	992	0.7148000000000001
Tech Support: Error Unknown	2019-02-27	211	391	128	339	0.7148000000000001
Abberbury	2019-04-18	3	25	5	8	0.7148000000000001
Glyph VR	2019-12-02	10	42	10	20	0.7145999999999999
卡片地下城Card Monsters: Dungeon	2019-07-17	398	299	96	494	0.7145
WWTSTB: Teacher	2019-03-19	12	105	30	42	0.7145
Put in	2019-10-03	52	105	30	82	0.7145
Drawngeon: Dungeons of Ink and Paper	2019-05-25	15	55	14	29	0.7144
GRAY	2019-03-11	96	347	113	209	0.7142000000000001
Din's Legacy	2019-08-28	118	129	38	156	0.7142000000000001
Galaxy Squad	2019-07-15	118	301	97	215	0.7140000000000001
Driftland: The Magic Revival	2019-04-18	456	1217	430	886	0.7132
Vampire: The Masquerade - Coteries of New York	2019-12-11	836	1736	623	1459	0.7131000000000001
Railroad Corporation	2019-11-18	306	852	296	602	0.7131000000000001
GOD WARS The Complete Legend	2019-06-13	90	140	42	132	0.7131000000000001
Poor Stickman	2019-02-26	7	48	12	19	0.713
THE LAST PLAYER	2019-08-07	52	198	62	114	0.7126
Groundhog Day: Like Father Like Son	2019-09-17	11	70	19	30	0.7126
Exorcise The Demons	2019-09-18	8	21	4	12	0.7125
Deathly Storm: The Edge of Life	2019-02-27	2	21	4	6	0.7125
The Curious Study of Dr. Blackwood - A VR Tech Demo	2019-04-26	7	21	4	11	0.7125
干支セトラ　陰ノ巻	2019-01-25	6	21	4	10	0.7125
sCATter	2019-02-07	6	21	4	10	0.7125
Eleven Islands	2019-02-25	5	21	4	9	0.7125
The Stillness of the Wind	2019-02-07	99	865	302	401	0.7123999999999999
Sweet Dream Succubus - Nightmare Edition	2019-09-07	28	241	77	105	0.7123999999999999
VirtualCast	2019-07-29	358	73	20	378	0.7123999999999999
Curious Cases	2019-04-04	52	252	81	133	0.7121
Stranded Sails - Explorers of the Cursed Islands	2019-10-17	671	555	190	861	0.7115
四圣传说之黑暗森林	2019-05-03	3	31	7	10	0.711
Fruit Postal Service	2019-06-28	93	1037	369	462	0.7108
Geeksos	2019-04-16	10	44	11	21	0.7107
Marble Combat	2019-02-20	63	120	36	99	0.7105
PixARK	2019-05-31	14144	7729	2944	17088	0.7104
The Spy Who Shrunk Me	2019-06-14	12	78	22	34	0.7101999999999999
Minions Battle	2019-05-17	13	78	22	35	0.7101999999999999
Action: Source	2019-09-12	11	90	26	37	0.7101000000000001
Internet Cafe Simulator	2019-10-25	1058	6268	2382	3440	0.71
Defend The Keep	2019-07-15	7	17	3	10	0.71
Pon Para and the Great Southern Labyrinth	2019-05-09	26	17	3	29	0.71
Exile Squadron	2019-11-11	5	17	3	8	0.71
Vortex Attack EX	2019-10-24	4	17	3	7	0.71
BRITANNIA VR: OUT OF YOUR MIND	2019-11-07	8	17	3	11	0.71
Knife Sisters	2019-04-24	5	24	5	10	0.7099
Doughlings: Invasion	2019-08-01	4	24	5	9	0.7099
Seven Bullets Zombie Apocalypse	2019-04-18	3	24	5	8	0.7099
True Love '95	2019-12-20	4	24	5	9	0.7099
Dark Parables: Portrait of the Stained Princess Collector's Edition	2019-09-20	9	24	5	14	0.7099
The Land of Crows	2019-12-23	4	24	5	9	0.7099
Hentai Pussy	2019-03-25	7	166	52	59	0.7098000000000001
The Isle of the Dead	2019-06-19	15	34	8	23	0.7098000000000001
Pixel Puzzles Traditional Jigsaws	2019-11-18	105	262	86	191	0.7095
GSpot Master｜穴王拳	2019-10-23	23	151	47	70	0.7093
Beware of Trains	2019-01-22	10	53	14	24	0.7093
The Window Box	2019-02-19	8	53	14	22	0.7093
Pax Romana: Romulus	2019-05-29	32	56	15	47	0.7090000000000001
OMON Simulator	2019-10-18	1076	1947	719	1795	0.7089
God's Trigger	2019-04-18	178	609	213	391	0.7089
東方翠神廻廊 〜 Faith in the Goddess of Suwa.	2019-02-11	51	139	43	94	0.7088
Hotel Tutwin	2019-04-15	7	37	9	16	0.7088
Escape from Chernobyl	2019-07-05	5	37	9	14	0.7088
The Ballad Singer	2019-02-15	30	65	18	48	0.7084999999999999
PlataGO!	2019-06-13	19	86	25	44	0.7084
Hentai beautiful girls	2019-01-23	8	68	19	27	0.7084
Toby's Island	2019-11-30	4	5	0	4	0.7084
Fantasy Fairways	2019-08-08	3	5	0	3	0.7084
Carsteroids	2019-08-23	1	5	0	1	0.7084
Ascending Madness	2019-08-30	3	5	0	3	0.7084
Chaotic Void	2019-11-18	9	5	0	9	0.7084
RogueVerse	2019-08-23	4	5	0	4	0.7084
Where's Baby	2019-04-02	3	5	0	3	0.7084
The planet's rescuer	2019-01-01	5	5	0	5	0.7084
Taptiles	2019-01-24	6	5	0	6	0.7084
Bala na manga	2019-02-22	2	5	0	2	0.7084
Root Beer On Tap	2019-10-29	3	5	0	3	0.7084
GeminiArms	2019-04-05	3	5	0	3	0.7084
Riddles of the Owls' Kingdom. Magic Wings	2019-01-04	6	5	0	6	0.7084
tia.sav	2019-08-08	2	5	0	2	0.7084
Chucky	2019-01-19	3	5	0	3	0.7084
Maze 3D	2019-01-08	1	5	0	1	0.7084
Mr Boom's Firework Factory	2019-07-10	2	5	0	2	0.7084
Asdivine Dios	2019-06-05	5	5	0	5	0.7084
Hooklings	2019-09-25	2	5	0	2	0.7084
VKT Prime System Crash	2019-02-06	2	5	0	2	0.7084
Joe Jump	2019-04-25	3	5	0	3	0.7084
Neon Infinity	2019-02-13	3	5	0	3	0.7084
Malevolence	2019-02-19	2	5	0	2	0.7084
Mostly Scared of Spiders	2019-05-30	2	5	0	2	0.7084
Alice's Jigsaw. Wonderland Chronicles 2	2019-05-22	3	5	0	3	0.7084
Lifeless Vanguard	2019-04-04	2	5	0	2	0.7084
SleepWalker	2019-05-30	2	5	0	2	0.7084
The Long Sky	2019-03-20	2	5	0	2	0.7084
Flavortown:VR	2019-05-17	3	5	0	3	0.7084
Moonstone Crossroads	2019-04-05	3	5	0	3	0.7084
Prismatic Maze	2019-03-29	2	5	0	2	0.7084
Infinity	2019-05-01	3	5	0	3	0.7084
Beatcrash	2019-05-07	1	5	0	1	0.7084
Flux	2019-05-24	2	5	0	2	0.7084
Yet Another Level	2019-07-14	3	5	0	3	0.7084
The Hunter's Journals - Pale Harbour	2019-06-24	1	5	0	1	0.7084
Real Man Got 100	2019-06-26	2	5	0	2	0.7084
Lost In Sweets	2019-11-01	4	5	0	4	0.7084
YUT YUT	2019-07-04	3	5	0	3	0.7084
青岚血枫	2019-07-25	3	5	0	3	0.7084
Escape Game Cake	2019-09-13	2	5	0	2	0.7084
RailRoadVR	2019-07-19	2	5	0	2	0.7084
Greetings From Krampus!	2019-12-16	2	5	0	2	0.7084
Erstwhile Tower	2019-08-14	2	5	0	2	0.7084
ClearIt5	2019-08-22	4	5	0	4	0.7084
Phantom 3D	2019-08-26	2	5	0	2	0.7084
Keeper 2119	2019-10-07	2	5	0	2	0.7084
Graviton	2019-09-16	5	5	0	5	0.7084
The Rainbow World	2019-12-19	3	5	0	3	0.7084
Advisors at the End of the Universe	2019-10-25	3	5	0	3	0.7084
Breeza Budgie Bill	2019-09-23	5	5	0	5	0.7084
Give Up The Dupe	2019-12-17	2	5	0	2	0.7084
Darkour	2019-11-11	2	5	0	2	0.7084
The Loopholes Chronicles	2019-10-25	3	5	0	3	0.7084
Detective Solitaire Inspector Magic	2019-11-25	7	5	0	7	0.7084
Adventureland XL	2019-12-02	4	5	0	4	0.7084
Color Soul: Memories	2019-11-16	2	5	0	2	0.7084
Useless Box: The Game	2019-11-06	1	5	0	1	0.7084
Shape Cascade	2019-12-05	5	5	0	5	0.7084
Get Me Outta Here - Deluxe/Remastered Edition	2019-11-30	2	5	0	2	0.7084
Star Gods	2019-11-12	2	5	0	2	0.7084
King rocket	2019-11-27	1	5	0	1	0.7084
Dragon Stone - Legendary Archer	2019-11-29	2	5	0	2	0.7084
Foe Frenzy	2019-12-13	2	5	0	2	0.7084
Renegade Grounds: Episode 2	2019-12-31	2	5	0	2	0.7084
Winter Fury: The Longest Road	2019-12-18	4	27	6	10	0.7081000000000001
Fidelity	2019-04-09	2	27	6	8	0.7081000000000001
The Sphere of Abyss	2019-11-25	32	27	6	38	0.7081000000000001
Race Race Racer	2019-12-03	52	27	6	58	0.7081000000000001
TrenchesWIP	2019-08-17	57	1012	366	423	0.7078
Gothic Playable Teaser	2019-12-13	3888	10152	3945	7833	0.7077
Mad Machines	2019-11-15	273	158	50	323	0.7076000000000001
JetX	2019-04-11	16	43	11	27	0.7076000000000001
Jim is Moving Out!	2019-07-19	5	13	2	7	0.7075
Last Rose	2019-08-30	3	13	2	5	0.7075
RpgEra	2019-03-11	4	13	2	6	0.7075
Desolate City: The Bloody Dawn Enhanced Edition	2019-01-29	2	13	2	4	0.7075
RowRow	2019-01-31	5	13	2	7	0.7075
Trap for Winners	2019-03-28	3	13	2	5	0.7075
The Color of the Roses	2019-03-27	3	13	2	5	0.7075
CrunchTime	2019-10-10	3	13	2	5	0.7075
Giant Life	2019-06-07	6	13	2	8	0.7075
Puzzle: Fire Sticks	2019-10-11	9	13	2	11	0.7075
8 Eyes	2019-08-14	2	13	2	4	0.7075
ID-EGO	2019-11-24	3	13	2	5	0.7075
Visitor2 / 来访者二	2019-07-31	156	132	41	197	0.7073999999999999
Cute Cute Cuties	2019-08-09	5	106	32	37	0.7073999999999999
Animus - Stand Alone	2019-07-24	8	46	12	20	0.7072
Brewer	2019-08-15	110	46	12	122	0.7072
Twists of My Life	2019-10-08	1017	349	119	1136	0.7071
Balancelot	2019-05-23	25	94	28	53	0.7070000000000001
Project Torque	2019-12-20	327	1206	442	769	0.7069
Drunken Fist	2019-08-26	5	49	13	18	0.7069
Heroes of Myth	2019-07-25	53	49	13	66	0.7069
Team Sonic Racing™	2019-05-21	1056	2095	785	1841	0.7068000000000001
奇幻与砍杀 Fantasy & Blade Ⅱ	2019-10-08	24	91	27	51	0.7068000000000001
The Forbidden Arts	2019-08-07	6	30	7	13	0.7068000000000001
PAGAN: Autogeny	2019-10-31	3	30	7	10	0.7068000000000001
Harvester of Dreams : Episode 1	2019-01-28	4	20	4	8	0.7068000000000001
Ellen	2019-02-15	4	20	4	8	0.7068000000000001
Saint Hazel's Horsepital	2019-05-06	5	20	4	9	0.7068000000000001
Kra-Ken	2019-07-29	4	20	4	8	0.7068000000000001
The Angel Inn	2019-10-24	5	20	4	9	0.7068000000000001
Silk	2019-10-11	7	20	4	11	0.7068000000000001
TsukaiFurushitaKotobaYaUtaWoMV	2019-10-20	3	20	4	7	0.7068000000000001
单词训练营 | Word Training Camp	2019-11-08	3	20	4	7	0.7068000000000001
Alchemist's Awakening	2019-06-03	40	359	123	163	0.7067
One day 一天	2019-11-02	28	52	14	42	0.7067
D3D INSIDE	2019-11-06	5	52	14	19	0.7067
Crystal Crisis	2019-07-31	48	82	24	72	0.7066
魅魔新妻 Succubus Waifu	2019-11-27	33	185	60	93	0.7065
Naughty Girl 2	2019-09-05	3	55	15	18	0.7065
Cup Of Ethanol	2019-08-30	8	61	17	25	0.7064
Hentai Waifu	2019-11-25	5	61	17	22	0.7064
Mountain Taxi Driver	2019-09-13	6	193	63	69	0.7061000000000001
Juice Girl	2019-04-12	85	108	33	118	0.7061000000000001
Toys of War	2019-02-28	4	9	1	5	0.7057
KOMMERSANT	2019-04-25	3	9	1	4	0.7057
Broken Metal	2019-12-08	2	9	1	3	0.7057
Kronorite	2019-09-21	5	9	1	6	0.7057
Ectolibrium	2019-01-31	3	9	1	4	0.7057
CONTINGENCY	2019-08-26	3	9	1	4	0.7057
WarpThrough	2019-12-10	7	9	1	8	0.7057
Houdini's Castle	2019-02-19	6	9	1	7	0.7057
Fragile Equilibrium	2019-01-05	5	9	1	6	0.7057
F8S	2019-02-05	8	9	1	9	0.7057
Воин Хинора	2019-03-11	4	9	1	5	0.7057
I'm Hungry	2019-11-01	4	9	1	5	0.7057
涅槃之路	2019-04-04	4	9	1	5	0.7057
The Cat and the Box	2019-04-20	4	9	1	5	0.7057
LOTUS Minigames: Berlin Traffic	2019-07-07	12	9	1	13	0.7057
VTB Basketball League	2019-04-12	9	9	1	10	0.7057
Azurael's Circle: Chapter 4	2019-04-22	3	9	1	4	0.7057
DanCop - Daniela on Duty	2019-05-15	2	9	1	3	0.7057
MPaliens	2019-07-27	4	9	1	5	0.7057
Crisis of the Middle Ages	2019-05-29	3	9	1	4	0.7057
WarpZone vs THE DIMENSION	2019-12-16	4	9	1	5	0.7057
Shadowland	2019-07-03	5	9	1	6	0.7057
JoustMania	2019-06-11	11	9	1	12	0.7057
Fares	2019-08-30	3	9	1	4	0.7057
Bunny Reversi	2019-06-21	4	9	1	5	0.7057
Cursed Roots	2019-10-25	3	9	1	4	0.7057
Shinobi Spirits S Legend of Heroes/忍スピリッツS 真田獣勇士伝	2019-08-15	5	9	1	6	0.7057
Nation Breakers: Steam Arena	2019-11-17	4	9	1	5	0.7057
Escape from Chernobyl: Jailbreak	2019-08-30	2	9	1	3	0.7057
O Rei	2019-08-25	3	9	1	4	0.7057
Psy High 2: High Summer	2019-08-15	23	9	1	24	0.7057
Corpoct	2019-09-20	3	9	1	4	0.7057
Alien Monopoly	2019-09-11	7	9	1	8	0.7057
Color +	2019-08-31	2	9	1	3	0.7057
Rainbow Pixel	2019-10-01	4	9	1	5	0.7057
Mystery Solitaire The Arkham Spirits	2019-12-09	5	9	1	6	0.7057
Kedemara - The Orphan's Ballad	2019-10-30	4	9	1	5	0.7057
Grudge TV	2019-11-23	3	9	1	4	0.7057
Classic Snake Adventures	2019-12-07	2	9	1	3	0.7057
Bronze Hoof	2019-12-11	5	9	1	6	0.7057
Particulate	2019-12-16	2	9	1	3	0.7057
The Walsingham Files - Chapter 2	2019-12-13	2	9	1	3	0.7057
Black Future '88	2019-11-21	120	464	163	283	0.7055
Abandon Ship	2019-10-22	734	831	302	1036	0.7054
Total War: THREE KINGDOMS	2019-05-23	192298	67467	27298	219596	0.7051999999999999
Indivisible	2019-10-08	2883	2174	823	3706	0.7051000000000001
Crossroads: Roguelike RPG Dungeon Crawler	2019-03-20	55	39	10	65	0.7048000000000001
Samurai of Hyuga Book 4	2019-08-29	61	39	10	71	0.7048000000000001
Falnarion Tactics	2019-01-07	4	23	5	9	0.7048000000000001
Toddler Shooter	2019-01-03	4	23	5	9	0.7048000000000001
Night Catcher	2019-03-22	4	23	5	9	0.7048000000000001
GraFi	2019-04-26	3	23	5	8	0.7048000000000001
Corpse Party 2: Dead Patient	2019-10-23	72	227	76	148	0.7046
Super Naughty Maid	2019-05-31	22	194	64	86	0.7046
PBA Pro Bowling	2019-10-23	92	121	38	130	0.7044
EarthNight	2019-12-03	10	72	21	31	0.7044
Nya Nya Nya Girls 2 (ʻʻʻ)_(=^･ω･^=)_(ʻʻʻ)	2019-01-12	5	42	11	16	0.7044
Budo Girl War - Maid	2019-07-29	5	42	11	16	0.7044
Xecryst Remains	2019-02-21	23	69	20	43	0.7042
Dead End Job	2019-12-13	23	66	19	42	0.7041
HAMMY	2019-12-18	217	66	19	236	0.7041
Don't Kill the Cow	2019-11-08	11	63	18	29	0.7041
Blocks!: Richard III	2019-10-09	20	60	17	37	0.7040000000000001
Revulsion	2019-02-19	11	57	16	27	0.7040000000000001
Swing Dunk (Beta)	2019-12-23	58	51	14	72	0.7040000000000001
Wounded - The Beginning	2019-02-28	18	157	51	69	0.7038
Aftercharge	2019-01-10	1156	168	55	1211	0.7037000000000001
Wayward Souls	2019-08-28	64	143	46	110	0.7037000000000001
Dead Frontier 2	2019-07-15	10101	15541	6220	16321	0.7036
STAND OUT	2019-05-17	147	1016	377	524	0.7034
3000th Duel	2019-12-13	40	392	138	178	0.7034
Angel Light The Elven Truce	2019-07-26	4	26	6	10	0.7034
Hotlap Heroes	2019-04-11	6	16	3	9	0.7033
Desert Kill	2019-04-17	4	16	3	7	0.7033
Dream Enders	2019-02-08	11	16	3	14	0.7033
3 GEEKS	2019-02-22	4	16	3	7	0.7033
Spy Tactics	2019-07-12	6	16	3	9	0.7033
Pixel Art Hentai Trap Hot Spring	2019-10-09	4	16	3	7	0.7033
Suzunaan on Fire	2019-12-31	12	16	3	15	0.7033
Night Call	2019-07-17	125	391	138	263	0.7029000000000001
Exteme Racing on Highway	2019-03-06	11	77	23	34	0.7027
There The Light	2019-05-31	7	77	23	30	0.7027
The Myth Seekers 2: The Sunken City	2019-06-13	21	77	23	44	0.7027
Hard Love - Darkest Desire	2019-10-31	22	97	30	52	0.7026000000000001
Beekeeper	2019-08-15	4	29	7	11	0.7025
STURMWIND EX	2019-09-30	6	29	7	13	0.7025
CATGIRL LOVER 2	2019-10-16	401	302	105	506	0.7023999999999999
Mi Mi Mi	2019-06-20	6	91	28	34	0.7021
Kamimachi Site - Dating story	2019-06-03	21	122	39	60	0.7020000000000001
DemonsTier	2019-02-08	9	32	8	17	0.7019
Voidship: The Long Journey	2019-02-08	53	105	33	86	0.7018000000000001
Watchers	2019-10-22	412	430	154	566	0.7016
Summer Islands	2019-06-21	13	59	17	30	0.7016
Mr. Maze	2019-02-09	7	35	9	16	0.7015000000000001
Abyss Manager	2019-11-03	81	56	16	97	0.7014
ANDROMALIUS	2019-05-09	7	56	16	23	0.7014
Kare wa Kanojo	2019-03-27	6	47	13	19	0.7011000000000001
7776 II: Dwarven Greed	2019-09-18	5	44	12	17	0.7011000000000001
百花三国志(Banner of the THREE KINGDOMS)	2019-08-23	20	44	12	32	0.7011000000000001
The Qaedon Wars - The Story Begins	2019-09-12	6	19	4	10	0.7008
Classic Jigsaw Puzzles	2019-01-17	10	19	4	14	0.7008
Last Neighbor	2019-11-13	6	107	34	40	0.7006
CHERNOBYL: The Untold Story	2019-09-24	341	216	74	415	0.7005
Moe! Ninja Girls	2019-02-27	40	213	73	113	0.7001999999999999
The Caligula Effect: Overdose	2019-03-12	164	353	126	290	0.7000000000000001
吞食孔明传 Tunshi Kongming Legends	2019-04-02	941	732	273	1214	0.6999
The Exorcist: Legion VR (Deluxe Edition)	2019-10-10	27	112	36	63	0.6998000000000001
Hovership Havoc	2019-04-12	5	22	5	10	0.6994
The Far Kingdoms: Awakening Solitaire	2019-03-11	5	22	5	10	0.6994
Epitasis	2019-05-01	34	106	34	68	0.6992
Forever Lost: Episode 1	2019-03-04	5	12	2	7	0.6990999999999999
Battle Bolts	2019-05-23	16	12	2	18	0.6990999999999999
Annwn: The Otherworld	2019-04-15	3	12	2	5	0.6990999999999999
Invisible Fist	2019-05-06	7	12	2	9	0.6990999999999999
Flan	2019-04-29	4	12	2	6	0.6990999999999999
Super Ninja Meow Cat	2019-02-21	4	12	2	6	0.6990999999999999
Space Captain McCallery - Episode 2: Pilgrims in Purple Moss	2019-03-14	2	12	2	4	0.6990999999999999
Pull Ball	2019-01-19	11	12	2	13	0.6990999999999999
Alchemic DungeonsDX	2019-02-14	9	12	2	11	0.6990999999999999
Mistero a Villa MilaFlora	2019-03-04	7	12	2	9	0.6990999999999999
Zone 10	2019-07-22	136	12	2	138	0.6990999999999999
PonGlow	2019-06-10	2	12	2	4	0.6990999999999999
IS<Infinite Stratos> Versus Colors	2019-08-06	7	12	2	9	0.6990999999999999
Heaven's Grave	2019-08-21	6	12	2	8	0.6990999999999999
Cube Attack	2019-10-04	17	12	2	19	0.6990999999999999
Nijowari: Where Angels Fall	2019-11-15	2	12	2	4	0.6990999999999999
1001 Jigsaw Castles And Palaces	2019-11-11	4	12	2	6	0.6990999999999999
Queeny Army	2019-11-04	3	12	2	5	0.6990999999999999
Layers of Fear 2	2019-05-28	739	1591	617	1356	0.6988
DOZA 2 - NOVOGODNIY PEREDOZ	2019-04-06	5	55	16	21	0.6988
Overland	2019-09-19	202	332	119	321	0.6987000000000001
Day of Dragons	2019-12-04	2490	3377	1343	3833	0.6986
Shop Manager : Video Game Tycoon	2019-03-27	17	52	15	32	0.6986
Secret Saga: Xamadeon Stone	2019-02-28	8	52	15	23	0.6986
Mandy's Room 2: Naughty By Nature	2019-08-02	17	52	15	32	0.6986
Streamer's Life	2019-07-31	227	100	32	259	0.6985
Metaloid : Origin	2019-03-28	6	25	6	12	0.6985
Victorian Mysteries: The Yellow Room	2019-07-14	6	25	6	12	0.6985
RRRR3	2019-10-17	5	25	6	11	0.6985
eFootball PES 2020	2019-09-10	21018	18590	7664	28682	0.6984
UnHolY ToRturEr	2019-12-13	36	72	22	58	0.6984
牧剑(Tale Of Swords)	2019-12-31	51	157	53	104	0.6981999999999999
Crowd Simulator	2019-09-24	44	263	93	137	0.6981
Peace Restored	2019-08-29	18	69	21	39	0.6981
Destroy The World	2019-02-08	9	46	13	22	0.6981
God Hand	2019-02-11	7	28	7	14	0.698
Lightstep Chronicles	2019-08-01	11	28	7	18	0.698
Save Daddy Trump	2019-07-09	6	83	26	32	0.6979000000000001
Ope	2019-11-29	18	83	26	44	0.6979000000000001
My Typing Skill	2019-10-19	6	43	12	18	0.6979000000000001
Utopia	2019-12-12	20	37	10	30	0.6977
Hang The Kings	2019-10-25	3	37	10	13	0.6977
Nowhere Prophet	2019-07-19	473	723	274	747	0.6970000000000001
Order Up VR	2019-06-13	20	60	18	38	0.6970000000000001
Paths Taken	2019-06-06	13	74	23	36	0.6968000000000001
Onii-chan Asobo	2019-09-27	47	271	97	144	0.6965000000000001
River City Melee Mach!!	2019-10-10	29	85	27	56	0.6965000000000001
Dream Eater Ep1 噬梦者第一章	2019-05-27	151	430	159	310	0.6962999999999999
From Head to Toe	2019-07-19	7	71	22	29	0.6962999999999999
Girls	2019-01-18	8	104	34	42	0.6962
Truberbrook	2019-03-12	316	1193	465	781	0.696
Doors & Rooms	2019-02-01	4	15	3	7	0.6959000000000001
PsiSyn: The Game	2019-01-16	21	15	3	24	0.6959000000000001
Blocky McBlockFace	2019-01-09	3	15	3	6	0.6959000000000001
The Dame Was Loaded	2019-01-28	3	15	3	6	0.6959000000000001
Hentai Babes - In Costume	2019-05-20	5	15	3	8	0.6959000000000001
Incredible Dracula 4: Games Of Gods	2019-05-30	7	15	3	10	0.6959000000000001
Imbroglio	2019-11-04	4	15	3	7	0.6959000000000001
Idle Space Raider	2019-02-05	434	157	54	488	0.6954000000000001
This Merchant Life	2019-09-06	84	117	39	123	0.6954000000000001
Conception PLUS: Maidens of the Twelve Stars	2019-11-06	65	98	32	97	0.6953
Pumped BMX Pro	2019-02-07	18	87	28	46	0.6951999999999999
Felix the Reaper	2019-10-17	115	284	103	218	0.6950000000000001
Disney Classic Games Aladdin and the Lion King	2019-10-29	57	175	61	118	0.6950000000000001
cat notebook	2019-02-02	11	45	13	24	0.6950000000000001
1BIT CASTLE	2019-10-25	5	59	18	23	0.6945
SteelLIFE	2019-01-04	9	18	4	13	0.6944
Tomb Towers	2019-04-04	4	18	4	8	0.6944
Super Welder	2019-05-20	4	18	4	8	0.6944
RRRR2	2019-04-22	6	18	4	10	0.6944
Scarytales: All Hail King Mongo	2019-05-28	4	18	4	8	0.6944
Time Travelling Navy Seal Ninja Warrior	2019-07-24	3	18	4	7	0.6944
A Tofu Tail	2019-12-12	4	8	1	5	0.6944
Wolf's Fury	2019-05-03	17	8	1	18	0.6944
Omega Racers	2019-09-06	2	8	1	3	0.6944
Derpy Fight	2019-02-20	4	8	1	5	0.6944
DUNKYPUNG	2019-01-07	2	8	1	3	0.6944
Murderwave: Digital Slaughter	2019-08-09	3	8	1	4	0.6944
Jet Ant	2019-01-09	2	8	1	3	0.6944
Beyond The Veil	2019-04-19	3	8	1	4	0.6944
Titan shield	2019-05-20	6	8	1	7	0.6944
Stupid Cupid	2019-03-14	2	8	1	3	0.6944
SimpleMovie	2019-01-01	2	8	1	3	0.6944
The ScreaMaze	2019-01-10	4	8	1	5	0.6944
I am Ball	2019-01-23	2	8	1	3	0.6944
Spykebots	2019-02-01	4	8	1	5	0.6944
Sneaker	2019-10-30	5	8	1	6	0.6944
Totem Force	2019-04-04	20	8	1	21	0.6944
Nano Driller	2019-03-05	2	8	1	3	0.6944
Legend of Cina	2019-03-30	3	8	1	4	0.6944
Under Water : Abyss Survival VR	2019-05-15	2	8	1	3	0.6944
Apollo 17 - Moonbuggy VR	2019-07-17	3	8	1	4	0.6944
LOGistICAL 2: France	2019-04-29	16	8	1	17	0.6944
America's Retribution Term 2	2019-05-09	4	8	1	5	0.6944
Spelling Quest Online	2019-12-18	6	8	1	7	0.6944
墨色三国志	2019-06-27	6	8	1	7	0.6944
Vermillion Watch: Parisian Pursuit Collector's Edition	2019-07-12	4	8	1	5	0.6944
Monochrome Order	2019-09-11	4	8	1	5	0.6944
FromTheEarth VR	2019-09-12	2	8	1	3	0.6944
Tower of the Alchemist	2019-08-09	4	8	1	5	0.6944
Raid on Area 51	2019-08-12	1	8	1	2	0.6944
Civil: The Game	2019-09-12	5	8	1	6	0.6944
Little Helper	2019-10-26	4	8	1	5	0.6944
Lucid Nina	2019-09-10	2	8	1	3	0.6944
Forest Home	2019-09-20	4	8	1	5	0.6944
Incredible Dracula: Vargosi Returns	2019-10-17	7	8	1	8	0.6944
Gates to Terra II	2019-11-12	4	8	1	5	0.6944
Daymare: 1998	2019-09-17	345	2013	807	1152	0.6943
Best Plumber	2019-10-17	94	39	11	105	0.6943
Starlink: Battle for Atlas	2019-04-30	88	150	52	140	0.6936
Last Days Of Tascaria	2019-10-04	7	21	5	12	0.6936
Psikodelya	2019-08-07	3	21	5	8	0.6936
Magic Mouse	2019-03-02	18	21	5	23	0.6936
EONIA	2019-10-17	4	30	8	12	0.6934
Silver Chains	2019-08-06	127	525	200	327	0.6933
Deck Hunter	2019-05-30	148	225	81	229	0.6933
bit Dungeon III	2019-05-03	229	134	46	275	0.6933
Reynard	2019-02-22	6	27	7	13	0.6933
Pro Strategy Football 2020	2019-09-13	15	27	7	22	0.6933
RAILED	2019-08-30	8	24	6	14	0.6933
AXYOS: Battlecards	2019-04-22	4	24	6	10	0.6933
Uncharted Ocean	2019-12-09	350	379	142	492	0.6929000000000001
WARSAW	2019-10-02	351	640	247	598	0.6928
Hentai Maido	2019-06-07	5	47	14	19	0.6924
Creo God Simulator	2019-03-02	11	58	18	29	0.6920000000000001
HyperShip Out of Control 2	2019-01-09	3	4	0	3	0.6920000000000001
Return Home	2019-08-30	3	4	0	3	0.6920000000000001
Gravity Garden	2019-11-04	6	4	0	6	0.6920000000000001
Beraltors	2019-05-15	2	4	0	2	0.6920000000000001
Skeleton Sprint	2019-09-16	1	4	0	1	0.6920000000000001
Shawy Adventures	2019-06-13	1	4	0	1	0.6920000000000001
Fallen Empires	2019-09-30	2	4	0	2	0.6920000000000001
La Corda d'Oro Octave	2019-02-14	20	4	0	20	0.6920000000000001
Roidrekt	2019-02-28	1	4	0	1	0.6920000000000001
Retro Rockets	2019-08-02	4	4	0	4	0.6920000000000001
Monster Trampoline	2019-01-19	3	4	0	3	0.6920000000000001
Bitworm	2019-01-18	3	4	0	3	0.6920000000000001
Save Thine Kingdom	2019-03-05	2	4	0	2	0.6920000000000001
Arcane Domains	2019-02-28	2	4	0	2	0.6920000000000001
Maestro: Dark Talent Collector's Edition	2019-01-25	5	4	0	5	0.6920000000000001
Diamonds	2019-11-19	1	4	0	1	0.6920000000000001
ШПML5 (ShPML5)	2019-10-12	1	4	0	1	0.6920000000000001
Super Alpaca Bros.	2019-01-30	2	4	0	2	0.6920000000000001
Mortadelo y Filemón: La banda de Corvino	2019-03-21	2	4	0	2	0.6920000000000001
Robot King Part 2: Boss Battles	2019-03-26	2	4	0	2	0.6920000000000001
Don't Go into the Woods	2019-07-01	2	4	0	2	0.6920000000000001
Slave RPG	2019-03-28	2	4	0	2	0.6920000000000001
Tankorama	2019-03-13	3	4	0	3	0.6920000000000001
Logical Now!	2019-04-13	3	4	0	3	0.6920000000000001
BFGE	2019-03-01	3	4	0	3	0.6920000000000001
Book of Eos	2019-03-15	3	4	0	3	0.6920000000000001
Carreras de Velocidad	2019-04-01	1	4	0	1	0.6920000000000001
Board Quizz Adventure	2019-05-14	4	4	0	4	0.6920000000000001
EURGAVA™ - Tomb of Senza	2019-04-05	2	4	0	2	0.6920000000000001
Where are My Pipes?	2019-04-09	4	4	0	4	0.6920000000000001
BUCKLER 2	2019-04-14	3	4	0	3	0.6920000000000001
Jelly Blocks	2019-04-11	2	4	0	2	0.6920000000000001
火柴人和七色彩虹 Stickman's Rainbow	2019-04-17	1	4	0	1	0.6920000000000001
Emergency Water Landing	2019-04-20	5	4	0	5	0.6920000000000001
IMPALE YOUR FRIENDS!	2019-06-19	4	4	0	4	0.6920000000000001
Hello, World.	2019-04-19	2	4	0	2	0.6920000000000001
Time Loop Fighter	2019-04-24	2	4	0	2	0.6920000000000001
Re[Map]	2019-05-23	3	4	0	3	0.6920000000000001
Necronomistore	2019-04-24	2	4	0	2	0.6920000000000001
Herakles and the Princess of Troy	2019-07-01	3	4	0	3	0.6920000000000001
Magnetic Pull	2019-06-06	2	4	0	2	0.6920000000000001
Space Bomb	2019-07-16	5	4	0	5	0.6920000000000001
Run Jump Rabbit Turtle	2019-07-29	2	4	0	2	0.6920000000000001
Square Weapons Dungeon	2019-09-05	4	4	0	4	0.6920000000000001
MadCowBalls2	2019-10-18	2	4	0	2	0.6920000000000001
Counterspell	2019-07-30	2	4	0	2	0.6920000000000001
Ehandcipation	2019-08-17	4	4	0	4	0.6920000000000001
jwing - the next puzzle game	2019-05-30	7	4	0	7	0.6920000000000001
Simgirls: Lovemore College RPG	2019-08-03	3	4	0	3	0.6920000000000001
Red Death: 8Feet	2019-08-05	2	4	0	2	0.6920000000000001
Aozora Under Girls - Karisome Irony	2019-06-17	2	4	0	2	0.6920000000000001
Lilith-M	2019-09-09	1	4	0	1	0.6920000000000001
Sapper	2019-12-18	2	4	0	2	0.6920000000000001
DunkRatz	2019-09-04	4	4	0	4	0.6920000000000001
PrimeOrbial	2019-07-16	5	4	0	5	0.6920000000000001
The Hunter's Journals - Vile Philosophy	2019-07-15	1	4	0	1	0.6920000000000001
Triangulum	2019-07-30	2	4	0	2	0.6920000000000001
Hallway Simulator 2020	2019-08-28	3	4	0	3	0.6920000000000001
Dream Keeper	2019-07-31	2	4	0	2	0.6920000000000001
Tokyo Wizard	2019-09-19	5	4	0	5	0.6920000000000001
Geocells Quadcells	2019-12-13	5	4	0	5	0.6920000000000001
Extreme Tactical Executioners	2019-08-23	2	4	0	2	0.6920000000000001
The Shattered Blade	2019-09-30	3	4	0	3	0.6920000000000001
Area 51 Defense	2019-12-22	2	4	0	2	0.6920000000000001
明日探险家	2019-08-17	3	4	0	3	0.6920000000000001
Trial And Terror	2019-12-20	1	4	0	1	0.6920000000000001
The Gadget Twins	2019-08-20	2	4	0	2	0.6920000000000001
Switchblade	2019-08-22	2	4	0	2	0.6920000000000001
Blitzkrieg	2019-11-25	2	4	0	2	0.6920000000000001
Project SolarBot	2019-09-06	3	4	0	3	0.6920000000000001
Tonetaker VR	2019-09-18	1	4	0	1	0.6920000000000001
Flint	2019-09-16	2	4	0	2	0.6920000000000001
City Gangs San Andreas	2019-09-12	2	4	0	2	0.6920000000000001
Grid Creeps	2019-11-27	3	4	0	3	0.6920000000000001
腾起之蛇	2019-10-09	2	4	0	2	0.6920000000000001
Teragard	2019-10-03	5	4	0	5	0.6920000000000001
Puzzlection	2019-10-02	2	4	0	2	0.6920000000000001
Legend of Everything	2019-11-09	2	4	0	2	0.6920000000000001
MAD Maze	2019-10-14	2	4	0	2	0.6920000000000001
TORINTO	2019-10-17	2	4	0	2	0.6920000000000001
Alfonzo's Arctic Adventure	2019-11-05	1	4	0	1	0.6920000000000001
Slippery Sausage	2019-12-16	1	4	0	1	0.6920000000000001
Whispered Secrets: Dreadful Beauty Collector's Edition	2019-11-08	4	4	0	4	0.6920000000000001
CubeParkour	2019-11-21	3	4	0	3	0.6920000000000001
Dodge If you Can!	2019-12-07	2	4	0	2	0.6920000000000001
Jack-O-Lantern Covers of Darkness	2019-12-15	1	4	0	1	0.6920000000000001
Ping Pong Space	2019-12-05	3	4	0	3	0.6920000000000001
Gang District	2019-12-05	2	4	0	2	0.6920000000000001
BRG's Tale of The Gallant Jiraiya	2019-12-26	1	4	0	1	0.6920000000000001
Piv🍊t	2019-12-12	2	4	0	2	0.6920000000000001
Marenian Tavern Story: Patty and the Hungry God	2019-05-22	52	44	13	65	0.6918000000000001
Netsoccer2	2019-10-26	136	101	34	170	0.6916
Beat Stickman: Infinity Clones	2019-01-31	52	85	28	80	0.6916
RUSSI.A SIMULATOR	2019-11-20	20	252	93	113	0.6908
Marisa's Marvelous Magic Shop	2019-11-21	15	52	16	31	0.6907
记忆重构/Memories	2019-08-15	39	173	62	101	0.6906
Clown Thug Cop Zombies	2019-02-11	11	95	32	43	0.6905
Legendary Eleven	2019-03-01	9	79	26	35	0.6904000000000001
Intruders: Hide and Seek	2019-09-26	10	203	74	84	0.6901
Primal Pursuit	2019-02-28	21	60	19	40	0.6901
Angelo and Deemon: One Hell of a Quest	2019-09-27	16	100	34	50	0.6900000000000001
Combat Core	2019-01-10	15	49	15	30	0.6900000000000001
Runefall 2	2019-10-10	24	35	10	34	0.6900000000000001
Arcadia	2019-11-01	14	92	31	45	0.6899
Mirror Maker	2019-01-17	345	690	272	617	0.6898000000000001
The Islander: Town Architect	2019-12-12	13	76	25	38	0.6897
Mushroom Crusher Extreme	2019-05-11	6	11	2	8	0.6897
Journey of Haha	2019-06-07	4	11	2	6	0.6897
Wreckin Ball Adventure	2019-08-02	7	11	2	9	0.6897
A song in the void	2019-03-15	10	11	2	12	0.6897
Necrolance	2019-05-16	3	11	2	5	0.6897
Telecube Nightmare	2019-05-20	2	11	2	4	0.6897
Settlers of Orion	2019-05-16	7	11	2	9	0.6897
Haunted Hotel: Eclipse Collector's Edition	2019-01-11	5	11	2	7	0.6897
AIRA VR	2019-01-31	2	11	2	4	0.6897
Tetsumo Party	2019-07-26	6	11	2	8	0.6897
Alicia Quatermain 4: Da Vinci and the Time Machine	2019-10-31	9	11	2	11	0.6897
Newt's Voyage	2019-03-15	5	11	2	7	0.6897
SUBS	2019-07-25	3	11	2	5	0.6897
Echo Royale	2019-04-26	6	11	2	8	0.6897
Hentai Babes - Broken Vows	2019-04-22	7	11	2	9	0.6897
That's Pretty Clever	2019-06-19	8	11	2	10	0.6897
Blood Brothers	2019-06-19	10	11	2	12	0.6897
Rescue Team 6	2019-04-22	6	11	2	8	0.6897
GourMelee	2019-06-06	5	11	2	7	0.6897
Astralojia: Episode 1	2019-08-30	2	11	2	4	0.6897
The Longest Love	2019-09-07	4	11	2	6	0.6897
Beardy the Digger	2019-10-22	3	11	2	5	0.6897
Lootcraft	2019-11-14	8	11	2	10	0.6897
Spellinkers	2019-11-11	2	11	2	4	0.6897
Wars of the Roses	2019-11-27	3	11	2	5	0.6897
Drone Combat	2019-12-05	199	11	2	201	0.6897
DrainLive	2019-12-12	42	57	18	60	0.6894
Siluman Fantasy	2019-04-19	9	32	9	18	0.6894
Crowd Control	2019-09-20	51	32	9	60	0.6894
Adventure Climb VR	2019-04-17	21	197	72	93	0.6893000000000001
SNK HEROINES Tag Team Frenzy	2019-02-21	92	464	180	272	0.6890000000000001
Re:Gals Panic｜幻想天蠶變	2019-10-26	17	94	32	49	0.6888
Z Dawn	2019-12-06	99	166	60	159	0.6887000000000001
Nyasha Land of Elves	2019-04-13	4	54	17	21	0.6887000000000001
Mosaic	2019-12-05	67	291	110	177	0.6886
Easy hentai puzzle	2019-07-31	5	43	13	18	0.6885
Shogun's Empire: Hex Commander	2019-06-27	15	43	13	28	0.6885
Skywalk	2019-05-20	3	26	7	10	0.6883
The Wild Eight	2019-10-03	2538	5045	2140	4678	0.6881999999999999
咔叽探险队 Kaki Raid	2019-09-26	904	645	256	1160	0.688
Quest for the Golden Duck	2019-01-24	5	14	3	8	0.688
Hyper Scuffle	2019-01-07	136	14	3	139	0.688
Galaxity : Beta VR	2019-01-25	14	14	3	17	0.688
Spark of Light	2019-03-21	2	14	3	5	0.688
The Path To Die	2019-03-08	4	14	3	7	0.688
NOTE : a Composer and a Note	2019-03-12	2	14	3	5	0.688
Pixel Art Monster - Color by Number	2019-04-03	6	14	3	9	0.688
Rhythm Defender	2019-05-14	3	14	3	6	0.688
The Chronicles of King Arthur: Episode 2 - Knights of the Round Table	2019-05-03	5	14	3	8	0.688
後藤一家の孤島殺人事件	2019-05-20	4	14	3	7	0.688
Hyacinthus	2019-07-29	4	14	3	7	0.688
Linea VR	2019-10-04	2	14	3	5	0.688
MMX	2019-09-21	4	14	3	7	0.688
Your little story: Winter	2019-12-18	2	14	3	5	0.688
Soviet Bear Uni Adventure	2019-11-06	13	51	16	29	0.6879000000000001
ELSWORD JAPAN	2019-03-14	284	51	16	300	0.6879000000000001
The Summoning	2019-11-22	2	51	16	18	0.6879000000000001
Skyfront VR	2019-03-08	81	109	38	119	0.6878000000000001
Rekindling	2019-04-22	5	23	6	11	0.6878000000000001
Adventures of forsenE: The Hobo Knight	2019-05-27	4	23	6	10	0.6878000000000001
Chicks and Tricks VR	2019-09-26	4	23	6	10	0.6878000000000001
LoliTower	2019-10-26	7	23	6	13	0.6878000000000001
Fateless	2019-11-28	3	23	6	9	0.6878000000000001
Auf Abwegen	2019-03-09	44	255	96	140	0.6877
Roomie Romance	2019-09-13	34	40	12	46	0.6877
Pathos	2019-05-08	11	40	12	23	0.6877
Self-knowledge VR	2019-01-09	14	20	5	19	0.6875
PanChira Concentration	2019-04-17	5	20	5	10	0.6875
Woman's body: For adults	2019-02-28	2	20	5	7	0.6875
Sole	2019-10-16	4	17	4	8	0.6875
The Godbeast	2019-05-16	3	17	4	7	0.6875
The First Track	2019-01-31	4	17	4	8	0.6875
Heroes of a Broken Land 2	2019-09-30	11	17	4	15	0.6875
Just Sleep - Meditate, Focus, Relax	2019-06-29	5	17	4	9	0.6875
1001 Jigsaw. 6 Magic Elements	2019-07-05	5	17	4	9	0.6875
Dead Hand	2019-07-26	11	17	4	15	0.6875
Rescue Lucy 2	2019-08-01	3	17	4	7	0.6875
FULLCHOKE	2019-11-27	3	17	4	7	0.6875
Malediction	2019-12-31	26	80	27	53	0.6872
Hunter	2019-01-28	6	48	15	21	0.687
VALHALL Tests	2019-10-01	11	48	15	26	0.687
Generation Zero®	2019-03-26	11416	21745	9516	20932	0.6869
Hentai Vampire	2019-08-02	4	37	11	15	0.6869
Onigiri	2019-03-29	377	655	262	639	0.6868000000000001
Draw Rider 2	2019-02-13	191	64	21	212	0.6868000000000001
Basement	2019-11-11	329	1508	624	953	0.6867
Captain Starshot	2019-07-09	43	189	70	113	0.6867
Snooker 19	2019-04-17	236	411	161	397	0.6862
Room 40	2019-07-31	29	69	23	52	0.6861
Skyworld: Kingdom Brawl	2019-04-02	38	45	14	52	0.6861
Song Animals	2019-03-26	4	45	14	18	0.6861
Topless Hentai Mosaic	2019-04-05	6	53	17	23	0.6859000000000001
Automachef	2019-07-23	511	542	216	727	0.6858
Etherborn	2019-07-18	155	264	101	256	0.6855
Sex Simulator	2019-07-19	7	242	92	99	0.6855
Morok	2019-10-14	9	66	22	31	0.6853
SengokuNeet	2019-02-14	14	42	13	27	0.6851999999999999
Hard Light Vector	2019-03-26	11	42	13	24	0.6851999999999999
1812: Napoleon Wars	2019-10-17	9	42	13	22	0.6851999999999999
病毒恶化 VirusCrisis	2019-04-30	10	117	42	52	0.6847
Miner Lou	2019-05-30	46	63	21	67	0.6844
Code S-44 : Episode 1	2019-06-26	17	63	21	38	0.6844
Castle Woodwarf 2	2019-10-04	25	55	18	43	0.6840999999999999
TheMemory	2019-05-02	7	28	8	15	0.6840999999999999
Unravel Cyndy	2019-02-11	6	28	8	14	0.6840999999999999
Lightseekers	2019-01-31	106	96	34	140	0.6835
Talisman: Origins	2019-05-16	89	131	48	137	0.6833
Nevrosa: Spider Song	2019-06-04	3	25	7	10	0.6831
Time for Quest	2019-11-15	4	25	7	11	0.6831
Cave of Illusions	2019-10-30	4	25	7	11	0.6831
mmmmm donuts arhhh......	2019-09-23	3	36	11	14	0.6829999999999999
uFactory	2019-04-16	15	44	14	29	0.6828000000000001
Buoyancy	2019-08-30	294	469	189	483	0.6826000000000001
Omega Labyrinth Life	2019-12-10	131	177	67	198	0.6824
New Year's Eve 2020	2019-12-21	407	57	19	426	0.6824
Layers of Fear VR	2019-12-10	19	150	56	75	0.6823
CYBER FURRY GIRL	2019-08-07	5	80	28	33	0.6820999999999999
Battles For Spain	2019-08-05	5	22	6	11	0.682
Cube Mission	2019-01-17	3	22	6	9	0.682
Race With Ryan	2019-11-01	5	22	6	11	0.682
Rune Lord	2019-04-24	5	22	6	11	0.682
ELYSION	2019-11-08	9	22	6	15	0.682
萌萌２次大戰（略）３ Moe Moe World War II-3 	2019-08-12	7	22	6	13	0.682
ShockRods	2019-10-16	23	33	10	33	0.6818000000000001
Time Transit VR	2019-02-26	5	33	10	15	0.6818000000000001
Interactivity: The Interactive Experience	2019-10-23	8	33	10	18	0.6818000000000001
Feudal Alloy	2019-01-17	186	497	202	388	0.6816
Biker Garage: Mechanic Simulator	2019-11-28	137	294	116	253	0.6816
Circuitous	2019-07-09	3	7	1	4	0.6815000000000001
Fortress of Hell	2019-05-22	4	7	1	5	0.6815000000000001
VRでレムと異世界生活-膝枕&添寝編	2019-05-24	3	7	1	4	0.6815000000000001
The Dwarves of Glistenveld	2019-10-18	5	7	1	6	0.6815000000000001
Grounds of Glory	2019-02-22	8	7	1	9	0.6815000000000001
True North	2019-07-17	3	7	1	4	0.6815000000000001
Dismantle: Construct Carnage	2019-02-13	4	7	1	5	0.6815000000000001
You Are Here	2019-09-13	3	7	1	4	0.6815000000000001
Colonies	2019-07-02	4	7	1	5	0.6815000000000001
Yukinas Diary	2019-01-22	2	7	1	3	0.6815000000000001
Little Lost Robots	2019-04-03	3	7	1	4	0.6815000000000001
Age Of Omens	2019-07-05	5	7	1	6	0.6815000000000001
Alien League	2019-03-01	6	7	1	7	0.6815000000000001
Zyphoid	2019-03-08	3	7	1	4	0.6815000000000001
Raatihuone	2019-04-17	2	7	1	3	0.6815000000000001
Leaf	2019-04-12	3	7	1	4	0.6815000000000001
绿野白银树	2019-05-09	3	7	1	4	0.6815000000000001
The Incredible Adventures of Super Panda	2019-06-18	2	7	1	3	0.6815000000000001
Buoyant	2019-07-09	3	7	1	4	0.6815000000000001
Hiscores! Gold	2019-06-21	3	7	1	4	0.6815000000000001
Aircraft War	2019-06-14	2	7	1	3	0.6815000000000001
CYNOROID -GENTAGELSE-	2019-09-01	4	7	1	5	0.6815000000000001
Run Roll Rumble	2019-08-07	6	7	1	7	0.6815000000000001
Alpha Dog	2019-08-30	1	7	1	2	0.6815000000000001
Just Random Squares	2019-08-23	4	7	1	5	0.6815000000000001
Under The Ground	2019-08-25	2	7	1	3	0.6815000000000001
Tsuro - The Game of The Path VR Edition	2019-07-25	4	7	1	5	0.6815000000000001
Word Forward	2019-08-28	3	7	1	4	0.6815000000000001
PamPam Kana Students	2019-08-17	2	7	1	3	0.6815000000000001
edataconsulting VR Office	2019-10-22	2	7	1	3	0.6815000000000001
PPDD	2019-08-14	2	7	1	3	0.6815000000000001
Injection π23 'No Name, No Number'	2019-10-23	2	7	1	3	0.6815000000000001
Mendel's Garden	2019-10-24	4	7	1	5	0.6815000000000001
Impossamole	2019-09-03	2	7	1	3	0.6815000000000001
Graveyard Defender	2019-08-31	2	7	1	3	0.6815000000000001
Solitaire Game Halloween	2019-10-03	7	7	1	8	0.6815000000000001
Obligation	2019-10-07	2	7	1	3	0.6815000000000001
Smile To Fly	2019-11-08	2	7	1	3	0.6815000000000001
ECHORIA: Ancient Echoes	2019-10-30	4	7	1	5	0.6815000000000001
Путь Пацана	2019-11-04	3	7	1	4	0.6815000000000001
JAGD LANZER	2019-10-29	2	7	1	3	0.6815000000000001
The Clouds Travel Notes	2019-12-02	6	7	1	7	0.6815000000000001
Fairy Godmother Stories: Cinderella Collector's Edition	2019-11-22	4	7	1	5	0.6815000000000001
Cold wires	2019-12-18	1	7	1	2	0.6815000000000001
KILL la KILL -IF	2019-07-26	181	1005	422	603	0.6813
Grimshade	2019-03-26	79	102	37	116	0.6809999999999999
B-12	2019-07-12	57	19	5	62	0.6809999999999999
Thibalryn	2019-06-14	136	19	5	141	0.6809999999999999
SisterFight	2019-10-24	5	19	5	10	0.6809999999999999
三国佣兵传奇	2019-01-25	13	59	20	33	0.6808
夏荷 | Summer Lotus	2019-03-29	3	46	15	18	0.6807
Nympho Monster Domination	2019-11-21	13	46	15	28	0.6807
Eternal Battlefield	2019-12-23	184	410	166	350	0.6806
Gears 5	2019-09-10	10196	13843	6216	16412	0.6805
The Deer	2019-12-16	5	38	12	17	0.6804000000000001
Kaisuo	2019-05-18	15	38	12	27	0.6804000000000001
Ancient Guardian	2019-12-23	3007	104	38	3045	0.6802
VersaillesVR | The Palace is yours	2019-09-25	19	84	30	49	0.6801
AntiPodal	2019-03-23	6	16	4	10	0.68
Double Elf Fantasy	2019-08-14	10	16	4	14	0.68
Series Makers	2019-02-22	273	350	141	414	0.6799
Reiko's Fragments	2019-10-28	31	116	43	74	0.6797
Capsule	2019-11-15	2	13	3	5	0.6793000000000001
Skelittle: A Giant Party!	2019-11-28	4	13	3	7	0.6793000000000001
Rogue	2019-11-01	3	13	3	6	0.6793000000000001
Midnight Evil	2019-02-26	6	13	3	9	0.6793000000000001
Darkest Depths	2019-04-19	3	13	3	6	0.6793000000000001
KreisReise	2019-05-17	5	13	3	8	0.6793000000000001
神谋	2019-07-01	9	13	3	12	0.6793000000000001
The Ancient Labyrinth	2019-09-24	3	13	3	6	0.6793000000000001
2D Paintball	2019-05-01	5	10	2	7	0.6793000000000001
Red And The Deadly Sins	2019-05-15	4	10	2	6	0.6793000000000001
B. Braun Aesculap Spine VR	2019-04-19	9	10	2	11	0.6793000000000001
Catch The Kids	2019-03-01	3	10	2	5	0.6793000000000001
Where Thoughts Go: Resolutions	2019-01-05	8	10	2	10	0.6793000000000001
LOTUS Minigames: United Nations	2019-01-21	13	10	2	15	0.6793000000000001
Lyratha: Labyrinth - Survival - Escape	2019-03-11	2	10	2	4	0.6793000000000001
Balance Roll	2019-03-16	3	10	2	5	0.6793000000000001
Emoji TD	2019-05-01	2	10	2	4	0.6793000000000001
Mystery of the Ancients: Deadly Cold Collector's Edition	2019-06-21	4	10	2	6	0.6793000000000001
Cthulhu's Catharsis	2019-11-23	5	10	2	7	0.6793000000000001
Exile of the Gods	2019-07-11	18	10	2	20	0.6793000000000001
Bridge Builder Racer	2019-07-17	19	10	2	21	0.6793000000000001
Fallen valiant-Loopy	2019-09-03	6	10	2	8	0.6793000000000001
Project Wasteland	2019-10-14	9	10	2	11	0.6793000000000001
Learn Spanish! Easy Vocabulary	2019-08-27	4	10	2	6	0.6793000000000001
Drums of War	2019-10-01	3	10	2	5	0.6793000000000001
Fowl Magic	2019-08-22	2	10	2	4	0.6793000000000001
Ransomware Dating Sim	2019-12-06	3	10	2	5	0.6793000000000001
Gaijin Charenji 1 : Kiss or Kill	2019-12-08	2	10	2	4	0.6793000000000001
Hardland	2019-09-17	89	402	164	253	0.6790999999999999
Single Diary: Fresh Graduate	2019-11-04	150	118	44	194	0.6790999999999999
Pride Run	2019-10-11	6	27	8	14	0.6790999999999999
Lost City of Vampires	2019-02-22	5	27	8	13	0.6790999999999999
Rogue Rocks	2019-08-15	9	27	8	17	0.6790999999999999
Magnesia	2019-01-07	18	53	18	36	0.6785
Overstep	2019-11-22	85	361	147	232	0.6784
Miss Lisette's Assassin Maid	2019-09-13	128	93	34	162	0.6784
Just Ride: Apparent Horizon	2019-05-30	23	132	50	73	0.6783
COLLAPSED	2019-08-01	127	132	50	177	0.6783
莫比乌斯之环-不属于任何人的交响悲歌-MOBIUS & ELEGY BELONGS TO NOBODY	2019-10-25	25	206	81	106	0.6781999999999999
The True Tales of Bloodstreet 13 - Chapter 1	2019-02-01	15	40	13	28	0.6781
3 Blind Mice: A Remediation Game For Improper Children	2019-11-08	5	68	24	29	0.6779999999999999
Ikeda : The Scrap Hunter E.P.	2019-08-16	171	95	35	206	0.6776000000000001
Virtual Foosball	2019-05-07	7	24	7	14	0.6776000000000001
Call of Otechestvo Donbass	2019-05-03	2	24	7	9	0.6776000000000001
Cafe Crush	2019-07-19	5	24	7	12	0.6776000000000001
Roah	2019-11-28	54	50	17	71	0.6770999999999999
Dawn of the Lost Castle	2019-05-17	11	50	17	28	0.6770999999999999
Project 5: Sightseer	2019-08-16	464	328	134	598	0.6769
Village Feud	2019-06-21	42	230	92	134	0.6766
A Feeble Saga	2019-02-26	6	37	12	18	0.6765000000000001
Fear the Dark Unknown	2019-12-02	12	87	32	44	0.6764
Space Robinson	2019-10-08	110	140	54	164	0.6763
Nympho Trainer VR	2019-05-14	9	99	37	46	0.6761
Firebase Defence	2019-01-07	10	42	14	24	0.6759999999999999
Him & I	2019-10-04	3	21	6	9	0.6759000000000001
Asian Riddles	2019-12-25	5	21	6	11	0.6759000000000001
You Don't Have Time	2019-07-30	20	29	9	29	0.6758
Slay Together	2019-01-31	57	296	121	178	0.6757
Robothorium	2019-01-31	210	252	102	312	0.6757
A Place for the Unwilling	2019-07-25	23	47	16	39	0.6757
Battle Royale Tycoon	2019-09-02	75	339	140	215	0.6753
Race for Tuning	2019-04-19	50	339	140	190	0.6753
Dick Wilde 2	2019-02-19	14	34	11	25	0.6748000000000001
Wonder Boy Returns Remix	2019-08-09	9	64	23	32	0.6744
Saint Paul	2019-02-03	49	81	30	79	0.6742
Rugby Champions	2019-09-05	11	54	19	30	0.6741
Girls on the beach	2019-10-21	3	54	19	22	0.6741
Return Of The Zombie King	2019-11-04	12	54	19	31	0.6741
Tankex	2019-05-30	8	44	15	23	0.6741
Gear Puzzle: the inheritance of grandpa	2019-09-05	15	44	15	30	0.6741
UNBREAKER	2019-01-21	3	26	8	11	0.6739
Greed 2: Forbidden Experiments	2019-01-21	7	26	8	15	0.6739
Ashen	2019-12-09	674	2046	916	1590	0.6736
FINAL FANTASY VIII - REMASTERED	2019-09-03	3068	2230	1003	4071	0.6731
Door2:Key	2019-12-28	13	31	10	23	0.6729999999999999
Starters Orders 7 Horse Racing	2019-05-02	95	85	32	127	0.6726000000000001
Attack it! Devil legion	2019-07-02	12	85	32	44	0.6726000000000001
Desert Skies	2019-05-30	99	265	110	209	0.672
OUTBUDDIES DX	2019-10-15	21	162	65	86	0.672
BEAST KING	2019-03-28	21	15	4	25	0.672
Dances with Butterflies VR	2019-04-18	5	15	4	9	0.672
Cop Academy	2019-03-22	8	15	4	12	0.672
HA/CK	2019-02-15	4	15	4	8	0.672
PUZZLE: BIRDS	2019-01-10	4	15	4	8	0.672
CaptainMarlene	2019-05-03	4	15	4	8	0.672
101010	2019-10-03	2	15	4	6	0.672
Dungeons Again	2019-10-24	3	15	4	7	0.672
GraFi Halloween	2019-10-19	3	15	4	7	0.672
Terro Lunkka Adventures	2019-12-09	2	15	4	6	0.672
Triton Survival	2019-06-21	7	23	7	14	0.6718000000000001
Greed 3: Old Enemies Returning	2019-03-11	5	23	7	12	0.6718000000000001
Legend of the Tetrarchs	2019-07-26	7	23	7	14	0.6718000000000001
Inugami: Doggy Dojo!	2019-03-25	8	23	7	15	0.6718000000000001
Fateline(命运线)	2019-08-16	6	23	7	13	0.6718000000000001
Lords Mobile	2019-06-03	6224	3295	1507	7731	0.6717000000000001
Santa Claws	2019-12-13	6	65	24	30	0.6709
Orphan of the Petal	2019-02-04	27	48	17	44	0.6709
AntQueen 3D	2019-11-02	20	48	17	37	0.6709
Open Wheel Manager	2019-09-20	9	28	9	18	0.6709
Tuskers Number Adventure	2019-08-26	4	28	9	13	0.6709
Demoniaca: Everlasting Night	2019-09-19	28	147	59	87	0.6707
Insignificant	2019-10-08	3	3	0	3	0.6706000000000001
Sirius: Age of the Free Agents	2019-02-12	3	3	0	3	0.6706000000000001
LIZ: Before the Plague	2019-10-31	3	3	0	3	0.6706000000000001
Pond Wars	2019-06-17	2	3	0	2	0.6706000000000001
MORDER	2019-08-04	5	3	0	5	0.6706000000000001
ERMO	2019-11-25	3	3	0	3	0.6706000000000001
Hexxon	2019-10-03	3	3	0	3	0.6706000000000001
Asteroid Deathmatch	2019-01-31	2	3	0	2	0.6706000000000001
Golden Fall	2019-06-14	1	3	0	1	0.6706000000000001
Maze Gold Run	2019-09-24	2	3	0	2	0.6706000000000001
闇行者 Dark Xingzer	2019-11-27	2	3	0	2	0.6706000000000001
Blixten Quest	2019-01-11	1	3	0	1	0.6706000000000001
Tekling 2	2019-11-22	2	3	0	2	0.6706000000000001
Contact : Last Defence	2019-02-22	1	3	0	1	0.6706000000000001
Leprechaun Shadow	2019-09-05	2	3	0	2	0.6706000000000001
A Cheesy Game	2019-06-07	2	3	0	2	0.6706000000000001
Sunset Giant	2019-01-18	1	3	0	1	0.6706000000000001
Fast Food Fighters	2019-02-26	3	3	0	3	0.6706000000000001
Mission Evilguy	2019-06-19	2	3	0	2	0.6706000000000001
C.Q.C. - Close Quarters Combat	2019-11-14	1	3	0	1	0.6706000000000001
Boom Boom Bovine	2019-07-08	2	3	0	2	0.6706000000000001
::CallBack	2019-10-04	3	3	0	3	0.6706000000000001
Life In Helsinki	2019-01-02	2	3	0	2	0.6706000000000001
Steel Fight	2019-04-14	1	3	0	1	0.6706000000000001
Caladria Chronicles	2019-02-13	2	3	0	2	0.6706000000000001
Magus Over Fool	2019-02-27	3	3	0	3	0.6706000000000001
Hectic Highways	2019-02-01	2	3	0	2	0.6706000000000001
Hero Staff	2019-01-29	2	3	0	2	0.6706000000000001
Galactic Tower Defense	2019-02-08	3	3	0	3	0.6706000000000001
Beat Your Meat	2019-06-05	3	3	0	3	0.6706000000000001
Bot War	2019-02-25	2	3	0	2	0.6706000000000001
Vacation Adventures: Cruise Director	2019-02-11	4	3	0	4	0.6706000000000001
It's a Long Way To the Top (If You Wanna Be a CEO)	2019-04-09	4	3	0	4	0.6706000000000001
BeatShips	2019-10-07	3	3	0	3	0.6706000000000001
STEELPAW	2019-10-24	3	3	0	3	0.6706000000000001
Woodcutter Survival	2019-09-05	2	3	0	2	0.6706000000000001
Operation Valderon	2019-09-21	1	3	0	1	0.6706000000000001
Constructionary	2019-08-13	2	3	0	2	0.6706000000000001
Bob's Cat Challenge	2019-03-01	2	3	0	2	0.6706000000000001
xMoon	2019-06-13	2	3	0	2	0.6706000000000001
Takotan - 星のタコ	2019-05-15	2	3	0	2	0.6706000000000001
Laruaville 7	2019-04-25	4	3	0	4	0.6706000000000001
Hyper Flight	2019-04-26	2	3	0	2	0.6706000000000001
Rupert and Riley Shipwrecked	2019-05-10	2	3	0	2	0.6706000000000001
PipeWorks	2019-04-16	2	3	0	2	0.6706000000000001
Monster Crush - C4 Demolition Edition	2019-05-04	4	3	0	4	0.6706000000000001
Trainspotting Simulator	2019-04-30	2	3	0	2	0.6706000000000001
Icarus - Prima Regula	2019-04-22	2	3	0	2	0.6706000000000001
Block Run	2019-04-30	4	3	0	4	0.6706000000000001
Obscure Doubt	2019-04-26	2	3	0	2	0.6706000000000001
Triangle Mania	2019-05-17	2	3	0	2	0.6706000000000001
Body Discovery	2019-04-29	1	3	0	1	0.6706000000000001
UnderSpire	2019-07-02	2	3	0	2	0.6706000000000001
To the Stars and Beyond!	2019-05-01	2	3	0	2	0.6706000000000001
Under Stranger Stars	2019-08-26	2	3	0	2	0.6706000000000001
Cossanox	2019-05-17	3	3	0	3	0.6706000000000001
Contract Work	2019-11-24	1	3	0	1	0.6706000000000001
Laser Paddles	2019-11-22	2	3	0	2	0.6706000000000001
Kerfuffight	2019-08-30	4	3	0	4	0.6706000000000001
Weaving	2019-06-04	2	3	0	2	0.6706000000000001
DOOMTANK	2019-06-12	1	3	0	1	0.6706000000000001
Box Labyrinth	2019-06-27	2	3	0	2	0.6706000000000001
Grid Magic	2019-06-24	5	3	0	5	0.6706000000000001
The Lattice Grimoire	2019-07-26	3	3	0	3	0.6706000000000001
Midnight Grub Session	2019-07-11	2	3	0	2	0.6706000000000001
All Systems Operational	2019-08-22	3	3	0	3	0.6706000000000001
Creatures	2019-09-16	6	3	0	6	0.6706000000000001
Image of Perfection	2019-07-29	2	3	0	2	0.6706000000000001
Umbraseal	2019-07-27	2	3	0	2	0.6706000000000001
Magnetic Daydream	2019-07-25	2	3	0	2	0.6706000000000001
JERRY JOBHOPPER	2019-09-11	2	3	0	2	0.6706000000000001
南国育ち/Nangoku Sodachi	2019-10-04	4	3	0	4	0.6706000000000001
Meta: Assembled	2019-09-27	2	3	0	2	0.6706000000000001
One Gun 2: Stickman	2019-11-12	2	3	0	2	0.6706000000000001
Tales of Lazo	2019-11-11	3	3	0	3	0.6706000000000001
Heroic Mercenaries	2019-11-22	2	3	0	2	0.6706000000000001
Use Your Brain!	2019-08-18	1	3	0	1	0.6706000000000001
Brutal Sports - Football	2019-08-13	2	3	0	2	0.6706000000000001
Aspects of change	2019-09-17	1	3	0	1	0.6706000000000001
Blade Warrior	2019-09-05	2	3	0	2	0.6706000000000001
Super Monkey	2019-10-01	3	3	0	3	0.6706000000000001
Ichor	2019-09-29	2	3	0	2	0.6706000000000001
Joe Blunt Up In Smoke	2019-10-01	2	3	0	2	0.6706000000000001
Fado	2019-10-21	4	3	0	4	0.6706000000000001
The Final Battle	2019-09-11	1	3	0	1	0.6706000000000001
Slime Slam	2019-10-29	1	3	0	1	0.6706000000000001
Shard	2019-10-04	3	3	0	3	0.6706000000000001
Orbital Shipyards	2019-12-18	3	3	0	3	0.6706000000000001
A-Vroom!	2019-09-29	2	3	0	2	0.6706000000000001
Neighbourhood Loot	2019-12-05	2	3	0	2	0.6706000000000001
The Hunter's Journals - Blissful Ignorance	2019-10-31	1	3	0	1	0.6706000000000001
Warbrush	2019-10-21	2	3	0	2	0.6706000000000001
Space Road	2019-11-04	2	3	0	2	0.6706000000000001
Space Carrot	2019-12-04	2	3	0	2	0.6706000000000001
UpMove	2019-11-12	2	3	0	2	0.6706000000000001
Kōmori Fruit Rush	2019-12-13	3	3	0	3	0.6706000000000001
Hueor	2019-12-11	1	3	0	1	0.6706000000000001
CubeHub	2019-12-30	3	3	0	3	0.6706000000000001
Displace	2019-11-28	1	3	0	1	0.6706000000000001
Coffee Rush	2019-11-21	4	3	0	4	0.6706000000000001
K37-D	2019-12-22	2	3	0	2	0.6706000000000001
生物知识格斗大赛	2019-12-07	3	3	0	3	0.6706000000000001
Volleyball Fever Flat	2019-12-05	2	3	0	2	0.6706000000000001
My Home VR	2019-12-11	4	3	0	4	0.6706000000000001
Melbits™ World	2019-12-16	5	3	0	5	0.6706000000000001
Pictassembler	2019-12-24	2	3	0	2	0.6706000000000001
Suspicious Slide	2019-12-10	2	3	0	2	0.6706000000000001
Dating Life: Miley X Emily	2019-07-31	10	38	13	23	0.6705
Battlewake	2019-09-10	38	79	30	68	0.6702
BLOCKADE War Stories	2019-04-08	8	55	20	28	0.67
Citadel: Forged With Fire	2019-11-01	7777	3917	1814	9591	0.6698999999999999
Death in the Water	2019-10-10	7	100	39	46	0.6698999999999999
RepairBot	2019-01-05	4	12	3	7	0.6698000000000001
Parking 3D	2019-06-25	3	12	3	6	0.6698000000000001
Drawn Down	2019-06-26	4	12	3	7	0.6698000000000001
Photo Quiz - Animals	2019-12-13	8	12	3	11	0.6698000000000001
Vampire & Monsters: Hidden Object Games	2019-05-24	12	50	18	30	0.6695000000000001
Rise of the Pirates	2019-02-02	53	62	23	76	0.6694
PASHTET	2019-01-19	6	20	6	12	0.6694
Masteroid	2019-11-14	21	20	6	27	0.6694
My Island	2019-01-30	116	1037	466	582	0.669
TOKYO GHOUL：re [CALL to EXIST]	2019-11-14	147	1009	453	600	0.669
境界 Dice&Fighter	2019-11-26	116	69	26	142	0.669
SCP: Blackout	2019-08-09	42	175	72	114	0.6688
Black Paradox	2019-05-02	7	76	29	36	0.6688
Red Tractor Tycoon	2019-02-19	17	25	8	25	0.6685
Let's Create! Pottery VR	2019-12-09	6	25	8	14	0.6685
GraFi 3	2019-08-10	5	25	8	13	0.6685
Hentai NetWalk	2019-04-16	14	52	19	33	0.6683
Hypertrain	2019-02-28	16	30	10	26	0.6683
Hentai Inumimi	2019-07-30	2	30	10	12	0.6683
AAW Wrestle Lab	2019-09-27	19	30	10	29	0.6683
Moss Destruction	2019-03-01	19	78	30	49	0.6681
Second Second	2019-07-12	28	78	30	58	0.6681
GRID (2019)	2019-10-10	1038	4021	1884	2922	0.6677
Conan Unconquered	2019-05-29	1011	1158	526	1537	0.6676000000000001
Gunlok	2019-12-03	3	9	2	5	0.6676000000000001
Eggggg - The platform puker	2019-02-04	3	9	2	5	0.6676000000000001
El Taco Diablo	2019-03-11	5	9	2	7	0.6676000000000001
Top Down Survivor	2019-04-26	9	9	2	11	0.6676000000000001
Cliché - Critical Change	2019-03-29	7	9	2	9	0.6676000000000001
The Misadventure Of Melon	2019-08-20	2	9	2	4	0.6676000000000001
Grab Lab	2019-06-21	2	9	2	4	0.6676000000000001
KALEIDO STELLA	2019-06-20	3	9	2	5	0.6676000000000001
Eric The Unready	2019-01-28	2	9	2	4	0.6676000000000001
Caramel Port	2019-02-16	3	9	2	5	0.6676000000000001
Tenebrous Dungeon	2019-02-28	3	9	2	5	0.6676000000000001
LeonWaan MineSweeper	2019-02-09	5	9	2	7	0.6676000000000001
Deep Dungeon: Gym	2019-05-06	4	9	2	6	0.6676000000000001
Knighty Night	2019-06-03	2	9	2	4	0.6676000000000001
Poly Mole	2019-07-12	10	9	2	12	0.6676000000000001
Amora Crystal	2019-09-09	1	9	2	3	0.6676000000000001
The Adventures of Sullivan	2019-08-16	2	9	2	4	0.6676000000000001
Esport Test Toolkit	2019-09-20	12	9	2	14	0.6676000000000001
Battleships and Carriers - Pacific War	2019-11-15	5	9	2	7	0.6676000000000001
Bunny Sudoku	2019-11-29	5	9	2	7	0.6676000000000001
Interstellar Transport Company	2019-05-24	172	263	112	284	0.6675
Nyanco Dream	2019-11-23	4	42	15	19	0.6670999999999999
Seeds of Resilience	2019-06-13	243	240	102	345	0.667
符文女孩/Rune Girl	2019-06-28	197	1075	489	686	0.6668999999999999
Rift Keeper	2019-01-15	16	61	23	39	0.6668000000000001
House of 1000 Doors: Evil Inside	2019-03-11	13	75	29	42	0.6667000000000001
The Forgettable Dungeon	2019-10-21	14	17	5	19	0.6666
Frio3 - Parting and Meeting	2019-02-03	5	17	5	10	0.6666
Pathogen	2019-04-03	7	17	5	12	0.6666
Solitaire. Dragon Light	2019-01-31	6	17	5	11	0.6666
The Seduction of Shaqeera VR	2019-01-17	5	17	5	10	0.6666
Feditor	2019-02-04	12	17	5	17	0.6666
G.R.E.E.N. The life algorithm	2019-11-22	14	17	5	19	0.6666
Brood	2019-04-02	2	17	5	7	0.6666
Björk Vulnicura Virtual Reality Album	2019-09-05	7	17	5	12	0.6666
Above Earth	2019-08-31	6	17	5	11	0.6666
Canasta 3D Premium	2019-07-03	21	37	13	34	0.6665000000000001
Zen Chess: Mate in Three	2019-04-30	5	37	13	18	0.6665000000000001
Ritual: Crown of Horns	2019-11-07	12	37	13	25	0.6665000000000001
love love love	2019-07-12	50	188	79	129	0.6662
Orpheus's Dream	2019-09-15	54	159	66	120	0.6662
Monjarmageddon	2019-03-22	5	6	1	6	0.6662
Albedon Wars	2019-11-07	6	6	1	7	0.6662
Zero Sum Future	2019-10-19	5	6	1	6	0.6662
Terrawurm	2019-04-03	3	6	1	4	0.6662
WARP-TEK	2019-01-31	4	6	1	5	0.6662
Chessboard Kingdoms	2019-11-09	4	6	1	5	0.6662
Season of War (Alpha)	2019-02-19	2	6	1	3	0.6662
Brainmelter Deluxe	2019-03-29	2	6	1	3	0.6662
Switch & Ditch	2019-01-09	2	6	1	3	0.6662
Killing Trials	2019-02-07	3	6	1	4	0.6662
Eggys Games Flash Collection	2019-02-01	3	6	1	4	0.6662
Strangers of the Power 3	2019-05-01	2	6	1	3	0.6662
Commando Fodder: War Dogs	2019-03-01	3	6	1	4	0.6662
Adventures of Isabelle Fine: Murder on Rails	2019-07-09	2	6	1	3	0.6662
Shift Shaft	2019-03-05	6	6	1	7	0.6662
Fear for Sale: Endless Voyage Collector's Edition	2019-03-22	4	6	1	5	0.6662
Alice's Jigsaw. Wonderland Chronicles	2019-04-10	4	6	1	5	0.6662
The Fifth Horseman	2019-05-16	2	6	1	3	0.6662
TheMist	2019-03-28	6	6	1	7	0.6662
Fast Travel: Loot Delivery Service	2019-04-20	3	6	1	4	0.6662
Cheeky Beetle And The Unlikely Heroes	2019-05-22	2	6	1	3	0.6662
The Tower of Worth	2019-05-13	3	6	1	4	0.6662
The Kaiju Offensive	2019-04-19	2	6	1	3	0.6662
GNRBLEX	2019-07-26	4	6	1	5	0.6662
Home A Drone	2019-09-19	2	6	1	3	0.6662
Stigfinnare	2019-10-15	3	6	1	4	0.6662
Aurora Hex - Pattern Puzzles	2019-06-05	4	6	1	5	0.6662
The Tower: The Order of XII	2019-09-26	2	6	1	3	0.6662
Avis Rapida - Aerobatic Racing	2019-05-24	3	6	1	4	0.6662
FinalAdventure	2019-05-31	3	6	1	4	0.6662
PING REDUX	2019-10-16	2	6	1	3	0.6662
The Governor	2019-07-14	2	6	1	3	0.6662
Royal Life: Hard to be a Queen	2019-07-12	4	6	1	5	0.6662
Duck in Town - A Rising Knight	2019-09-30	4	6	1	5	0.6662
Super Platformer Gun	2019-09-30	2	6	1	3	0.6662
GrapplingHook	2019-09-19	2	6	1	3	0.6662
ED-IT	2019-10-21	4	6	1	5	0.6662
Dark Romance: The Ethereal Gardens Collector's Edition	2019-09-06	6	6	1	7	0.6662
ISLA test	2019-10-26	2	6	1	3	0.6662
Fairytale Mosaics Beauty and Beast	2019-12-02	3	6	1	4	0.6662
Infinite Sparkles	2019-11-14	2	6	1	3	0.6662
Lee inside TV	2019-10-31	2	6	1	3	0.6662
A Zone	2019-11-01	2	6	1	3	0.6662
Vector Light	2019-12-20	2	6	1	3	0.6662
How to Become a Ninja: Part 1	2019-11-15	3	6	1	4	0.6662
Dancing Arrow : Beat Smash	2019-12-26	4	6	1	5	0.6662
Ascent Free-Roaming VR Experience 	2019-12-27	1	6	1	2	0.6662
Guilds Of Delenar	2019-03-22	14	32	11	25	0.6659999999999999
Spuds Unearthed	2019-09-19	7	32	11	18	0.6659999999999999
Kurr Snaga	2019-05-10	7	32	11	18	0.6659999999999999
Beyond the Stars VR	2019-06-05	10	32	11	21	0.6659999999999999
Music Killer	2019-10-31	883	287	124	1007	0.6659
Escape from Fortress Lugohm	2019-08-16	105	70	27	132	0.6659
Fat Dude Simulator	2019-05-22	3	70	27	30	0.6659
Kissing Simulator	2019-07-15	4	63	24	28	0.6659
The Homestead	2019-06-10	39	22	7	46	0.6657
"Tactics V: ""Obsidian Brigade"""	2019-08-09	12	22	7	19	0.6657
With Loneliness	2019-04-29	3	22	7	10	0.6657
接头	2019-08-09	7	22	7	14	0.6657
The LEGO® Movie 2 - Videogame	2019-02-26	250	675	304	554	0.6656000000000001
Mini Tone	2019-07-30	6	44	16	22	0.6656000000000001
Ring the City	2019-07-01	100	86	34	134	0.6655
Gun Crazy	2019-11-12	6	72	28	34	0.6652
Between Planets	2019-08-03	136	58	22	158	0.6651
Femdom Waifu	2019-03-08	29	598	269	298	0.665
Mirage Online Classic	2019-12-30	14	39	14	28	0.6648999999999999
RIOT - Civil Unrest	2019-02-12	776	1030	473	1249	0.6648000000000001
Warparty	2019-03-28	164	302	132	296	0.6644
Kingdom Wars 2: Definitive Edition	2019-07-09	121	265	115	236	0.6644
Hot & Steamy Knights	2019-07-12	39	92	37	76	0.6639
Tavern Tycoon	2019-03-11	151	545	246	397	0.6637000000000001
Nation War:Chronicles	2019-03-12	109	307	135	244	0.6635
Make War	2019-10-16	20	62	24	44	0.6633
Corpse Killer - 25th Anniversary Edition	2019-07-31	6	29	10	16	0.6633
Micronomicon: Heroes	2019-04-05	9	14	4	13	0.6633
Grid Clash VR	2019-09-04	10	14	4	14	0.6633
Freefall 3050AD	2019-01-22	3	14	4	7	0.6633
The Scuttle	2019-03-26	3	14	4	7	0.6633
The Ploshers	2019-04-16	2	14	4	6	0.6633
Zero One / 杀戮世界	2019-03-21	3	14	4	7	0.6633
Flyeeex	2019-10-28	7	14	4	11	0.6633
Frequency Garden	2019-11-11	2	14	4	6	0.6633
Fork Knights	2019-10-10	136	14	4	140	0.6633
WWII TCG - World War 2: The Card Game	2019-02-23	124	259	113	237	0.6631999999999999
SCP: Резонанс	2019-10-25	4	78	31	35	0.6631999999999999
不惑英雄传(puzzled heroes)	2019-04-30	89	55	21	110	0.6631999999999999
The Paperman	2019-12-20	20	213	92	112	0.6629
Adventure Slime	2019-09-03	4	24	8	12	0.6627
El Hincha - El Videojuego	2019-06-09	8	19	6	14	0.6625
Baldina's Basis in Education Literary Grammar	2019-07-29	4	19	6	10	0.6625
Lumina	2019-10-09	13	19	6	19	0.6625
Atomorf	2019-08-25	5	19	6	11	0.6625
Desolate	2019-01-17	1832	4964	2398	4230	0.6623
Marle: The Labyrinth of the Black Sea	2019-05-10	196	100	41	237	0.6622
云聚：失落的魔法 Magic Ganglia	2019-08-15	63	91	37	100	0.6620999999999999
Super Pixel Racers	2019-01-31	11	82	33	44	0.6620999999999999
Brunch Club	2019-08-29	19	43	16	35	0.6620999999999999
Eleanor 3	2019-08-26	114	111	46	160	0.6619
Diamonds	2019-06-28	19	102	42	61	0.6618
Meaty McSkinBones	2019-07-15	37	75	30	67	0.6616
青蛙跳模拟器	2019-02-07	34	59	23	57	0.6615000000000001
VICCP	2019-06-20	32	104	43	75	0.6614
Bot Battles	2019-04-05	80	31	11	91	0.6614
Stay Safe: Labyrinth of the Mad	2019-08-13	8	31	11	19	0.6614
Femdom Lines	2019-08-06	11	31	11	22	0.6614
Toilet Simulator	2019-01-18	12	348	156	168	0.6612
Signed and Sealed With a Kiss	2019-04-30	42	45	17	59	0.6609
QuietMansion2	2019-06-22	5	38	14	19	0.6609
BallBoi	2019-08-08	31	38	14	45	0.6609
Zengeon	2019-06-24	469	1010	474	943	0.6606000000000001
Love Hentai: Fap Fast, Die Young	2019-06-17	6	26	9	15	0.6603
Fat Prisoner Simulator 2	2019-06-14	4	90	37	41	0.6602
Phase Shift	2019-04-25	63	81	33	96	0.6601
Robot Soccer Challenge	2019-02-18	5	47	18	23	0.6598999999999999
Ordeal of Princess Eris	2019-06-07	216	103	43	259	0.6597
996的真实老板篇	2019-06-05	13	40	15	28	0.6596
Gekido Kintaro's Revenge	2019-03-04	5	33	12	17	0.6596
Dodge Bubble	2019-03-28	3	33	12	15	0.6596
Lawnmower Game 4: The Final Cut	2019-05-10	6	33	12	18	0.6596
Git Gud or Get Rekt	2019-10-20	12	33	12	24	0.6596
Anime Tanks Arena	2019-10-18	4	65	26	30	0.6594
INTERSTELLAR ROGUE	2019-06-11	5	21	7	12	0.6593000000000001
EEP 16 Expert	2019-11-06	27	21	7	34	0.6593000000000001
Technosphere	2019-04-09	3	11	3	6	0.6593000000000001
Korvux	2019-03-15	6	11	3	9	0.6593000000000001
Fantastic Creatures	2019-11-14	8	11	3	11	0.6593000000000001
The Polynesian Cultural Center VR Experience	2019-06-06	12	11	3	15	0.6593000000000001
Baby Redemption	2019-04-05	6	11	3	9	0.6593000000000001
Sunset Planet	2019-03-01	2	11	3	5	0.6593000000000001
ThunderGod	2019-05-29	7	11	3	10	0.6593000000000001
ChessBase 15 Steam Edition	2019-10-15	15	11	3	18	0.6593000000000001
Ferret Scoundrels	2019-05-09	17	11	3	20	0.6593000000000001
Gorgeous Elves of Ganassa	2019-09-14	5	11	3	8	0.6593000000000001
Eldarune: Tides of Existence	2019-11-25	3	11	3	6	0.6593000000000001
Ninja Roquinexu	2019-05-30	2	11	3	5	0.6593000000000001
Water Margin - The Tale of Clouds and Wind	2019-07-03	2	11	3	5	0.6593000000000001
Bandit Point	2019-10-11	4	11	3	7	0.6593000000000001
Gythol Granditti: The Crypt of Darkness	2019-07-19	5	11	3	8	0.6593000000000001
Throw The Ball In The Hole	2019-09-20	2	11	3	5	0.6593000000000001
Shadows and Dust	2019-09-27	14	11	3	17	0.6593000000000001
HalloweenStory	2019-09-23	4	11	3	7	0.6593000000000001
PUZZLETIME: Castle Party	2019-11-15	8	11	3	11	0.6593000000000001
Blood will be Spilled	2019-05-29	14	49	19	33	0.6589
AWAKE - Definitive Edition	2019-01-13	6	49	19	25	0.6589
Moor	2019-12-20	4	16	5	9	0.6586
As We Know It	2019-05-08	4	16	5	9	0.6586
A Bloody Party	2019-01-25	4	16	5	9	0.6586
The Secret of Gillwood	2019-03-28	3	16	5	8	0.6586
The Chronicles of Jonah and the Whale	2019-01-08	5	16	5	10	0.6586
Brave Battle Saga - The Legend of The Magic Warrior	2019-03-18	3	16	5	8	0.6586
Gekisou!BenzaRace-ToiletShootingStar-	2019-08-26	10	16	5	15	0.6586
Welcome To... Chichester OVN 2 : Master Tormenter Grendel Jinx !?	2019-10-09	2	16	5	7	0.6586
Bullet Beat	2019-11-12	2	16	5	7	0.6586
Trickster VR: Horde Attack!	2019-06-21	15	42	16	31	0.6585
Seirei	2019-03-20	5	35	13	18	0.6581999999999999
WhiTaers: Gongren Edition	2019-01-26	3	35	13	16	0.6581999999999999
Transporter Truck Simulator	2019-09-17	3	35	13	16	0.6581999999999999
RADtv	2019-08-02	6	28	10	16	0.6581999999999999
LesLove.Club: Jessica and Ashley	2019-06-02	7	28	10	17	0.6581999999999999
Beyond Shattered Isles	2019-11-12	8	28	10	18	0.6581999999999999
The Rest of Our Lives	2019-11-05	4	28	10	14	0.6581999999999999
Dude Simulator 3	2019-08-23	5006	1347	646	5652	0.658
1001 Hugs	2019-09-26	9	60	24	33	0.658
Desert Of The Dead	2019-08-12	10	291	132	142	0.6575
Big Red Hood: Halloween	2019-10-29	7	44	17	24	0.6574
Gun Gun Pixies	2019-11-01	38	95	40	78	0.6573000000000001
Interpoint	2019-04-15	11	37	14	25	0.6569
1vs1: Battle Royale for the throne	2019-03-27	3	37	14	17	0.6569
Easter Clicker: Idle Manager	2019-05-21	30	37	14	44	0.6569
Clazer	2019-12-04	3	23	8	11	0.6567000000000001
Undercrewed	2019-09-27	24	23	8	32	0.6567000000000001
Go All Out	2019-06-06	9	23	8	17	0.6567000000000001
Exosphere	2019-04-06	209	23	8	217	0.6567000000000001
Angela's Odyssey	2019-04-25	4	23	8	12	0.6567000000000001
Please The Gods	2019-07-17	12	30	11	23	0.6565000000000001
Thunder Paw	2019-05-07	3	30	11	14	0.6565000000000001
Sanctum Breach	2019-12-09	9	30	11	20	0.6565000000000001
Steel Sword Story	2019-06-21	11	57	23	34	0.6559
Slave's Sword 2	2019-02-22	153	238	108	261	0.6556000000000001
HEIST	2019-09-27	6	18	6	12	0.6551
Akuto: Showdown	2019-03-28	6	18	6	12	0.6551
Saloon VR	2019-05-30	5	18	6	11	0.6551
Night Island	2019-08-27	6	18	6	12	0.6551
Combate Monero	2019-05-04	3	18	6	9	0.6551
Sky Shepherd	2019-05-06	6	18	6	12	0.6551
Overseas	2019-08-30	2	18	6	8	0.6551
Mulite Sword Man	2019-11-07	3	18	6	9	0.6551
Space Mercs	2019-08-02	11	32	12	23	0.655
Dodge Rocket	2019-08-26	5	32	12	17	0.655
Hentai Nekogirl	2019-10-17	3	32	12	15	0.655
Skyland 1976	2019-11-17	5	32	12	17	0.655
YIIK: A Postmodern RPG	2019-01-17	94	392	183	277	0.6548999999999999
Arrow Tourney	2019-09-12	16	85	36	52	0.6548
DriftForce	2019-04-16	13	41	16	29	0.6547
Nock: Hidden Arrow	2019-04-18	7	25	9	16	0.6546
Excive A-1000	2019-04-18	3	25	9	12	0.6546
Trial of the Towers	2019-04-06	7	25	9	16	0.6546
Sandbox Anything	2019-12-19	10	25	9	19	0.6546
Steamcraft	2019-04-25	121	117	51	172	0.6545000000000001
The Alchemist's House	2019-12-24	30	178	80	110	0.6543000000000001
3D Custom Lady Maker	2019-04-19	26	180	81	107	0.6542
Here & Elsewhere	2019-03-05	2	8	2	4	0.6542
Light Rider	2019-11-22	5	8	2	7	0.6542
Connectome:Pain Control	2019-01-28	3	8	2	5	0.6542
bayala - the game	2019-10-24	5	8	2	7	0.6542
mikapyon	2019-02-22	2	8	2	4	0.6542
Choice or Fate	2019-01-10	1	8	2	3	0.6542
Planet Nine	2019-02-18	5	8	2	7	0.6542
CONTINUE	2019-02-22	4	8	2	6	0.6542
OSIRIS	2019-04-23	3	8	2	5	0.6542
Fated Era	2019-02-11	2	8	2	4	0.6542
Chronicon Apocalyptica	2019-01-11	20	8	2	22	0.6542
Brawl	2019-01-20	5	8	2	7	0.6542
Sephirothic Stories	2019-03-15	3	8	2	5	0.6542
Spare Teeth VR	2019-12-12	3	8	2	5	0.6542
Reflections ~Dreams and Reality~	2019-03-14	6	8	2	8	0.6542
Command: Desert Storm	2019-03-28	18	8	2	20	0.6542
SCRAP RUSH!!	2019-06-20	4	8	2	6	0.6542
Butterfly 2	2019-05-07	2	8	2	4	0.6542
Minesweeper Peak VR	2019-05-08	3	8	2	5	0.6542
Reflections of Life: Equilibrium Collector's Edition	2019-05-10	5	8	2	7	0.6542
Underture	2019-07-10	2	8	2	4	0.6542
Rainbow Jigsaw	2019-07-26	3	8	2	5	0.6542
解梦事物所	2019-09-08	2	8	2	4	0.6542
[MISC] TIMELINES	2019-11-06	2	8	2	4	0.6542
Ailment	2019-10-23	2	8	2	4	0.6542
Danger City	2019-12-20	2	8	2	4	0.6542
Blacksmith	2019-01-11	57	65	27	84	0.6537999999999999
Ego Hearts	2019-02-01	11	43	17	28	0.6537999999999999
Apartment 327	2019-02-22	7	13	4	11	0.6537999999999999
1001 Jigsaw. Earth Chronicles	2019-02-19	5	13	4	9	0.6537999999999999
Tales of Sorrow: Strawsbrough Town	2019-01-27	5	13	4	9	0.6537999999999999
Luxor Solitaire	2019-03-06	5	13	4	9	0.6537999999999999
Mystery Solitaire Grimm Tales	2019-06-17	7	13	4	11	0.6537999999999999
KEIKA - A Puzzle Adventure	2019-07-09	4	13	4	8	0.6537999999999999
Roots Of The Woods	2019-09-22	4	13	4	8	0.6537999999999999
Haunted Hotel: Room 18 Collector's Edition	2019-11-01	5	13	4	9	0.6537999999999999
Boomer Remover	2019-12-18	4	13	4	8	0.6537999999999999
Hope's Farm	2019-12-13	7	13	4	11	0.6537999999999999
Front Lines	2019-06-17	23	156	70	93	0.6531
Ghost Stories	2019-06-06	16	56	23	39	0.653
General Practitioner	2019-12-13	208	160	72	280	0.6529
GOLD EXPRESS	2019-09-27	284	371	175	459	0.6526000000000001
Arc Savior	2019-01-31	4	20	7	11	0.6525
Elemental War	2019-07-19	9	20	7	16	0.6525
Welcome To... Chichester Redux : The Spy Of America And The Long Vacation	2019-01-29	2	20	7	9	0.6525
Foxyland 2	2019-04-17	6	20	7	13	0.6525
Hentai Mizugi	2019-09-13	2	20	7	9	0.6525
RICO	2019-03-14	166	281	131	297	0.6523000000000001
Kawaii Deathu Desu	2019-08-30	22	128	57	79	0.6520999999999999
"Game club ""Waka-Waka"""	2019-04-19	10	60	25	35	0.652
Automation Empire	2019-11-20	4721	1610	801	5522	0.6517000000000001
The seven deadly seas	2019-09-19	9	38	15	24	0.6517000000000001
Hentai Shooter 2: World Tour	2019-03-23	7	77	33	40	0.6515000000000001
Stygian: Reign of the Old Ones	2019-09-26	1335	1461	726	2061	0.6514
The Executioner	2019-09-25	176	245	114	290	0.6514
The Grandmaster	2019-05-14	9	29	11	20	0.6514
Sellswords : Ashen Company	2019-04-28	16	51	21	37	0.6511
Axis Football 2019	2019-09-27	36	81	35	71	0.6509999999999999
RWBY Deckbuilding Game	2019-02-14	130	133	60	190	0.6504000000000001
Give It Up! Plus	2019-01-30	29	22	8	37	0.6503
Lost Artifacts: Golden Island	2019-01-04	21	22	8	29	0.6503
Muppy The Bunny : The Danger of Wishes	2019-04-30	12	22	8	20	0.6503
AstronTycoon2: Ritual	2019-12-06	15	22	8	23	0.6503
Miracle Calamity Homeostasis	2019-11-28	2	22	8	10	0.6503
ZIC: Survival	2019-06-18	12	31	12	24	0.6502
Scatteria	2019-11-08	3	15	5	8	0.65
SixCubes	2019-02-19	4	15	5	9	0.65
Twinship	2019-03-14	5	15	5	10	0.65
Face Your Demons	2019-08-10	134	15	5	139	0.65
Woman's body: For adults 2	2019-12-01	2	15	5	7	0.65
Robin Hood: Country Heroes	2019-11-28	7	15	5	12	0.65
Somewhere inside	2019-11-08	11	44	18	29	0.6494
Monster Battles: TCG	2019-11-02	45	33	13	58	0.6492
Okaeri	2019-09-06	18	368	177	195	0.6489
Nothing!	2019-03-15	4	46	19	23	0.6489
Snowed IN	2019-01-25	8	24	9	17	0.6487
Succubus Contract	2019-04-18	8	24	9	17	0.6487
Ghost Parade	2019-10-31	9	24	9	18	0.6487
下一层的封魔塔 Forever War	2019-06-14	77	88	39	116	0.6481
Magical MILFs	2019-10-22	16	92	41	57	0.6478
Passcode Breaker: The Day Before	2019-10-18	11	5	1	12	0.6478
To The Capital 2	2019-02-20	3	5	1	4	0.6478
Neon Cat Tickler	2019-04-15	2	5	1	3	0.6478
Jar Battlers	2019-01-09	2	5	1	3	0.6478
Two Till Midnight	2019-09-10	3	5	1	4	0.6478
The Portal Dimension	2019-08-08	2	5	1	3	0.6478
Robozarro	2019-12-13	2	5	1	3	0.6478
Christmas Wonderland 2	2019-01-06	4	5	1	5	0.6478
RogueCraft Squadron	2019-02-18	2	5	1	3	0.6478
Cyborg Ninja vs. The Third Reich	2019-03-11	2	5	1	3	0.6478
TRE HUN: Unity-Chan x Action	2019-02-22	1	5	1	2	0.6478
Robohazard 2077	2019-02-22	2	5	1	3	0.6478
Wampee Helicopters	2019-05-01	3	5	1	4	0.6478
Line Loops - Logic Puzzles	2019-03-25	3	5	1	4	0.6478
Dráscula: The Vampire Strikes Back	2019-05-15	2	5	1	3	0.6478
BreakFest	2019-03-22	2	5	1	3	0.6478
BUTCHERBOX	2019-03-25	2	5	1	3	0.6478
Templum de Malum	2019-06-14	2	5	1	3	0.6478
Super Web Kittens: Act I	2019-06-26	2	5	1	3	0.6478
Hotel Mogul: Las Vegas	2019-04-08	5	5	1	6	0.6478
ReflexShot	2019-05-14	3	5	1	4	0.6478
New Yankee in King Arthur's Court 5	2019-05-08	9	5	1	10	0.6478
Little Savior / リトルセイバー	2019-05-14	6	5	1	7	0.6478
Hunt the Thailand Hidden	2019-06-20	2	5	1	3	0.6478
Pumpkin Dog Islands	2019-06-11	4	5	1	5	0.6478
Everything is Mayo	2019-09-15	2	5	1	3	0.6478
The Last Escape of Yeti	2019-06-28	1	5	1	2	0.6478
Hentai Girls Mosaic	2019-07-16	2	5	1	3	0.6478
Fury's Sky	2019-08-11	2	5	1	3	0.6478
Nauseous Pines	2019-11-08	2	5	1	3	0.6478
Voidlifted	2019-11-18	3	5	1	4	0.6478
Dark Veer	2019-10-24	2	5	1	3	0.6478
Supesu 2	2019-10-15	2	5	1	3	0.6478
Seek Hearts	2019-12-04	5	5	1	6	0.6478
Tower Climb	2019-12-11	2	5	1	3	0.6478
The Time of Awakening	2019-12-11	2	5	1	3	0.6478
Ice Age: Scrat's Nutty Adventure	2019-10-18	13	94	42	55	0.6476999999999999
Rock n' Rush: Battle Racing	2019-09-06	7	10	3	10	0.6476000000000001
Alvastia Chronicles	2019-01-18	6	10	3	9	0.6476000000000001
Dragon Roller Coaster VR	2019-01-25	6	10	3	9	0.6476000000000001
WEJAM	2019-10-24	5	10	3	8	0.6476000000000001
Trace of the past	2019-08-05	3	10	3	6	0.6476000000000001
守护传说	2019-09-03	2	10	3	5	0.6476000000000001
Temply Girls	2019-10-11	3	10	3	6	0.6476000000000001
Ocean Drive Challenge Remastered	2019-12-27	2	10	3	5	0.6476000000000001
Treasure chest Corps-結界を維持するため、魔物を退治した	2019-05-31	82	147	68	150	0.6473000000000001
Cyndy	2019-05-16	39	145	67	106	0.6473000000000001
Nomads of the Fallen Star	2019-01-31	14	26	10	24	0.6473000000000001
Party Pumper	2019-11-21	5	26	10	15	0.6473000000000001
Chocolat Rush	2019-07-25	4	17	6	10	0.6473000000000001
干支セトラ　陽ノ巻	2019-01-25	5	17	6	11	0.6473000000000001
The explorer of night	2019-03-22	3	17	6	9	0.6473000000000001
Dodge the Wall!	2019-05-04	10	17	6	16	0.6473000000000001
Meta Revelations - Ring Spirits	2019-05-09	12	17	6	18	0.6473000000000001
Led It Rain VR	2019-07-12	4	17	6	10	0.6473000000000001
Blank	2019-12-17	5	17	6	11	0.6473000000000001
Super Friends Party	2019-06-14	162	269	129	291	0.6469
Road to Eden	2019-02-28	58	259	124	182	0.6469
Forgiveness	2019-02-28	34	77	34	68	0.6469
К-9 Dog Job	2019-05-09	4	39	16	20	0.6468
PROZE: Enlightenment	2019-04-25	10	79	35	45	0.6467
PC Futbol Stars	2019-11-07	39	58	25	64	0.6464
Tap Cats: Epic Card Battle	2019-08-27	55	41	17	72	0.6463
Red Room	2019-08-24	3	28	11	14	0.6462000000000001
Witch Ring Meister	2019-04-19	13	28	11	24	0.6462000000000001
Doctor Who: The Edge Of Time	2019-11-12	60	150	70	130	0.6459999999999999
Monster Jam Steel Titans	2019-06-25	82	222	106	188	0.6459
Malevolence: The Sword of Ahkranox	2019-04-08	64	62	27	91	0.6459
Cyberpunk Sex Simulator	2019-11-02	7	93	42	49	0.6458
拯救大魔王:重生 Falsemen: Rebirth	2019-03-22	12	64	28	40	0.6456999999999999
SNOW	2019-02-14	2779	7892	4164	6943	0.6455
Save Koch	2019-04-18	49	101	46	95	0.6455
Planet Nomads	2019-05-03	372	1323	676	1048	0.6454000000000001
Dancing Girl	2019-06-28	94	685	344	438	0.6452
Grid Legion, Storm	2019-03-11	11	19	7	18	0.6452
Escape Velocity	2019-01-12	7	19	7	14	0.6452
Profundum	2019-01-18	6	19	7	13	0.6452
Wacktory	2019-09-13	5	19	7	12	0.6452
My Car	2019-03-05	21	278	135	156	0.6448999999999999
eBall	2019-05-21	10	72	32	42	0.6448999999999999
The Island: Into The Mist	2019-01-31	110	151	71	181	0.6448
Centralia: Homecoming	2019-10-26	9	49	21	30	0.6446
Townsmen - A Kingdom Rebuilt	2019-02-26	751	625	314	1065	0.6445000000000001
Zombie Apocalypse	2019-03-09	6	32	13	19	0.6444
Angry Golf	2019-09-13	4	32	13	17	0.6444
Hentai Pix	2019-09-30	9	32	13	22	0.6444
JackQuest: The Tale of The Sword	2019-01-24	7	21	8	15	0.6436000000000001
Hyperborea	2019-05-10	16	21	8	24	0.6436000000000001
Ruination	2019-03-08	4	21	8	12	0.6436000000000001
Gyro Boss DX	2019-03-22	3	12	4	7	0.6435
Blood Moon	2019-04-26	4	12	4	8	0.6435
GunBlaze	2019-10-15	5	12	4	9	0.6435
RANK RUNNER	2019-08-02	3	12	4	7	0.6435
STORM AREA 51: CUTE ALIEN GIRL EDITION	2019-08-03	3	12	4	7	0.6435
Inner	2019-08-15	2	12	4	6	0.6435
Super Rebellion	2019-11-15	2	12	4	6	0.6435
Exteme School Driving Simulator	2019-02-06	43	59	26	69	0.6433
记忆重现	2019-11-15	50	59	26	76	0.6433
CityBattle | Virtual Earth (EU)	2019-11-28	69	36	15	84	0.6432
Hotel Ever After - Ella's Wish	2019-09-13	8	36	15	23	0.6432
Surprising My Neighbors	2019-04-26	4	36	15	19	0.6432
Urban Trial Playground	2019-04-05	17	67	30	47	0.6428
Winter Solitaire	2019-03-08	5	23	9	14	0.6424
Hentai beautiful girls 2	2019-04-19	3	23	9	12	0.6424
Hero or Villain: Genesis	2019-09-19	44	23	9	53	0.6424
Arena Stars	2019-04-11	89	79	36	125	0.6423000000000001
Hentai Survive Island	2019-05-03	23	127	60	83	0.6421
Tiny Tanks	2019-04-11	76	85	39	115	0.6421
aMAZE Lunar	2019-02-26	3	44	19	22	0.6417
Hentai Cuties	2019-08-18	4	25	10	14	0.6414
Artist Idle	2019-01-18	516	284	141	657	0.6409999999999999
Holy Road	2019-04-12	262	138	66	328	0.6409
JumpHead: Battle4Fun!	2019-07-19	4	2	0	4	0.6408
Weekend Drive	2019-03-14	2	2	0	2	0.6408
A World With No Colour	2019-11-01	2	2	0	2	0.6408
Demolition	2019-09-05	1	2	0	1	0.6408
Penguins of The North	2019-08-09	5	2	0	5	0.6408
Acid Flip	2019-02-26	5130	2	0	5130	0.6408
WyVRn	2019-12-13	2	2	0	2	0.6408
GIF: The Game of Inevitable Frustration	2019-04-26	3	2	0	3	0.6408
Battlemaster	2019-11-15	1	2	0	1	0.6408
Moon Bus	2019-09-06	3	2	0	3	0.6408
The Deepest House	2019-03-18	2	2	0	2	0.6408
Lexie The Takeover	2019-08-26	2	2	0	2	0.6408
Free At Last	2019-11-02	3	2	0	3	0.6408
Existence	2019-08-22	2	2	0	2	0.6408
Six Second Slam	2019-02-05	2	2	0	2	0.6408
Action Card Football	2019-01-19	3	2	0	3	0.6408
Blow Up Pieces: Unleashed	2019-11-23	2	2	0	2	0.6408
Project Z	2019-10-29	2	2	0	2	0.6408
Quantum Covenant	2019-01-18	4	2	0	4	0.6408
Cave Racer	2019-03-01	3	2	0	3	0.6408
Dead by Wheel: Battle Royal	2019-12-08	2	2	0	2	0.6408
Death Cave	2019-02-24	1	2	0	1	0.6408
Refraction	2019-02-20	2	2	0	2	0.6408
SURVIVORS LEFT: X	2019-09-19	2	2	0	2	0.6408
A Sound Plan	2019-04-30	4	2	0	4	0.6408
Assault On Metaltron	2019-06-13	2	2	0	2	0.6408
Warriors Of Ragnarök	2019-01-18	3	2	0	3	0.6408
Neon Blast	2019-04-15	3	2	0	3	0.6408
Parity	2019-12-18	4	2	0	4	0.6408
Paradigm Blast	2019-01-18	4	2	0	4	0.6408
Just Roll With It	2019-08-06	2	2	0	2	0.6408
Walk On The Ground Simulator	2019-07-19	2	2	0	2	0.6408
happybluebear	2019-02-04	1	2	0	1	0.6408
Fant Kids Animated Puzzle	2019-04-03	2	2	0	2	0.6408
LCD Sports: American Football	2019-01-25	1	2	0	1	0.6408
Rolly's Adventure	2019-07-30	2	2	0	2	0.6408
Run Away	2019-02-05	1	2	0	1	0.6408
Bruken	2019-04-11	1	2	0	1	0.6408
GUIDE	2019-04-16	2	2	0	2	0.6408
Space Digger	2019-12-19	2	2	0	2	0.6408
Crash-Site: Conquest	2019-03-11	3	2	0	3	0.6408
Bewildebots	2019-06-04	1	2	0	1	0.6408
Deadly Kingdom	2019-03-01	1	2	0	1	0.6408
TRIDENT BARRAGE	2019-02-28	2	2	0	2	0.6408
Drumpfy Walls	2019-04-20	2	2	0	2	0.6408
Brix VR	2019-03-29	1	2	0	1	0.6408
Cartacombs	2019-02-20	1	2	0	1	0.6408
Crypto Crisis: Education Edition	2019-02-18	2	2	0	2	0.6408
Murder Machine Mini	2019-04-07	2	2	0	2	0.6408
Keystones	2019-03-01	2	2	0	2	0.6408
Fruit Crawler	2019-07-05	2	2	0	2	0.6408
A Game For You, Josh	2019-04-08	2	2	0	2	0.6408
Table Games VR	2019-04-05	2	2	0	2	0.6408
Alien Cow Farm	2019-05-31	2	2	0	2	0.6408
Pirate Cannons AHOY!	2019-03-11	1	2	0	1	0.6408
SpaceBullet	2019-03-20	2	2	0	2	0.6408
Frame Of Reference	2019-08-15	1	2	0	1	0.6408
Kim Shooter	2019-07-16	2	2	0	2	0.6408
You Versus 27 Elves	2019-03-26	2	2	0	2	0.6408
Ogrez	2019-06-19	1	2	0	1	0.6408
TimeFall	2019-04-30	2	2	0	2	0.6408
The Volcano	2019-10-19	1	2	0	1	0.6408
SurviVR - Castle Defender	2019-07-01	2	2	0	2	0.6408
Surface: The Soaring City Collector's Edition	2019-03-29	3	2	0	3	0.6408
RockaBowling VR	2019-05-10	2	2	0	2	0.6408
Fishy Dungeon Delving	2019-05-06	2	2	0	2	0.6408
Eternal Concord	2019-09-12	2	2	0	2	0.6408
Island Town Zombie Paradise	2019-04-26	2	2	0	2	0.6408
Mahjong Infinity	2019-06-07	5	2	0	5	0.6408
Moon Pool	2019-04-18	1	2	0	1	0.6408
Sicier's Zweck	2019-04-30	1	2	0	1	0.6408
Heaven's Voice Feast of Famine	2019-05-21	1	2	0	1	0.6408
DomiDo	2019-05-14	2	2	0	2	0.6408
MonteCube Dodge	2019-04-22	1	2	0	1	0.6408
Deadly Path	2019-05-14	2	2	0	2	0.6408
Helm Realm	2019-11-25	3	2	0	3	0.6408
Peku	2019-05-04	1	2	0	1	0.6408
Bugs 'N Boo Hags	2019-12-31	2	2	0	2	0.6408
Tiny World	2019-05-21	2	2	0	2	0.6408
Iceroyds!	2019-12-20	1	2	0	1	0.6408
Adventure of Great Wolf	2019-05-31	2	2	0	2	0.6408
Idunn Gurdians	2019-08-22	1	2	0	1	0.6408
Chernomeat Survival Game	2019-05-23	3	2	0	3	0.6408
Ivanoile ~ Christalixeur Corruption	2019-06-06	4	2	0	4	0.6408
打豹虎 Spider Derby	2019-07-04	2	2	0	2	0.6408
BloXoR	2019-05-27	1	2	0	1	0.6408
Humans 101	2019-08-13	2	2	0	2	0.6408
Tale Of Starship	2019-11-15	2	2	0	2	0.6408
HeroOfMetal-Episode01	2019-06-13	1	2	0	1	0.6408
Dark Skeleton Survival	2019-05-28	1	2	0	1	0.6408
Purple Noise Echo	2019-10-01	2	2	0	2	0.6408
DestructoPod	2019-07-25	2	2	0	2	0.6408
Story in the Dream World -Volcano And Possession-	2019-08-31	1	2	0	1	0.6408
Coffee Runner Black and Mocha	2019-07-23	1	2	0	1	0.6408
WhiteBird 白鸟	2019-07-27	1	2	0	1	0.6408
Roopocket	2019-09-19	3	2	0	3	0.6408
C.A.T.S. - Carefully Attempting not To Screw up	2019-07-18	2	2	0	2	0.6408
Drones	2019-11-15	3	2	0	3	0.6408
Everyone Goes Home	2019-07-30	1	2	0	1	0.6408
Anticorps VR	2019-07-30	2	2	0	2	0.6408
Fighting Frenzy: Swole Simulator	2019-08-03	1	2	0	1	0.6408
The Legend of Viccess	2019-10-01	2	2	0	2	0.6408
ThreeStep	2019-10-18	1	2	0	1	0.6408
Stupid Bat	2019-07-09	2	2	0	2	0.6408
Vacation Adventures: Park Ranger 3	2019-08-07	4	2	0	4	0.6408
Reverse Me! Rez/Ru	2019-06-28	1	2	0	1	0.6408
Over Sky	2019-07-12	2	2	0	2	0.6408
Paradox Escape Route	2019-10-23	2	2	0	2	0.6408
Champions	2019-07-24	2	2	0	2	0.6408
8bit Pigeon Hunter	2019-07-17	1	2	0	1	0.6408
Farrealm: The Prince of Winds	2019-07-25	1	2	0	1	0.6408
Fortune Telling	2019-07-27	4	2	0	4	0.6408
老板攻略	2019-07-30	2	2	0	2	0.6408
Flutter Bombs	2019-11-14	4	2	0	4	0.6408
ARC	2019-08-29	1	2	0	1	0.6408
Aura Shift	2019-08-14	2	2	0	2	0.6408
moofa	2019-09-30	2	2	0	2	0.6408
Strazeal	2019-08-26	3	2	0	3	0.6408
Ebullition LBVR	2019-09-19	4	2	0	4	0.6408
Flip Polygon	2019-08-21	2	2	0	2	0.6408
Smaller	2019-11-24	1	2	0	1	0.6408
DOUBLE INVASION!!	2019-12-11	1	2	0	1	0.6408
Mystic Mayhem Unleashed	2019-08-20	1	2	0	1	0.6408
Platforms	2019-08-30	2	2	0	2	0.6408
Try not to die	2019-11-04	1	2	0	1	0.6408
Battle Dome Redux	2019-11-26	5	2	0	5	0.6408
Protect Your Fool	2019-11-26	2	2	0	2	0.6408
ポエニ戦争　地中海の稲妻	2019-08-21	2	2	0	2	0.6408
Second Dimension RetroPak Vol. 1	2019-08-22	2	2	0	2	0.6408
境外狂奔	2019-09-17	2	2	0	2	0.6408
GodOrEvil.Bate	2019-09-03	3	2	0	3	0.6408
Boardwalk Carnival Game	2019-10-28	1	2	0	1	0.6408
Nightmare Cave	2019-09-12	1	2	0	1	0.6408
Austerlitz	2019-10-03	2	2	0	2	0.6408
Inspector - 生化战警	2019-10-02	1	2	0	1	0.6408
Dead Simple 21	2019-09-30	1	2	0	1	0.6408
Waterloo	2019-10-04	2	2	0	2	0.6408
Ball Pit Simulator	2019-11-01	3	2	0	3	0.6408
Foreign	2019-10-07	1	2	0	1	0.6408
Rain of Fire	2019-10-28	3	2	0	3	0.6408
ALPHA	2019-11-01	3	2	0	3	0.6408
Aah, Halloween pie!	2019-10-24	1	2	0	1	0.6408
ArachnoSplat	2019-11-15	1	2	0	1	0.6408
月牙楼风云	2019-12-13	2	2	0	2	0.6408
Dinodrifters	2019-12-21	2	2	0	2	0.6408
怪奇幻想夢物語 怪獣綺譚 誘宵地獄	2019-11-05	1	2	0	1	0.6408
BOX	2019-11-23	1	2	0	1	0.6408
GO-4-Soldier-1	2019-12-03	2	2	0	2	0.6408
Snowman	2019-11-26	1	2	0	1	0.6408
ASTROPUPPA	2019-12-06	1	2	0	1	0.6408
Hide and Secret: The Lost World	2019-11-21	5	2	0	5	0.6408
The Knight of the Crimson Tower	2019-11-20	2	2	0	2	0.6408
Fox-Trot Over Run	2019-12-05	1	2	0	1	0.6408
HABITKING RPG	2019-12-30	2	2	0	2	0.6408
Candera: The Forgotten Realm	2019-12-30	4	2	0	4	0.6408
Aigor Escape from Bishop	2019-12-25	2	2	0	2	0.6408
Everpath: A pixel art roguelite	2019-05-22	8	54	24	32	0.6406999999999999
The Mirum	2019-02-01	3	14	5	8	0.6406999999999999
Delirium VR	2019-03-26	3	14	5	8	0.6406999999999999
Pixel Puzzles 2: Paintings	2019-04-10	4	14	5	9	0.6406999999999999
Die, zombie sausage, die!	2019-12-18	3	14	5	8	0.6406999999999999
Repressed	2019-09-26	6	14	5	11	0.6406999999999999
Sir'HaXXX	2019-09-20	3	14	5	8	0.6406999999999999
TITAN SLAYER Ⅱ	2019-02-20	7	27	11	18	0.6406000000000001
Lornsword Winter Chronicle	2019-10-23	5	27	11	16	0.6406000000000001
Aliens Don't Exist	2019-01-02	5	27	11	16	0.6406000000000001
MMA Arena	2019-05-07	27	58	26	53	0.6405
HENTAI SUPER GIRL	2019-02-14	244	98	46	290	0.6402
RUCKBALL	2019-05-17	40	66	30	70	0.6402
Front Defense Heroes	2019-05-15	38	86	40	78	0.6401000000000001
Pupil: Wandering VR	2019-05-07	9	86	40	49	0.6401000000000001
MeiQi Season1	2019-09-29	20	82	38	58	0.6401000000000001
Wrack: Exoverse	2019-09-10	7	29	12	19	0.64
Horse Riding Deluxe	2019-04-17	9	29	12	21	0.64
Battle Royale Builder	2019-01-11	9	29	12	21	0.64
A Planet of Mine	2019-12-10	7	29	12	19	0.64
stein.world	2019-04-23	270	514	263	533	0.6397
Vambrace: Cold Soul	2019-05-28	394	495	253	647	0.6397
Chasing the Stars	2019-01-23	19	33	14	33	0.6391
Truth: Disorder III — Gemini / 真実：障害III - 双子座	2019-04-24	4	33	14	18	0.6391
Arkady Survive	2019-05-24	3	7	2	5	0.6389
Monads	2019-02-15	5	7	2	7	0.6389
Fantasy Girl Puzzle	2019-05-25	2	7	2	4	0.6389
Invaders from Dimension X	2019-01-24	5	7	2	7	0.6389
Ritual of the Moon	2019-04-19	2	7	2	4	0.6389
soul room	2019-01-07	2	7	2	4	0.6389
The Childs Sight	2019-03-28	2	7	2	4	0.6389
Find-Life EP1	2019-01-12	2	7	2	4	0.6389
Gunslugs:Rogue Tactics	2019-08-06	3	7	2	5	0.6389
Supernatural Super Squad Fight!	2019-05-07	25	7	2	27	0.6389
Viking: Sigurd's Adventure	2019-02-18	2	7	2	4	0.6389
Edge of Galaxy	2019-03-15	3	7	2	5	0.6389
Virtual Arctic Expedition	2019-04-06	13	7	2	15	0.6389
Crazy Ball	2019-05-13	2	7	2	4	0.6389
무연	2019-08-27	8	7	2	10	0.6389
Duskless: The Clockwork Army	2019-05-15	4	7	2	6	0.6389
Yume Puzzle	2019-05-28	2	7	2	4	0.6389
Speakerman	2019-06-17	2	7	2	4	0.6389
Bepuzzled Kittens Jigsaw Puzzle	2019-06-11	2	7	2	4	0.6389
WBTR	2019-07-27	4	7	2	6	0.6389
Police Stunt Cars	2019-08-09	3	7	2	5	0.6389
VR Puzzle Box	2019-09-11	3	7	2	5	0.6389
1942	2019-10-08	5	7	2	7	0.6389
Robot Vacuum Simulator X	2019-08-15	4	7	2	6	0.6389
Murgles	2019-10-29	3	7	2	5	0.6389
Hexadrift	2019-11-21	2	7	2	4	0.6389
Euclidean Skies	2019-02-05	21	35	15	36	0.6388
Elendia Ceus	2019-07-26	1061	16	6	1067	0.6388
The Queen of Blackwood High	2019-02-15	7	16	6	13	0.6388
Barney's Dream Cruise	2019-08-03	3	16	6	9	0.6388
Не падай!	2019-04-17	2	16	6	8	0.6388
Bad Business	2019-07-24	3	16	6	9	0.6388
HANGMAN	2019-07-24	3	16	6	9	0.6388
Rescue Team 8	2019-08-30	10	16	6	16	0.6388
九霄仙阙	2019-12-23	6	16	6	12	0.6388
ONINAKI	2019-08-22	689	267	134	823	0.6386000000000001
HentaiNYA	2019-05-21	5	37	16	21	0.6385000000000001
Vainglory	2019-02-13	1866	2719	1461	3327	0.6383
Breeding Village	2019-04-19	13	93	44	57	0.6383
Hentai Oppai	2019-04-19	2	39	17	19	0.6383
Punch Line	2019-05-23	12	41	18	30	0.6381
Top Burger	2019-04-24	5	41	18	23	0.6381
光与暗之恋曲	2019-10-21	39	41	18	57	0.6381
Beat.School	2019-12-12	9	41	18	27	0.6381
Spellsword Cards: Origins	2019-06-06	25	47	21	46	0.6377
Evil Maze 2	2019-03-08	21	67	31	52	0.6376
Time Break	2019-04-27	25	51	23	48	0.6376
Aetheria Online	2019-02-01	65	59	27	92	0.6375000000000001
VEmpire - The Kings of Darkness	2019-07-24	9	18	7	16	0.6375000000000001
WellTown	2019-01-29	11	18	7	18	0.6375000000000001
Drive for Your Life	2019-04-11	5	18	7	12	0.6375000000000001
PULSOR	2019-05-10	5	18	7	12	0.6375000000000001
Rotatex	2019-06-21	12	18	7	19	0.6375000000000001
Aleesha's Tower	2019-09-03	2	18	7	9	0.6375000000000001
Stellar Survivor	2019-06-20	28	114	55	83	0.6374000000000001
Trials Rising	2019-02-26	1760	1521	814	2574	0.6367
Xenon Racer	2019-03-26	137	394	203	340	0.6365999999999999
Bone Voyage	2019-06-24	41	232	117	158	0.6365
Snow Jewels	2019-05-30	5	20	8	13	0.6365
Telling Lies	2019-08-23	687	674	354	1041	0.6364
Eden Rising	2019-05-17	1387	912	484	1871	0.636
FIA European Truck Racing Championship	2019-07-18	124	184	92	216	0.636
Dement	2019-10-31	3	22	9	12	0.6358
Unfamiliar	2019-12-13	9	22	9	18	0.6358
Battle Tanks: Legends of World War II	2019-02-22	248	662	349	597	0.6355
I LIKE THE FLOWERS	2019-12-07	2	24	10	12	0.6353
Swords and Sandals Spartacus	2019-12-22	4	24	10	14	0.6353
Hentai House	2019-08-29	12	64	30	42	0.6349
aMAZE St.Patrick	2019-02-01	4	26	11	15	0.6349
Axiom Soccer	2019-04-11	159	260	133	292	0.6348
Placebo Effect	2019-05-03	2	9	3	5	0.6345000000000001
Battlemage	2019-01-02	4	9	3	7	0.6345000000000001
Salio	2019-03-22	6	9	3	9	0.6345000000000001
Woodboy	2019-05-28	2	9	3	5	0.6345000000000001
SubmarineCraft	2019-02-07	5	9	3	8	0.6345000000000001
Tess Elated	2019-02-14	4	9	3	7	0.6345000000000001
雪疑	2019-05-20	5	9	3	8	0.6345000000000001
B画少说	2019-02-15	4	9	3	7	0.6345000000000001
Dragon Chase	2019-01-31	6	9	3	9	0.6345000000000001
HotPuzzle:Video	2019-02-22	3	9	3	6	0.6345000000000001
CLASH! - Battle Arena	2019-02-20	4	9	3	7	0.6345000000000001
Minda	2019-09-08	4	9	3	7	0.6345000000000001
Cardlings	2019-06-05	8	9	3	11	0.6345000000000001
Continuum	2019-05-23	4	9	3	7	0.6345000000000001
Corridor Crusaders	2019-11-28	6	9	3	9	0.6345000000000001
I Am Gooey	2019-08-27	2	9	3	5	0.6345000000000001
灵卡大师 Master of LinCard	2019-09-26	7	9	3	10	0.6345000000000001
Fantasy Gladiators	2019-08-27	13	9	3	16	0.6345000000000001
Operation: Cheek Clapper	2019-09-20	5	9	3	8	0.6345000000000001
4islands	2019-10-20	4	9	3	7	0.6345000000000001
ZLM Crafter	2019-10-31	2	9	3	5	0.6345000000000001
The Battles of Spwak 3	2019-12-06	2	9	3	5	0.6345000000000001
Please Find Me	2019-06-28	6	30	13	19	0.6344
Twin Peaks VR	2019-12-13	9	30	13	22	0.6344
ART SQOOL	2019-02-05	24	114	56	80	0.6343
Boy Teen Dream	2019-01-24	8	46	21	29	0.6342
Artificial Iridescence	2019-09-04	3	34	15	18	0.6342
Taste of Power	2019-10-10	8	44	20	28	0.6341
Lady and Blade	2019-09-04	27	42	19	46	0.6341
Pet Chan	2019-12-18	7	38	17	24	0.6341
Startup Freak	2019-10-19	46	36	16	62	0.6341
Rummy 3D Premium	2019-06-24	16	36	16	32	0.6341
DayBreak Online	2019-06-13	203	167	84	287	0.634
Lesbian Breakout	2019-11-07	10	61	29	39	0.6321
Winged Sakura: Mindy's Arc 2	2019-04-26	10	11	4	14	0.6321
Radical Rex	2019-03-07	2	11	4	6	0.6321
GACHIMUCHI The Card Game	2019-03-08	4	11	4	8	0.6321
The Far Kingdoms: Sacred Grove Solitaire	2019-03-12	5	11	4	9	0.6321
Hentai Pair	2019-08-09	2	11	4	6	0.6321
KUMACURE	2019-05-31	2	11	4	6	0.6321
Timothy and the Mysterious Forest	2019-09-25	3	11	4	7	0.6321
Witch College	2019-07-30	3	11	4	7	0.6321
My Haunted Doll	2019-11-22	2	11	4	6	0.6321
Black Smith	2019-12-18	4	11	4	8	0.6321
Kanojo x Switch	2019-12-29	3	11	4	7	0.6321
Warhammer The Horus Heresy: Legions	2019-03-28	685	1458	798	1483	0.632
克苏鲁异闻录	2019-08-28	100	152	77	177	0.6319
Dino Zoo Transport Simulator	2019-09-23	5	59	28	33	0.6319
Mystery Island - Hidden Object Games	2019-10-25	282	116	58	340	0.6315
Hentai Fetish Tycoon	2019-12-06	27	80	39	66	0.6315
Forged of Blood	2019-08-01	183	78	38	221	0.6313000000000001
Cemetery Warrior 4	2019-10-02	200	53	25	225	0.6313000000000001
Football Drama	2019-09-18	28	51	24	52	0.6311
Our Lovely Escape	2019-09-30	39	49	23	62	0.6309
Night Sing	2019-07-19	36	108	54	90	0.6307
Cecconoid	2019-10-08	3	13	5	8	0.6306
Wanderfog	2019-07-17	7	13	5	12	0.6306
Slay All Goblins	2019-01-16	5	13	5	10	0.6306
BubbleGum-Push	2019-03-11	10	13	5	15	0.6306
Super Orb Collector	2019-02-25	2	13	5	7	0.6306
Back to 1998	2019-04-15	4	13	5	9	0.6306
Hentai Girl Run	2019-05-07	3	13	5	8	0.6306
AGENT 00111	2019-07-03	3	13	5	8	0.6306
Gamehunt	2019-06-11	2	13	5	7	0.6306
Monsters sandbox	2019-12-12	4	13	5	9	0.6306
The Secret of Hutton Grammar School	2019-12-10	3	13	5	8	0.6306
Countersnipe	2019-12-05	103	234	122	225	0.6305
Dawn Break -Origin-	2019-05-16	15	45	21	36	0.6305
Deviant Dungeon	2019-01-30	26	70	34	60	0.6304
Fighters Legacy	2019-08-01	6	43	20	26	0.6303
Virtual Hero VR	2019-06-17	13	43	20	33	0.6303
Traffix	2019-07-08	7	43	20	27	0.6303
The Shedding	2019-01-22	4	39	18	22	0.63
Jigsaw Masterpieces	2019-03-12	30	37	17	47	0.6298
Haxor	2019-04-12	5	15	6	11	0.6298
Psychose	2019-08-05	4	15	6	10	0.6298
Old Town Stories	2019-12-07	5	15	6	11	0.6298
Recyclomania	2019-08-28	3	15	6	9	0.6298
aMAZE Gears 2	2019-11-04	3	15	6	9	0.6298
A Long Stroll	2019-12-09	2	15	6	8	0.6298
Herd is Coming	2019-06-10	7	35	16	23	0.6296
Zen Chess: Mate in Four	2019-04-30	4	35	16	20	0.6296
reYal	2019-05-30	3	17	7	10	0.6293
The Renovator	2019-04-17	5	60	29	34	0.6292
aMAZE Easter	2019-03-27	6	31	14	20	0.6292
The Wanderer	2019-01-25	2600	29	13	2613	0.6291
在这个世界的尽头，你与我被遗忘的传说（in the world end, you and me the forget's legend）	2019-07-29	7	27	12	19	0.629
De'Vine: Card Battles	2019-03-15	8	19	8	16	0.629
Hentai Strawberry	2019-03-15	4	19	8	12	0.629
Blacksmith Run	2019-04-19	3	19	8	11	0.629
SwarmZ	2019-11-29	62	190	99	161	0.6289
Creature Card Idle	2019-12-22	66	58	28	94	0.6289
Dungeons of the Fallen	2019-10-05	15	25	11	26	0.6289
Call of Fries	2019-06-10	4	25	11	15	0.6289
Blessed Surface	2019-02-27	5	23	10	15	0.6288
7 Lives	2019-06-20	3	23	10	13	0.6288
Sacred Siren	2019-09-02	4	23	10	14	0.6288
Bot Land	2019-09-04	48	56	27	75	0.6287
Sacred Sword Princesses	2019-11-06	285	360	193	478	0.6284000000000001
The Pit: Infinity	2019-11-12	48	184	96	144	0.6284000000000001
HENTAI CLIMBER	2019-11-01	8	134	69	77	0.6278
武林志（Wushu Chronicles）	2019-04-09	1118	1541	863	1981	0.6275000000000001
WildKids	2019-08-27	10	48	23	33	0.6275000000000001
Project RIP	2019-10-12	22	80	40	62	0.6273
The Dead Tree of Ranchiuna	2019-02-14	4	46	22	26	0.6271
Almost There: The Platformer	2019-02-19	178	264	141	319	0.627
Refight:The Last Warship	2019-03-14	185	199	105	290	0.627
Land Of The Void	2019-03-06	28	42	20	48	0.6264000000000001
Eggoria	2019-06-07	38	42	20	58	0.6264000000000001
9Dragons: Kung Fu Arena	2019-05-28	178	182	96	274	0.6263000000000001
Allspace	2019-10-18	12	40	19	31	0.6261
Embark	2019-04-18	243	239	128	371	0.6257
Detective Sherlock Pug	2019-02-01	6	38	18	24	0.6257
Most Correct Football Simulator	2019-05-21	26	38	18	44	0.6257
Space Survivors Shooter	2019-04-19	3	4	1	4	0.6251
Spork: The Manic Utensil Storm	2019-02-14	1	4	1	2	0.6251
隐-Stealth	2019-08-14	3	4	1	4	0.6251
DangerSpace	2019-09-05	2	4	1	3	0.6251
ERI	2019-04-04	2	4	1	3	0.6251
GRITS Racing	2019-03-04	5	4	1	6	0.6251
夢物語ORIGIN	2019-03-22	2	4	1	3	0.6251
The Prometheus Secret Noohra	2019-02-22	3	4	1	4	0.6251
Jack & the creepy Castle	2019-03-29	1	4	1	2	0.6251
SCUOS	2019-03-27	30	4	1	31	0.6251
Market Dominion	2019-08-07	3	4	1	4	0.6251
TowerHex	2019-01-14	4	4	1	5	0.6251
M.E.M.E.S.	2019-02-08	2	4	1	3	0.6251
Twisty Puzzle Simulator	2019-04-09	4	4	1	5	0.6251
Arkane Rush Multiverse Mayhem	2019-01-22	3	4	1	4	0.6251
Time to Fight	2019-01-25	2	4	1	3	0.6251
Rebels & Redcoats	2019-09-25	3	4	1	4	0.6251
Minskies	2019-03-09	2	4	1	3	0.6251
Sinewave	2019-03-01	1	4	1	2	0.6251
Pirouette	2019-07-30	1	4	1	2	0.6251
龍炎高校伝説２ The Legend of the Dragonflame High School 2	2019-03-22	4	4	1	5	0.6251
b.m.g 19 - bike messenger go!	2019-03-21	1	4	1	2	0.6251
Future Futures - Command Z	2019-03-29	8	4	1	9	0.6251
YGGDRASIL JIGSAW PUZZLE	2019-04-18	2	4	1	3	0.6251
Rasen no Sora	2019-04-09	5	4	1	6	0.6251
Vacation Adventures: Park Ranger 2	2019-03-29	3	4	1	4	0.6251
Virtual Skydiving	2019-04-09	5	4	1	6	0.6251
Plunger Knight - Washers of Truth	2019-05-17	1	4	1	2	0.6251
Instinct Rush	2019-05-10	2	4	1	3	0.6251
Herald of the Depths	2019-04-30	4	4	1	5	0.6251
Life Combinations	2019-04-26	3	4	1	4	0.6251
Nick Logic for Kids	2019-05-19	3	4	1	4	0.6251
E06-Anomaly	2019-05-31	4	4	1	5	0.6251
Tunnel Vision	2019-10-08	1	4	1	2	0.6251
Vestige of the Past	2019-09-30	2	4	1	3	0.6251
The Panel DC	2019-06-25	3	4	1	4	0.6251
PsycoCat	2019-05-31	3	4	1	4	0.6251
Chaos Dream: Retribution	2019-06-25	2	4	1	3	0.6251
Break my body	2019-07-24	2	4	1	3	0.6251
The Beast of Gevaudan	2019-08-01	2	4	1	3	0.6251
Polar Jump	2019-07-18	3	4	1	4	0.6251
Guroopia!	2019-09-13	2	4	1	3	0.6251
CyberRunner	2019-08-30	10	4	1	11	0.6251
Otter Space Rescue	2019-08-27	1	4	1	2	0.6251
寻书人 Book Seeker	2019-08-23	3	4	1	4	0.6251
Parachronism: Order of Chaos	2019-09-13	1	4	1	2	0.6251
Wandering Gem Jockeying	2019-08-19	1	4	1	2	0.6251
Pentaball	2019-09-06	2	4	1	3	0.6251
Total Ski Jump	2019-09-10	1	4	1	2	0.6251
TILTit	2019-10-18	2	4	1	3	0.6251
Playing Both Sides	2019-09-24	5	4	1	6	0.6251
This Picture	2019-09-11	1	4	1	2	0.6251
Micro Car Crash Online Le Go!	2019-09-30	4	4	1	5	0.6251
Rambunny	2019-12-16	2	4	1	3	0.6251
Block Fall Simulator 2019	2019-10-16	2	4	1	3	0.6251
Living with a Scarecrow	2019-12-16	1	4	1	2	0.6251
PANDARA	2019-10-06	2	4	1	3	0.6251
BOW MAN	2019-10-07	12	4	1	13	0.6251
The Legend of Crystal Valley	2019-10-16	3	4	1	4	0.6251
Paranormal Files: Hook Man's Legend Collector's Edition	2019-09-27	5	4	1	6	0.6251
Starexcess	2019-11-21	1	4	1	2	0.6251
Golf98	2019-10-17	4	4	1	5	0.6251
MyStar	2019-11-12	3	4	1	4	0.6251
Disaster Dragon x Girls from Different Worlds	2019-11-05	4	4	1	5	0.6251
Exitium	2019-12-06	1	4	1	2	0.6251
BOTS	2019-12-05	4	4	1	5	0.6251
Phoenix Tales	2019-11-03	2	4	1	3	0.6251
DrumBeats VR	2019-02-01	12	90	46	58	0.625
Pineview Drive - Homeless	2019-04-05	28	66	33	61	0.625
Stick Em Up	2019-08-05	11	99	51	62	0.6247
YORG.io 3	2019-10-14	72	153	81	153	0.6241
Bury me, my Love	2019-01-10	21	73	37	58	0.624
Guards of the Gate	2019-01-30	17	28	13	30	0.6235
Otter of My Life	2019-10-04	4	28	13	17	0.6235
Favor Chess	2019-05-03	10	28	13	23	0.6235
Siege of Centauri	2019-09-12	204	261	142	346	0.6234000000000001
鬼山	2019-04-05	66	58	29	95	0.6234000000000001
Bubsy: Paws on Fire!	2019-05-16	11	45	22	33	0.6234000000000001
Valley of Decay	2019-06-27	42	69	35	77	0.6232
Countermark Saga Frozen sword	2019-06-06	8	26	12	20	0.6231
KiKi's adventure	2019-10-22	4	26	12	16	0.6231
Angeldust	2019-12-21	708	898	508	1216	0.623
Who Is This Man	2019-06-28	20	161	86	106	0.6229
Crypto Crisis	2019-02-21	9	24	11	20	0.6226
Flaws in the People We Love	2019-05-01	7	24	11	18	0.6226
Puzzle Walker (Demo)	2019-06-25	14	24	11	25	0.6226
My Happy Girls	2019-07-12	4	24	11	15	0.6226
SLEEPOVER	2019-01-18	53	22	10	63	0.6221
Tower of Fate	2019-08-13	6	22	10	16	0.6221
Hentai Shojo	2019-07-30	2	22	10	12	0.6221
Card Brawl	2019-01-26	6	20	9	15	0.6215
Super Demon Boy	2019-07-23	4	20	9	13	0.6215
Interactive Horror Stories	2019-10-25	15	81	42	57	0.6214000000000001
Bleeding Hunt VR Chap.1	2019-03-18	13	50	25	38	0.6214000000000001
城市生存计划	2019-11-06	18	37	18	36	0.6213000000000001
A Mining Game	2019-07-20	146	115	61	207	0.6211
The Adventures of Perseus	2019-02-27	5	18	8	13	0.621
Whipseey and the Lost Atlas	2019-08-27	5	18	8	13	0.621
Nevrosa: Primal Ritual	2019-11-23	4	18	8	12	0.621
Too White Basketball	2019-12-16	3	18	8	11	0.621
Mystery Case Files: Ravenhearst Unlocked Collector's Edition	2019-10-18	10	18	8	18	0.621
Steam Marines 2	2019-11-20	27	6	2	29	0.621
MECCHA ZOMBIES	2019-03-18	15	6	2	17	0.621
Hero's Story	2019-10-21	3	6	2	5	0.621
Snappy Turtle Ultimate	2019-12-04	3	6	2	5	0.621
Lost King's Lullaby	2019-04-25	2	6	2	4	0.621
Critical Gravity	2019-12-17	2	6	2	4	0.621
Guardians Of The Past	2019-03-14	4	6	2	6	0.621
The Black Widow	2019-08-01	2	6	2	4	0.621
Breacher Story	2019-01-02	2	6	2	4	0.621
Unknown	2019-01-05	3	6	2	5	0.621
Santa Tracker	2019-11-22	4	6	2	6	0.621
Once A Stray	2019-01-28	3	6	2	5	0.621
Snowrifters VEX	2019-06-30	11	6	2	13	0.621
Sweet Galaxy Adventure!	2019-07-03	6	6	2	8	0.621
Tales of Nebezem RPG: Red Peril	2019-03-15	7	6	2	9	0.621
Crossroads Extreme	2019-06-08	4	6	2	6	0.621
灵幻先生	2019-04-29	3	6	2	5	0.621
第四空间Fourth Space	2019-06-24	4	6	2	6	0.621
Illusion of L'Phalcia	2019-07-03	4	6	2	6	0.621
John's Wizard Dungeon	2019-08-01	2	6	2	4	0.621
Alone in the War	2019-10-16	2	6	2	4	0.621
Neon Tide	2019-09-16	1	6	2	3	0.621
Simple Railroad	2019-09-12	2	6	2	4	0.621
Return to Earth	2019-08-28	2	6	2	4	0.621
Those Chosen By God	2019-09-26	3	6	2	5	0.621
The Void of Desires	2019-10-07	1	6	2	3	0.621
Hooks & Shotguns	2019-10-19	2	6	2	4	0.621
我是院长	2019-10-14	6	6	2	8	0.621
"I Have Low Stats But My Class Is ""Leader"", So I Recruited Everyone I Know To Fight The Dark Lord"	2019-10-29	3	6	2	5	0.621
Ice Cream Fantasy - Ecchi Game	2019-11-22	2	6	2	4	0.621
War Robots: Planet Defender	2019-12-18	4	6	2	6	0.621
Plasmoid	2019-12-01	3	6	2	5	0.621
Planet Modular TD	2019-12-13	5	6	2	7	0.621
North Of Iraq Part 1	2019-12-20	3	6	2	5	0.621
Armadusa	2019-05-24	14	35	17	31	0.6207
Windscape	2019-03-27	22	203	111	133	0.6206
机退怪兽	2019-04-25	302	189	103	405	0.6206
Corona Borealis	2019-06-03	7	16	7	14	0.6204999999999999
WhiTaers	2019-01-24	5	16	7	12	0.6204999999999999
Nibû	2019-01-17	7	16	7	14	0.6204999999999999
Cooking Trip	2019-05-01	5	16	7	12	0.6204999999999999
THE SOUL HUNTER	2019-04-06	4	16	7	11	0.6204999999999999
Winter Magic Factory	2019-08-13	6	16	7	13	0.6204999999999999
Convenience Store	2019-10-03	12	16	7	19	0.6204999999999999
Explosive Jake	2019-11-10	7	16	7	14	0.6204999999999999
Winter Snow | 冬雪	2019-12-19	2	16	7	9	0.6204999999999999
Fantasy Strike	2019-07-25	383	1205	695	1078	0.6204
Rumble Arena	2019-06-07	75	127	68	143	0.6204
Unending Dusk	2019-03-18	10	46	23	33	0.6203000000000001
Golf Defied	2019-07-18	17	75	39	56	0.62
Miami Resort	2019-06-25	8	14	6	14	0.62
Baobabs Mausoleum Ep.3: Un Pato en Muertoburgo	2019-11-21	5	14	6	11	0.62
Boxing Champs	2019-05-30	3	14	6	9	0.62
Unsolved Mystery Club: Amelia Earhart	2019-07-23	4	14	6	10	0.62
UltraGoodness 2	2019-09-02	2	14	6	8	0.62
GraFi Christmas	2019-11-22	3	14	6	9	0.62
Dark Swords	2019-06-21	117	169	92	209	0.6199
The Bradwell Conspiracy	2019-10-08	42	55	28	70	0.6198
Пацанский цитатник / Russian Test	2019-06-25	3	55	28	31	0.6198
SuperEpic: The Entertainment War	2019-12-12	11	55	28	39	0.6198
Nanobotic	2019-04-22	104	107	57	161	0.6197
INVITATION	2019-05-17	9	44	22	31	0.6197
Third Eye	2019-08-05	5	8	3	8	0.6197
Mall Town	2019-06-20	3	8	3	6	0.6197
ArmZ VR	2019-03-28	3	8	3	6	0.6197
Chromatic Aberration	2019-01-11	2	8	3	5	0.6197
Drift King 2D	2019-05-11	5	8	3	8	0.6197
Gun Beat	2019-01-15	2	8	3	5	0.6197
Super Jigsaw Puzzle: Anime Reloaded	2019-02-13	6	8	3	9	0.6197
Dark Tales: Edgar Allan Poe's The Premature Burial Collector's Edition	2019-03-01	4	8	3	7	0.6197
Submarine Attack!	2019-05-17	3	8	3	6	0.6197
Attack Of The Retro Bots	2019-09-24	2	8	3	5	0.6197
Stroke Fill	2019-05-31	2	8	3	5	0.6197
Prison Ball: Full Blown	2019-07-13	40	8	3	43	0.6197
シニサギ	2019-07-24	3	8	3	6	0.6197
BOMTILES	2019-11-01	4	8	3	7	0.6197
Area 51	2019-08-08	3	8	3	6	0.6197
I'm from area 51	2019-08-07	2	8	3	5	0.6197
Treater	2019-08-26	2	8	3	5	0.6197
Disc Golf Adventure VR	2019-11-09	4	8	3	7	0.6197
Aria Dating Simulator	2019-11-17	3	8	3	6	0.6197
Aivolution	2019-01-30	49	12	5	54	0.6196
SUBARACITY	2019-04-04	5	12	5	10	0.6196
HORGIHUGH (ホーギーヒュー)	2019-06-11	4	12	5	9	0.6196
The Brink 尘与土	2019-05-11	5	12	5	10	0.6196
Trials of Harmony ~ Experimental Visual Novel	2019-09-30	3	12	5	8	0.6196
33 Rounds	2019-12-06	2	12	5	7	0.6196
final m00n - Defender of the Cubes	2019-01-31	3	10	4	7	0.6195
Fightttris VR	2019-02-27	4	10	4	8	0.6195
Lonia Saga 2	2019-08-19	23	10	4	27	0.6195
Seacurity Breach	2019-09-20	6	10	4	10	0.6195
PacketStorm	2019-02-28	4	10	4	8	0.6195
Triumph in the Skies	2019-11-26	5	10	4	9	0.6195
The Enthralling Realms: An Alchemist's Tale	2019-02-01	7	10	4	11	0.6195
Shantalia and Corali'hulu	2019-03-01	2	10	4	6	0.6195
Bowling Over It	2019-03-26	7	10	4	11	0.6195
Eva Reynes	2019-09-11	3	10	4	7	0.6195
Guns of Midnight	2019-06-04	6	10	4	10	0.6195
Grim Tales: The Vengeance Collector's Edition	2019-06-07	7	10	4	11	0.6195
LOCO	2019-09-20	2	10	4	6	0.6195
鸿门一宴(Malicious Dinner)	2019-09-10	2	10	4	6	0.6195
Drawing Path	2019-07-11	4	10	4	8	0.6195
Zorg The Typing Warrior	2019-07-10	2	10	4	6	0.6195
Church Art Of Sweden	2019-09-11	1	10	4	5	0.6195
Town Defence	2019-12-28	3	10	4	7	0.6195
Reincarnated As A Monster	2019-12-20	4	10	4	8	0.6195
CardLife	2019-02-28	444	1605	936	1380	0.6192000000000001
Generals & Rulers	2019-06-01	68	250	139	207	0.619
Play with NEKO	2019-11-18	5	42	21	26	0.619
Space Candy	2019-11-09	24	29	14	38	0.6186
live Desktop Beauty	2019-09-29	119	145	79	198	0.6185
Memorrha	2019-09-27	37	85	45	82	0.6184000000000001
时之回廊	2019-08-03	609	335	189	798	0.6182
Village Bus Driver Simulator	2019-10-25	3	67	35	38	0.618
Street Heat	2019-12-12	13	27	13	26	0.6178
Moi Mei	2019-07-18	9	27	13	22	0.6178
SUPERVERSE	2019-11-07	5	27	13	18	0.6178
巫师超凡者 Legend of the wizard 	2019-12-12	70	72	38	108	0.6171
VRLife	2019-04-11	17	25	12	29	0.6169
Plane Mechanic Simulator	2019-02-13	813	879	513	1326	0.6165999999999999
Diesel Brothers: Truck Building Simulator	2019-05-10	1377	793	463	1840	0.616
Jewel Puzzle Click	2019-08-07	3	23	11	14	0.616
Latte Stand Tycoon	2019-01-26	6	23	11	17	0.616
Block of Rum	2019-02-05	4	23	11	15	0.616
The Voice from Heaven	2019-01-28	9	23	11	20	0.616
Funny Archery	2019-10-04	10	23	11	21	0.616
Elon Must - Road to Respect	2019-04-18	3	34	17	20	0.6159
Extraction Valley	2019-08-14	138	43	22	160	0.6158
泠：落日孤行 - Ling	2019-09-17	40	148	82	122	0.6156
Epic Fun	2019-11-06	17	50	26	43	0.6152000000000001
Fade to Silence	2019-04-30	678	754	442	1120	0.615
BIOSZARD Corporation	2019-05-03	6	21	10	16	0.6149
Hentai Eroshojo	2019-09-23	2	21	10	12	0.6149
TD Heroes	2019-11-18	5	21	10	15	0.6149
The Fisherman - Fishing Planet	2019-10-17	644	681	399	1043	0.6146
Spellsword Cards: Demontide	2019-03-08	30	48	25	55	0.6144
Cyber Gun	2019-04-23	7	48	25	32	0.6144
Business Magnate	2019-03-01	118	128	71	189	0.6142000000000001
Draw With Unknown	2019-04-18	15	76	41	56	0.614
The Far Kingdoms: Elements	2019-01-04	7	19	9	16	0.6138
Trouble Travel TT	2019-02-14	6	19	9	15	0.6138
The Den of Chaos - 混沌の魔窟殿～アヒアハン１９世の指令編～	2019-01-18	10	19	9	19	0.6138
The Way of Cinnamon	2019-07-16	9	19	9	18	0.6138
EnviroGolf	2019-11-15	2	19	9	11	0.6138
Jungle Guardians	2019-02-28	64	46	24	88	0.6136
Vicious Circle	2019-08-13	323	165	93	416	0.6133
Gangsta Woman	2019-07-22	3	60	32	35	0.6133
妄想破绽	2019-11-27	3043	2478	1497	4540	0.6132
KurtzPel	2019-04-30	11937	21481	13267	25204	0.6131000000000001
Snow Arena	2019-06-25	16	28	14	30	0.6129
WARMODE	2019-09-14	3066	10466	6447	9513	0.6125
The Pusher	2019-02-22	8	17	8	16	0.6125
GOK	2019-03-26	5	17	8	13	0.6125
Soul Valley	2019-07-25	7	17	8	15	0.6125
Orc Raid	2019-07-20	3	17	8	11	0.6125
Songs of Skydale	2019-08-21	6	17	8	14	0.6125
1, 2, 3... Bruegel!	2019-06-19	8	17	8	16	0.6125
HUNTERS FOR YOUR BRAIN	2019-11-09	4	17	8	12	0.6125
Dream Detective	2019-12-04	9	17	8	17	0.6125
Drawkanoid: Review Breaker	2019-11-18	12	17	8	20	0.6125
RAGE 2	2019-05-14	13673	9391	5786	19459	0.6122
Dark Future: Blood Red States	2019-05-16	99	263	152	251	0.612
Happy Anime Puzzle	2019-04-04	5	42	22	27	0.6118
Trollskog	2019-08-19	24	26	13	37	0.6118
Warhammer Age of Sigmar: Champions	2019-02-19	182	217	125	307	0.6113000000000001
Depraved	2019-09-21	723	693	413	1136	0.6112
GATARI	2019-04-25	4	15	7	11	0.6111
BATTLLOON	2019-02-27	5	15	7	12	0.6111
Shivering Sky	2019-02-04	3	15	7	10	0.6111
Whack A Hoe	2019-08-15	4	15	7	11	0.6111
Cage of the Succubi	2019-12-06	70	85	47	117	0.6109
Road to your City	2019-11-18	26	47	25	51	0.6108
Demon Pit	2019-10-17	8	47	25	33	0.6108
Cube Land Arena	2019-03-08	1017	149	85	1102	0.6103000000000001
Record of Agarest War Mariage	2019-02-01	67	88	49	116	0.61
Optimum Link	2019-03-01	36	76	42	78	0.6099
Inferna	2019-12-20	2907	1227	745	3652	0.6098
U-BOOT The Board Game	2019-05-23	15	45	24	39	0.6098
eMemories	2019-07-19	8	38	20	28	0.6097
Deep Diving Simulator	2019-05-27	24	57	31	55	0.6095
HexLab	2019-01-25	4	13	6	10	0.6095
Of Ships & Scoundrels	2019-11-14	7	13	6	13	0.6095
Tiny Love	2019-02-16	9	13	6	15	0.6095
Hex Defense - VR	2019-02-15	6	13	6	12	0.6095
Dumb test: Check your teammates	2019-02-11	2	13	6	8	0.6095
Codex Temondera: Lost Vision	2019-07-30	7	13	6	13	0.6095
Heroland	2019-12-03	9	13	6	15	0.6095
Mother Daughter Pleasure Pets	2019-09-20	14	50	27	41	0.6091
Norman's Great Illusion	2019-08-29	26	22	11	37	0.609
Picross Bonbon - Nonogram	2019-06-20	20	43	23	43	0.6088
Eternal Essence	2019-11-14	13	29	15	28	0.6085
Crystal Maidens	2019-06-03	250	427	256	506	0.6076
Scrunk	2019-04-16	8	11	5	13	0.6076
The Endless Mission	2019-11-14	26	11	5	31	0.6076
天罡星宿海	2019-03-15	4	11	5	9	0.6076
The Lovebirds	2019-07-24	3	11	5	8	0.6076
CosPuzzle	2019-03-07	4	11	5	9	0.6076
Era of Miracles	2019-10-02	3	11	5	8	0.6076
弹幕那个恶人	2019-03-21	7	11	5	12	0.6076
PUZZLE: OCEAN	2019-04-13	4	11	5	9	0.6076
Elite Escape	2019-10-18	3	11	5	8	0.6076
TERMINAL	2019-12-17	3	11	5	8	0.6076
Dream Home	2019-11-27	18	20	10	28	0.6074
Below Sunshade	2019-11-19	26	46	25	51	0.6071
Groomer	2019-03-11	3	27	14	17	0.6071
Survivor	2019-04-22	20	73	41	61	0.6067
The Occupation	2019-03-05	115	202	119	234	0.6066
Iron Blade	2019-06-25	38	98	56	94	0.6065
Tanks2.DE	2019-03-22	23	56	31	54	0.6063000000000001
Outlaws of the Old West	2019-03-12	4751	3659	2298	7049	0.6059
Infinite Children	2019-05-06	15	86	49	64	0.6058
Fighter Royale - Last Ace Flying	2019-04-29	28	49	27	55	0.6056
Hentai Girl Sets	2019-03-29	10	18	9	19	0.6055
Hentai Octoq Puzzle	2019-01-26	5	18	9	14	0.6055
Try 'n Cry - Prologue	2019-12-12	8	18	9	17	0.6055
WheelTravel	2019-04-18	12	9	4	16	0.6054
Future Aero Racing S Ultra	2019-02-21	3	9	4	7	0.6054
Data mining 5	2019-01-25	2	9	4	6	0.6054
5.84 Wing	2019-03-08	2	9	4	6	0.6054
Beat Blaster	2019-02-15	4	9	4	8	0.6054
The Antidote	2019-02-22	3	9	4	7	0.6054
Exogenesis ~Perils of Rebirth~	2019-04-19	7	9	4	11	0.6054
The Red Reactor	2019-05-10	6	9	4	10	0.6054
The Garden Pub	2019-04-29	3	9	4	7	0.6054
Who Are You, Mr. Cooper?	2019-05-23	2	9	4	6	0.6054
.fall	2019-10-28	6	9	4	10	0.6054
Beyond the Wizard	2019-06-22	6	9	4	10	0.6054
Oceanum Mortis	2019-07-19	3	9	4	7	0.6054
Heroes of Shaola	2019-08-01	3	9	4	7	0.6054
Saturday of Piercing Screams	2019-08-15	2	9	4	6	0.6054
VITAL	2019-12-13	5	9	4	9	0.6054
零下记忆	2019-12-19	4	9	4	8	0.6054
Basic Car Repair Garage VR	2019-11-10	4	9	4	8	0.6054
Space Junkies	2019-03-26	61	220	131	192	0.6051
Survive on Raft	2019-07-06	48	520	318	366	0.6046
Blind Date 3D	2019-08-15	17	30	16	33	0.6043999999999999
My Bike	2019-08-16	3	30	16	19	0.6043999999999999
Magic Quest: TCG	2019-09-04	34	30	16	50	0.6043999999999999
H Chan: Girl	2019-05-28	5	23	12	17	0.6037
Ecio	2019-06-20	22	23	12	34	0.6037
Idle Earth	2019-01-04	15	16	8	23	0.6034
The Unintended Consequences of Curiosity	2019-03-22	4	16	8	12	0.6034
Dragon Racer	2019-01-31	32	16	8	40	0.6034
Psycho Train	2019-06-06	6	16	8	14	0.6034
Cricket Captain 2019	2019-05-30	166	55	31	197	0.6032000000000001
Arcade Classics Anniversary Collection	2019-04-18	46	171	102	148	0.603
AT SUNDOWN: Shots in the Dark	2019-01-22	655	28	15	670	0.6028
Hentai puzzle ? Not again....	2019-04-01	3	28	15	18	0.6028
#SkiJump	2019-06-28	3	7	3	6	0.6028
Little Einar	2019-01-19	2	7	3	5	0.6028
Franky Lettuce 🥗	2019-01-22	2	7	3	5	0.6028
Happy Empire - A Bouquet for the Princess: Enhanced Edition	2019-03-11	4	7	3	7	0.6028
1001 Jigsaw. World Tour: Great America	2019-01-21	3	7	3	6	0.6028
EF Universe: Reclaiming the World	2019-03-28	19	7	3	22	0.6028
In Orbit	2019-01-18	5	7	3	8	0.6028
Agartha	2019-03-20	5	7	3	8	0.6028
Moonlight thief	2019-04-27	5	7	3	8	0.6028
Fruit Lockers Reborn! 2	2019-01-23	4	7	3	7	0.6028
Kanji in Motion	2019-07-26	4	7	3	7	0.6028
Block Dodge Challenge	2019-08-29	5	7	3	8	0.6028
Time Traveler	2019-04-25	2	7	3	5	0.6028
Day: 40	2019-05-27	3	7	3	6	0.6028
Animal Friends Adventure	2019-05-02	4	7	3	7	0.6028
Make Route: Escape the police	2019-04-26	2	7	3	5	0.6028
New Yankee in King Arthur's Court 4	2019-04-26	7	7	3	10	0.6028
Sudoku 9X16X25	2019-06-22	3	7	3	6	0.6028
方解夢異聞 ～ Avant-Garde Discerning Paralleler	2019-06-28	4	7	3	7	0.6028
Gunk	2019-12-09	3	7	3	6	0.6028
Anime Girls Jigsaw Puzzles	2019-08-21	3	7	3	6	0.6028
Hospital 9	2019-10-25	3	7	3	6	0.6028
zzzzz	2019-10-08	3	7	3	6	0.6028
Grand Academy II: Attack of the Sequel	2019-11-07	12	7	3	15	0.6028
The Magician's Workshop	2019-12-19	13	7	3	16	0.6028
Room Escape '1053'	2019-12-12	2	7	3	5	0.6028
Dark Invasion VR	2019-12-12	2	7	3	5	0.6028
The Settlers 7 : History Edition	2019-01-22	307	409	251	558	0.6027
SurvivalZ Battlegrounds	2019-04-02	67	219	132	199	0.6027
Your Home	2019-02-27	4	33	18	22	0.6023
HENTAI GIRL PUZZLE	2019-04-05	6	33	18	24	0.6023
Earth Atlantis	2019-01-29	7	38	21	28	0.6021
Princess Maker Go!Go! Princess	2019-12-23	54	76	44	98	0.6019
RIFF VR	2019-03-11	7	21	11	18	0.6017
Love ritual	2019-04-09	31	66	38	69	0.6015
Trapped on Monster Island	2019-10-04	129	79	46	175	0.6012
Undholm	2019-01-07	29	56	32	61	0.6011
Girl X	2019-06-07	12	26	14	26	0.601
HelixVision	2019-09-02	10	87	51	61	0.6009000000000001
Cryptrunner	2019-05-28	7	14	7	14	0.6009000000000001
Mortadelo y Filemón: El sulfato atómico	2019-05-22	3	14	7	10	0.6009000000000001
I Know Everything	2019-06-07	6	14	7	13	0.6009000000000001
Shuttlecock-H	2019-05-24	7	14	7	14	0.6009000000000001
Zombie Rush : Extinction	2019-07-02	12	14	7	19	0.6009000000000001
Hidden	2019-08-07	5	14	7	12	0.6009000000000001
Jera	2019-08-21	9	14	7	16	0.6009000000000001
Summon of asmodeus	2019-04-30	36	103	61	97	0.6005
Battlegrounds2D.io	2019-08-15	2	5	2	4	0.5997
Bloodgeon	2019-11-02	4	5	2	6	0.5997
The Broken Seal: Arena	2019-10-20	5	5	2	7	0.5997
UglyDolls: An Imperfect Adventure	2019-04-26	4	5	2	6	0.5997
CubeCreatorX	2019-11-14	3	5	2	5	0.5997
Trends	2019-01-08	7	5	2	9	0.5997
1001 Jigsaw. World Tour: London	2019-02-05	4	5	2	6	0.5997
化者天狱 Revenant in the Paradise	2019-02-04	2	5	2	4	0.5997
The Angry Banana	2019-02-12	2	5	2	4	0.5997
The Virtual Reality Museum of Immersive Experiences	2019-02-20	2	5	2	4	0.5997
Flying in Labyrinth	2019-02-17	1	5	2	3	0.5997
Hockey Camp - Goaltender	2019-02-11	2	5	2	4	0.5997
Hentai Babes - Sport Lovers	2019-03-20	2	5	2	4	0.5997
Ancient Battle: Successors	2019-09-04	3	5	2	5	0.5997
100 Years’ War	2019-08-09	4	5	2	6	0.5997
In.My.Mind	2019-03-12	2	5	2	4	0.5997
The Crater	2019-04-05	3	5	2	5	0.5997
Universe 24	2019-04-23	2	5	2	4	0.5997
The Prison	2019-07-12	4	5	2	6	0.5997
The Superlatives: Shattered Worlds	2019-03-28	17	5	2	19	0.5997
Ballista Legend	2019-04-19	3	5	2	5	0.5997
Super Lumberjack	2019-05-02	1	5	2	3	0.5997
The First Day	2019-06-07	3	5	2	5	0.5997
Decker	2019-06-24	3	5	2	5	0.5997
Turn Me On	2019-08-18	1	5	2	3	0.5997
reD:起始的旋转之音	2019-07-12	3	5	2	5	0.5997
Solitaire Match 2 Cards. Valentine's Day	2019-09-09	4	5	2	6	0.5997
1001 Jigsaw World Tour: Europe	2019-08-19	6	5	2	8	0.5997
Magistrangers	2019-08-21	6	5	2	8	0.5997
Jigoro	2019-08-22	4	5	2	6	0.5997
polyfuru feat. ASANO RURI / ポリフる feat. 朝ノ瑠璃	2019-09-20	7	5	2	9	0.5997
Blackbeard the Cursed Jungle	2019-09-18	2	5	2	4	0.5997
Super Minesweeper attACK	2019-09-18	2	5	2	4	0.5997
Old School Horror Game : Bright Day	2019-10-24	1	5	2	3	0.5997
Metrail	2019-11-02	2	5	2	4	0.5997
Cowboys vs Hipsters	2019-12-10	2	5	2	4	0.5997
In the Service of Mrs. Claus	2019-12-12	11	5	2	13	0.5997
Aloe and Cal	2019-12-27	2	5	2	4	0.5997
Box: The Game	2019-01-16	412	112	67	479	0.5994
Goblin's Shop	2019-04-19	77	44	25	102	0.5994
TankDestruction	2019-07-10	40	19	10	50	0.5994
Terminal squad: Sentinel	2019-12-19	4	19	10	14	0.5994
AreaZ	2019-10-23	11	39	22	33	0.5991
Ylands	2019-12-05	5540	4217	2737	8277	0.599
Power & Revolution 2019 Edition	2019-03-12	340	736	466	806	0.599
Sex City	2019-09-06	4	24	13	17	0.5989
Catching	2019-05-02	21	29	16	37	0.5988
Zombie Killing Simulator	2019-02-11	7	52	30	37	0.5987
The Rescue of Mermaids	2019-05-23	10	47	27	37	0.5982999999999999
Diesel Express VR	2019-01-23	3	12	6	9	0.598
The Ultra Code	2019-08-07	5	12	6	11	0.598
Mythical	2019-02-16	23	12	6	29	0.598
The Last Roman Village	2019-07-26	5	12	6	11	0.598
Slime Simulator Games	2019-04-01	4	12	6	10	0.598
Bloodstream	2019-08-07	3	12	6	9	0.598
Alphaman	2019-11-19	3	12	6	9	0.598
SHEEP.IO	2019-06-16	4	12	6	10	0.598
Angler's Life	2019-10-31	5	12	6	11	0.598
叫我铸造师	2019-09-17	10	12	6	16	0.598
THE LAST SURVIVOR	2019-01-25	28	42	24	52	0.5979
Hacked: Hentai prison	2019-08-15	6	50	29	35	0.5974
Ashes of Oahu	2019-08-29	9	32	18	27	0.5971000000000001
1000$	2019-07-31	3	32	18	21	0.5971000000000001
Rest In Pieces	2019-11-16	6	32	18	24	0.5971000000000001
Hide and Seek	2019-02-01	63	450	285	348	0.5969
Battle Arena	2019-09-16	25	27	15	40	0.5968
Outbreak: Lost Hope	2019-04-22	3	17	9	12	0.5968
Dirty Education	2019-02-13	6	22	12	18	0.5966
Junglex	2019-04-05	7	22	12	19	0.5966
The Backrooms Simulator	2019-07-23	3	22	12	15	0.5966
Love love demon ji	2019-11-26	5	22	12	17	0.5966
Maui Mallard in Cold Shadow	2019-05-17	7	40	23	30	0.5963
Peasant Knight	2019-03-22	2	3	1	3	0.596
Aussie Sports VR 2016	2019-03-05	7	3	1	8	0.596
Tunnel VR	2019-10-16	2	3	1	3	0.596
Alive Hunter	2019-11-21	1	3	1	2	0.596
NO LOVE	2019-11-25	2	3	1	3	0.596
Abandoned Snowy Castle	2019-05-28	2	3	1	3	0.596
Miner	2019-01-01	2	3	1	3	0.596
Ricecakers	2019-11-30	2	3	1	3	0.596
Drone Spektra	2019-06-03	2	3	1	3	0.596
Dumb Little Creatures	2019-05-22	3	3	1	4	0.596
The Party of Demons	2019-01-18	2	3	1	3	0.596
Antistatic	2019-01-24	4	3	1	5	0.596
Furry Shakespeare: Dashing Dinosaurs & Sexy Centaurs	2019-08-28	3	3	1	4	0.596
COUCH VERSUS	2019-01-23	1	3	1	2	0.596
Abrakadaboom	2019-04-18	2	3	1	3	0.596
The Great Emu War	2019-02-25	1	3	1	2	0.596
Ninja Power Slasher	2019-01-28	2	3	1	3	0.596
Cell Defender	2019-05-08	3	3	1	4	0.596
Where is The Beach	2019-01-18	2	3	1	3	0.596
Again	2019-06-24	3	3	1	4	0.596
Settlement Zero	2019-02-06	1	3	1	2	0.596
Dragon Iris	2019-02-01	2	3	1	3	0.596
Crash Landed	2019-03-13	1	3	1	2	0.596
DUST-UP	2019-02-23	4	3	1	5	0.596
Jump Doper	2019-08-01	6	3	1	7	0.596
Ghost Buster 3D	2019-02-14	1	3	1	2	0.596
Rollossus	2019-03-02	4	3	1	5	0.596
Firon	2019-03-02	1	3	1	2	0.596
Art by Numbers	2019-10-14	4	3	1	5	0.596
Ancient Battle: Alexander	2019-07-25	3	3	1	4	0.596
Age of Darkness: Die Suche nach Relict	2019-05-22	2	3	1	3	0.596
礎の楯 -AEGIS-	2019-06-11	3	3	1	4	0.596
AttackNoids	2019-03-25	1	3	1	2	0.596
Helltower	2019-03-26	2	3	1	3	0.596
都市恐怖故事	2019-03-29	3	3	1	4	0.596
busy spider	2019-05-31	3	3	1	4	0.596
ZombieOrNotZombie	2019-04-17	1	3	1	2	0.596
Ghoul Britannia: Land of Hope and Gorey	2019-10-09	2	3	1	3	0.596
Summer Resort Mogul	2019-04-05	4	3	1	5	0.596
Rick Rack	2019-08-01	2	3	1	3	0.596
Achievement Machine: Cubic Chaos	2019-11-22	2	3	1	3	0.596
Exemption	2019-05-30	2	3	1	3	0.596
PhilGood	2019-08-05	2	3	1	3	0.596
The Lost Game	2019-06-20	7	3	1	8	0.596
原体	2019-06-16	1	3	1	2	0.596
Karl BOOM	2019-11-01	6	3	1	7	0.596
Vermin Hunter	2019-10-25	2	3	1	3	0.596
Round Rooms	2019-07-16	2	3	1	3	0.596
4K Bricks Breaker Plus	2019-10-02	1	3	1	2	0.596
Contraptions	2019-10-08	2	3	1	3	0.596
HoloSprint	2019-12-27	1	3	1	2	0.596
Meu Mundo	2019-08-05	3	3	1	4	0.596
FlyCatcher	2019-11-06	110	3	1	111	0.596
Solitaire Jack Frost Winter Adventures	2019-09-02	5	3	1	6	0.596
Monster planet	2019-09-09	2	3	1	3	0.596
Drift 1969	2019-09-11	2	3	1	3	0.596
Hero Of The Forest	2019-10-03	2	3	1	3	0.596
Hexagun	2019-11-04	2	3	1	3	0.596
Lithium Inmate 39 Relapsed Edition	2019-11-05	2	3	1	3	0.596
Victoriana - Steampunk Text Adventure	2019-10-13	2	3	1	3	0.596
Math The Question	2019-10-25	1	3	1	2	0.596
Future Snooker	2019-11-15	2	3	1	3	0.596
Space Station Invader VR	2019-12-31	1	3	1	2	0.596
Speed Masters ASD	2019-11-28	1	3	1	2	0.596
Stripper Anya: Christmas Special	2019-12-16	4	3	1	5	0.596
Escape the Ninja Room	2019-12-17	2	3	1	3	0.596
Newt One	2019-09-06	6	43	25	31	0.5954
Windstorm: An Unexpected Arrival	2019-03-28	18	43	25	43	0.5954
Monster Castle	2019-03-26	71	67	40	111	0.5953
Battle Survive Hentai	2019-12-11	3	30	17	20	0.5952000000000001
Donald VS Martians	2019-04-19	4	25	14	18	0.5946
Hotel Giant	2019-07-04	8	10	5	13	0.5943
Brrrainz: Feed your Hunger	2019-04-05	9	10	5	14	0.5943
Summer Rush	2019-05-10	3	10	5	8	0.5943
С15	2019-08-03	2	10	5	7	0.5943
曲阿小将	2019-11-20	19	10	5	24	0.5943
Elite Soldier: 3D Shooter	2019-09-05	4	10	5	9	0.5943
Infectis	2019-10-07	6	10	5	11	0.5943
MiMiMiShKa	2019-11-02	3	10	5	8	0.5943
Goblin Quest: Escape!	2019-02-19	1	1	0	1	0.5942000000000001
The Invasion of Area 51	2019-10-25	1	1	0	1	0.5942000000000001
¡Zombies! : Faulty Towers	2019-08-14	1	1	0	1	0.5942000000000001
Music of the Spheres	2019-05-25	1	1	0	1	0.5942000000000001
Proton Ball	2019-02-18	2	1	0	2	0.5942000000000001
Cardinal Conclave	2019-09-27	1	1	0	1	0.5942000000000001
Bacon Roll	2019-02-06	1	1	0	1	0.5942000000000001
Cannon Fire	2019-03-20	1	1	0	1	0.5942000000000001
Sub Terra Draconis	2019-12-02	2	1	0	2	0.5942000000000001
Multiple Views Objects	2019-04-21	1	1	0	1	0.5942000000000001
Bifrost Project	2019-09-30	2	1	0	2	0.5942000000000001
Dungeon Jump	2019-06-13	1	1	0	1	0.5942000000000001
Realmstone	2019-07-26	2	1	0	2	0.5942000000000001
G.A.M.E.S	2019-07-30	1	1	0	1	0.5942000000000001
Snakelike	2019-01-11	2	1	0	2	0.5942000000000001
AI Vendetta	2019-09-02	2	1	0	2	0.5942000000000001
UFO Simulator Control Master	2019-01-14	1	1	0	1	0.5942000000000001
Ficterra	2019-02-27	3	1	0	3	0.5942000000000001
Homo Flimsy	2019-09-11	2	1	0	2	0.5942000000000001
Maze Crusher	2019-09-06	3	1	0	3	0.5942000000000001
The Disgusting Slaughterman	2019-12-18	2	1	0	2	0.5942000000000001
The Misadventures of Denniz & Diana	2019-02-28	2	1	0	2	0.5942000000000001
Circle Brawl	2019-02-27	2	1	0	2	0.5942000000000001
Quirky Crystal RPG	2019-02-20	4	1	0	4	0.5942000000000001
Chronophobia	2019-09-13	1	1	0	1	0.5942000000000001
Engram	2019-01-05	1	1	0	1	0.5942000000000001
Crimson Souls	2019-05-16	1	1	0	1	0.5942000000000001
Avoidon	2019-12-05	1	1	0	1	0.5942000000000001
Robot Female Hero 1	2019-03-13	1	1	0	1	0.5942000000000001
ManGuin – Penguin Apocalypse	2019-12-11	1	1	0	1	0.5942000000000001
BoxTheTop	2019-01-16	2	1	0	2	0.5942000000000001
Radio Violence	2019-04-16	4	1	0	4	0.5942000000000001
Party Poppers	2019-01-24	4	1	0	4	0.5942000000000001
Slide to finish	2019-04-29	1	1	0	1	0.5942000000000001
Surge Radio	2019-10-18	4	1	0	4	0.5942000000000001
Trash Rage	2019-04-26	2	1	0	2	0.5942000000000001
Antrum	2019-02-14	3	1	0	3	0.5942000000000001
Galactic Campaign	2019-04-25	2	1	0	2	0.5942000000000001
SHNIPERS	2019-11-15	2	1	0	2	0.5942000000000001
Tactics: Age of Affliction	2019-12-03	1	1	0	1	0.5942000000000001
Stellar Sphere	2019-03-29	1	1	0	1	0.5942000000000001
Battle of the Boros	2019-03-15	1	1	0	1	0.5942000000000001
Alien Jelly: Food For Thought!	2019-09-02	1	1	0	1	0.5942000000000001
The Tourist Trap	2019-05-30	5	1	0	5	0.5942000000000001
Wild Ride	2019-11-19	1	1	0	1	0.5942000000000001
Space Cruise	2019-01-17	2	1	0	2	0.5942000000000001
Bahama Conch n Burger Shack	2019-01-14	2	1	0	2	0.5942000000000001
Zero spring episode 3	2019-01-11	2	1	0	2	0.5942000000000001
Kill Tiger	2019-03-01	2	1	0	2	0.5942000000000001
Twisting Mower	2019-05-22	2	1	0	2	0.5942000000000001
M.C.I. Escapes	2019-02-20	2	1	0	2	0.5942000000000001
CrossTrix	2019-01-03	2	1	0	2	0.5942000000000001
De Profundis	2019-01-25	1	1	0	1	0.5942000000000001
Anti-Grav	2019-01-26	1	1	0	1	0.5942000000000001
Retro Space Shooter	2019-02-28	8	1	0	8	0.5942000000000001
Colorvore	2019-02-23	1	1	0	1	0.5942000000000001
Tanks Endeavor	2019-07-31	2	1	0	2	0.5942000000000001
Maze Quest 2: The Desert	2019-07-02	1	1	0	1	0.5942000000000001
Hello Emoji: Drawing to Solve Puzzles	2019-01-21	2	1	0	2	0.5942000000000001
Achievement Collector: Zombie	2019-01-25	1	1	0	1	0.5942000000000001
Elephants Can't Jump	2019-03-05	1	1	0	1	0.5942000000000001
Caverns of Karvella	2019-02-02	1	1	0	1	0.5942000000000001
Why Chicken? Why?	2019-02-07	2	1	0	2	0.5942000000000001
Top Torch	2019-02-09	1	1	0	1	0.5942000000000001
Baby Bee	2019-02-01	1	1	0	1	0.5942000000000001
Asteroid Navigation	2019-02-01	1	1	0	1	0.5942000000000001
Heroes of the Earth: inVasion	2019-04-30	2	1	0	2	0.5942000000000001
Trapped in Fear	2019-12-02	1	1	0	1	0.5942000000000001
Arch Drift	2019-02-07	2	1	0	2	0.5942000000000001
怪獣綺譚 朧十夜 空狐万華鏡	2019-02-15	1	1	0	1	0.5942000000000001
Micro Mayhem	2019-02-08	4	1	0	4	0.5942000000000001
VCuber	2019-02-26	1	1	0	1	0.5942000000000001
Combat Overrun	2019-08-28	2	1	0	2	0.5942000000000001
La Fuga	2019-03-28	1	1	0	1	0.5942000000000001
Cursor - by Mr iLyn.	2019-02-23	2	1	0	2	0.5942000000000001
Forever Lost: Episode 2	2019-03-04	4	1	0	4	0.5942000000000001
Full Pitch	2019-03-15	2	1	0	2	0.5942000000000001
Homing Shapes	2019-02-24	2	1	0	2	0.5942000000000001
420 Button Clicker	2019-02-14	1	1	0	1	0.5942000000000001
Bikini Surfer Girl - Wild Wahine	2019-03-22	1	1	0	1	0.5942000000000001
Maze Ninja	2019-02-22	1	1	0	1	0.5942000000000001
Sin; Vengeance	2019-02-26	2	1	0	2	0.5942000000000001
BionicBlitz	2019-02-27	2	1	0	2	0.5942000000000001
Two For One	2019-06-13	2	1	0	2	0.5942000000000001
Super Kittens	2019-03-10	2	1	0	2	0.5942000000000001
reaktron	2019-08-23	3	1	0	3	0.5942000000000001
Ne Touchez Pas 5	2019-03-04	2	1	0	2	0.5942000000000001
Big Boot Baseball	2019-04-13	1	1	0	1	0.5942000000000001
Space Bound	2019-03-05	1	1	0	1	0.5942000000000001
Long Z-Night	2019-05-23	2	1	0	2	0.5942000000000001
Boxed Out	2019-08-08	2	1	0	2	0.5942000000000001
Haprokon	2019-11-19	4	1	0	4	0.5942000000000001
Bears in Tanks	2019-04-01	4	1	0	4	0.5942000000000001
Stoppa!	2019-03-15	2	1	0	2	0.5942000000000001
Dracologic	2019-03-20	1	1	0	1	0.5942000000000001
Similars: Climb	2019-08-07	2	1	0	2	0.5942000000000001
酔いどれクイズshow 標鍛	2019-03-12	2	1	0	2	0.5942000000000001
BlueGlow	2019-03-28	1	1	0	1	0.5942000000000001
Daka Dara	2019-03-25	2	1	0	2	0.5942000000000001
UFOGEN	2019-03-20	1	1	0	1	0.5942000000000001
Observers	2019-04-09	4	1	0	4	0.5942000000000001
Time Warrior Z VR	2019-04-11	1	1	0	1	0.5942000000000001
Dimense: Chapter 1	2019-03-31	1	1	0	1	0.5942000000000001
Destruction	2019-03-19	2	1	0	2	0.5942000000000001
unknown garden	2019-03-28	3	1	0	3	0.5942000000000001
Contort Effect	2019-08-09	1	1	0	1	0.5942000000000001
eCrossminton	2019-07-10	2	1	0	2	0.5942000000000001
Asteroid Wars	2019-03-29	1	1	0	1	0.5942000000000001
Sqvishy	2019-04-29	1	1	0	1	0.5942000000000001
UNI TURRET	2019-04-10	1	1	0	1	0.5942000000000001
Hitchhiker	2019-05-03	2	1	0	2	0.5942000000000001
Noodle Jump	2019-04-30	1	1	0	1	0.5942000000000001
The Artifacts	2019-05-01	1	1	0	1	0.5942000000000001
Hour of the Snake	2019-04-19	2	1	0	2	0.5942000000000001
Fantasy Battles	2019-05-07	2	1	0	2	0.5942000000000001
Moonlight Warrior	2019-04-16	1	1	0	1	0.5942000000000001
Wizardas	2019-06-02	2	1	0	2	0.5942000000000001
Sentenced	2019-04-26	1	1	0	1	0.5942000000000001
Wolfgate	2019-05-21	2	1	0	2	0.5942000000000001
Boxwrecker Arena	2019-09-12	2	1	0	2	0.5942000000000001
War of the Seraphim	2019-05-23	1	1	0	1	0.5942000000000001
Maze of Memories	2019-04-26	2	1	0	2	0.5942000000000001
BL00	2019-05-09	1	1	0	1	0.5942000000000001
Forest of Evil	2019-06-21	2	1	0	2	0.5942000000000001
VR Party Pack	2019-05-04	1	1	0	1	0.5942000000000001
The Legion: FringeBound	2019-05-17	2	1	0	2	0.5942000000000001
BRG's Alice in Wonderland Visual Novel	2019-05-31	2	1	0	2	0.5942000000000001
Eternal Elements	2019-12-13	2	1	0	2	0.5942000000000001
Vacation Adventures: Cruise Director 2	2019-05-13	3	1	0	3	0.5942000000000001
Grit	2019-05-10	3	1	0	3	0.5942000000000001
Fakespearean: Overdramatic	2019-05-21	1	1	0	1	0.5942000000000001
Plague of Days	2019-05-23	2	1	0	2	0.5942000000000001
Open Ocean	2019-06-11	1	1	0	1	0.5942000000000001
Pirates of First Star	2019-06-24	2	1	0	2	0.5942000000000001
Rayball	2019-07-16	2	1	0	2	0.5942000000000001
Rigid Chess	2019-05-15	2	1	0	2	0.5942000000000001
Legion of Scorn	2019-05-24	1	1	0	1	0.5942000000000001
The Astrolarix	2019-05-16	1	1	0	1	0.5942000000000001
The New Universes: ~ Eine Neue Reise Beginnt ~ Chapter 1	2019-11-18	1	1	0	1	0.5942000000000001
Click Defense	2019-06-07	2	1	0	2	0.5942000000000001
Sky Realm: Essences	2019-05-31	3	1	0	3	0.5942000000000001
Cannibal Chickens	2019-06-11	1	1	0	1	0.5942000000000001
BRG's Red Riding Hood Visual Novel	2019-05-31	2	1	0	2	0.5942000000000001
Horresco Referens	2019-10-26	2	1	0	2	0.5942000000000001
Project ONe プロジェクト・ワン	2019-05-22	2	1	0	2	0.5942000000000001
Kaos	2019-05-28	1	1	0	1	0.5942000000000001
Blockus' Adventures	2019-05-28	2	1	0	2	0.5942000000000001
Master Cube	2019-07-18	1	1	0	1	0.5942000000000001
Altorius	2019-09-06	2	1	0	2	0.5942000000000001
Buzz Kill Zero	2019-11-15	1	1	0	1	0.5942000000000001
Cumulus	2019-12-17	1	1	0	1	0.5942000000000001
zumoubattoru	2019-06-11	1	1	0	1	0.5942000000000001
Roll+Heart	2019-08-02	3	1	0	3	0.5942000000000001
Nebulas Lasso	2019-08-02	3	1	0	3	0.5942000000000001
Nigel: The Minuscule Adventure	2019-08-19	1	1	0	1	0.5942000000000001
Asteroid Invaders	2019-07-19	1	1	0	1	0.5942000000000001
Animal Notes	2019-06-13	1	1	0	1	0.5942000000000001
Pencil vs. Eraser	2019-08-08	1	1	0	1	0.5942000000000001
Chlorophos	2019-06-16	2	1	0	2	0.5942000000000001
Bepuzzled Puppy Dog Jigsaw Puzzle	2019-06-07	1	1	0	1	0.5942000000000001
Cryptographer	2019-07-30	4	1	0	4	0.5942000000000001
A Day in the Life of Maria	2019-06-18	1	1	0	1	0.5942000000000001
Banished Monsters	2019-06-22	1	1	0	1	0.5942000000000001
Corrupted	2019-09-17	2	1	0	2	0.5942000000000001
Tank Nova	2019-11-14	2	1	0	2	0.5942000000000001
Mogh	2019-11-23	2	1	0	2	0.5942000000000001
Qwerty's Prison	2019-09-05	1	1	0	1	0.5942000000000001
Bepuzzled Jigsaw Puzzle: Japan	2019-07-03	1	1	0	1	0.5942000000000001
Departure Dash	2019-09-10	2	1	0	2	0.5942000000000001
Bepuzzled Jigsaw Puzzle: Sweets	2019-07-12	1	1	0	1	0.5942000000000001
Bepuzzled Jigsaw Puzzle: Aquatic	2019-07-13	1	1	0	1	0.5942000000000001
Planet Invasion	2019-08-16	1	1	0	1	0.5942000000000001
Tractage aux Portes 2: Mob à la Cafétéria	2019-07-24	1	1	0	1	0.5942000000000001
Admiral Stepinski	2019-10-21	1	1	0	1	0.5942000000000001
YAWS - Yet Another Waveshooter	2019-07-12	1	1	0	1	0.5942000000000001
Jomp The Jumper	2019-07-12	2	1	0	2	0.5942000000000001
TerTD	2019-08-12	1	1	0	1	0.5942000000000001
Deep Sea Tycoon: Diver's Paradise	2019-08-01	2	1	0	2	0.5942000000000001
My Planet [RTS]	2019-07-25	3	1	0	3	0.5942000000000001
Fun Fantasy Girls Jigsaw	2019-07-21	2	1	0	2	0.5942000000000001
Struggle	2019-10-03	2	1	0	2	0.5942000000000001
GarbageClassification	2019-08-11	2	1	0	2	0.5942000000000001
Engineer Arena	2019-08-14	4	1	0	4	0.5942000000000001
Puzzle Bear	2019-08-17	2	1	0	2	0.5942000000000001
Proxyah	2019-08-07	1	1	0	1	0.5942000000000001
Red Black Poker	2019-09-08	2	1	0	2	0.5942000000000001
Spiralagon	2019-10-01	2	1	0	2	0.5942000000000001
Android Helipad	2019-09-27	1	1	0	1	0.5942000000000001
Sanitarium Rush	2019-08-09	1	1	0	1	0.5942000000000001
Neonis	2019-08-13	3	1	0	3	0.5942000000000001
Tree House : The Avocado Mayhem	2019-08-15	1	1	0	1	0.5942000000000001
Zoological Era II	2019-08-12	2	1	0	2	0.5942000000000001
Ginga Kagekidan - 放課後くるーずっ！	2019-08-12	1	1	0	1	0.5942000000000001
Luna Sanctus	2019-08-23	3	1	0	3	0.5942000000000001
Synzzball	2019-09-26	2	1	0	2	0.5942000000000001
Dominos!	2019-10-16	4	1	0	4	0.5942000000000001
Xentripetal Force	2019-09-20	1	1	0	1	0.5942000000000001
CULT	2019-08-15	1	1	0	1	0.5942000000000001
Grid Wars	2019-09-02	2	1	0	2	0.5942000000000001
Daaang!	2019-09-25	2	1	0	2	0.5942000000000001
Building Killer	2019-08-23	1	1	0	1	0.5942000000000001
DOWN MEANS UP	2019-08-21	1	1	0	1	0.5942000000000001
RotoBrix	2019-11-15	1	1	0	1	0.5942000000000001
Boat Violence: Ship Happens	2019-09-10	2	1	0	2	0.5942000000000001
Thanks For Listening	2019-11-10	1	1	0	1	0.5942000000000001
Princess and Knight	2019-09-11	2	1	0	2	0.5942000000000001
Heart in the Dark	2019-11-05	2	1	0	2	0.5942000000000001
Blockey: Block Yeah!	2019-09-27	1	1	0	1	0.5942000000000001
The Tomb of Argazfell	2019-09-06	1	1	0	1	0.5942000000000001
Summer Knights	2019-09-10	1	1	0	1	0.5942000000000001
Moysenland	2019-10-05	1	1	0	1	0.5942000000000001
War Battle Royale Battlegrounds	2019-09-11	1	1	0	1	0.5942000000000001
Far From Orbit	2019-09-22	2	1	0	2	0.5942000000000001
Skyrift	2019-09-23	1	1	0	1	0.5942000000000001
The Last Promise	2019-10-31	1	1	0	1	0.5942000000000001
Those crazy crows	2019-09-13	1	1	0	1	0.5942000000000001
Sorcerer Lord	2019-09-26	1	1	0	1	0.5942000000000001
Night Guardian	2019-09-30	1	1	0	1	0.5942000000000001
Death To The Dragon Lord	2019-10-31	4	1	0	4	0.5942000000000001
The Delirium Vacation	2019-11-04	1	1	0	1	0.5942000000000001
Bloxicus	2019-09-20	1	1	0	1	0.5942000000000001
One Hour Left	2019-10-04	1	1	0	1	0.5942000000000001
CuBe	2019-09-27	1	1	0	1	0.5942000000000001
Roy Cluse: Itsy-Bitsy Edition	2019-09-23	1	1	0	1	0.5942000000000001
Happy STG	2019-09-30	2	1	0	2	0.5942000000000001
Dystopian Drift	2019-10-24	1	1	0	1	0.5942000000000001
Arabian Stones - The VR Sudoku Game	2019-10-03	2	1	0	2	0.5942000000000001
Starazius	2019-09-23	1	1	0	1	0.5942000000000001
Alan's Attitude	2019-10-16	1	1	0	1	0.5942000000000001
Mermaid Coralie ~ Love and Madness	2019-10-02	1	1	0	1	0.5942000000000001
A Ghostly Tale	2019-10-11	1	1	0	1	0.5942000000000001
Speakerman 2	2019-10-03	2	1	0	2	0.5942000000000001
Anime Otaku Girl 二次元宅女	2019-10-11	1	1	0	1	0.5942000000000001
黎明生机：启示录-Survival:Revelation	2019-10-25	4	1	0	4	0.5942000000000001
Final Mission VR	2019-11-01	1	1	0	1	0.5942000000000001
Dimensionality 3.5	2019-11-02	1	1	0	1	0.5942000000000001
Ground War	2019-12-16	1	1	0	1	0.5942000000000001
Language Worm	2019-10-18	2	1	0	2	0.5942000000000001
Eye Of Plunder	2019-11-05	1	1	0	1	0.5942000000000001
Super Novel Collector (Speedrun Edition)	2019-11-05	1	1	0	1	0.5942000000000001
Space Space	2019-10-27	1	1	0	1	0.5942000000000001
Parcel Panic	2019-11-06	1	1	0	1	0.5942000000000001
Collector	2019-10-29	1	1	0	1	0.5942000000000001
Adventure or Normality?	2019-10-29	1	1	0	1	0.5942000000000001
Empty Sharp	2019-12-02	2	1	0	2	0.5942000000000001
Il Sole e la Luna 2	2019-11-03	3	1	0	3	0.5942000000000001
Imaginarium	2019-11-08	2	1	0	2	0.5942000000000001
Future Pool	2019-12-20	2	1	0	2	0.5942000000000001
GASH	2019-11-28	2	1	0	2	0.5942000000000001
CreateTech	2019-12-13	1	1	0	1	0.5942000000000001
Laser Z	2019-12-13	1	1	0	1	0.5942000000000001
KAJA：追光者与秘境制造	2019-11-09	2	1	0	2	0.5942000000000001
I Will Be Your Eyes	2019-11-14	3	1	0	3	0.5942000000000001
Draconic Echoes: The Ardent War	2019-12-05	2	1	0	2	0.5942000000000001
Mega Balls	2019-11-25	1	1	0	1	0.5942000000000001
Takkyu Tournament Re:Serve	2019-12-14	1	1	0	1	0.5942000000000001
The Adventures of Willow and Ash	2019-11-25	1	1	0	1	0.5942000000000001
Myriad Tower Defense	2019-11-21	1	1	0	1	0.5942000000000001
Maximum Momentum	2019-12-10	2	1	0	2	0.5942000000000001
Holo Views	2019-12-10	213	1	0	213	0.5942000000000001
Microscope Madness	2019-12-18	1	1	0	1	0.5942000000000001
Super Space Shooter Arena	2019-12-19	1	1	0	1	0.5942000000000001
Time Travel Trainer	2019-12-05	1	1	0	1	0.5942000000000001
Royal Detective: The Last Charm Collector's Edition	2019-11-15	4	1	0	4	0.5942000000000001
Reverse Fantasy Legend 2 逆袭幻想传2	2019-12-12	2	1	0	2	0.5942000000000001
The Dis-United States Of America	2019-11-27	1	1	0	1	0.5942000000000001
Dashbot Ninja	2019-11-28	1	1	0	1	0.5942000000000001
Summoner VR	2019-12-24	1	1	0	1	0.5942000000000001
Remuage - MeltySensation	2019-12-09	1	1	0	1	0.5942000000000001
The Winter's Deal - Frosty Edition	2019-12-26	2	1	0	2	0.5942000000000001
The Sword	2019-12-20	1	1	0	1	0.5942000000000001
Tiles Shooter Puzzle Cube	2019-12-27	2	1	0	2	0.5942000000000001
Path	2019-12-31	2	1	0	2	0.5942000000000001
Mysteries of the Undead	2019-03-28	11	57	34	45	0.594
Monkeys & Dragons	2019-04-02	5	20	11	16	0.594
Mundus - Impossible Universe	2019-03-21	11	20	11	22	0.594
Fovos VR	2019-03-12	15	68	41	56	0.5938
BDSM Waifu	2019-07-18	6	49	29	35	0.5938
Showdown Bandit	2019-09-17	332	468	302	634	0.5932000000000001
Egress	2019-10-24	48	99	61	109	0.593
Boss Crushers	2019-05-15	89	44	26	115	0.5929
A Glider's Journey	2019-09-27	15	44	26	41	0.5929
九劫曲:诅咒之地 NINE TRIALS	2019-06-28	6151	2005	1328	7479	0.5927
Arena	2019-05-17	19	23	13	32	0.5921000000000001
Age-Old Cities VR	2019-06-13	14	23	13	27	0.5921000000000001
FUNGI	2019-12-27	33	31	18	51	0.5918
Khan VS Kahn	2019-08-27	157	161	102	259	0.5912
テーマパークの虫	2019-04-01	6	18	10	16	0.5910000000000001
GraFi 4	2019-09-14	3	18	10	13	0.5910000000000001
Easy hentai puzzle 2	2019-10-05	4	18	10	14	0.5910000000000001
To Be Headed Or Not To Be	2019-11-22	23	101	63	86	0.5909000000000001
Starlight	2019-11-25	10	150	95	105	0.5908
Vegas Slot	2019-10-18	5	26	15	20	0.5906
Connor's Desert Adventure	2019-08-29	3	26	15	18	0.5906
Space Ribbon	2019-01-04	163	59	36	199	0.5904
Super Island God VR	2019-05-17	10	37	22	32	0.5901
RIP	2019-09-11	13	13	7	20	0.59
Blind Girl	2019-01-21	5	13	7	12	0.59
girl friend simulator	2019-09-03	8	13	7	15	0.59
EasyPianoGame	2019-10-03	4	13	7	11	0.59
Highway Game	2019-11-11	4	13	7	11	0.59
Goblin Walker	2019-01-10	165	390	255	420	0.5897
Terror In The Atomic Desert	2019-03-22	2	8	4	6	0.5897
Pirates of the Asteroid Belt	2019-10-24	2	8	4	6	0.5897
Fly Flew Flown	2019-02-21	2	8	4	6	0.5897
Harvest Moon: Mad Dash	2019-11-18	4	8	4	8	0.5897
Quest For Wartorn Brotherhood	2019-05-27	2	8	4	6	0.5897
Medicalholodeck Pro Free Trial	2019-06-21	58	8	4	62	0.5897
Babylonia	2019-07-25	7	8	4	11	0.5897
Let's Go! Skiing VR	2019-09-27	4	8	4	8	0.5897
Restless Hero	2019-10-24	2	8	4	6	0.5897
Sick Way	2019-12-10	3	8	4	7	0.5897
BATTALION: Legacy	2019-05-23	16771	9874	6730	23501	0.5896
LAMO	2019-10-10	187	68	42	229	0.5896
夜之归途 Night Homing	2019-10-31	6	29	17	23	0.5895
Escape from Labyrinth	2019-08-29	16	29	17	33	0.5895
DeathMatch	2019-05-18	26	40	24	50	0.5894
Tactics & Strategy Master 2 :Princess of Holy Light	2019-04-11	69	97	61	130	0.5892000000000001
A.N.N.E	2019-06-25	9	21	12	21	0.5892000000000001
Fimbul	2019-02-28	10	21	12	22	0.5892000000000001
Chocolate makes you happy: St.Patrick's Day	2019-02-06	4	21	12	16	0.5892000000000001
Assault of the Robots	2019-04-08	3	21	12	15	0.5892000000000001
古战三国 Ancient War:Three Kingdoms	2019-02-27	162	74	46	208	0.5891
Last Year	2019-12-10	3666	4517	3069	6735	0.589
World Of Conquerors	2019-08-30	188	57	35	223	0.589
Shot Online	2019-01-22	123	63	39	162	0.5885
Born of Fire	2019-09-05	54	63	39	93	0.5885
GearStorm	2019-11-20	27	46	28	55	0.5885
Invasion 2037	2019-11-05	41	89	56	97	0.5884
Glorious Companions	2019-06-04	47	66	41	88	0.5883
Holoception	2019-10-24	19	35	21	40	0.588
Tessa's Ark	2019-02-27	16	24	14	30	0.5879
THE UNCLEARNESS	2019-08-11	4	24	14	18	0.5879
Hentai Best Girls	2019-09-27	3	24	14	17	0.5879
Game of Thrones Winter is Coming	2019-11-14	1681	1199	807	2488	0.5878
EARTH DEFENSE FORCE: IRON RAIN	2019-10-15	559	681	455	1014	0.5875
Hentai Sudoku	2019-06-12	12	55	34	46	0.5875
Super Powered Battle Friends	2019-05-17	5	16	9	14	0.5875
Anima	2019-09-26	2	16	9	11	0.5875
Lights Out	2019-01-25	20	16	9	29	0.5875
Mortadelo y Filemón: Una aventura de cine - Edición especial	2019-03-14	10	16	9	19	0.5875
Chocolate makes you happy: Easter	2019-04-05	3	16	9	12	0.5875
Shining City	2019-09-06	3	16	9	12	0.5875
Poly Quest	2019-09-25	5	16	9	14	0.5875
War Builder League	2019-06-19	58	99	63	121	0.5871000000000001
New Age	2019-08-27	59	67	42	101	0.5868
Myths and Legends Online	2019-08-09	224	309	204	428	0.5867
Kings of Lorn: The Fall of Ebris	2019-11-22	11	30	18	29	0.5863
Unicorn Princess	2019-11-14	9	30	18	27	0.5863
Room of Pandora	2019-04-24	5	30	18	23	0.5863
Swords of Gargantua	2019-06-06	83	197	129	212	0.5860000000000001
The Energy Lab	2019-01-01	6	19	11	17	0.5859000000000001
War Trigger Classic	2019-01-22	648	503	337	985	0.5858
Falling Bullets	2019-02-25	4	11	6	10	0.5855
Massive Effect	2019-03-18	3	11	6	9	0.5855
Orbitron	2019-06-11	12	11	6	18	0.5855
Discontinue	2019-06-10	2	11	6	8	0.5855
Pandemic Express - Zombie Escape	2019-09-27	897	2613	1795	2692	0.5854
Kotodama: The 7 Mysteries of Fujisawa	2019-05-31	17	36	22	39	0.5853
Dead Army - Radio Frequency	2019-03-29	95	39	24	119	0.585
The Last Sigil	2019-03-28	13	22	13	26	0.5849000000000001
Must Dash Amigos	2019-07-23	9	22	13	22	0.5849000000000001
Cube Defense	2019-03-22	9	42	26	35	0.5848
Warhammer Quest 2: The End Times	2019-01-30	157	166	109	266	0.5845
Kingdom Under Fire 2	2019-11-18	1886	1401	960	2846	0.5844
Imperator: Rome	2019-04-25	41945	13320	9316	51261	0.5841
Idle Cooking Emperor	2019-04-28	179	63	40	219	0.5841
Hentai Dgirls	2019-08-15	3	25	15	18	0.5841
WarFallen	2019-05-29	20	28	17	37	0.5836
Time To Parkour	2019-02-06	5	28	17	22	0.5836
Dusty Raging Fist	2019-05-08	5	14	8	13	0.5833
Oneironaut	2019-09-19	15	14	8	23	0.5833
Frane: Dragons' Odyssey	2019-04-04	3	6	3	6	0.5833
Neon Exile	2019-08-06	10	6	3	13	0.5833
Time, Space and Matter	2019-08-29	3	6	3	6	0.5833
Penn & Teller VR: Frankly Unfair, Unkind, Unnecessary, & Underhanded	2019-06-27	4	6	3	7	0.5833
Pylon Racer	2019-02-21	3	6	3	6	0.5833
Aussie Battler Tanks	2019-04-06	5	6	3	8	0.5833
PlanZ	2019-02-04	12	6	3	15	0.5833
Grove flowers	2019-02-26	2	6	3	5	0.5833
Strike Solitaire	2019-04-29	6	6	3	9	0.5833
Norman's Night In	2019-10-23	3	6	3	6	0.5833
Zakk Hazard The Deadly Spawn	2019-04-01	2	6	3	5	0.5833
ItazuraVR Safe for Work	2019-04-01	4	6	3	7	0.5833
Falnarion Tactics II	2019-07-15	2	6	3	5	0.5833
Axan Ships - Low Poly	2019-05-30	10	6	3	13	0.5833
ニャンフーガール：トアルデータの奪還 / NyanfuGirl	2019-10-16	3	6	3	6	0.5833
Boon Boon	2019-07-12	2	6	3	5	0.5833
Android Amazones	2019-08-06	3	6	3	6	0.5833
Guns Craft	2019-07-30	3	6	3	6	0.5833
Solitaire Victorian Picnic	2019-08-26	4	6	3	7	0.5833
Sexy President	2019-09-20	3	6	3	6	0.5833
Bruxinha Luana	2019-11-09	1	6	3	4	0.5833
Dawnfall	2019-12-02	13	6	3	16	0.5833
An Odyssey: Echoes of War	2019-12-26	13	6	3	16	0.5833
篮球计划 Project Dunk	2019-09-27	134	97	63	197	0.5832
DARK FABLE	2019-04-04	36	85	55	91	0.583
Pixel Battle Royale	2019-01-31	50	371	251	301	0.5826
Pixel Devil and the Broken Cartridge	2019-02-27	27	64	41	68	0.5826
Shards of Azuria	2019-08-10	15	61	39	54	0.5826
Pirates of Everseas	2019-08-12	74	58	37	111	0.5826
Something To Do With Love	2019-07-03	31	58	37	68	0.5826
SurvivalZ	2019-07-26	13	180	120	133	0.5821000000000001
Spoxel	2019-03-28	20	17	10	30	0.5821000000000001
Bondage Nightmare	2019-04-27	3	17	10	13	0.5821000000000001
New England Detective: Breakfast in Boston	2019-06-07	4	17	10	14	0.5821000000000001
Hacking with Benefits	2019-08-06	5	17	10	15	0.5821000000000001
ZED	2019-06-04	60	86	56	116	0.5819
Re-Legion	2019-01-31	253	171	114	367	0.5818
UNI	2019-04-01	212	238	161	373	0.5806
Worlds Collide	2019-06-12	15	29	18	33	0.5805
My Free Farm	2019-08-26	33	29	18	51	0.5805
Wasteland Survival	2019-06-04	913	3266	2301	3214	0.5802
Chess Arena-象棋竞技场	2019-05-10	10	9	5	15	0.5796
EggFight	2019-03-21	8	9	5	13	0.5796
Widget Satchel	2019-11-27	3	9	5	8	0.5796
Dimension Of Gameth	2019-03-26	19	9	5	24	0.5796
The Mansion	2019-06-14	10	9	5	15	0.5796
Desktop Dynasties	2019-03-08	5	9	5	10	0.5796
Haunting Hour	2019-03-09	11	9	5	16	0.5796
Black Salt Coreuption	2019-03-29	8	9	5	13	0.5796
PANTY SLIDE	2019-01-04	2	9	5	7	0.5796
Pix Tower	2019-02-09	3	9	5	8	0.5796
Draft Day Sports: College Football 2019	2019-02-08	16	9	5	21	0.5796
Sexy Heroine!	2019-05-02	6	9	5	11	0.5796
Soviet Souls	2019-05-07	4	9	5	9	0.5796
Elf Manor	2019-12-20	38	57	37	75	0.5794
The Church in the Darkness	2019-08-02	39	73	48	87	0.579
Jaws Of Extinction	2019-05-23	54	204	139	193	0.5784
Wolfenstein: Youngblood Deutsche Version	2019-07-25	494	171	116	610	0.5784
Landinar: Into the Void	2019-05-01	159	132	89	248	0.5782
Crazy Archery	2019-02-21	8	12	7	15	0.5782
Make a Killing	2019-10-30	2	12	7	9	0.5782
Mystery Masterpiece: The Moonstone	2019-06-29	5	12	7	12	0.5782
Bloody trains	2019-12-17	2	12	7	9	0.5782
War Rock	2019-02-07	449	540	376	825	0.578
SPECIAL FORCE VR: INFINITY WAR	2019-08-09	18	33	21	39	0.5779
Hockey Player VR	2019-05-08	7	30	19	26	0.5777
S.A.I.A.'s Awakening: A Robothorium Visual Novel	2019-01-17	9	15	9	18	0.5776
NeoGeometry	2019-02-04	4	15	9	13	0.5776
King of Halloween	2019-10-18	11	15	9	20	0.5776
Naval Action	2019-06-13	5222	6385	4578	9800	0.5774
Call Of The Mighty Warriors	2019-03-02	1277	143	97	1374	0.5774
Virtual Boxing League	2019-10-01	8	24	15	23	0.5774
家园/HOME	2019-04-08	3	24	15	18	0.5774
Agent Of Love	2019-07-25	8	21	13	21	0.5773
Money Makes Money	2019-05-04	21	21	13	34	0.5773
Chained: A Victorian Nightmare	2019-12-19	3	21	13	16	0.5773
Black Baron	2019-05-29	13	18	11	24	0.5773
血战夹皮沟	2019-12-14	21	78	52	73	0.5770000000000001
Vanguard: Normandy 1944	2019-04-05	66	101	68	134	0.5768
The Fog: Trap for Moths	2019-03-19	9	46	30	39	0.5768
Asterix & Obelix XXL 3 - The Crystal Menhir	2019-11-21	61	178	122	183	0.5766
Wet Beach Pussies	2019-03-05	5	85	57	62	0.5765
Wave Circles	2019-05-23	9	43	28	37	0.5765
The Magician's Research	2019-11-20	313	138	94	407	0.5764
Ravenfield: Multiplayer Mod	2019-07-10	247	711	503	750	0.5756
OSK - The End of Time	2019-09-20	4	50	33	37	0.5754
Princess Maker ~Faery Tales Come True (HD Remake)	2019-12-23	64	103	70	134	0.5752
Hunger Apartment	2019-03-20	27	60	40	67	0.5751
The Light Keeps Us Safe	2019-09-05	33	110	75	108	0.5750000000000001
Die 4te Offenbarung	2019-11-18	22	31	20	42	0.5750000000000001
Naxia	2019-11-23	9	64	43	52	0.5742
Butterbies	2019-01-19	3	4	2	5	0.5739
Dark Wish	2019-01-05	2	4	2	4	0.5739
In Darkness	2019-03-18	3	4	2	5	0.5739
Screensavers VR	2019-10-22	2	4	2	4	0.5739
DarkTrail	2019-01-06	6	4	2	8	0.5739
Redemption Cemetery: Children's Plight Collector's Edition	2019-02-01	4	4	2	6	0.5739
Solitaire: Learn Chemistry!	2019-02-17	3	4	2	5	0.5739
Fleet Scrapper	2019-02-16	3	4	2	5	0.5739
Asteroid Hideout	2019-03-14	2	4	2	4	0.5739
Hentai Babes - In Public	2019-03-19	2	4	2	4	0.5739
Shmup Moments	2019-03-18	3	4	2	5	0.5739
Vaporspace	2019-03-28	4	4	2	6	0.5739
Trysaria	2019-06-27	3	4	2	5	0.5739
Ecchi Puzzles	2019-05-22	3	4	2	5	0.5739
Peas Adventure	2019-04-18	1	4	2	3	0.5739
Frank & the TimeTwister Machine	2019-05-03	3	4	2	5	0.5739
Eslander	2019-08-27	3	4	2	5	0.5739
TUTUTUTU - Tea party	2019-08-14	2	4	2	4	0.5739
Surrounded by mice	2019-05-17	2	4	2	4	0.5739
Fractal Gallery VR	2019-06-06	1	4	2	3	0.5739
World Leader Card Game	2019-06-13	4	4	2	6	0.5739
End of Realms	2019-11-25	3	4	2	5	0.5739
Inbound UFO	2019-08-28	3	4	2	5	0.5739
Bugs!	2019-06-20	2	4	2	4	0.5739
Spider shooting bee	2019-06-19	2	4	2	4	0.5739
Radical Gear	2019-07-30	2	4	2	4	0.5739
Tricky Cow	2019-07-29	3	4	2	5	0.5739
Avalo Legends	2019-11-23	5	4	2	7	0.5739
Zombien	2019-08-22	7	4	2	9	0.5739
A Wanderer's Adventure	2019-08-22	2	4	2	4	0.5739
Mazes and Mages 2	2019-09-13	2	4	2	4	0.5739
Solitaire Legend of the Pirates	2019-09-19	4	4	2	6	0.5739
GYATM Dragon Edition	2019-10-31	2	4	2	4	0.5739
Draconic Route	2019-10-10	3	4	2	5	0.5739
Project: Gemini	2019-09-10	4	4	2	6	0.5739
Just Spin	2019-10-26	3	4	2	5	0.5739
Last Chance VR	2019-09-22	2	4	2	4	0.5739
Mahjong Royal Towers	2019-10-22	6	4	2	8	0.5739
SushiParty2	2019-10-28	2	4	2	4	0.5739
Hexterio	2019-10-15	3	4	2	5	0.5739
Bolf	2019-11-19	2	4	2	4	0.5739
Land of Ngoto	2019-11-21	3	4	2	5	0.5739
DwarfCorp	2019-02-01	35	98	67	102	0.5738000000000001
跳跳大咖	2019-04-09	76	51	34	110	0.5738000000000001
Meegah Mem 2	2019-08-09	6	38	25	31	0.5737
Tower VR	2019-08-09	10	22	14	24	0.5736
Horse Riding Tales	2019-04-13	72	263	185	257	0.5732
Overlanders	2019-05-23	5	19	12	17	0.5731
The Chills	2019-02-22	2	19	12	14	0.5731
Takenoko	2019-11-27	25	45	30	55	0.5728
NEET simulator	2019-01-06	27	16	10	37	0.5726
同居指南 | Cohabitation Guide	2019-07-12	8	16	10	18	0.5726
Nystagmus	2019-05-18	5	16	10	15	0.5726
GraFi 2	2019-06-06	3	16	10	13	0.5726
Azusa Online	2019-01-30	40	79	54	94	0.5725
Frontline Zed	2019-10-03	94	166	116	210	0.5724
Spirit Roots	2019-12-13	4	13	8	12	0.5721
Vixens From outer Space	2019-01-07	5	13	8	13	0.5721
Magic Heart	2019-03-31	3	13	8	11	0.5721
Cold Cable: Lifeshift	2019-03-22	2	13	8	10	0.5721
Grand Battle	2019-03-20	5	13	8	13	0.5721
Future Simulation World	2019-10-09	6	13	8	14	0.5721
Miscreation: Evolve Your Creature!	2019-11-18	34	118	82	116	0.5718
幻想英雄传 / Fantasy Hero Biography	2019-07-04	10	7	4	14	0.5718
Divine Business: Fantasy Trading Simulator	2019-02-19	3	7	4	7	0.5718
The Second Chance Strip Club	2019-04-04	7	7	4	11	0.5718
Sophica - Temples Of Mystery	2019-02-04	3	7	4	7	0.5718
Zulin Time	2019-11-24	136	7	4	140	0.5718
Fade Out	2019-05-21	2	7	4	6	0.5718
非正式警探 Informal Detective	2019-06-14	4	7	4	8	0.5718
Fog of War: The Battle for Cerberus	2019-04-26	31	7	4	35	0.5718
Hentai Babes - Waifu	2019-06-17	4	7	4	8	0.5718
Car Soccer World Cup	2019-08-02	5	7	4	9	0.5718
Handy	2019-10-10	3	7	4	7	0.5718
Planet Lander	2019-11-08	2	7	4	6	0.5718
Blast Zone! Tournament	2019-02-28	1814	520	373	2187	0.5717
Continuous Girl	2019-03-06	13	10	6	19	0.5717
War Theatre	2019-03-16	6	10	6	12	0.5717
Incandescent 2	2019-01-18	2	10	6	8	0.5717
Sonar Beat	2019-01-22	4	10	6	10	0.5717
Vasilis	2019-04-15	2	10	6	8	0.5717
Fantasy Heroes	2019-07-18	5	10	6	11	0.5717
iMemory	2019-03-14	4	10	6	10	0.5717
VaporFly	2019-08-13	3	10	6	9	0.5717
Heroes Of Avranche	2019-12-02	8	10	6	14	0.5717
Bionic Hunter VR	2019-12-20	2	10	6	8	0.5717
雀姬	2019-08-06	1216	1383	1006	2222	0.5713
Empires:The Rise	2019-01-16	89	36	24	113	0.5710000000000001
The Warhorn	2019-01-29	79	186	132	211	0.5699000000000001
12 HOURS	2019-06-07	7	40	27	34	0.5698
Border Officer	2019-07-19	174	609	442	616	0.5697
My House	2019-05-27	14	89	62	76	0.5697
Hell Warders	2019-02-21	38	82	57	95	0.5696
Sky Of Destruction	2019-04-25	4	20	13	17	0.5694
Love Chan	2019-09-27	8	20	13	21	0.5694
Gangsta Sniper 3: Final Parody	2019-11-12	3	20	13	16	0.5694
CARRUMBLE	2019-11-06	44	86	60	104	0.5692
New Day: Cataclysm	2019-06-05	25	27	18	43	0.5684
AVA	2019-09-21	4	27	18	22	0.5684
The Station VR	2019-12-13	4	17	11	15	0.5683
Crime Cities	2019-10-01	8	17	11	19	0.5683
Girl Kill Zombies	2019-09-24	2	17	11	13	0.5683
First Day	2019-08-23	943	34	23	966	0.5681
The Seduction of Shaqeera	2019-01-07	9	24	16	25	0.5673
RRRR	2019-01-22	4	14	9	13	0.5669
Destiny or Fate	2019-09-05	437	257	187	624	0.5663
Alice in CyberCity	2019-05-27	9	21	14	23	0.5660000000000001
别以为你是开发者我就不敢打你	2019-08-31	4	21	14	18	0.5660000000000001
Shoppe Keep 2	2019-04-25	1796	1205	899	2695	0.5655
Draft Day Sports: College Basketball 2019	2019-02-05	28	11	7	35	0.5653
Rubble Rush	2019-05-27	8	11	7	15	0.5653
Panic Diet!!	2019-10-28	5	11	7	12	0.5653
Periodic Deliveries	2019-12-17	8	11	7	15	0.5653
Hammer & Anvil VR	2019-02-13	7	32	22	29	0.5649000000000001
Super Monkey Ball: Banana Blitz HD	2019-12-10	95	188	137	232	0.5647
Norpon	2019-02-25	12	18	12	24	0.5644
Endless Maneuver	2019-03-13	6	18	12	18	0.5644
Chocolate makes you happy: Lunar New Year	2019-03-05	4	18	12	16	0.5644
Racing angle	2019-09-19	4	18	12	16	0.5644
Assassin's Creed III Remastered	2019-03-29	3561	4405	3341	6902	0.564
SCP-087 VR Survivor	2019-01-29	2	8	5	7	0.5632
VR Curling	2019-01-18	3	8	5	8	0.5632
Special Counter Force Attack	2019-02-08	1	8	5	6	0.5632
夕鬼 零 Yuoni: Rises	2019-04-29	4	8	5	9	0.5632
Summer Sports Games	2019-06-17	3	8	5	8	0.5632
Hail To The King	2019-01-04	4	8	5	9	0.5632
New World Horizon	2019-12-25	4	8	5	9	0.5632
Zeta Complex	2019-04-15	3	8	5	8	0.5632
Snowball Rush	2019-04-05	2	8	5	7	0.5632
Pixel Puzzles 2: Halloween	2019-10-21	5	8	5	10	0.5632
Link the animals	2019-06-01	1	8	5	6	0.5632
Deadly step	2019-09-13	2	8	5	7	0.5632
Robot terminator	2019-07-27	2	8	5	7	0.5632
Zombie Season	2019-12-18	136	8	5	141	0.5632
Deicide	2019-03-10	16	22	15	31	0.5629
Top Speed 2: Racing Legends	2019-08-19	87	79	57	144	0.5625
The Cup	2019-02-01	96	15	10	106	0.5625
Wer weiß denn sowas? - Das 2. Spiel	2019-10-15	19	15	10	29	0.5625
名媛女友-Girlfriend invites	2019-11-05	4	15	10	14	0.5625
坦克大战：共和国之辉	2019-08-13	93	91	66	159	0.5623
Jump with Friends	2019-05-14	8	41	29	37	0.562
我的妖狐妹妹	2019-02-04	6	26	18	24	0.562
Plagueworld	2019-07-26	9	30	21	30	0.5614
Aima Wars: Steampunk & Orcs	2019-12-18	30	19	13	43	0.561
Mermaid Colony	2019-09-11	14	19	13	27	0.561
Indian Legends Solitaire	2019-08-09	11	19	13	24	0.561
Aim FTW	2019-08-06	17	38	27	44	0.5606
KIN	2019-10-04	2	5	3	5	0.5605
KnifeBoy	2019-10-18	5	5	3	8	0.5605
Gumstein: The Awakening	2019-01-30	3	5	3	6	0.5605
Deadly Burrito	2019-02-18	7	5	3	10	0.5605
Agent 9	2019-03-15	6	5	3	9	0.5605
SNAILS	2019-01-03	2	5	3	5	0.5605
Train Manager	2019-02-11	3	5	3	6	0.5605
Korona:Nemesis	2019-08-18	5	5	3	8	0.5605
Trucking	2019-02-27	2	5	3	5	0.5605
Great Battles of the American Civil War	2019-10-24	4	5	3	7	0.5605
Amaranthine Voyage: The Orb of Purity Collector's Edition	2019-03-15	4	5	3	7	0.5605
Mango Cart	2019-03-25	2	5	3	5	0.5605
Shop Battle	2019-03-04	3	5	3	6	0.5605
Art of Horology	2019-04-06	1	5	3	4	0.5605
Vengeful Bat Dungeon Crawler	2019-04-04	2	5	3	5	0.5605
Striker A Type Game Pack	2019-05-02	2	5	3	5	0.5605
THE RITUAL (Indie Horror Game)	2019-05-07	2	5	3	5	0.5605
MIND SWITCH	2019-08-01	4	5	3	7	0.5605
RhythmSnake	2019-09-24	3	5	3	6	0.5605
Where Are We Now	2019-09-07	1	5	3	4	0.5605
Squirrel Jump	2019-08-30	3	5	3	6	0.5605
Santa's Visit	2019-11-01	3	5	3	6	0.5605
Three Of a Fish	2019-10-01	2	5	3	5	0.5605
Drunk ride	2019-10-21	2	5	3	5	0.5605
Arrow	2019-11-26	88	5	3	91	0.5605
零界战线	2019-12-19	11	5	3	14	0.5605
Dark Alley Elf	2019-04-16	29	42	30	59	0.5604
Grand Dude Simulator	2019-03-12	12	82	60	72	0.5601
The Emerald Tablet	2019-12-16	10	12	8	18	0.56
Space Viking Raiders	2019-01-15	10	12	8	18	0.56
Atmocity	2019-07-30	9	12	8	17	0.56
Hope for Village	2019-04-04	5	12	8	13	0.56
Other Submarine	2019-10-05	3	12	8	11	0.56
Gear City Against Chaos	2019-11-16	14	12	8	22	0.56
BAFF 4	2019-09-25	3	12	8	11	0.56
SURVIVAL: Postapocalypse Now	2019-12-04	785	5065	3915	4700	0.5599000000000001
Element: Space	2019-02-14	66	156	116	182	0.5599000000000001
Farlight Explorers	2019-02-01	36	116	86	122	0.5593
Armor Clash 3	2019-08-02	10	83	61	71	0.5593
Crossroads Inn Anniversary Edition	2019-10-23	1512	2107	1626	3138	0.559
Coin Pusher	2019-02-13	7	43	31	38	0.559
豆腐脑模拟器 Tofu Pudding Simulator	2019-05-06	36	39	28	64	0.559
The Cross Horror Game	2019-07-31	4	16	11	15	0.5586
Stay Out	2019-11-27	2400	8996	7024	9424	0.5582
Zen Chess: Champion's Moves	2019-10-01	4	20	14	18	0.5579999999999999
A Lazy Magic Teacher	2019-07-11	6	24	17	23	0.5577000000000001
Snow Clearing Driving Simulator	2019-09-23	4	24	17	21	0.5577000000000001
ECCHI NEKO GIRLS PUZZLE	2019-03-21	5	36	26	31	0.5575
VVVVV	2019-11-17	6	28	20	26	0.5575
One Night In The House	2019-08-29	2	2	1	3	0.5569
Dealey Plaza Paintball	2019-08-07	3	2	1	4	0.5569
Ultratank	2019-07-18	1770	2	1	1771	0.5569
Impossible Jumpy Quest	2019-08-14	2	2	1	3	0.5569
VRでエミリアと異世界生活-膝枕&添寝編	2019-05-24	2	2	1	3	0.5569
RACING GAME	2019-09-14	2	2	1	3	0.5569
Immunity	2019-12-01	2	2	1	3	0.5569
Sophont	2019-06-21	3	2	1	4	0.5569
Metori	2019-04-03	2	2	1	3	0.5569
The Journey to Fairytales	2019-03-26	1	2	1	2	0.5569
GunFu Heroes	2019-07-22	4	2	1	5	0.5569
Globat Pixels	2019-04-06	2	2	1	3	0.5569
Wandering Star	2019-01-01	2	2	1	3	0.5569
King Randall's Party	2019-01-22	2	2	1	3	0.5569
Be hate Free Interactive	2019-01-17	1	2	1	2	0.5569
Hellbanger	2019-07-26	3	2	1	4	0.5569
Corrupted Commander	2019-01-09	2	2	1	3	0.5569
Nanoswarm	2019-02-06	1	2	1	2	0.5569
Fantom Feast	2019-02-02	2	2	1	3	0.5569
MEMORISE : CREATION	2019-01-05	1	2	1	2	0.5569
Defeat the Beat	2019-12-14	3	2	1	4	0.5569
Tecroroid Assault	2019-02-08	2	2	1	3	0.5569
Fall In Love - My Billionaire Boss	2019-07-21	2	2	1	3	0.5569
Ski Drive: Biathlon	2019-03-01	2	2	1	3	0.5569
More and more	2019-08-01	2	2	1	3	0.5569
blocks	2019-01-25	2	2	1	3	0.5569
Aztec Tower	2019-01-22	2	2	1	3	0.5569
DEAD	2019-08-19	4	2	1	5	0.5569
Galaxicus	2019-06-29	11	2	1	12	0.5569
Theme Park Worker	2019-02-20	2	2	1	3	0.5569
Speedrun Ninja	2019-05-06	2	2	1	3	0.5569
Grater	2019-03-05	1	2	1	2	0.5569
Pokris	2019-03-22	1	2	1	2	0.5569
Mow Problem	2019-04-12	3	2	1	4	0.5569
Physics Drop	2019-05-03	2	2	1	3	0.5569
Super Catscape	2019-04-11	3	2	1	4	0.5569
Snipiyo	2019-04-03	2	2	1	3	0.5569
OfficeEscape	2019-04-16	1	2	1	2	0.5569
Metal Country	2019-04-11	1	2	1	2	0.5569
Crystallo	2019-04-20	1	2	1	2	0.5569
Divine D.I.V.A.	2019-05-06	1	2	1	2	0.5569
Super Star Blast	2019-04-24	2	2	1	3	0.5569
Run Gun Die Ultimate	2019-05-15	2	2	1	3	0.5569
Prototype-CUBE	2019-05-21	2	2	1	3	0.5569
Rescue bomber	2019-05-27	2	2	1	3	0.5569
Herman 2	2019-05-22	1	2	1	2	0.5569
Percy's Last Stand	2019-07-25	2	2	1	3	0.5569
Civitas Nova	2019-08-09	4	2	1	5	0.5569
Space BloX	2019-06-17	4	2	1	5	0.5569
MOK: Super Space Taxi	2019-06-13	1	2	1	2	0.5569
Absolute Fall	2019-06-05	1	2	1	2	0.5569
Vollun	2019-07-02	3	2	1	4	0.5569
Eat this!	2019-07-03	1	2	1	2	0.5569
天下往事 Journey of the world	2019-06-17	2	2	1	3	0.5569
Amazing: A House In Kansas VR	2019-06-21	1	2	1	2	0.5569
Fort	2019-07-15	3	2	1	4	0.5569
The Doulos Study	2019-07-19	2	2	1	3	0.5569
VQD	2019-09-03	1	2	1	2	0.5569
Kaiju Kite Attack	2019-10-01	1	2	1	2	0.5569
Smooth Mover	2019-09-14	2	2	1	3	0.5569
Streets of Neotokio	2019-12-23	2	2	1	3	0.5569
Cosmic Monsters	2019-12-30	2	2	1	3	0.5569
TAG WAR	2019-08-23	3	2	1	4	0.5569
Codebreaker	2019-08-30	3	2	1	4	0.5569
Labyrinths of the World: Fools Gold Collector's Edition	2019-08-09	4	2	1	5	0.5569
Grab the Mask	2019-08-19	3	2	1	4	0.5569
FeArea: Battle Royale	2019-11-21	4	2	1	5	0.5569
Power Punch II	2019-08-22	1	2	1	2	0.5569
VR垃圾分类_Refuse classification	2019-09-21	2	2	1	3	0.5569
Viper	2019-12-30	3	2	1	4	0.5569
Planet Automata	2019-09-10	1	2	1	2	0.5569
夢限ノ夜	2019-09-09	5	2	1	6	0.5569
Haunted Legends: The Scars of Lamia Collector's Edition	2019-08-16	3	2	1	4	0.5569
Legend of the Sword	2019-09-11	2	2	1	3	0.5569
Turtle Rush	2019-10-01	2	2	1	3	0.5569
Climb Out!	2019-10-05	2	2	1	3	0.5569
Snake: The Elder Forest	2019-10-20	1	2	1	2	0.5569
BounceBall3D	2019-09-22	2	2	1	3	0.5569
Dice Defenders	2019-09-28	4	2	1	5	0.5569
Safari Grounds - The Wilpattu Leopard	2019-10-02	2	2	1	3	0.5569
Home: Our Journey	2019-10-06	4	2	1	5	0.5569
Life Redemption	2019-09-28	1	2	1	2	0.5569
PlayerOne	2019-10-10	2	2	1	3	0.5569
Garbage Classification Simulator	2019-12-12	2	2	1	3	0.5569
New Tricks for Old Gods	2019-10-22	8	2	1	9	0.5569
Anonymous Player	2019-11-06	2	2	1	3	0.5569
Space Shapes	2019-11-19	2	2	1	3	0.5569
Super Angling	2019-11-19	2	2	1	3	0.5569
Origin	2019-11-30	1	2	1	2	0.5569
Escape from the Lostmoon	2019-11-16	1	2	1	2	0.5569
Heavy load	2019-11-30	2	2	1	3	0.5569
Catch The Ball 3	2019-11-22	2	2	1	3	0.5569
The Cruxis Sword	2019-11-22	3	2	1	4	0.5569
Third Rule of Universe	2019-11-15	1	2	1	2	0.5569
Scriptum VR: The Neighbor's House Escape Room	2019-12-03	1	2	1	2	0.5569
Zombie Tag Royale	2019-12-12	3	2	1	4	0.5569
Flashover MegaSector	2019-12-08	1	2	1	2	0.5569
Groove Runner	2019-12-10	1	2	1	2	0.5569
Colossals	2019-12-26	2	2	1	3	0.5569
Wrecker	2019-12-20	1	2	1	2	0.5569
Tree of Savior (Japanese Ver.)	2019-11-28	2144	95	71	2215	0.5568
Battle Motion	2019-02-04	4	9	6	10	0.5566
THE TEAR	2019-02-28	3	9	6	9	0.5566
brainCloud Bombers	2019-11-08	5	9	6	11	0.5566
Cat Defense	2019-04-20	3	9	6	9	0.5566
Night shot	2019-10-17	5	9	6	11	0.5566
Trump Vs Rocketman	2019-08-08	2	9	6	8	0.5566
Tower Defense: Defender of the Kingdom	2019-09-14	3	9	6	9	0.5566
Hope for City	2019-09-16	2	9	6	8	0.5566
Desert lost	2019-09-09	4	9	6	10	0.5566
MMA President	2019-12-06	5	9	6	11	0.5566
Telefrag VR	2019-07-19	105	49	36	141	0.5565
Warhammer: Chaosbane	2019-05-31	4603	2960	2318	6921	0.5562
Down to Hell	2019-08-30	5	33	24	29	0.5557
Boobs vs Zombies	2019-08-01	14	13	9	23	0.5555
Abstract	2019-05-23	7	13	9	16	0.5555
3Gun Nation VR	2019-02-28	4	13	9	13	0.5555
Welcome To... Chichester OVN : The Beach	2019-05-13	4	13	9	13	0.5555
Rainforest Solitaire	2019-08-29	10	13	9	19	0.5555
Strip Shooter	2019-10-11	4	13	9	13	0.5555
Zombieland: Double Tap - Road Trip	2019-10-15	8	21	15	23	0.5552
Girls of Hentai Mosaic	2019-06-07	4	21	15	19	0.5552
Elleros Origins: Season I	2019-02-21	8	17	12	20	0.5552
Noise	2019-10-13	8	146	112	120	0.5535
HENTAI ARENA HOLY PUSSY	2019-09-09	5	80	61	66	0.5522
Unsolved Mystery Club: Ancient Astronauts (Collector´s Edition)	2019-07-12	8	18	13	21	0.5522
HENTAI MINESWEEPER BEST	2019-02-20	6	53	40	46	0.5521
Disassembly VR	2019-01-31	20	85	65	85	0.5519
Stacks TNT	2019-03-13	7	14	10	17	0.5517000000000001
狼人杀单机版	2019-05-10	5	14	10	15	0.5517000000000001
守护未来 GUARD THE FUTURE	2019-04-29	5	14	10	15	0.5517000000000001
The Ring of Truth	2019-07-20	4	14	10	14	0.5517000000000001
DEUS EX MACHINA	2019-09-26	6	14	10	16	0.5517000000000001
Riddlord: The Consequence	2019-02-01	64	40	30	94	0.5516
Filthy Frank Kart	2019-09-29	2	6	4	6	0.5514
Mech League Hunting	2019-06-18	7	6	4	11	0.5514
Fantasy Monarch	2019-11-26	7	6	4	11	0.5514
Raid on the Ruhr	2019-03-28	5	6	4	9	0.5514
K.O.M.A	2019-03-14	6	6	4	10	0.5514
Flex Apocalypse Racing	2019-01-01	2	6	4	6	0.5514
Fused	2019-03-08	2	6	4	6	0.5514
Q&A: A Light-Roasted Romance	2019-05-01	2	6	4	6	0.5514
The Copper Canyon Shoot Out	2019-04-30	2	6	4	6	0.5514
Who We Are Now	2019-05-07	3	6	4	7	0.5514
Cannon Arena	2019-06-19	3	6	4	7	0.5514
Eormor: Shattered Lands	2019-11-08	3	6	4	7	0.5514
Don't Die	2019-08-08	3	6	4	7	0.5514
Head Over Heels	2019-08-09	4	6	4	8	0.5514
不可思议佣兵团	2019-10-04	3	6	4	7	0.5514
It Will Find You	2019-11-04	5	6	4	9	0.5514
A Pirate's Pleasure	2019-12-02	13	6	4	17	0.5514
Afterbern Democralypse	2019-12-24	2	6	4	6	0.5514
Moon River	2019-01-07	3	10	7	10	0.5513
THE NED BALLS	2019-01-24	2	10	7	9	0.5513
Estellium Legends	2019-02-05	5	10	7	12	0.5513
Wolfenstein: Cyberpilot Deutsche Version	2019-07-25	7	10	7	14	0.5513
Girls & Dungeons 2	2019-08-16	7	10	7	14	0.5513
Expansion	2019-07-25	3	10	7	10	0.5513
Magic Farm 3: The Ice Danger	2019-10-04	7	10	7	14	0.5513
ZHIVE	2019-08-24	3	10	7	10	0.5513
Treasure Fleet	2019-08-13	8	10	7	15	0.5513
摆渡人生	2019-11-09	5	10	7	12	0.5513
Squillamorph	2019-11-17	4	10	7	11	0.5513
Fear the Night	2019-07-17	838	489	386	1224	0.5512
Daenerys doesn’t want Hentai	2019-10-15	5	45	34	39	0.551
Grunt1914	2019-11-09	10	23	17	27	0.5505
Victorian Mysteries: Woman in White	2019-07-06	6	23	17	23	0.5505
Dark Gnome	2019-03-18	102	55	42	144	0.5502
Feral Blue	2019-10-22	81	129	101	182	0.549
Creatures Inc.	2019-03-22	41	90	70	111	0.549
Nancy Drew: Midnight in Salem	2019-12-03	800	538	430	1230	0.5487
Decay of Logos	2019-08-30	77	115	90	167	0.5487
Horror Hunt	2019-12-27	11	15	11	22	0.5484
BATALJ	2019-02-21	23	15	11	34	0.5484
Hyper Mum Ft Adult Gaming	2019-03-04	3	15	11	14	0.5484
Forklift: Simulator	2019-06-25	5	15	11	16	0.5484
Blades of Gory	2019-12-04	2	15	11	13	0.5484
Reign of the Succubus	2019-04-26	131	77	60	191	0.5479999999999999
Escape First 2	2019-06-20	98	147	116	214	0.5479
Need for Spirit: Off-Road Edition	2019-03-07	6	48	37	43	0.5478000000000001
Skinny	2019-07-05	5	39	30	35	0.5471
Nether: The Untold Chapter	2019-05-15	163	150	119	282	0.5468999999999999
Elo Hell	2019-07-30	7	11	8	15	0.5468999999999999
Auto Battle Royale	2019-08-29	127	11	8	135	0.5468999999999999
Halzae: Heroes of Divinity	2019-03-15	10	11	8	18	0.5468999999999999
Refill your Roguelike	2019-01-19	20	11	8	28	0.5468999999999999
Cyborg Invasion Shooter 3: Savior Of The World	2019-03-11	2	11	8	10	0.5468999999999999
Amanda's Sticker Book 2: Amazing Wildlife	2019-03-11	4	11	8	12	0.5468999999999999
Agent Lovesdick	2019-08-23	8	11	8	16	0.5468999999999999
Touhou Multi Scroll Shooting	2019-08-08	3	11	8	11	0.5468999999999999
Love Vibe: Aria	2019-01-10	38	266	213	251	0.5467000000000001
Vane	2019-07-22	30	262	210	240	0.5465
Vaporwave Drift	2019-11-03	3	25	19	22	0.5465
Flash Point	2019-03-23	14	35	27	41	0.546
Loco Parentis	2019-09-19	131	261	210	341	0.5457
Heart of the Kingdom: Rebellion	2019-01-31	5	16	12	17	0.5455
Chocolate makes you happy: Valentine's Day	2019-01-15	6	16	12	18	0.5455
Spot Girls Difference	2019-01-25	3	16	12	15	0.5455
Stickman League	2019-12-20	27	16	12	39	0.5455
Zen Chess: Blindfold Masters	2019-10-01	6	16	12	18	0.5455
Star Chef: Cooking & Restaurant Game	2019-04-03	180	171	137	317	0.5454
Citizens of Space	2019-06-18	12	21	16	28	0.545
Anthropomachy	2019-11-01	17	26	20	37	0.5448
PRiCERPG	2019-02-26	3	7	5	8	0.5448
Pursuer	2019-03-11	3	7	5	8	0.5448
Hidden Mysteries: Royal Family Secrets	2019-08-14	5	7	5	10	0.5448
It Runs Red	2019-05-01	2	7	5	7	0.5448
Gregor Hills Haunted Hospital	2019-06-07	2	7	5	7	0.5448
Poppy's Nightmare	2019-08-21	4	7	5	9	0.5448
The Defender: Farm and Castle 2	2019-12-13	2	7	5	7	0.5448
Doors of Silence - the prologue	2019-10-30	2	7	5	7	0.5448
House Number 666	2019-10-18	2	7	5	7	0.5448
Pax Ruthenia	2019-11-28	5	7	5	10	0.5448
Gravity Balls	2019-12-09	3	7	5	8	0.5448
nStations	2019-12-20	5	7	5	10	0.5448
胸怀三国 OL / 삼국지를 품다 / Embrace the Three Kingdoms OL	2019-05-23	162	72	57	219	0.5447
Borderlands 2 VR	2019-10-22	202	682	558	760	0.5441
HELLION	2019-10-21	1941	2246	1854	3795	0.5439
Dark Places	2019-04-09	242	68	54	296	0.5439
Dollhouse	2019-05-24	45	79	63	108	0.5437
Unearthing Mars 2: The Ancient War	2019-07-03	5	12	9	14	0.5433
The Five Cores Remastered	2019-07-30	9	12	9	18	0.5433
Matanga	2019-03-07	3	22	17	20	0.543
Turok: Escape from Lost Valley	2019-07-25	14	22	17	31	0.543
Orc Colony	2019-06-14	38	22	17	55	0.543
Tales of a Spymaster	2019-05-17	9	17	13	22	0.543
Blind Souls	2019-04-04	3	17	13	16	0.543
Earthshakers	2019-04-22	14	17	13	27	0.543
Project Katharsis	2019-05-20	18	17	13	31	0.543
ELON on MARS	2019-09-23	5	17	13	18	0.543
ByLo	2019-09-01	7	17	13	20	0.543
Picture toys	2019-11-14	6	17	13	19	0.543
Schrodinger's cat simulator	2019-12-30	3	17	13	16	0.543
War Blade	2019-09-03	221	251	205	426	0.5425
Misfire	2019-10-29	37	38	30	67	0.5424
Wide Cross	2019-11-27	135	99	80	215	0.542
Margonem	2019-02-20	61	133	108	169	0.5418999999999999
Lord of the click	2019-03-26	14	44	35	49	0.5417000000000001
Infinite Skyline	2019-02-07	4	3	2	6	0.5417000000000001
Caverns: Lost Sky	2019-01-31	3	3	2	5	0.5417000000000001
Funky Karts	2019-01-04	2	3	2	4	0.5417000000000001
Mahjong Valentine's Day	2019-02-09	4	3	2	6	0.5417000000000001
A Familiar Fairytale: Dyslexic Text Based Adventure	2019-11-19	2	3	2	4	0.5417000000000001
TrivaTune	2019-03-14	4	3	2	6	0.5417000000000001
冷月清辉照天涯(KUNG FU LEGEND)	2019-04-26	1	3	2	3	0.5417000000000001
YUNA: Sugar hearts and Love	2019-02-16	2	3	2	4	0.5417000000000001
A meadow Piece	2019-03-07	2	3	2	4	0.5417000000000001
Pilot Sports	2019-07-31	3	3	2	5	0.5417000000000001
SOF - RAIDERS	2019-02-15	1	3	2	3	0.5417000000000001
Cold Silence	2019-05-30	2	3	2	4	0.5417000000000001
Area Cooperation Economic Simulation: North Korea (ACES)	2019-01-19	2	3	2	4	0.5417000000000001
Choconoa	2019-02-01	2	3	2	4	0.5417000000000001
Rollman	2019-02-08	2	3	2	4	0.5417000000000001
Lyantei	2019-02-22	2	3	2	4	0.5417000000000001
Pilot Unknown	2019-03-28	3	3	2	5	0.5417000000000001
Sheep Collision	2019-03-25	3	3	2	5	0.5417000000000001
Astro4x	2019-05-16	2	3	2	4	0.5417000000000001
Tiger Tank 59 Ⅰ Winter Assault	2019-05-08	3	3	2	5	0.5417000000000001
It's Raining Fists and Metal	2019-12-20	3	3	2	5	0.5417000000000001
Il Sole e la Luna	2019-06-04	4	3	2	6	0.5417000000000001
Pop'n'splat	2019-06-04	3	3	2	5	0.5417000000000001
Highball	2019-06-20	3	3	2	5	0.5417000000000001
Codemancer	2019-08-12	2	3	2	4	0.5417000000000001
Shelter in Place	2019-11-21	9	3	2	11	0.5417000000000001
Paradigm City	2019-08-22	10	3	2	12	0.5417000000000001
Hentai LightUp	2019-08-05	4	3	2	6	0.5417000000000001
Mythic Pearls: The Legend of Tirnanog	2019-08-15	3	3	2	5	0.5417000000000001
Classic Hentai Logic Puzzle	2019-12-13	3	3	2	5	0.5417000000000001
Gem Collector	2019-09-01	1	3	2	3	0.5417000000000001
Mosh Pit	2019-09-03	11	3	2	13	0.5417000000000001
Merge	2019-08-22	3	3	2	5	0.5417000000000001
The Chasm	2019-10-06	2	3	2	4	0.5417000000000001
机甲雄心：巡天者	2019-11-05	2	3	2	4	0.5417000000000001
Cute Blocks	2019-09-05	2	3	2	4	0.5417000000000001
Kunoichi Ninja	2019-09-12	2	3	2	4	0.5417000000000001
P.3	2019-10-01	1	3	2	3	0.5417000000000001
Hacker Evolution - 2019 HD remaster	2019-09-23	3	3	2	5	0.5417000000000001
Marshmallow Madness	2019-09-26	3	3	2	5	0.5417000000000001
我们的国	2019-12-01	3	3	2	5	0.5417000000000001
Rainbow Robin	2019-10-14	2	3	2	4	0.5417000000000001
Game Breaker	2019-12-13	2	3	2	4	0.5417000000000001
The Lost Cave of the Ozarks	2019-10-28	2	3	2	4	0.5417000000000001
Sushi Pachi Panic	2019-11-04	1	3	2	3	0.5417000000000001
Picross.io	2019-11-10	4	3	2	6	0.5417000000000001
漫步者 The Walker	2019-12-04	2	3	2	4	0.5417000000000001
Bomber Fox	2019-12-19	3	3	2	5	0.5417000000000001
British Gangsters	2019-12-17	2	3	2	4	0.5417000000000001
Headspun	2019-08-28	7	18	14	21	0.5407000000000001
Jumping Over It With Kang KiYun	2019-07-17	152	18	14	166	0.5407000000000001
Super Arcade Soccer	2019-02-26	5	29	23	28	0.5402
Odyssey: The Deep Space Expedition	2019-01-18	4	13	10	14	0.5402
Ski Jumping Pro VR	2019-12-06	4	13	10	14	0.5402
FINAL ARCHER VR	2019-09-06	4	13	10	14	0.5402
Homeless Simulator	2019-04-24	12	128	105	117	0.5398
Noble In Exile / 落魄之家	2019-02-08	8	8	6	14	0.5398
Melting pot.	2019-03-21	2	8	6	8	0.5398
Great Ball of Fire	2019-04-26	2	8	6	8	0.5398
Drumpf: Presidential Dating Simulator	2019-06-21	4	8	6	10	0.5398
Space Mercenary Shooter : Episode 1	2019-07-19	3	8	6	9	0.5398
Tittilium	2019-08-08	2	8	6	8	0.5398
Dickie A Cumming	2019-07-11	2	8	6	8	0.5398
Shuffle World	2019-10-09	3	8	6	9	0.5398
SolSeraph	2019-07-10	41	52	42	83	0.5397
Narco Strike	2019-05-17	5	35	28	33	0.5397
AFTER-H	2019-09-23	27	58	47	74	0.5395000000000001
MiniGolf	2019-03-29	3	24	19	22	0.5395000000000001
HORSE	2019-02-09	10	82	67	77	0.5392
King of Texas	2019-02-21	9	30	24	33	0.5389
Smartphone Tycoon	2019-03-01	335	823	691	1026	0.5388000000000001
三国宏图(Great Cause Of The Three Kingdoms)	2019-05-08	10	19	15	25	0.5387
Dark Sauce	2019-03-02	3	19	15	18	0.5387
ArcheAge: Unchained	2019-10-17	7242	2030	1718	8960	0.5381
RemiLore: Lost Girl in the Lands of Lore	2019-09-04	29	25	20	49	0.538
Spherecraft	2019-06-01	6	25	20	26	0.538
Blind Justice	2019-12-17	8	31	25	33	0.5377000000000001
Metro Trip Simulator	2019-05-27	3	37	30	33	0.5376
Circuit Slinger	2019-01-01	18	14	11	29	0.5375
Demon Club	2019-05-06	43	14	11	54	0.5375
Ancient Anathema	2019-01-28	3	14	11	14	0.5375
Hidden World of Art 2	2019-11-29	5	14	11	16	0.5375
Warhammer: Chaos & Conquest	2019-11-18	523	532	449	972	0.537
X Wars Deluxe	2019-08-28	204	20	16	220	0.5368
Warlocks 2: God Slayers	2019-07-18	31	38	31	62	0.5366
骑士的魔法战争	2019-08-15	52	38	31	83	0.5366
Chaos Starter	2019-04-05	5	26	21	26	0.5366
King of Dragon Balls	2019-07-23	2	26	21	23	0.5366
MageWorks	2019-03-28	4	9	7	11	0.5359
Moe	2019-01-31	3	9	7	10	0.5359
炎之陨落 The Fallen of The Blaze Empire	2019-04-26	3	9	7	10	0.5359
Froggo	2019-03-09	3	9	7	10	0.5359
THC	2019-07-01	2	9	7	9	0.5359
Woman's body 3	2019-08-01	2	9	7	9	0.5359
12 HOURS 2	2019-08-20	2	9	7	9	0.5359
D1896	2019-11-15	4	9	7	11	0.5359
勇者有点太嚣张。™G (No Hero Allowed: No Puzzle Either!)	2019-08-07	54	33	27	81	0.5355
Blocks!: Julius Caesar	2019-12-11	9	33	27	36	0.5355
Exocraft	2019-03-12	103	171	145	248	0.5339
LONGING RING OF ESCA	2019-08-15	17	22	18	35	0.5337
Dino Delivery	2019-08-20	17	22	18	35	0.5337
Elderine: Dreams to Destiny	2019-01-15	5	4	3	8	0.5332
WINDSHIFT	2019-05-25	2	4	3	5	0.5332
Powernode	2019-02-27	2	4	3	5	0.5332
Weaverse	2019-09-03	2	4	3	5	0.5332
Bloody Mary: Forgotten Curse	2019-02-08	3	4	3	6	0.5332
Pirate Survival Fantasy Shooter	2019-06-03	2	4	3	5	0.5332
Fight For Love	2019-01-11	2	4	3	5	0.5332
A Lullaby of Colors	2019-02-21	3	4	3	6	0.5332
Puttin' Around	2019-03-06	4	4	3	7	0.5332
萌盟大冒险 Cute Adventure	2019-11-21	2	4	3	5	0.5332
Arena of Shaelo	2019-02-15	3	4	3	6	0.5332
Sloth: Heart to Heart	2019-05-01	2	4	3	5	0.5332
Bhavacakra Grace	2019-02-27	6	4	3	9	0.5332
World Peace Simulator 2019	2019-02-20	3	4	3	6	0.5332
VIP Shuttle	2019-04-11	3	4	3	6	0.5332
F18 Carrier Landing	2019-04-11	3	4	3	6	0.5332
These Lands	2019-04-26	3	4	3	6	0.5332
Adecke - Cards Games Deluxe	2019-04-20	3	4	3	6	0.5332
Ortolan	2019-11-26	2	4	3	5	0.5332
Ancient Stories: Gods of Egypt	2019-05-27	4	4	3	7	0.5332
Bocce VR	2019-06-19	2	4	3	5	0.5332
Running Black	2019-08-07	1	4	3	4	0.5332
El Culto(Demo)	2019-11-06	3	4	3	6	0.5332
Derby Carmageddon	2019-09-14	2	4	3	5	0.5332
Who Is You	2019-09-22	1	4	3	4	0.5332
Reviser	2019-10-31	3	4	3	6	0.5332
Hyper-Casual Hentai	2019-11-09	4	4	3	7	0.5332
Liquid Space	2019-12-15	2	4	3	5	0.5332
KUMO The Little Robot	2019-12-02	2	4	3	5	0.5332
Swag and Sorcery	2019-05-09	6118	1540	1331	7449	0.5331
Joan Jade and the Gates of Xibalba	2019-03-07	7	16	13	20	0.5331
Cardaria	2019-09-28	10	16	13	23	0.5331
荒野大蛮神WildSuperman	2019-04-08	19	10	8	27	0.5327000000000001
Last Hope Z - VR	2019-06-16	4	10	8	12	0.5327000000000001
Superstar Hero	2019-06-13	11	10	8	19	0.5327000000000001
The Searchers of Legends : Origin	2019-07-11	4	10	8	12	0.5327000000000001
Hexa Trains	2019-10-07	11	10	8	19	0.5327000000000001
Mable & The Wood	2019-08-23	23	43	36	59	0.5325
Combat Force	2019-12-06	8	59	50	58	0.5313
Rend	2019-03-30	5111	840	731	5842	0.5309
Hentai Petting Simulator	2019-08-09	4	31	26	30	0.5309
Discrepant	2019-12-07	3	11	9	12	0.53
Burnout Drift	2019-03-28	4	11	9	13	0.53
Love Hentai: Endgame	2019-02-20	2	11	9	11	0.53
WarGround	2019-02-02	11	11	9	20	0.53
Hookshot	2019-02-25	2	11	9	11	0.53
Wytchsun: Elleros Origins	2019-06-19	26	47	40	66	0.5297999999999999
Money Bath VR	2019-04-03	5	25	21	26	0.5297999999999999
约拍女神	2019-05-03	24	85	73	97	0.5297
Click Legends	2019-05-29	91	18	15	106	0.5297
Transport Services	2019-09-14	33	40	34	67	0.5295000000000001
Deep Race: Space	2019-04-29	4	19	16	20	0.5283
V.L.A.D.i.K	2019-03-01	17	259	227	244	0.5278
Rainbow Duck	2019-08-29	3	12	10	13	0.5278
Capture the planet: Cute War	2019-02-20	3	12	10	13	0.5278
Iron Heart	2019-06-03	4	12	10	14	0.5278
Data mining 7	2019-03-15	7	12	10	17	0.5278
Undoing	2019-01-31	4	5	4	8	0.5278
Malkyrs	2019-09-04	6	5	4	10	0.5278
Soul Grabber	2019-02-18	3	5	4	7	0.5278
Seraphims of Astraeus	2019-07-31	11	5	4	15	0.5278
1001 Jigsaw. World Tour: Australian Puzzles	2019-01-07	4	5	4	8	0.5278
Mutagen Extinction	2019-02-21	6	5	4	10	0.5278
Depth Of Consciousness	2019-01-26	2	5	4	6	0.5278
W4RR-i/o-RS: Descent	2019-02-20	2	5	4	6	0.5278
Senpai Teaches Me Japanese Part 1	2019-03-14	2	5	4	6	0.5278
Haunted Jail: Alcatas	2019-04-19	2	5	4	6	0.5278
Lonely Skies	2019-05-10	3	5	4	7	0.5278
Escape again	2019-07-23	5	5	4	9	0.5278
Bad Mojos	2019-06-06	7	5	4	11	0.5278
我们的房屋 OUR HOUSE	2019-09-08	6	5	4	10	0.5278
GGG Collection	2019-08-07	69	5	4	73	0.5278
Dreams of Solari - Chapter 1	2019-07-21	4	5	4	8	0.5278
Zombie Golf	2019-08-27	2	5	4	6	0.5278
The Ai Games	2019-08-20	2	5	4	6	0.5278
Hentai NetPuzzle	2019-08-27	4	5	4	8	0.5278
Buck Zombies	2019-08-17	4	5	4	8	0.5278
Sleep Paralysis	2019-09-03	3	5	4	7	0.5278
Memories on the Shoreline	2019-11-20	2	5	4	6	0.5278
Imaginator	2019-11-27	2	5	4	6	0.5278
The Climate Trail	2019-12-17	3	5	4	7	0.5278
Jazz Age	2019-12-02	9	5	4	13	0.5278
Heebie Jeebies: The Roller Coaster	2019-11-20	3	5	4	7	0.5278
Destinata	2019-12-30	3	5	4	7	0.5278
BattleRush: Ardennes Assault	2019-01-10	13	35	30	43	0.5276
EEP 15	2019-01-24	18	20	17	35	0.527
Nyasha Winter	2019-03-22	4	20	17	21	0.527
Braveland Heroes	2019-09-16	331	224	197	528	0.5269
Extreme Truck Simulator	2019-02-15	3	29	25	28	0.526
战场英雄物语	2019-11-19	270	29	25	295	0.526
Choice of the Dragon	2019-03-21	9	13	11	20	0.5259
UBERCOLD	2019-06-25	21	21	18	39	0.5258
Bannermen	2019-02-21	180	153	135	315	0.5256000000000001
Spike Volleyball	2019-02-05	59	195	173	232	0.5247999999999999
Espire 1: VR Operative	2019-09-24	192	264	235	427	0.5246000000000001
Genesis	2019-03-14	154	76	67	221	0.5244
Brother&Sister	2019-04-18	8	14	12	20	0.5242
Galactic Crew	2019-03-28	19	77	68	87	0.5241
Attack of the Mutant Fishcrows	2019-05-18	13	6	5	18	0.5239
GUNGRAVE VR	2019-03-06	3	6	5	8	0.5239
Gems of Magic: Lost Family	2019-04-05	3	6	5	8	0.5239
Jungle Z	2019-03-07	5	6	5	10	0.5239
Horror Stories	2019-02-21	3	6	5	8	0.5239
Crazy space pirate	2019-08-06	2	6	5	7	0.5239
CleanVR	2019-05-27	8	6	5	13	0.5239
Cat&rooms	2019-06-13	3	6	5	8	0.5239
Rage Melee	2019-09-12	3	6	5	8	0.5239
War Theatre: Blood of Winter	2019-09-27	3	6	5	8	0.5239
NAVALNY: A Nightmare of Corrupt	2019-09-27	2	6	5	7	0.5239
Running Ninja	2019-03-13	21	23	20	41	0.5236999999999999
The Mercenary Rise	2019-10-12	31	42	37	68	0.5232
ELEA	2019-08-23	5	24	21	26	0.5228
PUZZLE: ULTIMATE	2019-05-16	6	15	13	19	0.5228
Idle Racing GO: Car Clicker Tycoon	2019-01-11	223	287	258	481	0.5226
九劫曲:诅咒之地 Nine Trials Test Server	2019-03-01	300	145	130	430	0.5222
Angry Bunny	2019-10-31	6	25	22	28	0.522
Discharge	2019-04-19	14	16	14	28	0.5215
Urban Justice	2019-01-17	3	16	14	17	0.5215
HOT VIEW ECCHI GIRLS	2019-06-07	4	16	14	18	0.5215
Deep Race: Battle	2019-09-02	5	16	14	19	0.5215
Hentai Evilgirls	2019-08-22	2	16	14	16	0.5215
Stage of Light	2019-04-01	3	7	6	9	0.5211
Slime Adventure 2	2019-05-09	2	7	6	8	0.5211
Jinxed	2019-05-12	2	7	6	8	0.5211
Apollo 11 VR	2019-08-01	3	7	6	9	0.5211
落华居	2019-08-24	2	7	6	8	0.5211
Griddlers Legend Of The Pirates	2019-11-05	6	7	6	12	0.5211
Gamble Fight Plus	2019-04-19	82	78	70	152	0.521
Captain fly and sexy students	2019-10-12	6	27	24	30	0.5205
大富翁10(Richman 10)	2019-10-24	10791	6835	6271	17062	0.5203
Eilf	2019-04-30	11	17	15	26	0.5203
Factory Coin Mining	2019-12-06	9	17	15	24	0.5203
CGENcore	2019-02-16	131	49	44	175	0.52
Police Simulator: Patrol Duty	2019-06-18	1163	2010	1843	3006	0.5199
Mr. Barrel	2019-07-10	60	18	16	76	0.5193
the Ark of Horizon	2019-03-14	253	350	320	573	0.5192
HikeJam	2019-09-16	6	8	7	13	0.5189
Petoons Party	2019-04-30	4	8	7	11	0.5189
Anime Babes: Solitaire	2019-01-01	6	8	7	13	0.5189
Birth of a Hunter	2019-03-04	7	8	7	14	0.5189
Adagio	2019-05-23	3	8	7	10	0.5189
Cetetorius	2019-09-12	3	8	7	10	0.5189
Close Combat: The Bloody First	2019-10-03	311	213	195	506	0.5184000000000001
Objects in Space	2019-03-01	193	285	262	455	0.5179
Last Day of Rome	2019-09-07	314	94	86	400	0.5176
Trailer park mechanic	2019-01-07	9	20	18	27	0.5176
EndZ Village	2019-11-05	7	20	18	25	0.5176
Shadows and Lies	2019-06-19	406	9	8	414	0.5171
The Trials of Olympus 2: Wrath of the Gods	2019-01-28	7	9	8	15	0.5171
Woman's body 2	2019-02-20	2	9	8	10	0.5171
Zombies In The Forest	2019-03-29	2	9	8	10	0.5171
A way up!	2019-03-08	3	9	8	11	0.5171
Sideral	2019-06-21	3	9	8	11	0.5171
Forgotten	2019-07-02	2	9	8	10	0.5171
Mirador	2019-07-26	157	98	90	247	0.5169
Muscle Car Robot	2019-05-01	2	21	19	21	0.5168
AQUARYOUNS World	2019-11-11	13	21	19	32	0.5168
Heroes of Fortunia	2019-04-04	19	48	44	63	0.5162
Headsnatchers	2019-11-07	23574	799	744	24318	0.5159
Second Galaxy	2019-09-11	765	576	536	1301	0.5158
Hunting fields of Jackals	2019-04-15	4	10	9	13	0.5156000000000001
Victoria	2019-01-01	5	10	9	14	0.5156000000000001
Plunder! All Hands Ahoy	2019-09-13	6	10	9	15	0.5156000000000001
混乱使者	2019-09-02	4	10	9	13	0.5156000000000001
Artemis: God-Queen of The Hunt	2019-05-29	8	23	21	29	0.5155
Grand Strategy	2019-01-07	20	37	34	54	0.5153
MISTOVER	2019-10-10	2203	603	563	2766	0.5151
Mondly: Learn Languages in VR	2019-09-25	10	24	22	32	0.5149
Epic Adventures: Cursed Onboard	2019-04-11	5	11	10	15	0.5144
Story of one night	2019-07-19	4	11	10	14	0.5144
BAFF 3	2019-08-31	3	11	10	13	0.5144
WTF	2019-08-11	6	86	80	86	0.5142
Dungeon Hunter 5	2019-05-21	258	202	189	447	0.5139
Eli Girls	2019-07-22	6	26	24	30	0.5139
ROGAN: The Thief in the Castle	2019-07-05	29	75	70	99	0.5134000000000001
Your Anime Waifu	2019-10-29	3	12	11	14	0.5134000000000001
Offroad Racing	2019-12-20	26	43	40	66	0.5133
Wildland	2019-07-24	4	13	12	16	0.5125
Workhard	2019-09-09	3	13	12	15	0.5125
VR Ping Pong Pro	2019-11-12	7	30	28	35	0.5122
Titeuf: Mega Party	2019-11-21	6	14	13	19	0.5117
秘境缚姬	2019-11-27	7	69	65	72	0.5115
Hentai Crazy Girls	2019-09-06	3	15	14	17	0.511
Forebearers	2019-04-12	43	56	53	96	0.5104
Call Of Pixel: Close Quarters	2019-07-23	21	17	16	37	0.5099
The Last Dinner	2019-01-10	12	17	16	28	0.5099
Dr. Trolley's Problem	2019-04-25	10	18	17	27	0.5094
Gang of Four	2019-11-27	193	99	95	288	0.5082
FPSBois	2019-12-20	10	21	20	30	0.5082
Anomaly Zone	2019-10-31	302	334	322	624	0.5078
AWAY: Journey to the Unexpected	2019-02-13	25	83	80	105	0.5072
The Withering	2019-11-17	47	182	176	223	0.507
Record of Lodoss War Online	2019-01-16	105	62	60	165	0.5063000000000001
Pagan: Absent Gods	2019-08-27	3030	1408	1370	4400	0.5062
Fight the Horror	2019-04-09	29	30	29	58	0.506
Outpost Zero	2019-07-25	380	410	400	780	0.5054
Jumanji: The Video Game	2019-11-08	13	36	35	48	0.5051
Space Ops VR	2019-05-30	16	39	38	54	0.5047
Unlucky Seven	2019-08-30	39	63	62	101	0.5031
Undress Tournament	2019-01-24	29	64	63	92	0.503
Narcos: Rise of the Cartels	2019-11-19	148	302	299	447	0.5021
NBA 2K20	2019-09-06	48375	30493	30412	78787	0.5006
Through Abandoned: The Refuge	2019-03-25	9	56	56	65	0.5
Street Outlaws The List	2019-11-29	19	32	32	51	0.5
Renzo Racer	2019-08-28	15	30	30	45	0.5
Idle Chess Story	2019-06-19	35	24	24	59	0.5
Dinosaur Bone Digging	2019-04-25	5	18	18	23	0.5
BAFF	2019-05-20	2	17	17	19	0.5
Light The Way	2019-01-25	3	14	14	17	0.5
Avast Ye: Antventure be Calling	2019-08-02	752	14	14	766	0.5
我的大学	2019-06-14	42	14	14	56	0.5
AO Tennis 2 Tools	2019-12-19	14	14	14	28	0.5
Virtual Army: Revolution	2019-01-31	9	13	13	22	0.5
Helheim	2019-02-01	5	13	13	18	0.5
Yet Another Survival Game	2019-02-28	3	13	13	16	0.5
Nyasha Beach	2019-03-27	2	13	13	15	0.5
Caretaker	2019-10-25	4	12	12	16	0.5
Chill II	2019-03-21	2	12	12	14	0.5
Skat 3D Premium	2019-05-29	15	12	12	27	0.5
Steamulator 2019	2019-01-30	6	11	11	17	0.5
凯旋岛	2019-04-04	4	11	11	15	0.5
Fox and Bunny	2019-05-23	4	11	11	15	0.5
Mutiny Island	2019-10-19	5	10	10	15	0.5
Hentai Waifu	2019-02-21	3	9	9	12	0.5
Room 208	2019-08-08	4	9	9	13	0.5
smysl 2 gravity	2019-08-22	3	9	9	12	0.5
荒岛求生	2019-09-23	8	9	9	17	0.5
Furries & Scalies & Bears OH MY!	2019-01-16	4	8	8	12	0.5
GG Puzzler	2019-05-28	3	8	8	11	0.5
Ninja?	2019-01-23	7	8	8	15	0.5
PartyLine VR	2019-09-13	4	7	7	11	0.5
It's a Trap	2019-03-13	2	7	7	9	0.5
Zombies in the dark	2019-08-04	3	7	7	10	0.5
Match Three Pirates! Heir to Davy Jones	2019-04-19	3	7	7	10	0.5
FORGOTTEN IN HELL	2019-04-25	2	7	7	9	0.5
BeiJing Courier Simulator	2019-05-24	9	7	7	16	0.5
Legends of Catalonia	2019-05-29	4	7	7	11	0.5
Alien Kingdom	2019-07-26	2	7	7	9	0.5
Sex Adventure - The Board Game	2019-12-06	3	7	7	10	0.5
Draft Day Sports: Pro Basketball 2020	2019-11-29	18	7	7	25	0.5
Go Cabbies!GB	2019-01-04	6	6	6	12	0.5
Strip Slot Sonja	2019-03-07	4	6	6	10	0.5
Cyber Rage: Retribution	2019-04-04	3	6	6	9	0.5
Pretty - Exotic	2019-05-06	2	6	6	8	0.5
The Legends of Class one 嗨哥一班大冒险	2019-06-27	3	6	6	9	0.5
Never Let Me Awake	2019-05-08	2	6	6	8	0.5
Park assault	2019-05-27	3	6	6	9	0.5
X-Team	2019-12-11	4	5	5	9	0.5
From Orbit	2019-08-27	11	5	5	16	0.5
Zvezda	2019-04-22	5	5	5	10	0.5
Saving Simon	2019-02-21	1	5	5	6	0.5
VR Party Pack	2019-12-04	4	5	5	9	0.5
Smash team	2019-02-05	4	5	5	9	0.5
Life source	2019-05-02	2	5	5	7	0.5
Rebound Dodgeball Evolved	2019-09-20	10	5	5	15	0.5
Data mining 0	2019-04-12	2	5	5	7	0.5
The Poisoner	2019-08-01	6	5	5	11	0.5
MMA Executive	2019-08-26	3	5	5	8	0.5
Insect Simulator	2019-12-01	2	5	5	7	0.5
Slime Adventure Legacy	2019-08-30	2	5	5	7	0.5
Motel Bondage	2019-09-07	3	5	5	8	0.5
Vectrix	2019-09-03	2	5	5	7	0.5
Reality Incognita	2019-10-14	2	4	4	6	0.5
Silent Gentleman	2019-04-29	1683	4	4	1687	0.5
Fishing on the Fly	2019-06-03	3	4	4	7	0.5
Cubit	2019-02-07	3	4	4	7	0.5
The Armclaw Experiment	2019-04-04	2	4	4	6	0.5
Draid	2019-05-09	2	4	4	6	0.5
BARE BOOB BRAWLERZ: POWER CLAW	2019-10-22	2	4	4	6	0.5
Heaven & Hell 2	2019-02-14	4	4	4	8	0.5
Farming Village	2019-08-16	2	4	4	6	0.5
Tales of Ancient Nights	2019-01-29	1	4	4	5	0.5
Afterlife	2019-08-21	3	4	4	7	0.5
Bonds of the Skies	2019-02-22	4	4	4	8	0.5
Diacrisis	2019-04-27	1	4	4	5	0.5
Escape From Earth	2019-08-16	136	4	4	140	0.5
Reel Fishing: Road Trip Adventure	2019-09-18	4	4	4	8	0.5
Mystic RUS-files	2019-05-14	2	4	4	6	0.5
VR takibi ~bonefire simulator~	2019-09-20	2	4	4	6	0.5
酒店二 The Hotel 2	2019-05-24	3	4	4	7	0.5
All That Remains: A story about a child's future	2019-08-01	2	4	4	6	0.5
Fight For Freedom	2019-07-30	3	4	4	7	0.5
Last Knight	2019-08-15	2	4	4	6	0.5
DriftWay	2019-09-03	3	4	4	7	0.5
Sword of the Slayer	2019-09-12	22	4	4	26	0.5
Swinger-Man	2019-12-02	2	4	4	6	0.5
There is a Thief in my House	2019-11-01	3	4	4	7	0.5
Mahjong Gold	2019-12-17	5	4	4	9	0.5
The Last Pixel	2019-11-17	2	4	4	6	0.5
DEM_Stage_Zero	2019-12-20	2	4	4	6	0.5
IOX	2019-12-23	3	4	4	7	0.5
Warhead	2019-06-11	3	3	3	6	0.5
Stardust VR	2019-04-11	3	3	3	6	0.5
Current	2019-03-15	2	3	3	5	0.5
Space Whip	2019-04-22	2	3	3	5	0.5
Hurricane chase(飓风追击)	2019-07-25	4	3	3	7	0.5
Drawz	2019-01-14	2	3	3	5	0.5
天火(TianHuo)	2019-03-15	3	3	3	6	0.5
Crazy Mosquito	2019-02-14	2	3	3	5	0.5
方块人	2019-03-07	2	3	3	5	0.5
十日	2019-08-24	3	3	3	6	0.5
Galaxy in Peril	2019-05-01	2	3	3	5	0.5
WW2 Z Range VR	2019-09-16	2	3	3	5	0.5
Tiger Tank 59 Ⅰ Battleship	2019-06-10	135	3	3	138	0.5
Tiger Tank 59 Ⅰ Super Tank	2019-06-18	3	3	3	6	0.5
0Gravity	2019-07-27	2	3	3	5	0.5
mAIn COMPetition	2019-09-09	2	3	3	5	0.5
The Last AntLion	2019-07-26	2	3	3	5	0.5
DanceGirl-swinwear	2019-09-03	3	3	3	6	0.5
The Werewolf Hills	2019-08-17	3	3	3	6	0.5
Laservasion	2019-09-03	2	3	3	5	0.5
BioMech	2019-09-06	1	3	3	4	0.5
Voyagers	2019-11-24	3	3	3	6	0.5
Time Squared	2019-11-10	4	3	3	7	0.5
Vugluskr: Zombie Rampage	2019-10-14	2	3	3	5	0.5
Mouse Mayhem Shooting & Racing	2019-12-13	5	3	3	8	0.5
Builder VR	2019-12-27	2	3	3	5	0.5
Kid Baby: Starchild	2019-04-24	5	2	2	7	0.5
Hunt 'n Sneak	2019-04-10	5	2	2	7	0.5
Deadland VR	2019-04-02	2	2	2	4	0.5
Iffy Institute	2019-02-01	5	2	2	7	0.5
Abstract Hell	2019-01-04	3	2	2	5	0.5
Heavyweight Simulator 3	2019-07-03	2	2	2	4	0.5
Necro Defense	2019-01-25	2	2	2	4	0.5
Home Plate Baseball	2019-04-24	3	2	2	5	0.5
Echoes of the Past: The Citadels of Time Collector's Edition	2019-01-18	3	2	2	5	0.5
Infernum	2019-11-15	1	2	2	3	0.5
Fantasy Sino-Japanese War 幻想甲午	2019-01-11	2	2	2	4	0.5
Noel's Hope	2019-01-28	1	2	2	3	0.5
Last Letter	2019-02-09	2	2	2	4	0.5
Millionaire Dancer	2019-04-16	2	2	2	4	0.5
Suwarudo	2019-02-25	3	2	2	5	0.5
Land of Dread	2019-02-01	2	2	2	4	0.5
THE TRACKER	2019-11-03	2	2	2	4	0.5
Apolune	2019-02-06	1	2	2	3	0.5
Nasty	2019-02-06	3	2	2	5	0.5
Lgnorant girl doll	2019-02-15	3	2	2	5	0.5
Defection	2019-03-15	26	2	2	28	0.5
The Witchcraft of Skysword - 天翔と剣のウィッチクラフト	2019-02-25	2	2	2	4	0.5
Levers & Buttons	2019-04-13	3	2	2	5	0.5
Lord Democrat Strikes Out!	2019-03-30	1	2	2	3	0.5
Die Already	2019-04-01	1	2	2	3	0.5
Becoming a Dandelion Spore	2019-03-31	1	2	2	3	0.5
Archibald 2	2019-04-11	2	2	2	4	0.5
Tiger Tank 59 Ⅰ Rainstorm	2019-05-19	2	2	2	4	0.5
Get Out	2019-04-29	4	2	2	6	0.5
Chopper To Hell	2019-04-24	481	2	2	483	0.5
Rogue Slash	2019-11-06	2	2	2	4	0.5
Smart Gecko	2019-05-15	2	2	2	4	0.5
TopDownFarter	2019-05-24	2	2	2	4	0.5
Dive with Sylvia VR	2019-06-11	1	2	2	3	0.5
Niara: Rebellion Of the King Visual Novel RPG	2019-05-31	1	2	2	3	0.5
Au fil de l'eau	2019-10-25	1	2	2	3	0.5
Deck Box Dungeons	2019-05-29	97	2	2	99	0.5
All Evil Night 2	2019-05-30	3	2	2	5	0.5
Truefish	2019-07-10	3	2	2	5	0.5
Devellage	2019-09-12	1	2	2	3	0.5
Bikerz	2019-12-13	1	2	2	3	0.5
1001 Jigsaw. World Tour: France	2019-09-23	3	2	2	5	0.5
Night & Day	2019-08-04	2	2	2	4	0.5
Bounce	2019-07-24	2	2	2	4	0.5
FIGHT BALL VR	2019-08-03	2	2	2	4	0.5
Gods of Havoc: Fall to Earth	2019-08-22	2	2	2	4	0.5
ChatAid	2019-07-30	2	2	2	4	0.5
Dragon of Hongkong	2019-08-27	1	2	2	3	0.5
Forex Demo Accelerator	2019-09-02	2	2	2	4	0.5
Maze	2019-08-30	2	2	2	4	0.5
Someone Cloned The President	2019-08-22	1	2	2	3	0.5
Tinhead	2019-08-23	1	2	2	3	0.5
WAR GHOST	2019-09-06	1	2	2	3	0.5
Ladies Orders	2019-08-27	2	2	2	4	0.5
Vengeance ~ In my family's name	2019-08-30	2	2	2	4	0.5
wolves team	2019-09-12	4	2	2	6	0.5
Urban riots	2019-09-09	2	2	2	4	0.5
Quest for Conquest	2019-10-29	5	2	2	7	0.5
Mahjong Dimensions 3D - Fantasy Anime	2019-09-18	2	2	2	4	0.5
Twilight's Last Gleaming	2019-11-01	3	2	2	5	0.5
Cerberus: Orbital watch	2019-10-29	2	2	2	4	0.5
Spaceman	2019-12-31	2	2	2	4	0.5
Musical Aim Trainer	2019-12-15	2	2	2	4	0.5
Armorgeddon	2019-12-11	2	2	2	4	0.5
Bottler3000	2019-12-17	1	2	2	3	0.5
Pirates Treasure II	2019-12-31	1	2	2	3	0.5
Darkness and a Crowd	2019-12-27	3	1	1	4	0.5
Robosoul: From the Depths of Pax-Animi	2019-05-10	2	1	1	3	0.5
The Rift	2019-03-30	1	1	1	2	0.5
Rocketboarder	2019-06-20	2	1	1	3	0.5
A Dream of Burning Sand	2019-02-04	1	1	1	2	0.5
Legions At War	2019-12-06	2	1	1	3	0.5
baby game plan 0-3	2019-10-15	1	1	1	2	0.5
It Could Have Been Me	2019-05-19	1	1	1	2	0.5
強襲機甲/Drone Striker	2019-04-10	2	1	1	3	0.5
Requiem	2019-06-21	3	1	1	4	0.5
Tenacious	2019-02-04	2	1	1	3	0.5
Breen Origins	2019-07-01	7	1	1	8	0.5
Starboost EX	2019-01-18	2	1	1	3	0.5
RollerPlay	2019-12-03	3	1	1	4	0.5
Final Islands	2019-04-26	2	1	1	3	0.5
Lab Runner: X	2019-11-28	1	1	1	2	0.5
Fatal Hour: Roadkill	2019-02-01	1	1	1	2	0.5
Standard Legend	2019-03-29	1	1	1	2	0.5
Gyro Buster	2019-01-26	3	1	1	4	0.5
Dog In A Box	2019-02-01	2	1	1	3	0.5
New Adult Reality	2019-01-01	2	1	1	3	0.5
Justice	2019-06-03	2	1	1	3	0.5
Comit in Cosmo Knight's Revenge	2019-01-08	1	1	1	2	0.5
Mojack - Quest of Jackal : Puzzle game	2019-01-29	1	1	1	2	0.5
Pilgrimage	2019-01-18	3	1	1	4	0.5
ライフワン-lifeOne	2019-02-28	3	1	1	4	0.5
Tower Tank: TD Reversal	2019-01-04	1	1	1	2	0.5
Statue Defender	2019-02-22	2	1	1	3	0.5
STRANGE AND WEIRD MUSEUM	2019-01-03	1	1	1	2	0.5
Mage VR -Mini Version-	2019-01-10	3	1	1	4	0.5
The Town	2019-01-22	2	1	1	3	0.5
Dark Sun Pictures' Dark Sun - The Space Shooter	2019-01-25	1	1	1	2	0.5
PsyOps Solutions	2019-01-04	1	1	1	2	0.5
Card Adventures	2019-01-31	1	1	1	2	0.5
VRLab Academy: Anatomy VR	2019-07-13	3	1	1	4	0.5
Cavyrn	2019-02-14	3	1	1	4	0.5
Meister	2019-01-22	2	1	1	3	0.5
True Colors	2019-12-14	2	1	1	3	0.5
Bob and Kuura: Lost in Snowglobe	2019-02-06	3	1	1	4	0.5
3rd Invasion - Zombies vs. Steel	2019-03-01	2	1	1	3	0.5
Radioactive	2019-03-22	1	1	1	2	0.5
Escargot	2019-07-31	3	1	1	4	0.5
Let's Worm	2019-03-15	3	1	1	4	0.5
Recycler's Terminal	2019-03-28	1	1	1	2	0.5
EscapeRoute	2019-03-09	1	1	1	2	0.5
The Driver's Mission	2019-08-06	1	1	1	2	0.5
Jungle Adventure	2019-03-27	1	1	1	2	0.5
Welcome To... Chichester 3 : The Demon Of Chichester And The Last Day	2019-07-12	1	1	1	2	0.5
Dice Keeper	2019-04-26	2	1	1	3	0.5
Gray Memory	2019-03-28	1	1	1	2	0.5
Frank and 10 roots	2019-03-30	1	1	1	2	0.5
Infested Inside Multiplayer Online	2019-07-10	6	1	1	7	0.5
The Highscore	2019-04-30	8	1	1	9	0.5
Adventure in King Caries Land	2019-04-24	1	1	1	2	0.5
Obsidian Crown	2019-10-22	1	1	1	2	0.5
Xiu's SuperMarket	2019-06-22	2	1	1	3	0.5
R_sin	2019-05-11	1	1	1	2	0.5
Four Seals	2019-04-29	2	1	1	3	0.5
GoVenture TYPING	2019-05-06	3	1	1	4	0.5
The secret of FYNDEMOOR Park	2019-05-24	1	1	1	2	0.5
EscapeeZ	2019-05-15	2	1	1	3	0.5
Not So Heart	2019-07-11	2	1	1	3	0.5
BRG's The Stonecutter Visual Novel	2019-05-31	1	1	1	2	0.5
虚幻深渊 The Illusory abyss	2019-05-28	2	1	1	3	0.5
Happy World	2019-05-23	5	1	1	6	0.5
Aura	2019-07-23	4	1	1	5	0.5
PrincessGuardiansParodyH	2019-05-21	2	1	1	3	0.5
Ritbone	2019-06-21	2	1	1	3	0.5
Lost	2019-10-10	3	1	1	4	0.5
CUBG:Car unknown battlegrounds	2019-08-01	4	1	1	5	0.5
Master of the Forbidden Sea	2019-07-17	1	1	1	2	0.5
Mind Trap	2019-09-17	1	1	1	2	0.5
Cosmo Chaser	2019-06-29	1	1	1	2	0.5
Rainbow Run	2019-07-10	3	1	1	4	0.5
The Pirate Queen	2019-12-22	1	1	1	2	0.5
CricVRX - VR Cricket	2019-07-23	5	1	1	6	0.5
Corporate America	2019-11-22	5	1	1	6	0.5
Dream Jump Adventure	2019-09-02	2	1	1	3	0.5
Infinite Skyline: Superflight	2019-09-04	2	1	1	3	0.5
Rize of the Summonds	2019-08-08	2	1	1	3	0.5
Space raven quest - Tiny planet	2019-07-26	2	1	1	3	0.5
Secret City: The Human Threat Collector's Edition	2019-07-19	4	1	1	5	0.5
Laranga	2019-08-29	2	1	1	3	0.5
Lonepath	2019-08-19	2	1	1	3	0.5
Minesweep World	2019-10-07	2	1	1	3	0.5
Penguins vs. Bugs	2019-09-12	1	1	1	2	0.5
FOREST OF ELF	2019-09-06	1	1	1	2	0.5
Shuttlecock-H: Covered Rematch	2019-09-10	2	1	1	3	0.5
Neighborhood	2019-09-24	2	1	1	3	0.5
Horace: First Trip	2019-10-05	1	1	1	2	0.5
Hot Takes	2019-09-09	1	1	1	2	0.5
Errant Heart	2019-10-01	1	1	1	2	0.5
Counter Terrorism - Minesweeper	2019-10-13	1	1	1	2	0.5
Elite Battle : Rio	2019-10-30	1	1	1	2	0.5
Retro RPG Online 2	2019-10-17	1	1	1	2	0.5
Kendo	2019-10-11	2	1	1	3	0.5
RaceXXL Space	2019-10-04	5	1	1	6	0.5
A Dragon's Tale VR	2019-10-22	2	1	1	3	0.5
The Book Of Yorle	2019-10-28	4	1	1	5	0.5
Unlit	2019-11-25	2	1	1	3	0.5
Desert coachman	2019-10-24	2	1	1	3	0.5
Context	2019-10-25	2	1	1	3	0.5
Swordrite	2019-11-01	2	1	1	3	0.5
Remember, Lights Out	2019-10-29	1	1	1	2	0.5
Climb Challenge	2019-11-18	1	1	1	2	0.5
Narwhar Project Hornwhale	2019-12-06	2	1	1	3	0.5
Beat Or Die The MiniGames	2019-12-09	1	1	1	2	0.5
Memory Match Saga	2019-11-22	1	1	1	2	0.5
The Shenanigans of Cherry and Trix	2019-12-20	1	1	1	2	0.5
砌墙 Qi Qiang	2019-12-12	1	1	1	2	0.5
Meandering Fiend	2019-12-09	1	1	1	2	0.5
ReFrame	2019-12-12	2	1	1	3	0.5
Star of Lemutia : Reborn	2019-12-20	1	1	1	2	0.5
Blood Scrolls	2019-12-11	1	1	1	2	0.5
Days Gone By	2019-12-09	1	1	1	2	0.5
HELLO PLAYER	2019-12-16	1	1	1	2	0.5
The Big SokoBang	2019-12-17	2	1	1	3	0.5
Foxfall	2019-12-26	1	1	1	2	0.5
METAL SLUG XX	2019-02-01	57	419	420	477	0.49950000000000006
AVA: Dog Tag	2019-05-02	3674	493	496	4170	0.4987
On The Road - Truck Simulator	2019-11-14	81	511	515	596	0.4983
New Frontier	2019-12-27	930	1854	1892	2822	0.4954
SugarMill	2019-12-19	16	38	39	55	0.4953
RUINS Survival	2019-07-04	12	32	33	45	0.49450000000000005
Not in Heaven	2019-01-31	5	29	30	35	0.494
Northern Lights	2019-02-19	5	29	30	35	0.494
Fort Boyard	2019-06-27	8	28	29	37	0.4938
Her Majesty's Ship	2019-07-12	128	53	55	183	0.493
Burden	2019-01-17	6	21	22	28	0.49210000000000004
Magic Encyclopedia: Moon Light	2019-05-13	7	18	19	26	0.49100000000000005
Fantasy Blacksmith	2019-11-15	273	757	789	1062	0.4908
An Adventurer's Tale	2019-05-23	242	17	18	260	0.49060000000000004
1912 Titanic Mystery	2019-07-17	5	17	18	23	0.49060000000000004
Wanna Run Again - Sprite Girl	2019-04-26	6	16	17	23	0.4901
Fear in Hospital	2019-07-03	29	178	188	217	0.4886
DIY Simulator	2019-06-07	7	13	14	21	0.4883
Galactineers	2019-02-26	77	12	13	90	0.4875
Extreme Offroad Monster Simulator	2019-10-29	3	12	13	16	0.4875
Counter Terrorist Agency	2019-12-05	226	218	232	458	0.4869
Mental House	2019-09-04	4	11	12	16	0.4866
Predestination	2019-02-27	17	39	42	59	0.4864
Sento Stream	2019-09-04	3	23	25	28	0.48560000000000003
Burndown	2019-11-05	23	10	11	34	0.48560000000000003
Moon Tycoon	2019-07-19	6	10	11	17	0.48560000000000003
Seven Nations	2019-07-17	9	10	11	20	0.48560000000000003
Majula Frontier: The Offense	2019-12-04	13	10	11	24	0.48560000000000003
EndlessHell	2019-04-17	5	9	10	15	0.4844
Hentai Cyberpunk SCI-FI	2019-11-10	3	9	10	13	0.4844
Lavender	2019-12-12	74	33	36	110	0.4843
Hentai balls v3	2019-02-21	5	8	9	14	0.4829
Through The Dust	2019-10-07	5	8	9	14	0.4829
Red Evil	2019-11-16	4	8	9	13	0.4829
Lovely Heroines	2019-10-16	4	8	9	13	0.4829
Immortal Girl	2019-11-08	5	8	9	14	0.4829
The Legend of Arcadieu	2019-11-13	4	8	9	13	0.4829
Lucky Of Love	2019-01-24	13	41	45	58	0.4828
암전:Blackout	2019-04-23	34	40	44	78	0.48240000000000005
Kingdom Of Rhea	2019-10-03	9	62	68	77	0.4822
Arkin	2019-09-25	8	7	8	16	0.4811
Post War Dreams	2019-09-27	4	7	8	12	0.4811
Space Tycoon	2019-01-04	8	7	8	16	0.4811
Data mining 6	2019-02-21	2	7	8	10	0.4811
The Trials of Olympus III: King of the World	2019-03-19	11	7	8	19	0.4811
Diastone: Confusion	2019-07-12	5	7	8	13	0.4811
Planetoid Pioneers Online	2019-07-11	207	73	81	288	0.4797
Love Alchemy: A Heart In Winter	2019-03-12	5	24	27	32	0.47950000000000004
Idle Guardians	2019-05-10	108	24	27	135	0.47950000000000004
Rise of Ages	2019-01-29	41	90	100	141	0.47909999999999997
Velocity G	2019-03-11	3	6	7	10	0.4789
Azure Wing: Rising Gale	2019-05-02	5	6	7	12	0.4789
ROAD HOMEWARD 2: river trip	2019-04-29	2	6	7	9	0.4789
Peanut	2019-05-13	2	6	7	9	0.4789
Sniper Commando Attack	2019-07-31	2	6	7	9	0.4789
大侠坛说	2019-08-27	5	6	7	12	0.4789
Jailbreak Simulator	2019-08-16	4	6	7	11	0.4789
Paladin Slayer	2019-09-06	3	6	7	10	0.4789
70 Seconds! Adventure	2019-08-30	2	6	7	9	0.4789
Antarctic Girl 南極娘	2019-10-22	4	6	7	11	0.4789
Late Night 1320	2019-03-16	9	23	26	35	0.47880000000000006
Hentai Like a Boss	2019-01-25	5	14	16	21	0.47850000000000004
Spire of Sorcery (Limited Early Access)	2019-11-14	114	40	45	159	0.4783
Survival Camp	2019-12-31	35	101	113	148	0.47750000000000004
Criss Cross	2019-04-29	119	90	101	220	0.4771
Pantropy	2019-01-31	365	140	157	522	0.4765
Mine the Gold	2019-04-11	14	28	32	46	0.47630000000000006
Halloween with Veronica	2019-10-17	7	20	23	30	0.47630000000000006
Multirotor Sim 2	2019-12-09	3	5	6	9	0.4761
Bedtime Blues	2019-03-29	2	5	6	8	0.4761
Mad Gun Range VR Simulator	2019-04-04	3	5	6	9	0.4761
Super Space Jump Man	2019-03-05	2	5	6	8	0.4761
Extinction: Alien Invasion	2019-03-29	3	5	6	9	0.4761
Logistics Expert	2019-07-03	5	5	6	11	0.4761
Amortizer Off-Road	2019-05-19	3	5	6	9	0.4761
Lust Selection: Episode One	2019-06-07	3	5	6	9	0.4761
Bouncy Bob: Episode 2	2019-10-30	5	5	6	11	0.4761
Christmas Cats Revenge	2019-12-13	2	5	6	8	0.4761
Nucvivor	2019-04-01	4	12	14	18	0.4758
Welcome To Cathouse（欢迎来到猫咪花园）	2019-11-27	4	12	14	18	0.4758
TKKG - Die Feuerprobe	2019-07-17	10	12	14	24	0.4758
Robot Warriors	2019-04-22	3	35	40	43	0.4757
Battle for the Galaxy	2019-05-13	226	125	142	368	0.47409999999999997
VR Flight Simulator New York - Cessna	2019-01-05	5	11	13	18	0.47409999999999997
Marvin The Hatter	2019-04-19	4	11	13	17	0.47409999999999997
Stream Service	2019-08-22	9852	31	36	9888	0.4732
Family Hidden Secret	2019-05-03	16	31	36	52	0.4732
MONKEY KING: HERO IS BACK	2019-10-16	207	211	240	447	0.473
BAFF 2	2019-06-27	4	10	12	16	0.4722
Beat Miner	2019-04-03	1	4	5	6	0.4722
Golden Key	2019-05-29	4	4	5	9	0.4722
Car Transporter 2013	2019-07-03	2	4	5	7	0.4722
Fairground 2 - The Ride Simulation	2019-01-01	4	4	5	9	0.4722
Boobs or gtfo	2019-01-12	2	4	5	7	0.4722
Kingdom-Heroes	2019-06-22	2	4	5	7	0.4722
Cold Bite	2019-02-22	3	4	5	8	0.4722
Angry Farm	2019-07-18	2	4	5	7	0.4722
Twinkle Star - 未来はすぐそこで待っている	2019-04-15	2	4	5	7	0.4722
Inori's House	2019-06-18	3	4	5	8	0.4722
VRRCC	2019-05-20	2	4	5	7	0.4722
Light Hunters: Battalion of Darkness	2019-11-14	4	4	5	9	0.4722
ZomB: Battlegrounds	2019-07-26	5	4	5	10	0.4722
Hentai MatchUp	2019-08-01	3	4	5	8	0.4722
Star Police	2019-11-17	2	4	5	7	0.4722
GOLD EXPRESS	2019-10-31	17	4	5	22	0.4722
Monophobia	2019-12-05	2	4	5	7	0.4722
Medieval - Embers of War	2019-10-18	3	4	5	8	0.4722
Wolfenstein: Cyberpilot	2019-07-25	38	122	140	178	0.4721
Happy Words	2019-05-17	20	50	58	78	0.47200000000000003
Grave Keeper	2019-03-29	11	42	49	60	0.47140000000000004
Invasion Zero	2019-01-11	15	15	18	33	0.4703
Protocol VR	2019-04-16	9	21	25	34	0.47020000000000006
活下去	2019-10-08	19	27	32	51	0.47000000000000003
When Wardens Fall	2019-08-15	5	9	11	16	0.47000000000000003
Block Granny Horror	2019-08-16	2	9	11	13	0.47000000000000003
Let's make... sports	2019-11-05	2	9	11	13	0.47000000000000003
Crazy city	2019-11-28	3	9	11	14	0.47000000000000003
High School Otome	2019-10-31	8	20	24	32	0.469
Super president How to rule the country	2019-02-27	3	14	17	20	0.4687
Fear The Wolves	2019-02-06	611	1598	1836	2447	0.4683
Hand to Hand Combat	2019-06-28	5	8	10	15	0.4673
Metro Explosion Simulator	2019-09-18	2	8	10	12	0.4673
Alive 2 Survive	2019-10-10	6	8	10	16	0.4673
Desire Gambling House/欲望赌馆	2019-09-12	136	35	42	178	0.4668
Divenia	2019-09-03	6	3	4	10	0.4668
Fun VR Farm	2019-01-23	4	3	4	8	0.4668
Heart and Axe	2019-01-29	1	3	4	5	0.4668
Chaos Village	2019-02-14	2	3	4	6	0.4668
Delta Squad	2019-05-29	2	3	4	6	0.4668
Faux	2019-03-18	2	3	4	6	0.4668
Furry Chronicles	2019-03-10	2	3	4	6	0.4668
Prison Escape	2019-03-13	2	3	4	6	0.4668
Human Sacrifice	2019-03-20	2	3	4	6	0.4668
krAsAvA Shot	2019-04-04	1	3	4	5	0.4668
Mystery Trackers: Winterpoint Tragedy Collector's Edition	2019-04-12	5	3	4	9	0.4668
Jacob's Fantastic SeXXXual Voyage	2019-06-10	2	3	4	6	0.4668
Where is my family	2019-05-31	3	3	4	7	0.4668
Wingsuit: Gudvangen	2019-06-25	3	3	4	7	0.4668
Bombuzal	2019-08-15	2	3	4	6	0.4668
Detonation	2019-07-08	2	3	4	6	0.4668
NORR part I: Ace Shot	2019-07-24	3	3	4	7	0.4668
ViVO	2019-08-14	2	3	4	6	0.4668
Alien Infection	2019-10-24	2	3	4	6	0.4668
The Man with the Ivory Cane	2019-07-25	4	3	4	8	0.4668
Banana Invaders	2019-09-05	1	3	4	5	0.4668
Desert monsters	2019-09-09	2	3	4	6	0.4668
Griddlers Victorian Picnic	2019-10-28	4	3	4	8	0.4668
Dragon Slayer	2019-09-22	3	3	4	7	0.4668
Evrisia Art	2019-09-23	2	3	4	6	0.4668
Cross Border VR	2019-11-20	2	3	4	6	0.4668
Rebound Ball	2019-12-19	1	3	4	5	0.4668
Terrible Beast from the East	2019-01-04	169	46	55	224	0.46649999999999997
War Online: Pacific	2019-01-17	21	29	35	56	0.46649999999999997
Everreach: Project Eden	2019-12-04	83	197	232	315	0.4658
时之扉	2019-06-11	26	17	21	47	0.4648
Skully Pinball	2019-04-16	4	12	15	19	0.4648
Negligee: Love Stories	2019-02-08	11	27	33	44	0.4645
SNUSE 221	2019-04-02	2	7	9	11	0.46409999999999996
gun man	2019-04-26	2	7	9	11	0.46409999999999996
时间旅者(TimeWalker)	2019-05-31	10	7	9	19	0.46409999999999996
Mizari Loves Company	2019-11-13	5	7	9	14	0.46409999999999996
Warzone VR	2019-01-26	17	16	20	37	0.4632
Gangsta Sniper 2: Revenge	2019-02-04	6	16	20	26	0.4632
not my car – Battle Royale	2019-04-05	735	618	732	1467	0.4626
Professional Thief	2019-03-13	2	11	14	16	0.4625
TriangleStorm	2019-11-19	2	11	14	16	0.4625
My Bones Remastered	2019-08-06	3	25	31	34	0.4623
Ballance: The Return	2019-12-17	6	20	25	31	0.462
Code/The Werewolf Party	2019-07-29	8	15	19	27	0.46130000000000004
Flying Aces - Navy Pilot Simulator	2019-09-27	5	19	24	29	0.46049999999999996
Streng Check	2019-03-27	3841	6	8	3849	0.46020000000000005
Endangered	2019-01-10	2787	6	8	2795	0.46020000000000005
The Hero	2019-09-26	2	6	8	10	0.46020000000000005
TUBWT	2019-05-01	4	6	8	12	0.46020000000000005
Clans to Kingdoms	2019-08-01	3	6	8	11	0.46020000000000005
NEKROTRONIC VR	2019-08-29	3	6	8	11	0.46020000000000005
Biotope	2019-07-23	175	94	115	290	0.4598
PraeBot	2019-02-22	4	10	13	17	0.4598
6120	2019-04-19	7	14	18	25	0.4593
Hartacon Tactics	2019-01-01	6	18	23	29	0.45880000000000004
Dolphin Swim	2019-04-10	110	18	23	133	0.45880000000000004
Hentai Girl in Space	2019-01-07	6	22	28	34	0.45840000000000003
Sex & Gun VR	2019-04-15	8	35	44	52	0.4583
Galaxy Crash	2019-08-30	3	2	3	6	0.4583
The Ragdoll	2019-11-18	2	2	3	5	0.4583
All For One	2019-01-01	3	2	3	6	0.4583
Qian-Shan Village	2019-08-02	2	2	3	5	0.4583
Ascend	2019-07-11	2	2	3	5	0.4583
8bit Arena	2019-05-20	11	2	3	14	0.4583
Oops!!! Puzzles!!!	2019-03-29	1	2	3	4	0.4583
Goblin Squad - Total Division	2019-05-10	5	2	3	8	0.4583
The Magnet Trials	2019-02-22	2	2	3	5	0.4583
方块联盟	2019-05-31	18	2	3	21	0.4583
Scroll2Read	2019-01-07	9	2	3	12	0.4583
Chaos Caves	2019-01-25	4	2	3	7	0.4583
Sick Love - An RPG Maker Novel	2019-01-17	2	2	3	5	0.4583
Warforged	2019-04-03	4	2	3	7	0.4583
Candy Mandy	2019-03-06	3	2	3	6	0.4583
A Story of Us - ep. 1 - First Memories	2019-02-27	2	2	3	5	0.4583
Destiny Hunter	2019-03-17	2	2	3	5	0.4583
Aqua Rally	2019-04-26	9	2	3	12	0.4583
Roach Killer	2019-04-15	1	2	3	4	0.4583
Puss in Boots: Fear Not Hooman	2019-05-10	2	2	3	5	0.4583
Mage VR: The Lost Memories	2019-03-08	1	2	3	4	0.4583
迷宫战争(Maze Wars)	2019-04-02	11	2	3	14	0.4583
Glacial	2019-03-26	2	2	3	5	0.4583
Cosmic Cash	2019-05-07	2	2	3	5	0.4583
Wind Force	2019-04-08	10	2	3	13	0.4583
Candy Adventure	2019-04-05	2	2	3	5	0.4583
Ultimate Poker	2019-08-14	7	2	3	10	0.4583
Virtual Reality Emergency Response Sim	2019-06-12	2	2	3	5	0.4583
Forestation: Circles Of Nature	2019-06-24	3	2	3	6	0.4583
Blood Magic	2019-08-23	2	2	3	5	0.4583
Tiger Tank 59 Ⅰ Volcano	2019-05-24	1	2	3	4	0.4583
Meowk and Frocco	2019-07-25	1	2	3	4	0.4583
Scenner	2019-06-12	2	2	3	5	0.4583
Lilit H Project	2019-06-07	4	2	3	7	0.4583
故郷をさがす三姉妹/ The Three Sisters looking for their back home.	2019-06-29	1	2	3	4	0.4583
Matter of the Dreams	2019-06-28	1	2	3	4	0.4583
ZomB	2019-09-17	3	2	3	6	0.4583
Crystal Defense	2019-07-31	2	2	3	5	0.4583
Afloat	2019-08-22	2	2	3	5	0.4583
HENTAI Sliding Puzzle	2019-08-09	2	2	3	5	0.4583
Hentai Cute	2019-08-16	3	2	3	6	0.4583
Follow the White Rabbit VR (화이트래빗)	2019-09-11	1	2	3	4	0.4583
Frustrate-a-ball	2019-09-11	1	2	3	4	0.4583
Air	2019-10-30	4	2	3	7	0.4583
Binky show	2019-12-04	2	2	3	5	0.4583
Fart Fiasco Premium	2019-11-11	2	2	3	5	0.4583
Black Office - Entertainment Department	2019-10-28	4	2	3	7	0.4583
Kira's Contract	2019-10-27	3	2	3	6	0.4583
Dead territory	2019-12-18	3	2	3	6	0.4583
Homeless Simulator 2	2019-05-25	5	30	38	43	0.4576
Nostos	2019-12-06	997	408	497	1494	0.4572
Beyond Enemy Lines 2 Enhanced Edition	2019-08-08	19	17	22	41	0.457
Brutal Inventions	2019-12-29	6	9	12	18	0.45670000000000005
Epic Adventures: La Jangada	2019-01-20	5	9	12	17	0.45670000000000005
The Last Cowboy	2019-06-10	2	9	12	14	0.45670000000000005
How To Be A Real Dude	2019-05-09	7	29	37	44	0.4565
Blame him	2019-06-03	26	67	84	110	0.4561
PlanetSide Arena	2019-09-19	1506	867	1056	2562	0.4559
Flying Soul	2019-01-15	2	5	7	9	0.45520000000000005
Two Clusters: Kain	2019-04-30	15	5	7	22	0.45520000000000005
***	2019-03-17	2	5	7	9	0.45520000000000005
TAG WAR VR	2019-08-23	7	5	7	14	0.45520000000000005
Favo!+	2019-11-16	5	5	7	12	0.45520000000000005
Spider Solitaire F	2019-09-05	4	5	7	11	0.45520000000000005
Super Lee World	2019-08-03	2	5	7	9	0.45520000000000005
閃電對決Lightning Wings II	2019-10-27	4	5	7	11	0.45520000000000005
PUT IN BAD	2019-11-09	2	5	7	9	0.45520000000000005
Dual Family	2019-09-16	60	73	92	152	0.4548
World of Zombies	2019-01-25	4	12	16	20	0.4545
FRENZY PLANTS	2019-09-26	2	12	16	18	0.4545
Wolfenstein: Youngblood	2019-07-25	6582	5327	6479	13061	0.45409999999999995
I Can't Believe It's Not Gambling 2K GOTY Edition	2019-12-16	11	23	30	41	0.45380000000000004
Ultrawings FLAT	2019-04-30	4	8	11	15	0.45310000000000006
Full Of Love	2019-04-11	6	8	11	17	0.45310000000000006
Private Dance VR	2019-05-01	4	8	11	15	0.45310000000000006
Pleasure Airlines	2019-05-30	3	8	11	14	0.45310000000000006
Inside The Park VR	2019-08-30	5	8	11	16	0.45310000000000006
末法仙路	2019-06-20	19	30	39	58	0.4529
REDVIIL	2019-03-12	6	26	34	40	0.45270000000000005
Corma	2019-01-23	83	231	290	373	0.452
EBONY	2019-11-19	3	11	15	18	0.4516
Sim Empire	2019-04-15	135	77	99	234	0.4507
从前有个仙儿	2019-02-19	122	24	32	154	0.4497
Fantasy Maid	2019-07-25	3	17	23	26	0.4495
The Woods: VR Escape the Room	2019-04-04	5	7	10	15	0.4487
Okay, Panic!	2019-07-10	4	7	10	14	0.4487
Leylines	2019-01-11	9	4	6	15	0.4486
Defendion	2019-07-22	2	4	6	8	0.4486
Fugue	2019-10-02	2	4	6	8	0.4486
Rusty Runner	2019-07-11	2	4	6	8	0.4486
Encore Card Games	2019-12-20	16	4	6	22	0.4486
GUNGRAVE VR U.N	2019-03-06	2	4	6	8	0.4486
守护神石 StoneDefence	2019-01-10	2	4	6	8	0.4486
Gladiator: Blades of Fury	2019-03-07	2	4	6	8	0.4486
222	2019-02-22	2	4	6	8	0.4486
2014.Aftermath	2019-04-30	2	4	6	8	0.4486
GOLF in PAPER	2019-12-13	2	4	6	8	0.4486
Mountain Rescue Simulator	2019-10-10	4	4	6	10	0.4486
Nubla	2019-09-04	2	4	6	8	0.4486
Oceans We Make	2019-11-29	2	4	6	8	0.4486
Gates of Hell	2019-11-05	2	4	6	8	0.4486
You are apt	2019-08-31	2	4	6	8	0.4486
Medieval Towns	2019-03-15	6	10	14	20	0.4483
Draft Day Sports: Pro Football 2020	2019-08-05	27	10	14	41	0.4483
Find the Oil Racing Edition	2019-04-01	3	19	26	29	0.44680000000000003
1406	2019-03-21	6	42	56	62	0.4465
Endless Battle	2019-01-03	468	154	200	668	0.4461
DemonsAreCrazy	2019-09-12	466	283	365	831	0.4457
Clickable Coffee Shop	2019-07-26	10	12	17	27	0.4448
Duel Girl	2019-08-16	8	12	17	25	0.4448
Desire Den	2019-03-19	4	21	29	33	0.44450000000000006
Echo Tokyo: Phoenix	2019-03-29	16	9	13	29	0.44450000000000006
MRAK	2019-10-09	2	6	9	11	0.4434
Chaos Theory	2019-02-01	4	6	9	13	0.4434
Author Clicker	2019-03-14	2	6	9	11	0.4434
Global Soccer: A Management Game 2019	2019-05-31	5	6	9	14	0.4434
Kakuro	2019-07-29	2	6	9	11	0.4434
Furious Goal	2019-09-23	2	6	9	11	0.4434
Phlyndir	2019-08-01	2	1	2	4	0.44310000000000005
Memory Eater	2019-09-07	2	1	2	4	0.44310000000000005
Mini Hockey VR	2019-01-23	2	1	2	4	0.44310000000000005
Reflecting Reflections	2019-08-10	1	1	2	3	0.44310000000000005
TwoPlay Mahjong	2019-02-15	2	1	2	4	0.44310000000000005
Skyland Defense	2019-02-07	4	1	2	6	0.44310000000000005
Decisions	2019-08-10	1	1	2	3	0.44310000000000005
Ozapell Mystery Text Adventure	2019-04-01	1	1	2	3	0.44310000000000005
Afterlifes	2019-07-03	2	1	2	4	0.44310000000000005
Zombie Deathrace Feeding Frenzy	2019-06-28	2	1	2	4	0.44310000000000005
Panda Hero	2019-07-05	1	1	2	3	0.44310000000000005
Dark Shiny	2019-01-31	2	1	2	4	0.44310000000000005
The Scenic Treasures - Japanese Learning Visual Novel	2019-01-01	2	1	2	4	0.44310000000000005
Bullynoid	2019-03-15	2	1	2	4	0.44310000000000005
Ordo Et Chao: New World	2019-03-14	8	1	2	10	0.44310000000000005
Bounty Hunter	2019-01-22	2	1	2	4	0.44310000000000005
Rival Nation Wars	2019-05-02	1	1	2	3	0.44310000000000005
Balloon Girl	2019-07-25	1	1	2	3	0.44310000000000005
Spacelair	2019-03-22	2	1	2	4	0.44310000000000005
Perhaps When We Dream	2019-02-12	2	1	2	4	0.44310000000000005
Royale Storm Bowling	2019-03-29	1	1	2	3	0.44310000000000005
Robo Miner 2	2019-04-15	2	1	2	4	0.44310000000000005
Polygon's Royale	2019-03-08	2	1	2	4	0.44310000000000005
BluBoy: The Journey Begins	2019-06-06	3	1	2	5	0.44310000000000005
Tiger Tank 59 Ⅰ Break The Fog	2019-03-01	1	1	2	3	0.44310000000000005
HellHole	2019-03-29	1	1	2	3	0.44310000000000005
Massive Air Combat	2019-03-16	2	1	2	4	0.44310000000000005
Tiger Fighter 1931 Tora!	2019-03-15	1	1	2	3	0.44310000000000005
Mahjong: Magic Chips	2019-06-25	3	1	2	5	0.44310000000000005
Tiger Tank 59 Ⅰ Black Hill Fortress	2019-04-09	1	1	2	3	0.44310000000000005
Narazumono	2019-05-17	1	1	2	3	0.44310000000000005
Wrath of the Samurai	2019-07-10	1	1	2	3	0.44310000000000005
Gunship Recon	2019-05-08	2	1	2	4	0.44310000000000005
Space Duke	2019-05-08	1	1	2	3	0.44310000000000005
Planet Jump 2	2019-05-24	2	1	2	4	0.44310000000000005
Neverland Treasure	2019-07-19	5	1	2	7	0.44310000000000005
DISONANTE	2019-05-24	8	1	2	10	0.44310000000000005
Valley Run	2019-07-03	1	1	2	3	0.44310000000000005
Warhead Destined	2019-09-03	1	1	2	3	0.44310000000000005
Square Norm	2019-11-08	2	1	2	4	0.44310000000000005
Spaceman Defender	2019-07-19	1	1	2	3	0.44310000000000005
Alien Shooter in Space Cradle - Virtual Reality	2019-07-12	2	1	2	4	0.44310000000000005
C64 & AMIGA Classix Remakes Sixpack 3	2019-07-27	2	1	2	4	0.44310000000000005
N.E.O	2019-11-06	4	1	2	6	0.44310000000000005
Tiger Fighter 1931 Tora!Tora!	2019-08-13	1	1	2	3	0.44310000000000005
Tiger Fighter 1931 Tora!Tora!Tora!	2019-08-13	1	1	2	3	0.44310000000000005
Legends	2019-08-13	1	1	2	3	0.44310000000000005
The Empire's Crisis	2019-10-14	2	1	2	4	0.44310000000000005
EAGLETALON vs. HORDE OF THE FLIES	2019-12-23	2	1	2	4	0.44310000000000005
Instacalm VR	2019-10-09	2	1	2	4	0.44310000000000005
Captain Cook: Word Puzzle	2019-11-29	3	1	2	5	0.44310000000000005
You Only Livez Twice	2019-10-26	2	1	2	4	0.44310000000000005
Unnamed Adventure/无名之旅	2019-11-20	1	1	2	3	0.44310000000000005
Castle Commander	2019-11-25	2	1	2	4	0.44310000000000005
Wall Street Tycoon	2019-03-14	105	54	73	178	0.4426
ViRo Playspace	2019-09-13	37	160	212	249	0.44189999999999996
Holopoint: Chronicle	2019-02-01	5	11	16	21	0.4414
Broken Spell	2019-09-30	5	11	16	21	0.4414
Last Days Motel	2019-02-03	21	46	63	84	0.441
DISSIDIA FINAL FANTASY NT Free Edition	2019-03-12	2182	1417	1842	4024	0.4405
Jon Shafer's At the Gates	2019-01-23	663	204	271	934	0.4405
Matchville	2019-06-18	39	45	62	101	0.44
Cicadas - The IQA Edition	2019-10-07	5	8	12	17	0.44
Date Write	2019-02-01	2	8	12	14	0.44
Picross Hansel and Gretel - Nonograms	2019-03-25	9	8	12	21	0.44
Sexy Miss	2019-04-21	5	8	12	17	0.44
Your Girl	2019-06-05	7	8	12	19	0.44
Nightmare Game	2019-07-19	9	8	12	21	0.44
uznali ? soglasnbI ?	2019-09-23	4	8	12	16	0.44
Deadly Zone	2019-04-03	1	3	5	6	0.43950000000000006
Unrest Indigo	2019-04-12	2	3	5	7	0.43950000000000006
Operation Snowman	2019-01-25	2	3	5	7	0.43950000000000006
Expanse	2019-10-30	4	3	5	9	0.43950000000000006
Astrog	2019-03-01	2	3	5	7	0.43950000000000006
Treasure Masters, Inc.: The Lost City	2019-04-03	4	3	5	9	0.43950000000000006
JetX Space Edition	2019-05-30	4	3	5	9	0.43950000000000006
First Customer	2019-06-25	2	3	5	7	0.43950000000000006
Soccer Kid	2019-07-09	3	3	5	8	0.43950000000000006
Last warrior	2019-07-11	2	3	5	7	0.43950000000000006
Wrecked Crash Simulator	2019-05-16	4	13	19	23	0.439
Space Expand	2019-02-22	16	10	15	31	0.4375
Badland Caravan	2019-05-27	12	10	15	27	0.4375
I Wanna Brother	2019-08-22	8	10	15	23	0.4375
EBOLA	2019-07-10	57	54	75	132	0.4374
Storm Area 51	2019-08-31	20	23	33	53	0.4372
VR Racing	2019-06-06	5	15	22	27	0.43710000000000004
Voltage	2019-05-28	3	5	8	11	0.4368
DearCraft	2019-05-06	3	5	8	11	0.4368
Brutal Games	2019-08-06	7	5	8	15	0.4368
Defoliation	2019-04-26	4	5	8	12	0.4368
Picross Floof	2019-04-01	3	5	8	11	0.4368
SAMOSBOR 2D	2019-08-05	2	5	8	10	0.4368
Bootybuns 2	2019-08-27	10	5	8	18	0.4368
MMA Team Manager	2019-03-11	8	25	36	44	0.43590000000000007
I am the dirt-for art	2019-09-26	18	12	18	36	0.43560000000000004
Moot District	2019-05-10	4	7	11	15	0.4347
Death Rpg	2019-03-29	2	7	11	13	0.4347
Birchian Flight Simulator	2019-07-04	3	7	11	14	0.4347
Apollo 11 VR HD: First Steps	2019-07-25	7	7	11	18	0.4347
Divan Chronicles	2019-10-21	3	7	11	14	0.4347
Ruins to Rumble	2019-09-27	2	9	14	16	0.43310000000000004
Real Girl VR	2019-07-26	10	9	14	24	0.43310000000000004
Time Break 2121	2019-08-21	4	9	14	18	0.43310000000000004
WWE 2K20	2019-10-21	961	2522	3378	4339	0.4328
Trident's Wake	2019-06-04	12	43	62	74	0.43170000000000003
Quantum Legend - vr show	2019-03-04	11	11	17	28	0.43170000000000003
Creature Hunt	2019-04-10	4	15	23	27	0.42969999999999997
Crafting Block World	2019-09-05	4	15	23	27	0.42969999999999997
STAY COOL, KOBAYASHI-SAN!: A RIVER CITY RANSOM STORY	2019-11-07	9	17	26	35	0.4288
Total Esports Action Manager	2019-04-03	4	6	10	14	0.4283
Anime Vampire Slayer	2019-06-01	2	6	10	12	0.4283
Dino Tour	2019-02-27	8	6	10	18	0.4283
LAB Defence	2019-07-10	2	6	10	12	0.4283
Lemons Must Die	2019-07-03	2	4	7	9	0.4282
The Yellow Quiz	2019-04-16	4	4	7	11	0.4282
Last Line VR: A Zombie Defense Game	2019-07-26	3	4	7	10	0.4282
MONSTERS:SURVIVAL	2019-04-01	5	4	7	12	0.4282
Lightmare Castle	2019-11-01	2	4	7	9	0.4282
Dungeon Bosses	2019-05-24	2	4	7	9	0.4282
3x3 mini-Shogi	2019-04-20	2	4	7	9	0.4282
Hippo eating banana	2019-05-10	2	4	7	9	0.4282
Hentai Ninja Garden	2019-08-01	2	4	7	9	0.4282
Battle Sorcerer	2019-11-20	6	4	7	13	0.4282
Depths of Madness	2019-05-14	10	19	29	39	0.42810000000000004
Real Fishing VR	2019-03-06	5	8	13	18	0.4279
不死-Immortal	2019-07-30	2	8	13	15	0.4279
Strike!OvulationDivine Fist! Rebellion to Extinction!	2019-12-20	2	10	16	18	0.4274
3D Text Adventure	2019-09-10	3	10	16	19	0.4274
CHAIN SAW	2019-06-17	5	10	16	21	0.4274
DK Online	2019-03-05	891	233	329	1220	0.42729999999999996
Armored Battle Crew	2019-06-06	196	234	331	527	0.4269
Rebirth	2019-02-26	8	14	22	30	0.4264
Tobit	2019-02-14	3	14	22	25	0.4264
Diminutive	2019-06-25	2	2	4	6	0.4261
Wand Wars VR	2019-01-08	3	2	4	7	0.4261
MinigolfParkVR	2019-03-29	3	2	4	7	0.4261
Ican	2019-05-30	3	2	4	7	0.4261
Arauco Saga 	2019-11-01	2	2	4	6	0.4261
Ruthless Water	2019-01-09	3	2	4	7	0.4261
Vacation Adventures: Park Ranger	2019-01-11	3	2	4	7	0.4261
Elf Epizode One	2019-01-23	2	2	4	6	0.4261
PARSE ALLY	2019-02-04	2	2	4	6	0.4261
Nogalious MSX	2019-02-28	2	2	4	6	0.4261
BAD BILLY 2D VR	2019-02-19	3	2	4	7	0.4261
Golden war spirit	2019-06-24	2	2	4	6	0.4261
Hocus Potions	2019-05-12	3	2	4	7	0.4261
Idle Portal Guardian	2019-05-20	13	2	4	17	0.4261
麻神消消乐	2019-05-19	51	2	4	55	0.4261
Martians Vs Robots	2019-05-24	2	2	4	6	0.4261
Milly the dog	2019-06-06	2	2	4	6	0.4261
STRASHILKA	2019-07-29	2	2	4	6	0.4261
蹩脚的炼金术师	2019-07-01	5	2	4	9	0.4261
The Stranger: Interactive Game	2019-07-22	2	2	4	6	0.4261
Climatic Survival: Northern Storm	2019-08-21	1	2	4	5	0.4261
Hentai ChessKnight	2019-08-31	2	2	4	6	0.4261
Immortal Wanna	2019-08-19	3	2	4	7	0.4261
Raiding Area 51 - Break out Waifu	2019-08-20	3	2	4	7	0.4261
Warships On The Halloween Night	2019-09-13	2	2	4	6	0.4261
Gangsters 1920	2019-11-07	2	2	4	6	0.4261
Man Wreck	2019-10-24	3	2	4	7	0.4261
Explosion Magic Firebolt	2019-11-08	2	2	4	6	0.4261
GOOSE.IO	2019-10-29	2	2	4	6	0.4261
InfiniteBeat	2019-11-23	3	2	4	7	0.4261
Fantasy Realm TD	2019-12-12	5	2	4	9	0.4261
Between Two Castles - Digital Edition	2019-11-15	475	161	232	707	0.42460000000000003
CONTRA: ROGUE CORPS	2019-09-24	30	79	116	146	0.42450000000000004
Where the Bees Make Honey	2019-03-26	7	24	37	44	0.4242
Clicker Warriors	2019-10-22	221	46	69	290	0.4239
Sex & Gun PC	2019-09-10	13	11	18	31	0.4227
Yanpai Simulator	2019-07-04	4	17	27	31	0.4225
暗黑破坏岛/DiabloIslanD	2019-09-26	21	9	15	36	0.42240000000000005
Project VR Wild Hunt	2019-09-08	3	7	12	15	0.4218
Total Seclusion	2019-12-10	3	7	12	15	0.4218
Stickman Racer Road Draw 2	2019-02-18	3	7	12	15	0.4218
Deep Diving VR	2019-09-12	5	7	12	17	0.4218
Spot The Differences 2020 | 大家来找茬 2020	2019-12-13	4	7	12	16	0.4218
Try To Survive	2019-04-03	10	29	45	55	0.4214
Crash Dummy	2019-03-01	2	5	9	11	0.4204
The Expedition	2019-02-15	3	5	9	12	0.4204
Four-color Fantasy	2019-03-15	4	5	9	13	0.4204
Transhaping	2019-02-25	4	5	9	13	0.4204
Agross	2019-09-02	2	5	9	11	0.4204
Oncoming Death Steam Edition	2019-07-02	3	3	6	9	0.4167
Core Of Darkness	2019-05-17	7	3	6	13	0.4167
Hentai Girls: Christmas	2019-05-23	1	3	6	7	0.4167
Forest Mage	2019-07-19	2	3	6	8	0.4167
Animal war	2019-08-03	2	3	6	8	0.4167
Gravity Control	2019-08-14	2	3	6	8	0.4167
Hentai Girl Slide Puzzle	2019-09-20	1	3	6	7	0.4167
Cocktail for Beauty	2019-08-31	2	3	6	8	0.4167
World War 2 Winter Gun Range VR Simulator	2019-11-27	3	3	6	9	0.4167
Arzt Simulator	2019-12-02	6	3	6	12	0.4167
Hibiscus Red	2019-11-08	44	17	28	72	0.4164
Resort Boss: Golf	2019-07-25	58	56	87	145	0.41590000000000005
Blood Bond - Into the Shroud	2019-02-27	4	6	11	15	0.41450000000000004
ArchMMO 2	2019-04-12	4	6	11	15	0.41450000000000004
Defending Territory	2019-09-07	5	6	11	16	0.41450000000000004
Night City 2177	2019-02-24	14	37	59	73	0.4143
Crimson Hotel	2019-08-27	13	18	30	43	0.41369999999999996
Drop	2019-05-09	146	141	216	362	0.4128
Dodge This!	2019-02-25	7	9	16	23	0.41250000000000003
Rending Sky	2019-12-25	9	17	29	38	0.4105
Unearthing Process	2019-05-16	6	4	8	14	0.4103
Derpy pirates! The search for the bungalow	2019-11-13	5	4	8	13	0.4103
Blood Island	2019-01-23	2	4	8	10	0.4103
Bridge! 3	2019-11-07	5	4	8	13	0.4103
Boom! Boom!	2019-09-06	2	4	8	10	0.4103
C-War 2	2019-06-26	10	4	8	18	0.4103
Little Awesome Dudes	2019-09-05	3	4	8	11	0.4103
AREA 51 - DEFENCE	2019-09-24	3	4	8	11	0.4103
Zombie horde	2019-10-24	2	4	8	10	0.4103
Resurrector	2019-11-26	2	4	8	10	0.4103
ATROFIL: THE KEY	2019-12-16	3	4	8	11	0.4103
Peace of Evil	2019-05-09	5	7	13	18	0.41000000000000003
Fantasy Hero Manager	2019-05-23	11	7	13	24	0.41000000000000003
Cattle Call: Hollywood Talent Manager	2019-03-04	28	47	76	104	0.4097
Devil's Hunt	2019-09-17	120	351	536	656	0.4092
Ghost Land	2019-07-20	6	10	18	24	0.409
War in Pocket 	2019-09-26	133	8	15	148	0.40630000000000005
Munchkin	2019-11-19	40	19	33	73	0.4061
Arctic Fleet	2019-03-29	15	11	20	35	0.406
141	2019-11-21	5	11	20	25	0.406
The End of an Age: Fading Remnants	2019-07-05	2	0	1	3	0.4058
Blue Crystal	2019-05-01	4	0	1	5	0.4058
DragonCrash	2019-03-15	2	0	1	3	0.4058
Metronix Lab	2019-08-15	5	0	1	6	0.4058
Zyxia: Neon Termination	2019-10-21	1	0	1	2	0.4058
BoomTris	2019-10-04	1	0	1	2	0.4058
Battle for Gaming	2019-01-09	1	0	1	2	0.4058
Quotes Quest - Match 3	2019-01-18	2	0	1	3	0.4058
It's A Racing Game	2019-01-16	8	0	1	9	0.4058
Barbarroja	2019-01-22	1	0	1	2	0.4058
War of Gaia: Into the Fire	2019-05-10	3	0	1	4	0.4058
Trapper	2019-06-02	2	0	1	3	0.4058
M.A.D. Cliff - All Quiet On The Bridge	2019-09-26	1	0	1	2	0.4058
Exo Racing	2019-10-01	2	0	1	3	0.4058
Viper Attack	2019-12-05	2	0	1	3	0.4058
Displacement Arcade Game Box	2019-01-18	1	0	1	2	0.4058
Bezirk	2019-01-09	2	0	1	3	0.4058
Byte Chaser	2019-01-09	1	0	1	2	0.4058
Torn Earth	2019-03-09	1	0	1	2	0.4058
Beyond Critical	2019-12-20	2	0	1	3	0.4058
Where's Rascal　～ラスカルはどこ？～	2019-02-01	1	0	1	2	0.4058
3 on 3 Super Robot Hockey	2019-04-05	1	0	1	2	0.4058
肥肥大作战 fat battle	2019-01-31	1	0	1	2	0.4058
细胞战争	2019-03-30	1	0	1	2	0.4058
SurReal Subway	2019-01-04	2	0	1	3	0.4058
Gravity Panda	2019-01-11	2	0	1	3	0.4058
传送到别的世界开后宫	2019-01-25	1	0	1	2	0.4058
Chishiki Runner	2019-01-18	1	0	1	2	0.4058
Trinity Town Monastery | Martial Arts and Meditation	2019-04-06	1	0	1	2	0.4058
Insect Revolution VR	2019-04-24	2	0	1	3	0.4058
One Million Worlds	2019-03-29	2	0	1	3	0.4058
The Pack	2019-01-27	1	0	1	2	0.4058
Scrapyard Robot Rampage	2019-02-19	1	0	1	2	0.4058
Endzeit	2019-04-03	2	0	1	3	0.4058
FanaticBlader	2019-03-13	1	0	1	2	0.4058
Project Centauri	2019-03-20	1	0	1	2	0.4058
Umbrella	2019-02-06	1	0	1	2	0.4058
SuperBeam	2019-03-04	1	0	1	2	0.4058
Repel Aliens 3D	2019-02-14	1	0	1	2	0.4058
Neon Slashers	2019-07-12	4	0	1	5	0.4058
Super Agent: Drunk Kent	2019-09-06	1	0	1	2	0.4058
Ribbon Racer Next	2019-02-22	2	0	1	3	0.4058
Pagans Must Die	2019-04-08	1	0	1	2	0.4058
My Arctic Farm	2019-02-22	1	0	1	2	0.4058
Forever Lost: Episode 3	2019-03-04	4	0	1	5	0.4058
Mazania	2019-05-14	1	0	1	2	0.4058
FAN CLUB	2019-06-20	1	0	1	2	0.4058
Voipas	2019-07-05	1	0	1	2	0.4058
Bud Blitz	2019-03-08	2	0	1	3	0.4058
Beasty Karts	2019-05-14	2	0	1	3	0.4058
Destruction	2019-03-15	2	0	1	3	0.4058
Hentai! GIRLS GIRLS GIRLS	2019-04-06	3	0	1	4	0.4058
IN GAME	2019-03-15	1	0	1	2	0.4058
Hentai Puzzle Party	2019-04-10	1	0	1	2	0.4058
cockroach Planet Survival	2019-03-07	2	0	1	3	0.4058
Escape from the tomb tower	2019-03-18	2	0	1	3	0.4058
BattleCubes: Arena	2019-03-28	2	0	1	3	0.4058
Over The Cloud: Lost Planet	2019-05-07	2	0	1	3	0.4058
ShooterSpheres	2019-03-20	1	0	1	2	0.4058
SABAT Fight Arena	2019-06-25	2	0	1	3	0.4058
Shadow Runner	2019-03-27	1	0	1	2	0.4058
ZYKRUN	2019-04-29	1	0	1	2	0.4058
Perplexity: Suburban Home	2019-04-11	1	0	1	2	0.4058
Claw Staff	2019-07-18	1	0	1	2	0.4058
Siberian Run VR	2019-05-17	1	0	1	2	0.4058
The Elemental Heart	2019-04-17	1	0	1	2	0.4058
Pirates Are BLANKing Awesome	2019-07-17	2	0	1	3	0.4058
Secrets of War	2019-05-22	3	0	1	4	0.4058
Space Tower	2019-11-19	1	0	1	2	0.4058
PARTY BINGO	2019-05-02	4	0	1	5	0.4058
Digital Rose	2019-10-04	3	0	1	4	0.4058
Ultimate Shotgun Championship	2019-05-09	1	0	1	2	0.4058
Maldrin Journey	2019-06-05	2	0	1	3	0.4058
Hilda Bewildered	2019-06-12	2	0	1	3	0.4058
RifleRange	2019-05-14	2	0	1	3	0.4058
Kunoichi	2019-06-05	1	0	1	2	0.4058
The Battles of Spwak	2019-05-28	1	0	1	2	0.4058
Attached	2019-06-06	2	0	1	3	0.4058
Otiiz's adventure 2	2019-05-29	2	0	1	3	0.4058
Rampart Tactics	2019-05-29	1	0	1	2	0.4058
Breach Point	2019-06-03	1	0	1	2	0.4058
Zenkat	2019-06-12	1	0	1	2	0.4058
Poly Fishing	2019-08-19	1	0	1	2	0.4058
Card Throw VR	2019-06-26	1	0	1	2	0.4058
Energy Hunter Boy	2019-07-09	1	0	1	2	0.4058
Power Block	2019-11-01	3	0	1	4	0.4058
Axan Ships	2019-06-14	1	0	1	2	0.4058
Insectipede	2019-06-21	1	0	1	2	0.4058
Eidolon adventure	2019-06-25	1	0	1	2	0.4058
Bepuzzled Space Jigsaw Puzzle	2019-06-25	1	0	1	2	0.4058
Bepuzzled Animals Jigsaw Puzzle	2019-06-27	2	0	1	3	0.4058
Bepuzzled Jigsaw Puzzle: Nature	2019-07-03	1	0	1	2	0.4058
Bepuzzled Jigsaw Puzzle: Paradise	2019-07-12	1	0	1	2	0.4058
AOS Manager	2019-07-14	1	0	1	2	0.4058
The Tales of Epicton Kingdom	2019-07-28	2	0	1	3	0.4058
Squad Erotica	2019-07-27	2	0	1	3	0.4058
It Pays To Be A Winner	2019-09-25	2	0	1	3	0.4058
Thugsters Battle Royale	2019-09-20	2	0	1	3	0.4058
Sort Battle: Dungeon	2019-07-25	6	0	1	7	0.4058
Realms of Regalia: Royal Rumble	2019-08-08	6	0	1	7	0.4058
Crosser	2019-08-27	1	0	1	2	0.4058
Monoa City Parking	2019-08-12	2	0	1	3	0.4058
Elder Village	2019-09-21	2	0	1	3	0.4058
祭壇の花	2019-08-29	1	0	1	2	0.4058
The Yellow Ladder	2019-11-10	1	0	1	2	0.4058
Ribbon	2019-08-30	1	0	1	2	0.4058
VR Roof Tile	2019-10-22	1	0	1	2	0.4058
Quilly	2019-09-30	1	0	1	2	0.4058
SereNest	2019-08-29	2	0	1	3	0.4058
Stratoscape	2019-11-08	3	0	1	4	0.4058
Industriworks	2019-09-23	1	0	1	2	0.4058
YASG	2019-09-16	2	0	1	3	0.4058
Ten Days to War	2019-10-08	2	0	1	3	0.4058
Pension Day	2019-09-03	1	0	1	2	0.4058
The Seven	2019-09-11	1	0	1	2	0.4058
Quantum Multiverse	2019-09-07	1	0	1	2	0.4058
Funny Road Chase Simulator	2019-09-06	2	0	1	3	0.4058
Super Bora Dragon Eyes	2019-09-13	1	0	1	2	0.4058
Inside The Cubes	2019-09-20	1	0	1	2	0.4058
Cheer and Track	2019-10-02	2	0	1	3	0.4058
Delivery	2019-09-26	1	0	1	2	0.4058
Jigsaw puzzle - Evolution	2019-09-18	2	0	1	3	0.4058
Concept 20	2019-12-20	1	0	1	2	0.4058
Hunter's Soul	2019-12-13	3	0	1	4	0.4058
LowPoly 3D Art Paint by Number	2019-10-12	2	0	1	3	0.4058
Quantumleaper	2019-11-29	2	0	1	3	0.4058
Iron Sun	2019-11-20	1	0	1	2	0.4058
Lost Home : Battle Of Island	2019-10-25	1	0	1	2	0.4058
Danger Course VR	2019-11-11	1	0	1	2	0.4058
Piping Hot	2019-10-30	1	0	1	2	0.4058
最后的阳光 The Last Sunshine	2019-10-18	1	0	1	2	0.4058
Short Scary Stories	2019-11-13	2	0	1	3	0.4058
妈妈，别走	2019-10-29	1	0	1	2	0.4058
The Airship Designer	2019-11-12	1	0	1	2	0.4058
Molly: fear of clowns	2019-10-29	1	0	1	2	0.4058
Craft Elements	2019-12-19	1	0	1	2	0.4058
Spooky Night 2	2019-11-05	2	0	1	3	0.4058
Escape!	2019-11-08	1	0	1	2	0.4058
A Dark World: The Glowing City	2019-11-16	2	0	1	3	0.4058
PM-1 Inverse Universe	2019-12-25	2	0	1	3	0.4058
Robot Boy	2019-11-27	1	0	1	2	0.4058
Posibility	2019-12-12	1	0	1	2	0.4058
El Culto: edición completa	2019-12-05	1	0	1	2	0.4058
The Visitors	2019-12-04	1	0	1	2	0.4058
Alien Invasion 3D part 2	2019-11-29	1	0	1	2	0.4058
History Racers 2	2019-12-25	1	0	1	2	0.4058
Tales of Beasteria	2019-12-13	2	0	1	3	0.4058
Primitive Survival	2019-12-23	2	0	1	3	0.4058
Heathen Engineering's Terran	2019-03-21	5	5	10	15	0.4057
ISLAND 404	2019-01-30	2	5	10	12	0.4057
消灭魔王军	2019-01-12	19	5	10	29	0.4057
Chili The Chipmunk Pinball Adventure	2019-05-03	12	5	10	22	0.4057
In Search of a Home	2019-10-10	7	5	10	17	0.4057
RD's Adventure Mini Golf	2019-01-16	3	1	3	6	0.40399999999999997
Asteroidiga	2019-11-20	3	1	3	6	0.40399999999999997
Second Chance	2019-01-07	2	1	3	5	0.40399999999999997
The Story of My Life	2019-02-01	2	1	3	5	0.40399999999999997
Woodcutter Simulator 2011	2019-07-03	3	1	3	6	0.40399999999999997
Symphony of Stars	2019-06-03	2	1	3	5	0.40399999999999997
Virus Expansion	2019-03-29	2	1	3	5	0.40399999999999997
WARED	2019-06-19	2	1	3	5	0.40399999999999997
Zombie Killer - Type to Shoot!	2019-02-18	2	1	3	5	0.40399999999999997
The Legendary Assassin KAL	2019-07-18	1	1	3	4	0.40399999999999997
PrincessGuardians	2019-02-02	1	1	3	4	0.40399999999999997
Kabitis 2: Fire Sword	2019-09-08	1	1	3	4	0.40399999999999997
Fantasy Island	2019-02-18	2	1	3	5	0.40399999999999997
Slime Crunch	2019-02-15	2	1	3	5	0.40399999999999997
Epic World	2019-10-31	2	1	3	5	0.40399999999999997
Latangerine Last Journey	2019-04-01	1	1	3	4	0.40399999999999997
Murder On The Island	2019-12-10	2	1	3	5	0.40399999999999997
Sage Mountain	2019-05-21	2	1	3	5	0.40399999999999997
Vinios	2019-05-16	1	1	3	4	0.40399999999999997
Wheelie King VR	2019-05-29	2	1	3	5	0.40399999999999997
Fancy Skiing: Speed	2019-06-07	4	1	3	7	0.40399999999999997
Polities	2019-09-30	2	1	3	5	0.40399999999999997
D.A.M.A.G.E	2019-07-18	1	1	3	4	0.40399999999999997
The Last Town	2019-05-31	5	1	3	8	0.40399999999999997
Fruit Mess	2019-06-08	2	1	3	5	0.40399999999999997
Astonishing Baseball 2019	2019-06-17	2	1	3	5	0.40399999999999997
The Fragment	2019-10-27	1	1	3	4	0.40399999999999997
DarkFairyTales SleepingBeauty	2019-07-25	3	1	3	6	0.40399999999999997
Hoodo	2019-09-07	1	1	3	4	0.40399999999999997
Mithral Gun:Biomechanical	2019-12-31	2	1	3	5	0.40399999999999997
Tiger Fighter 1931 Sunset	2019-08-16	2	1	3	5	0.40399999999999997
Phantom Astronaut Lucid VR	2019-09-30	2	1	3	5	0.40399999999999997
Protect the campus	2019-09-28	2	1	3	5	0.40399999999999997
Dark Fairy Fantasy	2019-10-16	2	1	3	5	0.40399999999999997
Dual Blade ~ Battle of The Female Ninja ~	2019-10-06	1	1	3	4	0.40399999999999997
Ghouls Underground	2019-11-22	1	1	3	4	0.40399999999999997
Space zone defender	2019-11-15	2	1	3	5	0.40399999999999997
Romguns	2019-11-26	2	1	3	5	0.40399999999999997
BreadHead Adventure	2019-11-30	4	1	3	7	0.40399999999999997
Defending Frontiers	2019-12-18	2	1	3	5	0.40399999999999997
Live checkpoint	2019-12-30	2	1	3	5	0.40399999999999997
365 Days	2019-02-25	1570	12	22	1592	0.40340000000000004
三和大神	2019-01-26	17	15	27	44	0.4032
Lost Artifacts: Frozen Queen	2019-09-19	6	9	17	23	0.4032
梦涯	2019-05-18	4	6	12	16	0.402
Martian Law	2019-10-18	239	136	221	460	0.4012
x2Roulette	2019-06-09	14	13	24	38	0.4011
Let's Sing 2019	2019-07-16	13	13	24	37	0.4011
大时代：三国立志	2019-05-15	23	10	19	42	0.4006
Icesolation	2019-03-15	6	2	5	11	0.40030000000000004
BRING IT DOWN!	2019-10-22	3	2	5	8	0.40030000000000004
Temple of Pizza	2019-01-13	4	2	5	9	0.40030000000000004
SkyGameChanger-AirCombat II-	2019-02-13	2	2	5	7	0.40030000000000004
Athletics Games VR	2019-02-22	2	2	5	7	0.40030000000000004
Slow.Bullet VR	2019-04-18	12	2	5	17	0.40030000000000004
Global Infection	2019-05-16	1	2	5	6	0.40030000000000004
Life of a Capitalist	2019-09-20	1	2	5	6	0.40030000000000004
Tiger Tank 59 Ⅰ Air Strike	2019-06-04	2	2	5	7	0.40030000000000004
Zombie valley	2019-10-24	3	2	5	8	0.40030000000000004
Hoarding Simulator	2019-11-24	4	2	5	9	0.40030000000000004
Hidden Fears (Moonlight Edition)	2019-08-01	4	20	36	40	0.3994
Square Head Zombies 2 - FPS Game	2019-07-30	3	17	31	34	0.3994
3D Pinball Hentai	2019-01-21	3	17	31	34	0.3994
Lapya	2019-05-28	11	7	14	25	0.39909999999999995
Seraphic Destroyer	2019-11-27	4	7	14	18	0.39909999999999995
Cook Dungeon	2019-12-12	13	7	14	27	0.39909999999999995
Dawn of the Dragons: Ascension	2019-11-01	57	14	26	83	0.399
When They Arrived	2019-01-07	5	49	84	89	0.3985
DrumMasterVR	2019-06-28	2	3	7	9	0.3972
Streamer Shall Not Pass!	2019-11-21	27	3	7	34	0.3972
Raccoon: The Orc Invasion	2019-12-21	1	3	7	8	0.3972
The Love Boat - Second Chances	2019-03-08	19	8	16	35	0.39659999999999995
Club Soccer Director PRO 2020	2019-09-26	21	8	16	37	0.39659999999999995
4004-022	2019-05-05	4	8	16	20	0.39659999999999995
VR Katherine	2019-12-07	15	8	16	31	0.39659999999999995
Border Force	2019-02-07	27	29	52	79	0.3957
Mini Wars	2019-11-11	4	4	9	13	0.3946
DooM in the Dark 2	2019-11-21	2	4	9	11	0.3946
Tale of Fortune	2019-05-18	13	9	18	31	0.3945
World of Guns: VR	2019-12-21	8	24	44	52	0.39409999999999995
Cyber OutRun	2019-08-15	3	24	44	47	0.39409999999999995
Road to Guangdong	2019-06-06	75	53	93	168	0.3935
Death Waves	2019-02-19	2	5	11	13	0.3924
雪策边境	2019-03-22	12	11	22	34	0.391
Princess's Peak	2019-06-12	53	11	22	75	0.391
烽火大秦	2019-12-05	42	6	13	55	0.39049999999999996
Cowboy	2019-12-29	2	6	13	15	0.39049999999999996
Volcan Defend the Tower	2019-02-06	4	7	15	19	0.3889
DooM in the Dark	2019-03-08	2	7	15	17	0.3889
Eternity: The Last Unicorn	2019-03-05	33	68	122	155	0.3871
Winning Post 9	2019-03-28	1698	15	30	1728	0.386
御龙在天-平衡国战版	2019-06-22	134	34	64	198	0.38530000000000003
Riot Street	2019-03-19	14	10	21	35	0.3851
Ashes of Creation Apocalypse	2019-09-25	832	301	519	1351	0.3847
Barbarian Souls	2019-08-30	3	33	63	66	0.3832
Anno Domini: Godfather	2019-05-03	13	4	10	23	0.3805
2100	2019-02-21	2	4	10	12	0.3805
Half-Past Impossible	2019-08-28	2	4	10	12	0.3805
打工妹日记	2019-11-22	7	4	10	17	0.3805
Trauma Simulator	2019-10-24	7	4	10	17	0.3805
尸如潮水	2019-01-02	5	5	12	17	0.3804
POCKET CAR : VR GROUND	2019-01-09	10	5	12	22	0.3804
13 Cycles	2019-03-22	3	3	8	11	0.3803
The Coroner Saga	2019-06-04	6	3	8	14	0.3803
新巨商	2019-10-12	9	3	8	17	0.3803
Gladiator: Road to the Colosseum	2019-08-08	11	3	8	19	0.3803
NUMB	2019-09-27	3	3	8	11	0.3803
Beyond Enemy Lines: Operation Arctic Hawk	2019-03-07	6	6	14	20	0.38
Cube World	2019-09-30	35622	6747	11347	46969	0.37950000000000006
EnchantedGirl	2019-02-04	15	8	18	33	0.379
Weightless: An immersive and relaxing experience	2019-05-11	3	2	6	9	0.379
VireFit	2019-03-25	2	2	6	8	0.379
AirShock	2019-02-24	2	2	6	8	0.379
Hit & Run VR	2019-04-05	3	2	6	9	0.379
Endless Defence 2	2019-07-26	2	2	6	8	0.379
Zombies war	2019-05-21	2	2	6	8	0.379
HUNTER	2019-07-04	2	2	6	8	0.379
Orionide: Prologue	2019-07-26	3	2	6	9	0.379
Stop it - Driving Simulation	2019-07-30	6	2	6	12	0.379
Alien Creatures	2019-08-05	2	2	6	8	0.379
Good doktor	2019-12-25	6	2	6	12	0.379
Through Blocks	2019-05-06	3	12	26	29	0.3769
Alternate Jake Hunter: DAEDALUS The Awakening of Golden Jazz	2019-07-05	11	16	34	45	0.3751
Bloom: Labyrinth	2019-01-22	3	1	4	7	0.3749
Lost Tales - The Castle Escape	2019-07-12	1	1	4	5	0.3749
King of the Dead	2019-11-05	1	1	4	5	0.3749
AstroGenesis	2019-06-06	2	1	4	6	0.3749
It's Not A Moon	2019-05-20	6	1	4	10	0.3749
ASTRONEST VR	2019-02-28	1	1	4	5	0.3749
Border Control	2019-03-06	1	1	4	5	0.3749
God Monster	2019-02-06	4	1	4	8	0.3749
Apoapsis	2019-02-25	1	1	4	5	0.3749
War of Power: The Last Fight	2019-02-26	2	1	4	6	0.3749
Duckumentary	2019-03-23	4	1	4	8	0.3749
Heidentum	2019-04-11	2	1	4	6	0.3749
DevilShaft: TheTower	2019-04-12	1	1	4	5	0.3749
Retro Pixel Racers	2019-05-30	1	1	4	5	0.3749
Hardcore Parkour	2019-06-21	2	1	4	6	0.3749
Commando Dog	2019-07-10	2	1	4	6	0.3749
Back To Hell	2019-07-14	1	1	4	5	0.3749
Oasis Shooting Ops	2019-07-12	2	1	4	6	0.3749
KingAndSlaves	2019-09-16	8	1	4	12	0.3749
Easter Egg	2019-12-08	6	1	4	10	0.3749
Rally Drift Cars	2019-09-18	3	1	4	7	0.3749
Tank Impact	2019-10-20	1	1	4	5	0.3749
Stickman go	2019-11-29	3	1	4	7	0.3749
Devil Threats	2019-12-12	2	1	4	6	0.3749
Tech Corp.	2019-07-25	297	85	163	460	0.3726
サバイバルメソッド Survival Method	2019-01-25	40	42	84	124	0.37210000000000004
Kick The Anime Simulator	2019-07-03	23	36	73	96	0.3715
Opencast Mining	2019-12-13	24	8	19	43	0.371
Red Horizon	2019-07-19	3	8	19	22	0.371
Seventh Circle	2019-09-19	41	7	17	58	0.37070000000000003
The Hunt in the Forest	2019-04-07	3	6	15	18	0.37020000000000003
time of the zombies	2019-01-22	2	5	13	15	0.3694
Australian Road Trains	2019-06-27	2	4	11	13	0.3679
Rogue Heist	2019-08-21	380	135	261	641	0.36719999999999997
恋爱公寓	2019-06-14	43	18	40	83	0.36590000000000006
Planet destroyer	2019-10-28	2	3	9	11	0.3655
Lustful Survival	2019-10-28	6	12	28	34	0.3654
City Of Jade: Imperial Frontier	2019-02-08	7	8	20	27	0.36350000000000005
And I Must Scream	2019-03-05	2	8	20	22	0.36350000000000005
Cave to Kingdom	2019-12-18	41	173	339	380	0.3627
Caelus Trident	2019-04-17	136	55	114	250	0.3626
BlueFear	2019-01-19	4	2	7	11	0.3611
Frozen Mystery	2019-01-25	1	2	7	8	0.3611
Banzai Hentai!	2019-12-18	2	2	7	9	0.3611
Project Skylab 3: A New Frontier	2019-04-09	3	2	7	10	0.3611
Valley Of The Moon	2019-09-03	2	2	7	9	0.3611
模拟家装修	2019-04-30	1	2	7	8	0.3611
Gentleman	2019-08-20	2	2	7	9	0.3611
Hunger Tower	2019-10-25	3	2	7	10	0.3611
Outside	2019-09-28	4	12	29	33	0.36
Two Worlds II HD - Shattered Embrace	2019-12-06	5000	5	14	5014	0.3593
Slaveblade	2019-09-02	136	5	14	150	0.3593
Rail Adventures	2019-06-21	2	0	2	4	0.3592
Dead Spawn	2019-09-24	2	0	2	4	0.3592
Wrath of Thor	2019-02-23	2	0	2	4	0.3592
Tranquility Base Mining Colony: The Moon - Explorer Version	2019-07-19	1	0	2	3	0.3592
Space Adventure TD	2019-03-13	2	0	2	4	0.3592
Element Z	2019-07-19	2	0	2	4	0.3592
Overcraft	2019-01-25	2	0	2	4	0.3592
Nightmare Trails	2019-04-12	1	0	2	3	0.3592
Luna and Cynthia	2019-01-05	1	0	2	3	0.3592
Crystal Chameleon	2019-01-04	2	0	2	4	0.3592
GUNSMOKE	2019-04-25	2	0	2	4	0.3592
Winter Sports Games	2019-12-24	4	0	2	6	0.3592
Rhythm Nights	2019-12-13	1	0	2	3	0.3592
Hunter Survive Zero	2019-01-06	22	0	2	24	0.3592
Boundary	2019-04-05	1	0	2	3	0.3592
UNDERWATER: STAY ALIVE	2019-02-09	1	0	2	3	0.3592
Molly - Can you survive 100 nights?	2019-04-24	1	0	2	3	0.3592
The Toymaker's Apprentice	2019-05-24	6	0	2	8	0.3592
Wand Wars: Rise	2019-02-10	3	0	2	5	0.3592
DINOVR	2019-02-28	1	0	2	3	0.3592
Maze Of Time	2019-02-23	4	0	2	6	0.3592
Sudoku3D 2: The Cube	2019-03-01	3	0	2	5	0.3592
polyfuru feat. MIYA KIMINO / ポリフる feat. キミノミヤ	2019-05-23	3	0	2	5	0.3592
Spikes Are Dangerous	2019-05-24	2	0	2	4	0.3592
Castle Of Pixel Skulls	2019-04-19	2	0	2	4	0.3592
The Tower	2019-05-24	4	0	2	6	0.3592
Dear Ashely	2019-05-07	1	0	2	3	0.3592
Horror Ville Maze Escape	2019-06-18	2	0	2	4	0.3592
Perfect	2019-06-28	1	0	2	3	0.3592
Run Thief	2019-08-23	1	0	2	3	0.3592
Interregnum	2019-06-28	1	0	2	3	0.3592
Second Final	2019-07-23	7	0	2	9	0.3592
Space Viking Raiders VR	2019-10-04	2	0	2	4	0.3592
Blockoid	2019-09-30	3	0	2	5	0.3592
Tailypo: The Game	2019-08-01	2	0	2	4	0.3592
Eggness	2019-08-14	1	0	2	3	0.3592
缸中之脑：谎言（Brain in a vat lies）	2019-09-13	1	0	2	3	0.3592
Tower Empire Builder	2019-12-13	2	0	2	4	0.3592
VirtuaLiron - Immersive YOGA practice	2019-11-15	2	0	2	4	0.3592
Haunted: Poppy's Nightmare	2019-10-31	1	0	2	3	0.3592
Sticky Dildo Man	2019-10-23	1	0	2	3	0.3592
Skyous	2019-10-15	1	0	2	3	0.3592
No Offence, But	2019-11-07	2	0	2	4	0.3592
Merge Towers	2019-12-28	2	0	2	4	0.3592
Shot the Body	2019-11-12	2	0	2	4	0.3592
Space electrician	2019-11-27	1	0	2	3	0.3592
Runoveryou	2019-11-29	2	0	2	4	0.3592
Fast Food Never More	2019-12-19	3	0	2	5	0.3592
Liberty Prime	2019-12-11	9	28	63	72	0.35700000000000004
Balanced Politics Simulator	2019-05-01	6	4	12	18	0.3565
Event Horizon - Frontier	2019-07-03	7	8	21	28	0.3564
没猫病制作人	2019-02-01	30	7	19	49	0.35479999999999995
Hentai Match Fantasy Stories	2019-12-19	6	11	28	34	0.35380000000000006
Easter!	2019-02-13	2	3	10	12	0.35240000000000005
Strange Passion - My Boss, My Mistress	2019-09-24	7	3	10	17	0.35240000000000005
Synthrun	2019-02-07	2	1	5	7	0.3522
人气动漫大乱斗	2019-12-17	2	1	5	7	0.3522
Borderlight	2019-03-22	2	1	5	7	0.3522
Callisto	2019-04-11	2	1	5	7	0.3522
Mission XAM	2019-05-17	2	1	5	7	0.3522
In the beginning	2019-09-07	4	1	5	9	0.3522
Robo Run	2019-05-26	2	1	5	7	0.3522
Awesome Jazz Clicker	2019-05-28	1	1	5	6	0.3522
Island 1979	2019-08-24	2	1	5	7	0.3522
Einn	2019-07-23	4	1	5	9	0.3522
Theater Commander: The Coming Wars	2019-08-08	4	1	5	9	0.3522
History Warriors	2019-10-27	3	1	5	8	0.3522
Forest spiders	2019-09-28	2	1	5	7	0.3522
Gamedev simulator	2019-12-04	2	1	5	7	0.3522
ROAD HOMEWARD: Open world	2019-12-27	1	1	5	6	0.3522
Dodge Dummy	2019-01-21	3	9	24	27	0.35130000000000006
Ultra Off-Road Simulator 2019: Alaska	2019-02-22	34	43	97	131	0.3506
RE:OZMA	2019-12-20	5	5	15	20	0.35000000000000003
House of Evil 2	2019-04-02	4	5	15	19	0.35000000000000003
War of Three Kingdoms	2019-04-08	19	8	22	41	0.3497
Welcome to Paradise	2019-06-22	6	8	22	28	0.3497
大老爷 GrandLordAuto	2019-09-27	201	60	134	335	0.3483
Space Company Simulator	2019-10-24	94	52	118	212	0.3472
Kill The Censored 2	2019-05-28	2	2	8	10	0.3458
Supercar Drift	2019-10-09	2	2	8	10	0.3458
My hot beach vacation	2019-12-31	2	2	8	10	0.3458
The 8th Day	2019-07-19	4	6	18	22	0.34490000000000004
Arctic Adventure: Episodes	2019-01-01	32	246	522	554	0.3446
Idle Dungeons	2019-06-07	195	68	154	349	0.3443
白石洲往事	2019-07-19	22	16	42	64	0.34149999999999997
Eugenics	2019-06-28	8	3	11	19	0.3407
Primordium - Day Zero	2019-12-20	5	3	11	16	0.3407
ROAD HOMEWARD 3: underwater world	2019-07-29	2	3	11	13	0.3407
Trinity of Chaos	2019-05-25	10	12	33	43	0.3404
MÅRD	2019-05-31	3	4	14	17	0.3367
Chroma Deluxe : Sexy Hentai Girls	2019-01-16	9	4	14	23	0.3367
Kill The Censored	2019-03-24	3	4	14	17	0.3367
School Owner	2019-10-27	24	16	44	68	0.3344
Mind's Eye: Secrets of the Forgotten	2019-03-07	5	11	32	37	0.334
Bat Hotel	2019-04-30	2	1	6	8	0.33380000000000004
A five-day tour in the morgue	2019-04-30	2	1	6	8	0.33380000000000004
地铁：恐怖末班车	2019-04-25	2	1	6	8	0.33380000000000004
Coast team	2019-05-24	3	1	6	9	0.33380000000000004
After The Suns	2019-06-24	1	1	6	7	0.33380000000000004
Jaxon The Thief	2019-08-09	2	1	6	8	0.33380000000000004
Mortadelo y Filemón: Operación Moscú	2019-09-06	4	1	6	10	0.33380000000000004
The Valley	2019-10-21	1	1	6	7	0.33380000000000004
Bad Girl	2019-12-31	1	1	6	7	0.33380000000000004
Sail And Sacrifice	2019-05-24	4	5	17	21	0.33340000000000003
Dead Castle	2019-05-18	2	5	17	19	0.33340000000000003
AIR Battlefront	2019-05-06	3	5	17	20	0.33340000000000003
Warz: Horde	2019-01-01	2	2	9	11	0.33240000000000003
Do or Die	2019-01-04	10	3	12	22	0.33020000000000005
Achievement Collector: Dog	2019-01-25	1	3	12	13	0.33020000000000005
Deatherem	2019-04-23	2	3	12	14	0.33020000000000005
My Anchor Girlfriend	2019-08-05	6	3	12	18	0.33020000000000005
Click Space Miner 2	2019-07-25	6	13	38	44	0.3295
Journey of the Sword	2019-01-31	1	0	3	4	0.32939999999999997
My Exotic Farm	2019-01-18	6	0	3	9	0.32939999999999997
Xtreme League	2019-03-07	2	0	3	5	0.32939999999999997
Dangerous Orbit	2019-02-13	1	0	3	4	0.32939999999999997
CubeRace	2019-02-22	1	0	3	4	0.32939999999999997
VehiCraft	2019-03-22	2	0	3	5	0.32939999999999997
Wolf or Boy	2019-05-23	1	0	3	4	0.32939999999999997
Sounds of Talent: Kpop Adventure	2019-04-08	1	0	3	4	0.32939999999999997
GALAXY MONSTER	2019-04-05	2	0	3	5	0.32939999999999997
Nameless Worlds	2019-10-31	2	0	3	5	0.32939999999999997
rOt 3D	2019-07-04	2	0	3	5	0.32939999999999997
Devil_catching_bees	2019-06-07	1	0	3	4	0.32939999999999997
DungeonEpic	2019-09-13	3	0	3	6	0.32939999999999997
Escape from Classroom	2019-07-13	2	0	3	5	0.32939999999999997
XENOS Defense	2019-08-16	1	0	3	4	0.32939999999999997
Forep Man	2019-08-19	1	0	3	4	0.32939999999999997
Tactikk	2019-09-06	1	0	3	4	0.32939999999999997
SnL	2019-09-05	3	0	3	6	0.32939999999999997
The lost dungeon of knight	2019-09-07	1	0	3	4	0.32939999999999997
Spectating Simulator The Racing	2019-09-27	1	0	3	4	0.32939999999999997
Earthlings Must Die	2019-10-14	1	0	3	4	0.32939999999999997
>Connect	2019-10-14	3	0	3	6	0.32939999999999997
Tank Hurricane	2019-12-10	1	0	3	4	0.32939999999999997
GALAXIUM	2019-10-15	374	59	147	521	0.3293
Lost Region	2019-07-15	163	78	194	357	0.3262
The Gameshow	2019-03-13	2	5	18	20	0.326
Crappy Tube	2019-01-01	31	3	13	44	0.3207
Urban Legends - The Dry Body	2019-08-22	3	3	13	16	0.3207
Gay Guys	2019-12-13	3	3	13	16	0.3207
Chupacabra	2019-07-23	2	1	7	9	0.3185
The Legacy of Music	2019-01-18	2	1	7	9	0.3185
Sarah, you are way too heavy 	2019-05-21	5	1	7	12	0.3185
ZorroMoro	2019-06-27	2	1	7	9	0.3185
Fiery catacombs	2019-09-01	1	1	7	8	0.3185
Seasons Girls	2019-09-09	3	1	7	10	0.3185
Jack troubles	2019-12-29	3	1	7	10	0.3185
The Region	2019-03-01	22	13	41	63	0.31829999999999997
Mining Empire: Earth Resources	2019-10-25	36	6	22	58	0.318
test	2019-03-20	4	8	28	32	0.3159
LEFT ALIVE™	2019-03-05	647	212	532	1179	0.3143
Hidden Objects - The Mystery House	2019-08-19	3	3	14	17	0.312
SkydiVeR	2019-02-28	3	2	11	14	0.3103
Sextris Effect	2019-06-13	2	2	11	13	0.3103
HomeWork Is Crazy / 作业疯了	2019-06-14	1468	329	833	2301	0.309
Encore Casino Games	2019-12-30	6	0	4	10	0.308
NO-GO	2019-09-06	1	0	4	5	0.308
Puzzle Out VR	2019-03-05	1	0	4	5	0.308
Madland	2019-08-22	1	0	4	5	0.308
All Of Zhem	2019-03-30	3	0	4	7	0.308
Abandonment	2019-01-05	2	0	4	6	0.308
IgKnight Golf Defender	2019-11-07	2	0	4	6	0.308
Lizardquest-Alien waters	2019-02-16	2	0	4	6	0.308
Don't Look Back	2019-02-22	6	0	4	10	0.308
VRAdventure	2019-10-11	2	0	4	6	0.308
Space Trade Fleet 1.5	2019-04-19	2	0	4	6	0.308
Pet Puzzle	2019-06-08	1	0	4	5	0.308
Drone Racer	2019-12-24	4	0	4	8	0.308
SARE Inception	2019-08-01	1	0	4	5	0.308
Neon Tower Blast	2019-07-24	1	0	4	5	0.308
Japocaliptyca/ Япокалиптика	2019-07-25	1	0	4	5	0.308
ROAD HOMEWARD 4: last step	2019-09-25	2	0	4	6	0.308
Hentai Like a Boss 2	2019-12-26	2	4	18	20	0.3056
Alien invasion	2019-06-03	3	1	8	11	0.3056
Hentai Fight Club	2019-09-06	3	3	15	18	0.3041
The Backrooms	2019-08-01	2	10	37	39	0.3023
AXE:SURVIVAL	2019-01-15	3	5	22	25	0.3006
Blood Bowl: Death Zone	2019-07-10	17	35	109	126	0.3005
Digging Dragon	2019-03-01	3	3	16	19	0.2967
The Breach: A VR Escape Game	2019-07-01	2	1	9	11	0.2943
Air Attack 3.0, Aerial Firefighting Game	2019-12-25	2	0	5	7	0.2916
Reflex	2019-06-21	2	0	5	7	0.2916
学院英雄梦 HeroDreamOfSchool	2019-01-15	2	0	5	7	0.2916
Chaos	2019-09-19	1	0	5	6	0.2916
Human Pinball : Iceage	2019-03-23	1	0	5	6	0.2916
누가 그녀를 죽였나	2019-05-27	7	0	5	12	0.2916
Challenging Dogfights	2019-10-01	3	0	5	8	0.2916
For Inco	2019-10-23	8	0	5	13	0.2916
Survived	2019-11-01	2	0	5	7	0.2916
Nippon Ecchi Jigsaw	2019-10-10	3	4	21	24	0.28750000000000003
War Platform	2019-01-01	2	1	10	12	0.2845
Valentines Cafe	2019-02-14	2	1	10	12	0.2845
DARK BLOOD	2019-05-25	2	1	10	12	0.2845
Curse of the dungeon	2019-10-31	1	1	10	11	0.2845
Red Gate	2019-05-20	144	47	162	306	0.2799
One Drop Bot	2019-04-25	181	93	302	483	0.2791
UNDEFINED	2019-08-13	2	0	6	8	0.2783
Tomb Robber	2019-03-27	1	0	6	7	0.2783
Super Urban Wizard	2019-11-01	1	0	6	7	0.2783
Outliver: Redemption	2019-01-29	1	0	6	7	0.2783
SincereMen	2019-08-06	2	0	6	8	0.2783
For a Better Country	2019-09-20	2	0	6	8	0.2783
March Forward	2019-10-15	2	0	6	8	0.2783
Lost In Dungeon	2019-09-30	3	0	6	9	0.2783
Men of War: Assault Squad 2 - Cold War	2019-09-12	488	253	774	1262	0.2778
Master Of Secrets: Dark Europe	2019-06-25	5	1	11	16	0.2758
Widower's Sky	2019-09-05	8	2	16	24	0.27140000000000003
At Home	2019-03-27	3	7	36	39	0.2707
Artillery Globe	2019-02-15	3	0	7	10	0.26739999999999997
The Psychiatrist: Major Depression	2019-05-03	1	0	7	8	0.26739999999999997
Nanoworld	2019-11-15	2	0	7	9	0.26739999999999997
The incredible friends	2019-12-04	2	0	7	9	0.26739999999999997
Ball Fall	2019-06-17	2	2	17	19	0.2655
Cyber City	2019-12-17	135	33	133	268	0.2633
Dust On Wheels	2019-03-19	2	2	18	20	0.26
Lost Daughter	2019-07-09	182	77	289	471	0.2593
VRange	2019-06-19	3	0	8	11	0.2581
Dig to the Stars	2019-02-01	3	0	8	11	0.2581
live Mince	2019-02-06	2	0	8	10	0.2581
ADM 2(WHEN WORLDS COLLIDE)	2019-06-14	1	0	8	9	0.2581
Adventure Galaxy	2019-11-15	1	0	9	10	0.25
Memorial Park of Hypoxia	2019-04-30	3	1	15	18	0.249
Trailing Girl	2019-11-17	4	1	15	19	0.249
Nuclear Power Station Creator	2019-02-08	16	9	55	71	0.2429
War Trains	2019-10-22	3	2	22	25	0.2414
CENTRALIA	2019-07-30	10	4	34	44	0.23629999999999998
This Side	2019-05-15	8	0	13	21	0.2259
Rescuers2019	2019-12-29	3	0	13	16	0.2259
Once Upon A Death	2019-07-26	3	0	15	18	0.217
homicide	2019-05-19	3	0	15	18	0.217
★ Fallalypse ★ Disconnect ❄	2019-05-24	3	0	16	19	0.21309999999999998
NEW LIFE	2019-08-12	60	22	153	213	0.2046
Rules of The Mafia: Trade & Blood	2019-04-19	22	3	44	66	0.1998
Heroes in the Sky-Origin	2019-01-04	7	0	21	28	0.1972
RimWorld	2018-10-17	60789	155354	2997	63786	0.968
Bloons TD 6	2018-12-18	53943	240551	6265	60208	0.9633
Celeste	2018-01-25	4177	69722	1630	5807	0.9606
Dead Cells	2018-08-06	14910	126294	3679	18589	0.9581000000000001
Subnautica	2018-01-24	51156	218296	7728	58884	0.9544
DUSK	2018-12-10	551	17770	419	970	0.9521
Just Shapes & Beats	2018-05-31	966	16280	372	1338	0.9521
GRIS	2018-12-13	1354	59916	2109	3463	0.9492
Epic Battle Fantasy 5	2018-11-30	2648	4560	57	2705	0.9492
Blade & Sorcery	2018-12-11	4892	39268	1318	6210	0.9484
Mirror	2018-04-19	8250	83523	3314	11564	0.9468000000000001
Zup! S	2018-11-15	722	11503	294	1016	0.9468000000000001
The Forest	2018-04-30	76226	454953	21773	97999	0.9455
Return of the Obra Dinn	2018-10-18	1256	19717	644	1900	0.9447
Cube Escape: Paradox	2018-09-20	1837	7539	201	2038	0.9420000000000001
Fox Hime Zero	2018-05-24	383	4427	111	494	0.9378000000000001
Ultimate Custom Night	2018-06-27	11320	44130	2062	13382	0.9374
Yakuza 0	2018-08-01	8985	55779	2725	11710	0.9368000000000001
NEKOPARA Extra	2018-07-27	575	3332	75	650	0.9367000000000001
Sabbat of the Witch	2018-10-26	198	2056	31	229	0.9366
Kenshi	2018-12-06	10971	63982	3272	14243	0.9355
The Room Three	2018-11-13	1339	8988	331	1670	0.9348000000000001
Zup! X	2018-05-17	389	5961	196	585	0.9343000000000001
Flowers -Le volume sur ete-	2018-07-26	34	1004	4	38	0.9342
Lethal League Blaze	2018-10-24	2673	5342	174	2847	0.9334
Hello Charlotte: Childhood's End	2018-01-04	70	1375	18	88	0.932
Coloring Pixels	2018-08-17	1535	5733	210	1745	0.9307
Maitetsu:Pure Station	2018-09-21	339	3107	99	438	0.9278000000000001
Aim Lab	2018-02-07	10381	81126	4981	15362	0.9277
Mark of the Ninja: Remastered	2018-10-09	687	4562	170	857	0.9277
STEINS;GATE 0	2018-05-08	787	4599	174	961	0.9274
The Curse of Monkey Island	2018-03-22	374	2070	54	428	0.9273
Meteor 60 Seconds!	2018-02-26	346	4026	149	495	0.9266
Miracle Snack Shop	2018-12-25	345	2153	60	405	0.9264
Farming Simulator 19	2018-11-19	59466	63330	3913	63379	0.9262
The Void Rains Upon Her Heart	2018-02-14	39	549	0	39	0.9252
Kingdom Rush Origins	2018-10-17	2000	5012	211	2211	0.9247
Zup! 8	2018-02-22	754	3738	144	898	0.9244
Airships: Conquer the Skies	2018-08-16	1313	4611	192	1505	0.9242
The Witch's House MV	2018-10-31	195	2348	75	270	0.9241
Lobotomy Corporation	2018-04-09	3748	23245	1355	5103	0.9237000000000001
Into the Breach	2018-02-27	14682	16074	903	15585	0.923
Yoku's Island Express	2018-05-29	283	3804	154	437	0.923
House Flipper	2018-05-17	13032	68633	4549	17581	0.9228000000000001
The Walking Dead: The Final Season	2018-08-14	4120	14244	802	4922	0.922
永冻之壳 The Shell of Permafrost	2018-12-09	33	1009	20	53	0.9209999999999999
FAR: Lone Sails	2018-05-17	924	13117	760	1684	0.92
DISTRAINT 2	2018-11-13	96	3205	134	230	0.9198999999999999
Farm Together	2018-10-11	6998	18224	1129	8127	0.919
SYNTHETIK	2018-03-16	3458	10869	628	4086	0.9187000000000001
Bean Battles	2018-08-22	286	8213	456	742	0.9181999999999999
Door Kickers: Action Squad	2018-09-10	2454	8351	466	2920	0.9181
The Ditzy Demons Are in Love With Me	2018-10-26	141	1400	45	186	0.9164
The Crown of Leaves	2018-11-26	270	1617	57	327	0.9161
The Red Strings Club	2018-01-22	287	8912	530	817	0.9156000000000001
My Brother Rabbit	2018-09-21	89	1504	52	141	0.9155
Parkitect	2018-11-29	1400	6010	338	1738	0.9147
Wandersong	2018-09-27	226	2829	131	357	0.9147
Heartbound	2018-12-25	121	1384	47	168	0.9147
CrossCode	2018-09-21	3429	12948	833	4262	0.9146
Mhakna Gramura and Fairy Bell	2018-02-19	25	570	8	33	0.9145000000000001
Akane	2018-09-10	117	2201	94	211	0.9144
killer7	2018-11-15	224	2188	95	319	0.9137000000000001
one night, hot springs	2018-08-30	62	2163	94	156	0.9135
東方幕華祭 TouHou Makuka Sai ~ Fantastic Danmaku Festival	2018-08-17	87	1132	36	123	0.9131999999999999
DEEP SPACE WAIFU: NEKOMIMI	2018-12-18	135	995	29	164	0.9131999999999999
The Messenger	2018-08-30	679	7876	485	1164	0.9128000000000001
Unavowed	2018-08-08	327	1845	77	404	0.9127
Scalak	2018-05-22	32	816	21	53	0.9123000000000001
Rusty Lake Paradise	2018-01-11	1139	3597	190	1329	0.9122
The House in Fata Morgana: A Requiem for Innocence	2018-05-17	54	765	19	73	0.9118
OH MY GOD, LOOK AT THIS KNIGHT	2018-02-20	46	1729	74	120	0.9109
Among Us	2018-11-16	447476	604643	53950	501426	0.9107
Moss	2018-06-07	164	2668	137	301	0.9098
Muv-Luv Alternative	2018-02-28	200	2008	94	294	0.9098
Higurashi When They Cry Hou - Ch.6 Tsumihoroboshi	2018-06-14	46	449	6	52	0.9097
Sprout	2018-01-05	46	1402	57	103	0.9095000000000001
Swarmlake	2018-03-12	437	1569	68	505	0.9091
RetroMaze	2018-05-21	9	1097	40	49	0.9089
Do Not Feed the Monkeys	2018-10-24	1888	7534	498	2386	0.9087999999999999
Hentai Girl Linda	2018-12-07	393	4340	258	651	0.9087999999999999
Monster Prom	2018-04-27	1510	11424	804	2314	0.9087000000000001
Noel the Mortal Fate S1-7	2018-05-15	137	1750	80	217	0.9087000000000001
Delete	2018-01-25	43	1262	50	93	0.9087000000000001
Jet Island	2018-09-21	87	1502	65	152	0.9085
DYO	2018-02-14	113	901	30	143	0.9081
Marie's Room	2018-04-13	285	5628	359	644	0.9079
Rolling Line	2018-04-27	146	1542	69	215	0.9077
Bloodstained: Curse of the Moon	2018-05-24	953	3553	208	1161	0.9074
Ding Dong XL	2018-06-15	696	703	20	716	0.9073000000000001
Kaori After Story	2018-12-03	123	441	7	130	0.9073000000000001
ISLAND	2018-08-24	80	1241	51	131	0.9072
Super Ledgehop: Double Laser	2018-11-16	18	599	15	33	0.9068
Pit People	2018-03-02	2504	7045	478	2982	0.9067000000000001
Friday the 13th: Killer Puzzle	2018-04-13	1674	5314	344	2018	0.9066
Horizon Chase Turbo	2018-05-15	226	4541	287	513	0.9063
Google Spotlight Stories: Age of Sail	2018-11-14	18	429	7	25	0.9063
KovaaK's	2018-04-03	2846	25847	2075	4921	0.9062000000000001
Half-Life 2: Year Long Alarm	2018-11-16	48	1617	77	125	0.9061
ZeroRanger	2018-09-28	74	1191	50	124	0.9059
Guns, Gore and Cannoli 2	2018-03-02	568	3352	201	769	0.9056000000000001
Liftoff	2018-09-13	646	6398	437	1083	0.9055
Battle for Wesnoth	2018-05-02	1019	3970	249	1268	0.9052
Hentai Girl	2018-08-17	450	12776	973	1423	0.9048999999999999
Frostpunk	2018-04-24	29361	82507	7337	36698	0.9048
Crash Bandicoot™ N. Sane Trilogy	2018-06-29	3755	13571	1043	4798	0.9047000000000001
Megaquarium	2018-09-13	917	2516	143	1060	0.9047000000000001
TSIOQUE	2018-11-07	94	1484	71	165	0.9046
PIPE	2018-03-15	439	5519	374	813	0.9045000000000001
Yume Nikki	2018-01-10	469	5239	352	821	0.9045000000000001
Montaro : RE	2018-11-23	45	1170	51	96	0.9043000000000001
A Raven Monologue	2018-01-11	70	2267	128	198	0.9036
Adventure of a Lifetime	2018-04-26	95	724	25	120	0.903
Zero-K	2018-04-27	946	2849	174	1120	0.9028
The Awesome Adventures of Captain Spirit	2018-06-25	8739	11913	934	9673	0.9025
Lost in Vivo	2018-11-05	79	2515	151	230	0.9020999999999999
The Hex	2018-10-16	118	2815	175	293	0.9018
The Bard's Tale Trilogy	2018-08-14	696	1139	53	749	0.9015000000000001
Hexologic	2018-05-29	133	861	35	168	0.9014
Hentai Girl Hime	2018-11-06	298	3787	254	552	0.9013
UNDER NIGHT IN-BIRTH Exe:Late[cl-r]	2018-08-21	1377	3083	198	1575	0.9012000000000001
Gachi Heroes	2018-10-26	1620	1903	108	1728	0.9011
EXAPUNKS	2018-10-22	764	1433	76	840	0.9
Crystalline	2018-08-22	109	1273	65	174	0.8997
Banyu Lintar Angin - Little Storm -	2018-01-11	10	690	26	36	0.8996
The Legend of Heroes: Trails of Cold Steel II	2018-02-14	1689	2253	139	1828	0.8994
DEEP SPACE WAIFU: FANTASY	2018-09-27	373	1109	54	427	0.8994
TREE	2018-08-13	26	1935	116	142	0.8987999999999999
Hakuoki: Edo Blossoms	2018-03-13	128	710	28	156	0.8987999999999999
Chinese Parents	2018-09-29	32593	20835	1837	34430	0.8985
HITMAN™ 2	2018-11-13	361001	66195	6340	367341	0.8984000000000001
Dungreed	2018-02-15	3332	7379	581	3913	0.8984000000000001
Aimtastic	2018-01-28	230	2418	155	385	0.8984000000000001
Wolf Tails	2018-05-04	105	807	35	140	0.8981
东方试闻广纪 ~ Perfect Memento of Touhou Question	2018-08-03	145	804	35	180	0.8979
Two Point Hospital	2018-08-30	34009	27477	2508	36517	0.8976999999999999
Distance	2018-09-18	463	6212	483	946	0.8976999999999999
The Gardens Between	2018-09-20	138	2168	137	275	0.8976999999999999
Katamari Damacy REROLL	2018-12-06	433	4228	313	746	0.8969
Copy Kitty	2018-04-19	149	314	6	155	0.8966
BallisticNG	2018-12-15	113	2464	166	279	0.8961
Overload	2018-05-31	276	1689	103	379	0.8961
Bad North	2018-11-16	1136	7262	594	1730	0.8959
Warhammer 40,000: Mechanicus	2018-11-15	2748	10248	880	3628	0.8954000000000001
Muv-Luv	2018-02-28	204	959	49	253	0.8951000000000001
HELLO LADY!	2018-06-29	114	754	35	149	0.8945000000000001
428 Shibuya Scramble	2018-09-04	408	1465	89	497	0.8943000000000001
Secret Little Haven	2018-04-16	18	296	6	24	0.8942
Cheeky Chooks	2018-11-01	427	2216	152	579	0.8937999999999999
WhiteLily 1：丽丽公主	2018-08-17	799	1148	65	864	0.8937999999999999
Attack on Titan 2 - A.O.T.2	2018-03-15	1385	5083	409	1794	0.8937
Fureraba ~Friend to Lover~	2018-05-04	69	293	6	75	0.8937
Touhou Genso Wanderer -Reloaded- / 不可思议的幻想乡TOD -RELOADED- / 不思議の幻想郷TOD -RELOADED-	2018-10-26	1183	1596	101	1284	0.8935
Genital Jousting	2018-01-18	610	8860	771	1381	0.8934000000000001
Paradise Cleaning!	2018-10-31	137	1205	70	207	0.8934000000000001
Sam & Max Hit the Road	2018-11-16	41	576	24	65	0.893
Simson Tuningwerkstatt 3D	2018-12-03	40	188	1	41	0.8928
The Jackbox Party Pack 5	2018-10-17	2748	2171	152	2900	0.8924
MewnBase	2018-12-07	102	1030	58	160	0.8923000000000001
VR Flush	2018-06-20	13	694	33	46	0.8921
Reentry - An Orbital Simulator	2018-11-15	56	512	21	77	0.8911
Monobeno	2018-01-26	74	580	26	100	0.8906999999999999
Racket: Nx	2018-07-17	31	478	19	50	0.8906000000000001
Fallen Hero: Rebirth	2018-03-15	196	319	9	205	0.89
Siralim 3	2018-10-15	193	903	51	244	0.8898999999999999
DRAGON BALL FighterZ	2018-01-26	44303	54750	5786	50089	0.8897
Broken Reality	2018-11-29	59	1312	85	144	0.8895000000000001
Overcooked! 2	2018-08-07	12108	43415	4545	16653	0.8894
Wizard of Legend	2018-05-15	6487	16052	1570	8057	0.8893000000000001
Frog Detective 1: The Haunted Island	2018-11-22	42	3319	267	309	0.8893000000000001
神社的百合香 ~ Floral Aroma in the Shrine	2018-10-01	20	579	27	47	0.8893000000000001
天命奇御 Fate Seeker	2018-08-08	16413	11472	1094	17507	0.8887999999999999
Ghost of a Tale	2018-03-13	883	3909	326	1209	0.8887999999999999
Kingdom Two Crowns	2018-12-11	4097	16867	1670	5767	0.8886000000000001
DARK SOULS™: REMASTERED	2018-05-23	24501	69712	7570	32071	0.8885
FRAMED Collection	2018-05-17	461	1840	133	594	0.8885
Fatal Twelve	2018-03-30	56	716	38	94	0.8884000000000001
Zup! Zero 2	2018-09-11	1783	953	57	1840	0.8883
Russian Subway Dogs	2018-08-02	22	222	4	26	0.8881
Devil May Cry HD Collection	2018-03-13	767	7416	684	1451	0.8879000000000001
A Light in the Dark	2018-06-15	158	1503	105	263	0.8876000000000001
GROUND BRANCH	2018-08-14	1674	11752	1150	2824	0.8871
Equilinox	2018-11-23	588	2524	200	788	0.8871
Evenicle	2018-10-10	266	1036	66	332	0.8867
TerraTech	2018-08-10	5726	17358	1771	7497	0.8865000000000001
Cateau	2018-10-17	30	325	11	41	0.8862000000000001
Mutant Year Zero: Road to Eden	2018-12-04	4067	16775	1722	5789	0.8858
7 Billion Humans	2018-08-23	715	1420	101	816	0.8858
DX-Ball 2: 20th Anniversary Edition	2018-11-21	80	380	15	95	0.8856999999999999
EMERGENCY 4 Deluxe	2018-04-24	279	1247	87	366	0.885
Duck Souls	2018-09-06	7	256	7	14	0.885
Speed Dating for Ghosts	2018-02-14	66	397	17	83	0.8842
Romance of the Three Kingdoms XI with Power Up Kit	2018-01-17	1701	2329	192	1893	0.8837
Your Dry Delight	2018-08-17	32	547	29	61	0.8833
Shan Gui II: Sweet Osmanthus II	2018-12-16	232	476	24	256	0.8824
Timberman VS	2018-10-12	2649	3024	269	2918	0.8818000000000001
Assassin's Creed Odyssey	2018-10-05	62069	121763	14669	76738	0.8813
Love's Sweet Garnish	2018-09-07	79	661	40	119	0.8813
Mini-Dead	2018-05-04	99	728	46	145	0.8811
The Adventure Pals	2018-04-03	336	1502	118	454	0.881
Donut County	2018-08-28	636	6735	680	1316	0.8804000000000001
Rise Of Titans	2018-07-31	21	247	8	29	0.8803000000000001
Null Vector	2018-05-03	142	261	9	151	0.8802
A Book of Beasts and Buddies	2018-11-14	18	356	16	34	0.8801000000000001
Snow Daze	2018-10-29	115	1109	82	197	0.88
Space Between Worlds	2018-07-30	16	431	22	38	0.8799
Lake of Voices	2018-08-28	56	463	25	81	0.8792
Teleportals. I swear it's a nice game	2018-06-16	16	297	12	28	0.8792
Isoland 2: Ashes of Time	2018-05-02	77	254	9	86	0.8788
Lucah: Born of a Dream	2018-08-21	23	373	18	41	0.8787
El Tango de la Muerte	2018-04-24	10	236	8	18	0.878
Bud Spencer & Terence Hill - Slaps And Beans	2018-04-20	226	1439	118	344	0.8778
Sunset Overdrive	2018-11-16	2326	8925	968	3294	0.8769
Hiveswap Friendsim	2018-04-13	747	1143	90	837	0.8769
The Office Quest	2018-05-25	101	637	42	143	0.8765999999999999
Dark Deception	2018-09-27	1461	12993	1462	2923	0.8765000000000001
Mega Man 11	2018-10-02	1629	3390	331	1960	0.8765000000000001
Touhou: Scarlet Curiosity	2018-07-11	164	959	73	237	0.8761
The Vagrant	2018-07-13	1268	6465	687	1955	0.876
Welcome to Light Fields	2018-03-14	71	254	10	81	0.876
I Walk Among Zombies Vol. 1 (Adult Version)	2018-12-17	36	391	21	57	0.8758
Re Angel	2018-04-17	73	136	2	75	0.8756
The Navigator	2018-08-03	22	210	7	29	0.8753000000000001
Full Metal Furies	2018-01-17	587	2335	219	806	0.8752
Outlaws + A Handful of Missions	2018-11-16	28	480	29	57	0.8752
Wrongworld	2018-05-11	44	420	24	68	0.8748
LEGO® DC Super-Villains	2018-10-16	866	4392	454	1320	0.8747
Pummel Party	2018-09-20	20957	38561	4751	25708	0.8745999999999999
Kabounce	2018-05-29	2597	2303	218	2815	0.8744
Candleman: The Complete Journey	2018-02-01	127	1007	80	207	0.8744
Garden Paws	2018-12-18	340	2051	192	532	0.8738
LUMINES REMASTERED	2018-06-26	74	435	26	100	0.8736
Golf Peaks	2018-11-13	39	366	20	59	0.8736
GLAD VALAKAS SIMULATOR	2018-06-14	35	422	25	60	0.8734000000000001
OPUS: Rocket of Whispers	2018-02-08	51	1166	98	149	0.8733
Marble It Up!	2018-11-16	114	558	38	152	0.8726
Guacamelee! 2	2018-08-21	770	2469	243	1013	0.8724
FINAL FANTASY XII THE ZODIAC AGE	2018-02-01	8386	5886	649	9035	0.8722
Dig or Die	2018-07-10	868	3608	376	1244	0.8722
Toaster Jam	2018-11-14	1008	126	2	1010	0.8722
Lily's Night Off	2018-08-20	7	92	0	7	0.8722
月夜下的紅茶杯 ~ Blacktea With Moon	2018-05-09	22	499	33	55	0.8718000000000001
Nowhere Patrol	2018-11-05	14	169	5	19	0.8717
Supipara - Chapter 2 Spring Has Come!	2018-04-12	19	90	0	19	0.8714000000000001
For The King	2018-04-19	9625	28902	3643	13268	0.8711
GNOG	2018-07-17	68	777	61	129	0.8709
Shaolin vs Wutang	2018-07-26	38	872	71	109	0.8706999999999999
Answer The Question	2018-08-02	9	137	3	12	0.8706999999999999
Dragon Cliff 龙崖	2018-05-11	5953	6080	691	6644	0.87
Maitetsu	2018-06-29	37	323	18	55	0.87
Viki Spotter: Camping	2018-07-18	73	203	8	81	0.87
Hiding Spot	2018-10-16	10	120	2	12	0.87
Ultimate Fishing Simulator	2018-08-30	2485	5668	640	3125	0.8699
Just, Bearly	2018-05-31	12	454	30	42	0.8699
Pleasure Puzzle:Portrait	2018-09-24	619	1558	147	766	0.8697
Shooty Skies	2018-03-06	345	1261	114	459	0.8697
Changed	2018-04-05	171	10737	1292	1463	0.8694
Wayhaven Chronicles: Book One	2018-03-08	130	285	15	145	0.8693000000000001
Beneath the Surface	2018-11-13	59	363	22	81	0.8691
Totally Accurate Battlegrounds	2018-06-05	29438	68649	9207	38645	0.8689
NEKO-NIN exHeart 2	2018-04-27	47	260	13	60	0.8689
NavalArt	2018-06-20	298	1065	95	393	0.8681000000000001
Hidden Paws Mystery	2018-12-18	13	220	10	23	0.8678
Gizmo	2018-12-05	23	266	14	37	0.8676
Steven Universe: Save the Light	2018-08-13	200	1010	90	290	0.8674
cyubeVR	2018-01-26	38	816	69	107	0.8673000000000001
Ys: Memories of Celceta	2018-07-25	263	635	50	313	0.8672
Age of History II	2018-11-21	2901	27866	3655	6556	0.8671
Dream Car Builder	2018-09-21	75	869	75	150	0.8671
Jimmy and the Pulsating Mass	2018-08-07	54	404	27	81	0.867
Forgotton Anne	2018-05-15	143	1463	142	285	0.8669
Up Left Out	2018-06-29	8	351	22	30	0.8669
The Crooked Man	2018-01-16	23	668	54	77	0.8666
Ostalgie: The Berlin Wall	2018-03-25	2548	562	43	2591	0.8666
Shining Song Starnova	2018-09-13	57	284	16	73	0.8665
My Holiday	2018-08-21	93	178	7	100	0.8663
Northgard	2018-03-07	20235	46610	6320	26555	0.8662000000000001
My Memory of Us	2018-10-09	38	674	55	93	0.8662000000000001
Feather Of Praying 羽翼的祈愿	2018-06-07	42	214	10	52	0.8662000000000001
Assault Spy	2018-10-02	67	645	52	119	0.8661
Human-powered spacecraft	2018-05-03	37	558	43	80	0.8661
Sam & Dan: Floaty Flatmates	2018-12-12	37	585	46	83	0.8658
Squirm	2018-03-23	15	175	7	22	0.8653000000000001
Lagoon Lounge : The Poisonous Fountain	2018-07-06	90	484	36	126	0.8652
Neverwinter Nights: Enhanced Edition	2018-03-27	2410	6093	734	3144	0.865
F1 2018	2018-08-23	9809	11080	1404	11213	0.8649
東方憑依華　～ Antinomy of Common Flowers.	2018-01-05	1463	1662	170	1633	0.8648
qop 4	2018-12-19	95	197	9	104	0.8647
Scythe: Digital Edition	2018-09-05	1237	2824	314	1551	0.8645
Indiana Jones® and the Emperor's Tomb™	2018-11-16	65	650	54	119	0.8645
Maximum Action	2018-09-19	132	2900	324	456	0.8644
Grisaia Phantom Trigger Vol.4	2018-01-26	60	106	2	62	0.8642000000000001
Myst III: Exile	2018-09-24	57	305	19	76	0.8640000000000001
FoxTail	2018-03-01	32	325	21	53	0.8638
Metal Fatigue	2018-07-31	61	325	21	82	0.8638
Thronebreaker: The Witcher Tales	2018-11-09	3371	12718	1648	5019	0.8637
Through the Ages	2018-03-26	747	1675	174	921	0.8637
Diesel Railcar Simulator	2018-03-05	37	261	15	52	0.8637
Pipe Push Paradise	2018-01-19	8	145	5	13	0.8636
Rust	2018-02-08	245243	789255	118638	363881	0.8634000000000001
Atelier Lydie & Suelle ~The Alchemists and the Mysterious Paintings~	2018-03-27	398	510	40	438	0.8634000000000001
Hero-U: Rogue to Redemption	2018-07-10	209	451	34	243	0.8631000000000001
Vagante	2018-02-22	518	3724	436	954	0.863
Wrench	2018-12-19	150	931	87	237	0.863
Supaplex	2018-05-09	37	191	9	46	0.8628
qop 3	2018-06-07	985	317	21	1006	0.8621
Heaven Will Be Mine	2018-07-25	111	376	27	138	0.8619
Electronauts	2018-08-07	69	424	32	101	0.8618000000000001
Atelier Rorona ~The Alchemist of Arland~ DX	2018-12-04	256	470	37	293	0.8616
LIBRARY	2018-08-10	13	152	6	19	0.8616
Circle Empires	2018-08-08	1011	2962	344	1355	0.8614
天岚行 - Through the Mist and Sky	2018-06-06	63	163	7	70	0.8612000000000001
True Fear: Forsaken Souls Part 2	2018-11-02	153	457	36	189	0.861
Superfighters Deluxe	2018-11-30	146	2321	264	410	0.8605
AREA 4643	2018-12-21	60	84	1	61	0.8605
My Big Sister	2018-11-09	177	481	39	216	0.8604
Minit	2018-04-03	251	1967	219	470	0.8603000000000001
Kid,napper: Gosh, I'm Kidnapped by a Pupil	2018-05-31	409	3687	446	855	0.8601000000000001
MEANDERS	2018-02-07	32	376	28	60	0.86
Skelly Selest	2018-05-01	15	247	15	30	0.86
tiny & Tall: Gleipnir Part One	2018-09-04	52	170	8	60	0.8595999999999999
12 Labours of Hercules VIII: How I Met Megara	2018-12-26	25	135	5	30	0.8595999999999999
Treasure Hunter Claire	2018-07-20	702	1834	205	907	0.8592000000000001
Summer Memory of Bell	2018-07-23	18	191	10	28	0.8592000000000001
Long Gone Days	2018-03-28	44	274	18	62	0.8591
Tactical Monsters Rumble Arena	2018-02-01	1283	4025	498	1781	0.8590000000000001
Ninjin: Clash of Carrots	2018-09-04	21	323	23	44	0.8590000000000001
Atelier Meruru ~The Apprentice of Arland~ DX	2018-12-04	66	212	12	78	0.8590000000000001
My So-called Future Girlfriend	2018-12-11	20	243	15	35	0.8589
The Sand Man	2018-01-30	13	190	10	23	0.8588
KOEWOTAYORINI SP / 声之寄托SP	2018-02-14	58	211	12	70	0.8587
Merry Glade	2018-05-11	10	211	12	22	0.8587
Grisaia Phantom Trigger Vol.5	2018-07-27	108	108	3	111	0.8587
Cypher	2018-02-20	172	577	51	223	0.8586
Virtual Virtual Reality	2018-09-07	49	541	47	96	0.8584999999999999
SnowNight	2018-12-15	38	339	25	63	0.8583
The Rose of Segunda	2018-05-31	9	65	0	9	0.8583
Wreckfest	2018-06-14	3865	28896	4149	8014	0.8581000000000001
The Chronicles of Quiver Dick	2018-07-09	8	177	9	17	0.8581000000000001
Old School Musical	2018-09-13	92	701	66	158	0.8579000000000001
東周列萌志 Philosophic Love	2018-08-17	208	716	68	276	0.8577
Sagebrush	2018-09-18	5	176	9	14	0.8577
Pillars of Eternity II: Deadfire	2018-05-08	22724	14191	1975	24699	0.8573999999999999
Kara no Shojo	2018-10-22	25	325	24	49	0.8573000000000001
Red Matter	2018-11-10	35	795	78	113	0.8572
Damned Daniel	2018-11-30	6	104	3	9	0.8567
BYTEPATH	2018-02-24	87	264	18	105	0.8564
Thief Simulator	2018-11-09	5974	18787	2685	8659	0.8563
SEQUENCE STORM	2018-12-21	16	139	6	22	0.8563
Saint Slaughter X Days	2018-07-31	40	182	10	50	0.856
Football, Tactics & Glory	2018-06-01	1020	3163	395	1415	0.8558
Lucy Got Problems	2018-09-28	97	927	96	193	0.8556999999999999
Leaflet Love Story	2018-08-20	60	666	64	124	0.8556999999999999
Heroes of Hammerwatch	2018-03-01	2662	7149	968	3630	0.8554
Sector Six	2018-09-07	77	211	13	90	0.8554
Octogeddon	2018-02-08	156	688	67	223	0.8553000000000001
Gravity Bone	2018-11-08	9	307	23	32	0.8553000000000001
UBERMOSH:SANTICIDE	2018-07-27	18	180	10	28	0.8553000000000001
雨鸦 - You are my sanctuary	2018-09-25	13	190	11	24	0.8552
Super Dangerous Dungeons	2018-07-02	7	75	1	8	0.8552
Viki Spotter: Space Mission	2018-05-11	23	124	5	28	0.8547
A Piece of Wish upon the Stars	2018-11-04	27	157	8	35	0.8545999999999999
Lingering Fragrance	2018-08-11	95	506	46	141	0.8544
Cardinal Cross	2018-07-10	65	167	9	74	0.8544
Woodways	2018-04-02	7	87	2	9	0.8543000000000001
Monster Hunter: World	2018-08-09	334684	327006	52449	387133	0.8542000000000001
Return.	2018-08-03	40	856	89	129	0.8542000000000001
Who Am I: The Tale of Dorothy	2018-04-16	78	348	28	106	0.8542000000000001
Bio Inc. Redemption	2018-03-08	340	1560	181	521	0.8541
Dungeon Warfare 2	2018-07-06	684	823	85	769	0.8541
Shotgun Legend	2018-01-15	1976	711	71	2047	0.8541
Rapid Tap	2018-01-23	25	353	29	54	0.8533
VR Furballs - Demolition	2018-11-09	8	143	7	15	0.8532
Music Racer	2018-07-20	18509	3170	408	18917	0.8531000000000001
Jurassic World Evolution	2018-06-12	60296	43931	6746	67042	0.8528
Project Hospital	2018-10-30	2673	5693	780	3453	0.8525
So, uh... a spaceship crashed in my yard.	2018-08-06	117	202	13	130	0.8523999999999999
Overclocked	2018-10-10	488	295	23	511	0.8523000000000001
Sable's Grimoire	2018-05-18	38	119	5	43	0.8522
YumeCore	2018-02-16	49	161	9	58	0.8520000000000001
Tesla vs Lovecraft	2018-01-26	241	988	109	350	0.8519
Beholder 2	2018-12-05	1981	4950	675	2656	0.8518000000000001
Putin VS ISIS	2018-04-02	5	274	21	26	0.8515
Pivot XL	2018-05-14	8	139	7	15	0.8514
Iris.Fall	2018-12-07	172	2383	303	475	0.8512000000000001
DAMNOSAUR	2018-11-30	65	273	21	86	0.8512000000000001
This Is Not A Jumping Game	2018-02-24	12	117	5	17	0.8512000000000001
Ouroboros	2018-05-25	77	117	5	82	0.8512000000000001
Istanbul: Digital Edition	2018-10-18	50	207	14	64	0.8508
Rifter	2018-07-12	37	105	4	41	0.8508
MUSYNX	2018-12-05	458	4223	574	1032	0.8506999999999999
Ys VIII: Lacrimosa of Dana	2018-04-16	540	4102	556	1096	0.8506999999999999
Spiral Clicker	2018-10-25	545	1249	146	691	0.8506
Bonds	2018-11-01	11	93	3	14	0.8505
Rocket Boots Mania	2018-11-29	7	54	0	7	0.8504
Dead Dungeon	2018-11-12	12	233	17	29	0.8501000000000001
The MISSING: J.J. Macfield and the Island of Memories	2018-10-11	84	1027	117	201	0.85
Monster Garden	2018-02-08	2	80	2	4	0.8498000000000001
Go Morse Go! Arcade Edition	2018-02-26	6	53	0	6	0.8495
POLYBIUS	2018-12-21	12	203	14	26	0.8494
古剑奇谭三(Gujian3)	2018-12-14	10183	38010	5990	16173	0.8493
Nefertari: Journey to Eternity	2018-06-28	15	193	13	28	0.8492000000000001
Disgaea 5 Complete	2018-10-22	2191	2655	350	2541	0.8491
Spellsworn	2018-03-13	1517	1207	143	1660	0.8491
LEGO® The Incredibles	2018-06-15	285	1127	132	417	0.8491
Colorzzle	2018-08-10	60	113	5	65	0.8491
The friends of Ringo Ishikawa	2018-05-17	439	1598	198	637	0.8489
How To Cope With Boredom and Loneliness	2018-04-02	21	463	45	66	0.8484
Traum	2018-03-19	43	315	27	70	0.8484
Shenmue I & II	2018-08-21	1554	2199	286	1840	0.8483
Grim Nights	2018-10-12	613	1168	139	752	0.8483
Trapper's Delight	2018-03-06	68	263	21	89	0.8483
Infinos Gaiden	2018-01-20	16	65	1	17	0.8481000000000001
Ameagari no Hanaby	2018-09-22	17	65	1	18	0.8481000000000001
Light Bearers	2018-10-23	248	1020	119	367	0.848
1943 Berlin Blitz	2018-10-04	20	252	20	40	0.8477
Righty Tighty XL	2018-05-14	7	121	6	13	0.8477
Isoland	2018-05-02	50	216	16	66	0.8475
Valkyria Chronicles 4 Complete Edition	2018-09-25	2546	4926	702	3248	0.8473999999999999
Graveyard Keeper	2018-08-15	16993	27275	4316	21309	0.8473
Headliner: NoviNews	2018-10-23	198	628	67	265	0.8473
Squidlit	2018-03-02	11	385	36	47	0.8473
The Endless Empty	2018-11-03	11	140	8	19	0.8471
CHRONO TRIGGER	2018-02-27	953	6376	931	1884	0.8470000000000001
Juicy Realm	2018-05-03	1944	2994	409	2353	0.8470000000000001
Minotaur Arcade Volume 1	2018-12-21	6	50	0	6	0.8469
From Beyond Prologue	2018-12-07	8	87	3	11	0.8466
A Game About	2018-11-06	30	725	81	111	0.8462000000000001
Paladins	2018-05-08	60743	286328	49216	109959	0.8456999999999999
Dominari Tournament	2018-05-14	11	62	1	12	0.8456999999999999
The 25th Ward: The Silver Case	2018-03-13	41	254	21	62	0.8456
Omensight	2018-05-15	245	1247	155	400	0.8455
Football Game	2018-02-13	5	219	17	22	0.8454
Foto Flash	2018-02-01	155	253	21	176	0.8453
Taphouse VR	2018-09-27	39	201	15	54	0.8453
First Winter	2018-05-08	7	96	4	11	0.8453
Football Manager 2019	2018-11-02	75982	10779	1662	77644	0.845
War of Rights	2018-12-03	1327	8217	1245	2572	0.845
Hentai Memory	2018-07-20	10925	1303	164	11089	0.845
Pig Eat Ball	2018-09-27	268	73	2	270	0.8448000000000001
Cyberdimension Neptunia: 4 Goddesses Online	2018-02-27	3750	3992	574	4324	0.8447
Project Warlock	2018-12-06	365	3865	554	919	0.8447
Witch Hunt	2018-09-03	130	1796	237	367	0.8447
Hentai Mosaique Puzzle	2018-12-20	842	578	63	905	0.8443
The Chronicles of Nyanya	2018-02-16	37	144	9	46	0.8443
Disneyland Adventures	2018-09-14	103	464	48	151	0.8442000000000001
BEKKOUAME	2018-04-12	24	206	16	40	0.8439
Pocket Rogues	2018-10-25	30	265	23	53	0.8438
Orion Sandbox Enhanced	2018-09-21	22	368	36	58	0.8434999999999999
TOK	2018-11-15	9	222	18	27	0.8434999999999999
Clue/Cluedo: The Classic Mystery Game	2018-05-17	355	2213	304	659	0.8433
Zero G Arena	2018-08-09	133	655	75	208	0.8427
Bing Bong XL	2018-05-14	7	194	15	22	0.8426
Regions Of Ruin	2018-02-05	3062	3751	548	3610	0.8425
妄想症 Deliver Me	2018-08-10	656	1789	242	898	0.8423999999999999
Swaps and Traps	2018-02-12	12	70	2	14	0.8423999999999999
Shantae: Half-Genie Hero Ultimate Edition	2018-05-08	60	667	77	137	0.8423
Panzer War:Definitely Edition (Cry of War)	2018-03-01	58	609	69	127	0.8423
The King's Request: Physiology and Anatomy Revision Game	2018-06-25	18	149	10	28	0.8422000000000001
Ben and Ed - Blood Party	2018-02-13	443	1751	237	680	0.8421
Lamplight City	2018-09-13	85	549	61	146	0.8420000000000001
Gachimuchi Reloaded	2018-02-14	6	201	16	22	0.8420000000000001
Frightened Beetles	2018-05-11	18	360	36	54	0.8416
Battlezone: Combat Commander	2018-03-01	282	646	75	357	0.8414
Caliban Below	2018-06-20	8	191	15	23	0.8414
Seers Isle	2018-09-18	39	146	10	49	0.8408
War Brokers	2018-04-18	40	341	34	74	0.8406
Insurgency: Sandstorm	2018-12-12	14606	91796	16039	30645	0.8405
Stoneshard: Prologue	2018-06-05	735	3062	448	1183	0.8405
Nippon Marathon	2018-12-17	19	262	24	43	0.8404
NARUTO TO BORUTO: SHINOBI STRIKER	2018-08-30	6310	44451	7617	13927	0.8403
AHEGAL	2018-10-11	149	1184	155	304	0.8403
Wild Animal Sports Day	2018-08-31	23	261	24	47	0.84
The Rabbit and The Owl	2018-08-03	7	43	0	7	0.84
Iconoclasts	2018-01-23	932	3494	521	1453	0.8398000000000001
Simmiland	2018-11-30	749	1336	179	928	0.8397
TANKS	2018-06-12	23	116	7	30	0.8393
TANGLEWOOD	2018-08-14	13	77	3	16	0.8393
蓝宝石般的被害妄想少女	2018-11-28	207	700	85	292	0.8391
Galimulator	2018-03-16	76	387	41	117	0.8390000000000001
Eroico	2018-10-17	40	1029	134	174	0.8388
Diner Bros	2018-07-06	91	622	74	165	0.8388
Scavenger SV-4	2018-02-01	40	364	38	78	0.8388
Mike Dies	2018-02-23	11	42	0	11	0.8388
Super Mega Baseball 2	2018-05-01	487	913	117	604	0.8384999999999999
Grabity	2018-05-30	9	54	1	10	0.8384
360 No Scope Arena	2018-09-06	27	591	70	97	0.8383
Acid Nimbus	2018-10-01	483	167	13	496	0.8383
Q-YO Blaster	2018-01-15	9	158	12	21	0.8381000000000001
QuiVr	2018-06-18	68	448	50	118	0.838
Dead	2018-04-06	987	183	15	1002	0.838
Delver	2018-02-01	684	2353	344	1028	0.8379000000000001
WARRIORS OROCHI 4	2018-10-16	5924	4202	649	6573	0.8378
Tempest of the Heavens and Earth	2018-12-26	52	262	25	77	0.8378
CometStriker DX	2018-06-08	12	53	1	13	0.8373999999999999
Exiled Kingdoms	2018-02-23	217	700	87	304	0.8372
Without Within 3	2018-05-03	6	64	2	8	0.8372
Super Jigsaw Puzzle: Cities	2018-05-29	20	64	2	22	0.8372
60 Parsecs!	2018-09-18	727	2481	368	1095	0.8370000000000001
Shooting Hurts	2018-09-18	33	236	22	55	0.8369
E.Z	2018-02-17	15	204	18	33	0.8367
Warhammer: Vermintide 2	2018-03-08	104323	92577	16717	121040	0.8365
The Mirror Lied	2018-10-25	27	621	76	103	0.8365
Verlet Swing	2018-09-18	64	525	62	126	0.8365
Kaiju Big Battel: Fighto Fantasy	2018-10-31	4	40	0	4	0.8365
ReThink | Evolved 2	2018-04-09	5	40	0	5	0.8365
Space Invaders Extreme	2018-02-13	46	179	15	61	0.8362999999999999
Next 4	2018-06-01	30	111	7	37	0.8361000000000001
DRAGON QUEST® XI: Echoes of an Elusive Age™	2018-09-04	11793	7472	1224	13017	0.8358
Dark Fantasy: Jigsaw Puzzle	2018-11-17	19	300	31	50	0.8356
Flat Heroes	2018-08-02	122	436	50	172	0.8355
Fei Duanmu VS Kobayashi 端木斐 VS 小林正雪	2018-11-01	47	169	14	61	0.8354
Because We're Here ~Mohnblume und Blauerose~	2018-07-19	34	82	4	38	0.8353
Desktop Tree	2018-09-18	12	82	4	16	0.8353
Chicken in the Darkness	2018-10-29	3	39	0	3	0.8353
SPAGHET	2018-04-13	9	152	12	21	0.8351000000000001
OK K.O.! Let’s Play Heroes	2018-01-23	48	118	8	56	0.835
Grapple Force Rena	2018-12-04	22	118	8	30	0.835
Life is Strange 2	2018-09-26	468717	24669	4327	473044	0.8349
Reignfall	2018-12-10	48	348	38	86	0.8348000000000001
The Painter's Playground	2018-02-08	15	61	2	17	0.8344
One Ping Only	2018-04-15	13	213	20	33	0.8340000000000001
Rolling Bird	2018-12-28	21	166	14	35	0.8339
Remyadry	2018-07-10	291	489	59	350	0.8336
秋色的記憶(體驗版) / Fall...in Love (Demo)	2018-07-26	17	141	11	28	0.8336
Choice of Magics	2018-08-10	213	141	11	224	0.8336
PUSS!	2018-08-02	93	1072	149	242	0.8334999999999999
puzzlement	2018-02-01	16	196	18	34	0.8333
Lonely Yuri	2018-03-07	7	123	9	16	0.8327
Gnomes Garden: Christmas Story	2018-12-12	7	37	0	7	0.8327
Tardy	2018-03-09	31	179	16	47	0.8326000000000001
GLAD VALAKAS TOWER DEFENCE	2018-12-14	11	139	11	22	0.8323999999999999
ЕСТЬ ДВА СТУЛА	2018-06-19	25	1337	194	219	0.8322
JJBoom	2018-09-12	122	178	16	138	0.8322
Aura of Worlds	2018-04-24	4	78	4	8	0.8319
Little Bug	2018-09-25	14	48	1	15	0.8319
Varenje	2018-07-03	127	1117	159	286	0.8318000000000001
Full Ace Tennis Simulator	2018-02-28	61	302	33	94	0.8318000000000001
Bladed Fury	2018-12-18	1191	2663	419	1610	0.8316
Sakura Cupid	2018-02-12	49	244	25	74	0.8316
Koihime Enbu RyoRaiRai	2018-07-13	112	129	10	122	0.8314
vridniX	2018-08-16	5	36	0	5	0.8314
SUPER FLAIL	2018-08-03	22	137	11	33	0.8312999999999999
I L L U S I O N	2018-05-09	4	58	2	6	0.8312999999999999
Rage In Peace	2018-11-08	28	292	32	60	0.8309000000000001
STAR WARS™ Episode I Racer	2018-11-16	210	1461	218	428	0.8306
Adventure Time: Pirates of the Enchiridion	2018-07-17	59	513	65	124	0.8304
Unforeseen Incidents	2018-05-24	88	679	91	179	0.8301999999999999
4D Minesweeper	2018-02-14	89	254	27	116	0.8300000000000001
与雾雨魔理沙一起偷重要的东西 ~ Happy Stealing with Kirisame Marisa	2018-06-30	17	196	19	36	0.8300000000000001
BlamBox	2018-10-02	4	35	0	4	0.8300000000000001
A Winter's Daydream	2018-10-15	4	35	0	4	0.8300000000000001
ReThink 2	2018-10-02	6	35	0	6	0.8300000000000001
Surviving Mars	2018-03-15	23744	20231	3668	27412	0.8299
pla_toon	2018-08-13	129	1236	182	311	0.8298000000000001
Wolf & Rabbit	2018-04-04	27	246	26	53	0.8297
Sandmade	2018-05-16	5	142	12	17	0.8296
Mobile Forces	2018-06-08	7	66	3	10	0.8295
The Sunny Day 晴天	2018-07-06	6	66	3	9	0.8295
The Majesty of Colors Remastered	2018-02-28	9	46	1	10	0.8295
Wormster Dash	2018-10-01	6	46	1	7	0.8295
Project LUX	2018-02-02	28	321	37	65	0.8292
Transpose	2018-11-06	169	216	22	191	0.8292
Inline	2018-06-01	11	56	2	13	0.8291
StrikeForce Kitty	2018-02-20	152	498	64	216	0.8287000000000001
The Fruitless Flower 雾雨中的徒花	2018-03-09	7	92	6	13	0.8287000000000001
Timespinner	2018-09-25	395	2000	315	710	0.8286
Vカツ / V-Katsu	2018-08-01	435	471	60	495	0.8285
Solid Aether	2018-09-28	10	34	0	10	0.8285
Perceptions of the Dead 2	2018-06-14	5	65	3	8	0.8284
Carly and the Reaperman	2018-06-19	14	170	16	30	0.8283
Tiny Bird Garden Deluxe	2018-12-18	75	124	10	85	0.8281999999999999
Hellblade: Senua's Sacrifice VR Edition	2018-07-31	169	1110	164	333	0.8281000000000001
Catch & Release	2018-06-07	31	297	34	65	0.8281000000000001
Underhero	2018-09-19	114	886	127	241	0.828
Welcome to the Game II	2018-04-03	518	2090	333	851	0.8279000000000001
Penny Black	2018-05-17	23	82	5	28	0.8276000000000001
Shadow of the Tomb Raider	2018-09-14	38268	54857	10488	48756	0.8273999999999999
Ultimate Racing 2D	2018-05-24	61	414	52	113	0.8273999999999999
【SCP】器関ノ彷徨 -The will of a single Tale-【DEMOver.】	2018-05-04	33	301	35	68	0.8272
Rainy Day Racer	2018-07-13	4	33	0	4	0.8270000000000001
Heart of Moon : The Mask of Seasons	2018-12-06	11	33	0	11	0.8270000000000001
Hidden Paws	2018-03-22	56	601	82	138	0.8267
Blast-off	2018-01-22	1948	332	40	1988	0.8265000000000001
Remnants of Naezith	2018-02-05	79	518	69	148	0.8264
Corpse Party: Book of Shadows	2018-10-29	50	318	38	88	0.8262
Capcom Beat 'Em Up Bundle	2018-10-10	156	870	127	283	0.826
SEPTEMBER 1999	2018-10-10	26	1693	269	295	0.8259000000000001
Guns'n'Stories: Bulletproof VR	2018-03-08	24	356	44	68	0.8258
Egypt: Old Kingdom	2018-05-24	277	909	134	411	0.8257
Moondust: Knuckles Tech Demos	2018-06-21	35	53	2	37	0.8256
Yokai Mask	2018-09-21	4	43	1	5	0.8255
Arcane Golf	2018-07-26	4	43	1	5	0.8255
GonzoVR	2018-10-01	476	43	1	477	0.8255
Snail Trek - Chapter 4: The Final Fondue	2018-03-30	4	32	0	4	0.8255
Red Embrace	2018-02-15	15	135	12	27	0.8254000000000001
Koloro	2018-05-18	46	71	4	50	0.8254000000000001
Stunt Simulator Multiplayer	2018-12-07	16	71	4	20	0.8254000000000001
Jewel Match Twilight Solitaire	2018-09-13	15	96	7	22	0.8253
Next 3	2018-04-03	6	127	11	17	0.8251000000000001
GRIP: Combat Racing	2018-11-06	622	3475	594	1216	0.8250000000000001
Great Hero's Beard	2018-10-18	2175	991	149	2324	0.8249
Pro Office Calculator	2018-09-05	16	199	21	37	0.8249
Sudoku Jigsaw	2018-09-13	23	156	15	38	0.8247
Space Elite Force	2018-05-17	5	141	13	18	0.8245
Jewel Match Solitaire	2018-07-26	27	103	8	35	0.8245
Food Drive	2018-10-09	476	95	7	483	0.8245
Inch by Inch	2018-12-31	14	52	2	16	0.8244
Strange Brigade	2018-08-28	1956	5177	916	2872	0.8243
The Haunted Graveyard	2018-10-09	10	61	3	13	0.8242
Break The Targets	2018-06-21	10	42	1	11	0.8240999999999999
Google Spotlight Stories: Back to the Moon	2018-05-02	65	42	1	66	0.8240999999999999
In Celebration of Violence	2018-02-15	262	413	54	316	0.8240000000000001
Lost Frontier	2018-10-19	5	31	0	5	0.8239000000000001
Galaxy Champions TV	2018-09-06	6	94	7	13	0.8237000000000001
Sudoku Zenkai	2018-04-02	121	168	17	138	0.8235
Fare Thee Well	2018-04-07	19	117	10	29	0.8235
Gal*Gun 2	2018-07-20	145	1331	211	356	0.8233
Crash Wheels	2018-12-20	515	969	148	663	0.8231
SLICE	2018-05-10	6	51	2	8	0.8231
Museum of Symmetry	2018-08-09	8	60	3	11	0.823
Slipstream	2018-05-21	145	1201	189	334	0.8228
Jack N' Jill DX	2018-09-28	4	85	6	10	0.8228
Diamond Caves	2018-11-15	8	41	1	9	0.8227
MochiMochi	2018-09-12	6	41	1	7	0.8227
Castle Must Be Mine	2018-07-13	15	214	24	39	0.8224
Forgotten Hill Mementoes	2018-03-07	106	159	16	122	0.8224
Toki Time Trial	2018-07-20	23	68	4	27	0.8223
Ni no Kuni™ II: Revenant Kingdom	2018-03-23	10805	8325	1541	12346	0.8222
Mount Your Friends 3D: A Hard Man is Good to Climb	2018-02-23	195	330	42	237	0.8220000000000001
霎时晴荫	2018-11-20	13	92	7	20	0.8220000000000001
Shift Quantum	2018-05-30	99	59	3	102	0.8219
11-11 Memories Retold	2018-11-08	467	1376	223	690	0.8214
Oik Memory 2	2018-05-31	54	150	15	69	0.8212999999999999
428 〜封鎖された渋谷で〜	2018-09-06	112	143	14	126	0.8212999999999999
Nekomew's Potty Trouble	2018-01-11	9	67	4	13	0.8212
V-Racer Hoverbike	2018-04-13	12	211	24	36	0.8211
Nature Calls	2018-08-17	297	450	62	359	0.821
Nepenthe	2018-05-17	4	75	5	9	0.821
Nonogram - The Greatest Painter	2018-03-22	24	237	28	52	0.8209000000000001
Slappy Ass	2018-11-08	10	128	12	22	0.8209000000000001
The night of fire stealing/盗火之夜	2018-08-16	77	106	9	86	0.8209000000000001
Octahedron: Transfixed Edition	2018-03-20	52	142	14	66	0.8207
Beast Battle Simulator	2018-02-22	147	891	138	285	0.8206
Viviette	2018-10-18	23	338	44	67	0.8206
Legend of Himari	2018-03-19	1489	313	40	1529	0.8206
Bullets And More VR - BAM VR	2018-04-02	71	454	63	134	0.8205
Beavers Be Dammed	2018-01-16	116	442	61	177	0.8205
Spaceguard 80	2018-06-20	7	29	0	7	0.8204000000000001
Snail Trek - Chapter 3: Lettuce Be	2018-01-04	6	29	0	6	0.8204000000000001
CROSS†CHANNEL: Steam Edition	2018-03-27	17	229	27	44	0.8203
DMT	2018-12-14	9	162	17	26	0.8201999999999999
EMMA The Story	2018-05-24	3	90	7	10	0.8201999999999999
the Melody of Iris	2018-06-15	47	105	9	56	0.8201
Sword With Sauce	2018-03-21	464	4850	886	1350	0.8200000000000001
The Pirate's Fate	2018-03-27	150	286	36	186	0.8200000000000001
Robin	2018-02-08	45	517	74	119	0.8199
AirMech Strike	2018-03-30	2336	8543	1619	3955	0.8195
Hentai MineSweeper	2018-10-11	54	928	146	200	0.8195
The Oni Sellsword	2018-08-07	15	57	3	18	0.8195
Quarantine Circular	2018-05-22	61	352	47	108	0.8193000000000001
Cricket Club	2018-01-18	12	104	9	21	0.8193000000000001
The Waters Above: Prelude	2018-06-28	10	104	9	19	0.8193000000000001
Doughlings: Arcade	2018-05-08	11	89	7	18	0.8193000000000001
Loca-Love My Cute Roommate	2018-10-26	31	89	7	38	0.8193000000000001
Rogue Party	2018-11-01	7	48	2	9	0.8192
Super Daryl Deluxe	2018-04-10	338	382	52	390	0.8190999999999999
Gothicc Breaker	2018-03-28	16	160	17	33	0.8190999999999999
The Colonists	2018-10-24	723	823	128	851	0.8190000000000001
Youropa	2018-06-27	71	495	71	142	0.8190000000000001
Crashphalt	2018-10-12	107	81	6	113	0.8190000000000001
Paperbark	2018-12-12	25	264	33	58	0.8189000000000001
Sorcery Jokers	2018-01-13	24	73	5	29	0.8189000000000001
ATOM RPG	2018-12-19	2938	7932	1506	4444	0.8188
Psychonauts in the Rhombus of Ruin	2018-04-19	100	435	61	161	0.8188
Deity Empires	2018-09-25	82	270	34	116	0.8188
sweet pool	2018-12-20	22	232	28	50	0.8188
Omen Exitio: Plague	2018-03-05	122	410	57	179	0.8186
Sockman	2018-02-01	5	28	0	5	0.8186
Russpuppy Kid Games	2018-09-12	15	28	0	15	0.8186
Matter	2018-12-18	12	145	15	27	0.8183
Desecration of Wings	2018-03-16	40	56	3	43	0.8181999999999999
Contractors VR	2018-12-15	251	2764	493	744	0.8181
Attack Helicopter Dating Simulator	2018-09-27	11	131	13	24	0.8181
Nusantara: Legend of The Winged Ones	2018-12-07	8	38	1	9	0.8181
Crimson Gray: Dusk and Dawn	2018-10-05	16	95	8	24	0.818
Robbie Swifthand and the Orb of Mysteries	2018-09-20	6	72	5	11	0.8179000000000001
Lost Lands: Ice Spell	2018-07-16	24	72	5	29	0.8179000000000001
Ding Dong VR	2018-08-03	4	72	5	9	0.8179000000000001
Project: Gorgon	2018-03-13	677	1688	289	966	0.8178000000000001
The Adventures of Elena Temple: Definitive Edition	2018-03-15	3	47	2	5	0.8178000000000001
Fhtagn! - Tales of the Creeping Madness	2018-05-22	8	47	2	10	0.8178000000000001
DYNASTY WARRIORS 7: Xtreme Legends Definitive Edition	2018-12-06	266	991	160	426	0.8177
Fallen ~Makina and the City of Ruins~	2018-02-23	595	1405	237	832	0.8174
Super Pilot	2018-09-17	11	123	12	23	0.8174
.projekt	2018-03-17	11	123	12	23	0.8174
Kingdom Come: Deliverance	2018-02-13	96069	89004	18596	114665	0.8172
Son of a Witch	2018-05-16	93	339	46	139	0.8172
Blocked and Loaded	2018-03-01	11	94	8	19	0.8170999999999999
신기록 : A Compendium of Ghosts	2018-06-05	14	79	6	20	0.8170999999999999
Star Traders: Frontiers	2018-08-01	1111	2726	491	1602	0.8168000000000001
Flipping Death	2018-08-07	18	176	20	38	0.8168000000000001
Knight Bewitched	2018-04-18	57	129	13	70	0.8168000000000001
Katy and Bob: Safari Cafe	2018-06-18	1957	156	17	1974	0.8167
Super Volley Blast	2018-11-01	11	86	7	18	0.8166
Ms. Squeaker's Home for the Sick	2018-09-28	4	27	0	4	0.8166
永遠消失的幻想鄉 ～ The Disappearing of Gensokyo	2018-01-11	934	2909	528	1462	0.8165000000000001
THE ENIGMA MACHINE	2018-11-30	5	128	13	18	0.8161
Don't Forget Our Esports Dream	2018-11-20	37	78	6	43	0.8161
PokerStars VR	2018-11-08	184	2462	443	627	0.816
Infinite Adventures	2018-10-30	47	100	9	56	0.816
Leisure Suit Larry - Wet Dreams Don't Dry	2018-11-07	339	1190	200	539	0.8158
DOKA 2 KISHKI EDITION	2018-11-05	2018	2786	508	2526	0.8156
ADIOS Amigos	2018-09-12	22	85	7	29	0.8156
BLACK BIRD	2018-10-31	29	85	7	36	0.8156
Rikki & Vikki	2018-12-26	10	85	7	17	0.8156
Squeakers	2018-02-28	6	54	3	9	0.8156
12 Labours of Hercules VII: Fleecing the Fleece	2018-01-12	169	134	14	183	0.8155
The Broken Seal	2018-01-29	15	186	22	37	0.8153
The Greater Good	2018-10-23	60	92	8	68	0.8153
The Council	2018-03-13	784	3809	713	1497	0.8151999999999999
Tower of Time	2018-04-12	686	1745	307	993	0.8151
Meow Motors	2018-11-02	16	192	23	39	0.8151
Find someone else	2018-04-06	27	106	10	37	0.8151
BATTLETECH	2018-04-24	35767	23146	4737	40504	0.8150000000000001
FROSTBITE: Deadly Climate	2018-07-22	153	431	63	216	0.8149
Mysterious Realms RPG	2018-10-25	13	45	2	15	0.8148000000000001
Mary Skelter: Nightmares	2018-07-19	386	430	63	449	0.8147
GensoYonbaiKen2	2018-03-01	9	36	1	10	0.8147
Prime Mover	2018-05-21	44	172	20	64	0.8146
Point	2018-04-24	5	26	0	5	0.8146
Galencia	2018-07-17	4	26	0	4	0.8146
HEARTBEAT	2018-12-12	85	610	95	180	0.8145
Horns of Fear	2018-06-07	6	69	5	11	0.8145
Dude, Stop	2018-06-01	158	1538	269	427	0.8144
Mirror Drop	2018-05-18	5	61	4	9	0.8142
The Legacy: The Tree of Might	2018-12-24	19	61	4	23	0.8142
FINAL FANTASY XV WINDOWS EDITION	2018-03-06	29498	37207	7793	37291	0.8138
Amorous	2018-04-13	438	8361	1657	2095	0.8137000000000001
Sairento VR	2018-02-06	98	1384	241	339	0.8137000000000001
Sudoku Killer	2018-10-19	23	138	15	38	0.8137000000000001
Rogue Bit	2018-10-10	8	90	8	16	0.8135
Alicia Quatermain 2: The Stone of Fate	2018-07-03	14	68	5	19	0.8134
Viki Spotter: School	2018-03-13	8	68	5	13	0.8134
Burnin' Rubber 5 HD	2018-02-14	26	231	30	56	0.813
Super Jigsaw Puzzle: Monuments	2018-06-21	18	35	1	19	0.813
RHEM II SE: The Cave	2018-10-03	10	35	1	11	0.813
Flashing Lights	2018-06-07	727	10509	2118	2845	0.8129000000000001
Lost Lands: Mistakes of the Past	2018-12-13	21	75	6	27	0.8129000000000001
De Fobos y Deimos	2018-07-06	32	52	3	35	0.8129000000000001
Go Outside Simulator	2018-11-15	6	52	3	9	0.8129000000000001
The Adventures of Nick & Willikins	2018-03-06	30	110	11	41	0.8128000000000001
Lost Artifacts	2018-02-02	17	82	7	24	0.8126000000000001
New Star Manager	2018-09-27	175	359	52	227	0.8125
DERE EVIL .EXE	2018-07-03	20	336	48	68	0.8125
Later On	2018-01-26	4	25	0	4	0.8125
Warp Glider	2018-12-14	6	25	0	6	0.8125
KOEWOTAYORINI / 声之寄托	2018-03-27	234	772	127	361	0.8124
Pawarumi	2018-01-30	10	67	5	15	0.8122
NOISZ	2018-08-31	8	67	5	13	0.8122
The Station	2018-02-20	48	818	136	184	0.8120999999999999
Moonlighter	2018-05-29	6229	12764	2613	8842	0.8119
At Home Alone	2018-11-01	96	1531	274	370	0.8118000000000001
Puyo Puyo™Tetris® 	2018-02-27	1368	4317	839	2207	0.8115000000000001
Treadnauts	2018-08-17	45	160	19	64	0.8114
Mulaka	2018-02-27	61	141	16	77	0.8114
The Dark Room	2018-09-20	34	108	11	45	0.8111
Salary Man Escape	2018-09-18	5	34	1	6	0.8111
Pleasure Puzzle:Workshop	2018-11-01	15	178	22	37	0.8109999999999999
Acid Spy	2018-06-08	7	134	15	22	0.8109999999999999
Adera	2018-08-27	24	134	15	39	0.8109999999999999
Evergarden	2018-08-16	381	591	95	476	0.8109000000000001
Captive	2018-04-08	4	94	9	13	0.8107
MOMO.EXE	2018-08-29	11	754	126	137	0.8105
Wired	2018-07-24	15	80	7	22	0.8105
Freeways	2018-02-06	291	1071	187	478	0.8104000000000001
The Great C	2018-10-09	14	201	26	40	0.8103
Duck Life: Battle	2018-08-29	37	201	26	63	0.8103
SOMOS	2018-11-08	4	24	0	4	0.8103
Kitty Powers' Love Life	2018-02-08	119	158	19	138	0.8101
Zed Survival	2018-02-20	8	50	3	11	0.81
Space Pilgrim Academy: Year 2	2018-04-20	8	42	2	10	0.81
Dissembler	2018-02-21	10	65	5	15	0.8098000000000001
Not Tonight	2018-08-17	486	1649	303	789	0.8095
Super Lucky's Tale	2018-09-14	150	470	74	224	0.8094
Disturbed: Beyond Aramor	2018-05-18	29	33	1	30	0.8092
Gamma Bros	2018-12-10	22	125	14	36	0.8090999999999999
Forsaken Remastered	2018-07-31	36	156	19	55	0.8089000000000001
Hyperspace Dogfights	2018-05-14	9	92	9	18	0.8088
Deck Casters	2018-01-11	16	105	11	27	0.8086
Incredible Mandy	2018-11-27	57	105	11	68	0.8086
R-Type Dimensions EX	2018-11-28	73	227	31	104	0.8085
Viki Spotter: Around The World	2018-03-16	4	64	5	9	0.8085
Steel Vampire	2018-11-17	12	64	5	17	0.8085
Hidden Animals : Photo Hunt	2018-10-19	11	71	6	17	0.8084
Lonely in the Winter	2018-02-15	3	49	3	6	0.8084
Photonic Distress	2018-08-03	8	49	3	11	0.8084
Wonder Wickets	2018-10-17	16	41	2	18	0.8083
Towards The Pantheon	2018-05-16	10	41	2	12	0.8083
Ashi: Lake of Light	2018-07-05	3	41	2	5	0.8083
Space Pilgrim Academy: Year 3	2018-10-12	10	41	2	12	0.8083
NAIRI: Tower of Shirin	2018-11-29	55	389	60	115	0.8081
Impulsion	2018-07-19	22	220	30	52	0.8079999999999999
Semblance	2018-07-24	63	260	37	100	0.8079000000000001
The Big Journey	2018-04-20	26	271	39	65	0.8077
Dr. Frank's Build a Boyfriend	2018-05-31	41	225	31	72	0.8076000000000001
Chuusotsu! 1st Graduation: Time After Time	2018-04-24	22	56	4	26	0.8076000000000001
Protolife	2018-06-15	230	359	55	285	0.8073
Marble Race	2018-10-13	10	77	7	17	0.8073
Firebird - The Unfinished	2018-04-27	6	32	1	7	0.8072
Hinedere Beat	2018-09-17	3	32	1	4	0.8072
Galactic Bulwark Strike	2018-10-22	136	32	1	137	0.8072
Titanic: Adventure Out Of Time	2018-04-26	18	241	34	52	0.807
Game Dev Studio	2018-03-12	171	513	84	255	0.8069
OCTOPTICOM	2018-10-03	6	48	3	9	0.8069
Cows VS Vikings	2018-12-07	221	368	57	278	0.8068000000000001
Runefall	2018-06-06	34	103	11	45	0.8068000000000001
Path of Sin: Greed	2018-08-30	24	194	26	50	0.8066
Clawface	2018-03-13	26	128	15	41	0.8066
Lightning Angel Litona Liliche 섬광천사 리토나 리리셰	2018-12-05	4	40	2	6	0.8066
Turbo Tunnel	2018-06-01	28	134	16	44	0.8065000000000001
FPV Freerider Recharged	2018-03-17	19	115	13	32	0.8062
ABYSS CRAWLERS plus	2018-03-09	27	69	6	33	0.8059999999999999
Viki Spotter: Sports	2018-05-29	6	62	5	11	0.8059000000000001
Out of the Park Baseball 19	2018-03-22	1525	633	108	1633	0.8058
Zak McKracken and the Alien Mindbenders	2018-11-16	12	89	9	21	0.8058
Space Tyrant	2018-02-27	232	492	81	313	0.8057
Ceress and Orea	2018-04-20	4	108	12	16	0.8056000000000001
39 Days to Mars	2018-04-25	16	243	35	51	0.8054000000000001
Subterraneus	2018-12-12	4	22	0	4	0.8054000000000001
Combat rush	2018-08-14	3	22	0	3	0.8054000000000001
The Lost Legends of Redwall: Escape the Gloomer	2018-11-16	5	22	0	5	0.8054000000000001
Chess of Blades	2018-01-05	25	95	10	35	0.8053
Tiny Bubbles	2018-05-08	26	47	3	29	0.8053
Pegasus-5: Gone Astray	2018-07-11	6	31	1	7	0.8051
Celestial Hacker Girl Jessica	2018-07-17	4	31	1	5	0.8051
Neighbor	2018-09-29	7	31	1	8	0.8051
Umfend	2018-10-31	7	101	11	18	0.805
Quiver Dick's Terrible Tale For Terrible Parents To Read To Their Equally Terrible Children	2018-10-26	7	101	11	18	0.805
Ultra Space Battle Brawl	2018-10-04	14	75	7	21	0.805
Radiis	2018-07-19	13	75	7	20	0.805
Boo! Greedy Kid	2018-02-22	8	39	2	10	0.8048000000000001
NEO NEO	2018-06-16	6	39	2	8	0.8048000000000001
Switch - Black & White	2018-07-21	3	39	2	5	0.8048000000000001
Empire Deluxe Combined Edition	2018-06-01	73	107	12	85	0.8047
TAYAL	2018-10-10	11	68	6	17	0.8047
Domiverse	2018-03-07	9	54	4	13	0.8047
Dual Snake	2018-01-31	10	54	4	14	0.8047
Railway Empire	2018-01-26	5446	7116	1500	6946	0.8046
Eco	2018-02-06	6964	8930	1903	8867	0.8045
Catmaze	2018-05-24	42	398	64	106	0.8045
In Death	2018-10-02	70	807	144	214	0.8044
Your Diary +	2018-08-10	16	143	18	34	0.8043000000000001
Captain Forever Trilogy	2018-05-22	36	131	16	52	0.8043000000000001
Fortune-499	2018-05-11	9	125	15	24	0.8043000000000001
Pure Rock Crawling	2018-04-11	128	826	148	276	0.8042
Big Tower Tiny Square	2018-02-05	14	100	11	25	0.804
La-Mulana 2	2018-07-30	1191	704	124	1315	0.8039000000000001
Q.U.B.E. 2	2018-03-13	352	1232	232	584	0.8035
FPV Freerider	2018-05-17	24	159	21	45	0.8031999999999999
Viki Spotter: Shopping	2018-04-06	6	53	4	10	0.8031999999999999
Nova Flow	2018-03-15	20	30	1	21	0.8029999999999999
Second Chance	2018-11-22	117	915	168	285	0.8028000000000001
Super Gravity Ball	2018-02-02	2	21	0	2	0.8028000000000001
Dr Greenstuff	2018-10-31	67	129	16	83	0.8027
Razerwire:Nanowars	2018-02-28	6	86	9	15	0.8027
MXGP PRO	2018-06-29	303	848	155	458	0.8023
Scheming Through The Zombie Apocalypse: The Beginning	2018-06-08	688	301	47	735	0.8023
Hentai Summer	2018-12-07	8	140	18	26	0.8020999999999999
SOK MIN	2018-04-18	74	66	6	80	0.8020999999999999
Dad Quest	2018-08-17	17	128	16	33	0.802
The Inquisitor	2018-01-18	10	45	3	13	0.8019
Oppaidius Summer Trouble!	2018-12-10	10	59	5	15	0.8018000000000001
Russian World	2018-04-04	2	59	5	7	0.8018000000000001
The Universim	2018-08-28	2825	6090	1303	4128	0.8016
The Initiate 2: The First Interviews	2018-10-16	10	85	9	19	0.8016
SOULCALIBUR VI	2018-10-18	14684	9455	2067	16751	0.8014
BombTag	2018-02-13	608	1235	237	845	0.8013
Beat the Song	2018-08-28	3	91	10	13	0.8013
Adolescent Santa Claus	2018-06-30	24	1024	193	217	0.8012
TY the Tasmanian Tiger 3	2018-12-17	121	150	20	141	0.8009999999999999
Psychedelica of the Black Butterfly	2018-11-15	39	508	88	127	0.8009000000000001
Legendary Gary	2018-02-20	12	37	2	14	0.8009000000000001
The Tower of Five Hearts	2018-11-14	13	37	2	15	0.8009000000000001
VRITRA COMPLETE EDITION	2018-08-30	8	29	1	9	0.8007
Hyss	2018-12-14	8	29	1	9	0.8007
Escape from the Princess	2018-09-17	146	172	24	170	0.8006000000000001
Tangledeep	2018-02-01	477	1109	212	689	0.8005
Executive Assault 2	2018-10-18	294	888	166	460	0.8004000000000001
RIDE 3	2018-11-30	1080	3946	833	1913	0.8003
The Flood	2018-03-30	33	955	180	213	0.8003
Last Resort Island	2018-06-28	16	149	20	36	0.8003
Hexa Turn	2018-02-26	7	90	10	17	0.8003
Hakoniwa Explorer Plus	2018-06-06	123	419	71	194	0.8001
Momoiro Closet	2018-05-08	35	51	4	39	0.8001
Break Stuff With Coins	2018-05-04	4	20	0	4	0.8
Varion	2018-11-08	4	20	0	4	0.8
Briquid	2018-12-06	7	20	0	7	0.8
Murasaki Tsurugi	2018-12-19	7	20	0	7	0.8
StickyBots	2018-11-21	12	20	0	12	0.8
Memory Trainer	2018-07-19	4	20	0	4	0.8
Shred! 2 - ft Sam Pilgrim	2018-12-24	24	154	21	45	0.7998999999999999
Indie Pogo	2018-07-10	105	294	47	152	0.7996
The Crew 2	2018-06-29	12748	52651	12302	25050	0.7995000000000001
0°N 0°W	2018-03-01	8	246	38	46	0.7994
Diabolic	2018-03-26	37	303	49	86	0.7991
Heroes Of Hellas 4: Birth Of Legend	2018-02-14	13	36	2	15	0.7989
Zombie Cubes	2018-10-30	4	36	2	6	0.7989
Super Seducer	2018-03-06	431	1360	269	700	0.7987000000000001
Sopwith VR	2018-12-26	19	281	45	64	0.7986
Sky Noon	2018-12-18	126	517	92	218	0.7983
Invasion	2018-06-15	100	28	1	101	0.7983
Samsara	2018-02-06	7	28	1	8	0.7983
Epic Dumpster Bear	2018-04-04	4	28	1	5	0.7983
Dark Old Sun	2018-03-07	4	28	1	5	0.7983
ASHI WASH	2018-04-30	4	28	1	5	0.7983
Dave	2018-11-30	5	28	1	6	0.7983
河洛群俠傳 (Ho Tu Lo Shu ： The Books of Dragon)	2018-11-15	1877	7364	1631	3508	0.7981
Galactic Lander	2018-10-04	33	94	11	44	0.7981
Neos VR	2018-05-04	1404	1461	293	1697	0.7978000000000001
Martial Arts Brutality	2018-01-31	306	578	105	411	0.7977
Zen Chess: Mate in One	2018-04-10	21	258	41	62	0.7977
Clatter	2018-12-10	113	538	97	210	0.7975
HD Poker	2018-09-15	616	3075	654	1270	0.7973
4 for the Money Demo	2018-01-17	25	56	5	30	0.7973
Summer Funland	2018-02-23	26	262	42	68	0.7972
Super Jigsaw Puzzle	2018-02-15	462	93	11	473	0.7970999999999999
Space Bob vs. The Replicons	2018-09-28	29	87	10	39	0.7970999999999999
Paper Valley	2018-06-06	3	19	0	3	0.7970999999999999
Ruya	2018-11-02	3	19	0	3	0.7970999999999999
Blood City	2018-08-28	3	19	0	3	0.7970999999999999
Beat Blocks VR	2018-11-12	8	19	0	8	0.7970999999999999
The Hanged Man	2018-02-27	9	116	15	24	0.7968000000000001
PaulPaul - Act 1	2018-07-25	9	35	2	11	0.7968000000000001
Duke Dashington Remastered	2018-11-16	3	35	2	5	0.7968000000000001
Spitkiss	2018-11-06	4	35	2	6	0.7968000000000001
Signal Simulator	2018-04-29	136	726	137	273	0.7967000000000001
Code Brown	2018-11-09	25	110	14	39	0.7966
Stonewall Penitentiary	2018-05-14	9	42	3	12	0.7965000000000001
Indecision.	2018-02-09	16	475	85	101	0.7964
Super Seducer 2 : Advanced Seduction Tactics	2018-09-13	646	1294	260	906	0.7963
The Long Reach	2018-03-14	30	341	58	88	0.7962
Werewolves: Haven Rising	2018-07-26	52	74	8	60	0.7959999999999999
Hanger World	2018-01-24	6	27	1	7	0.7958
Tori	2018-04-19	3	27	1	4	0.7958
Bonkies	2018-09-10	16	27	1	17	0.7958
VANILLA GARDEN OF JUDGEMENT	2018-10-20	4	27	1	5	0.7958
Wizard Slime	2018-12-17	3	27	1	4	0.7958
Clad in Iron: Sakhalin 1904	2018-11-05	4	27	1	5	0.7958
Learn Japanese To Survive! Kanji Combat	2018-08-01	126	248	40	166	0.7955
Sprint Vector	2018-02-08	111	566	105	216	0.7951
Warstone TD	2018-05-23	342	2653	569	911	0.795
Suzy Cube	2018-06-19	32	257	42	74	0.795
The way to defeat the Archfiend / 打倒魔王的方法	2018-07-27	8	67	7	15	0.7948999999999999
Her	2018-10-16	9	67	7	16	0.7948999999999999
Tilesweeper	2018-08-23	112	287	48	160	0.7948000000000001
OS:Path	2018-04-19	6	34	2	8	0.7946
Dr. Cares - Family Practice	2018-12-05	23	34	2	25	0.7946
Pamali: Indonesian Folklore Horror	2018-12-28	72	487	89	161	0.7945000000000001
Just Ski	2018-02-07	23	141	20	43	0.7945000000000001
Run and Jump	2018-02-20	6	41	3	9	0.7945000000000001
Gray Dawn	2018-06-07	62	671	128	190	0.7944
Tasty Planet Forever	2018-10-16	67	199	31	98	0.7943000000000001
Settlements	2018-08-03	284	240	39	323	0.7942
Thunder Chase	2018-02-02	6	18	0	6	0.7939
Fair Deal: Las Vegas	2018-12-21	3	18	0	3	0.7939
Strategic Command WWII: World at War	2018-12-06	263	368	65	328	0.7937000000000001
SFD	2018-08-31	17	84	10	27	0.7937000000000001
Rival Megagun	2018-11-29	37	60	6	43	0.7937000000000001
Floor Kids	2018-05-16	35	145	21	56	0.7935
Death's Gambit: Afterlife	2018-08-14	2538	3693	818	3356	0.7934000000000001
寄居隅怪奇事件簿 Hermitage Strange Case Files	2018-11-12	1404	1481	308	1712	0.7934000000000001
Kidz	2018-07-26	103	233	38	141	0.7931999999999999
GlitchPets	2018-07-16	6	47	4	10	0.7931999999999999
Ruler by Default	2018-05-03	9	26	1	10	0.7931999999999999
Super Multitasking	2018-02-23	15	26	1	16	0.7931999999999999
Vesta	2018-01-19	5	26	1	6	0.7931999999999999
Theorem	2018-04-24	3	26	1	4	0.7931999999999999
Achievement Idler: Red	2018-05-13	27	212	34	61	0.7929
Love Letter	2018-10-24	193	380	68	261	0.7928000000000001
Shootout on Cash Island	2018-01-18	369	282	48	417	0.7927
SOK MAX	2018-02-12	5	53	5	10	0.7925
2236 A.D.	2018-05-11	6	53	5	11	0.7925
The Legacy: Prisoner	2018-06-19	16	53	5	21	0.7925
Sanguine Sanctum	2018-09-07	5	40	3	8	0.7925
Where The Water Tastes Like Wine - Fireside Chats	2018-11-15	13	40	3	16	0.7925
Ascendant Hearts	2018-01-19	70	100	13	83	0.7924
Bear With Me - Collector's Edition	2018-02-08	244	286	49	293	0.7923
G2 Fighter	2018-10-12	2670	2421	527	3197	0.7922
PUT ANNA	2018-08-09	9	59	6	15	0.7922
Jewel Match Solitaire Winterscapes	2018-12-21	18	59	6	24	0.7922
Brutal Alice -The Handred Day's War-	2018-02-05	37	127	18	55	0.792
魔塔2018	2018-11-09	30	127	18	48	0.792
Attack of the Earthlings	2018-02-08	95	290	50	145	0.7919
Light Fall	2018-04-26	33	105	14	47	0.7919
Paw Patrol: On A Roll	2018-10-23	89	284	49	138	0.7915000000000001
Dimension of Monster Girls	2018-04-13	16	121	17	33	0.7915000000000001
the untold story of hengshui school	2018-05-02	64	342	61	125	0.7914
Final Days	2018-09-18	13	82	10	23	0.7913
CHUCHEL	2018-03-07	243	2351	515	758	0.7911
Greetings	2018-08-24	22	502	95	117	0.7911
IOSoccer	2018-06-08	1204	1824	393	1597	0.7909999999999999
Potion Explosion	2018-05-16	217	178	28	245	0.7909999999999999
Dominatrix Simulator: Threshold	2018-10-22	19	584	113	132	0.7908
Yet Another Research Dog	2018-02-02	155	292	51	206	0.7908
Viki Spotter: Megapolis	2018-02-20	6	52	5	11	0.7908
MultiTaskMaster	2018-08-16	3	17	0	3	0.7905
Impulsow	2018-12-22	2	17	0	2	0.7905
AegisM	2018-07-27	18	39	3	21	0.7904000000000001
The Royal Game of Ur	2018-11-30	6	39	3	9	0.7904000000000001
Stay Safe	2018-05-22	14	25	1	15	0.7904000000000001
Kubble	2018-11-13	7	25	1	8	0.7904000000000001
The Ghost of You	2018-12-22	4	25	1	5	0.7904000000000001
Bus Simulator 18	2018-06-13	3914	9371	2218	6132	0.7902
Behind The Screen 螢幕判官 	2018-04-04	24	207	34	58	0.7902
Sakura Sadist	2018-05-25	59	338	61	120	0.7898999999999999
Sweep'n'Sweep	2018-03-20	6	32	2	8	0.7898999999999999
HYBRIS - Pulse of Ruin	2018-06-14	4	32	2	6	0.7898999999999999
7 Days in Dream 光尘	2018-05-14	3	32	2	5	0.7898999999999999
Corrupt	2018-09-15	12	32	2	14	0.7898999999999999
Onmyoji	2018-04-18	4978	2162	476	5454	0.7897
TimeTekker	2018-06-07	5	45	4	9	0.7895000000000001
Sakura MMO	2018-10-15	47	245	42	89	0.7894
Wizard101	2018-09-06	1060	4564	1053	2113	0.7893000000000001
Lu Bu Maker	2018-07-17	64	134	20	84	0.789
Hunt and Snare	2018-12-17	104	452	86	190	0.7889
The Banner Saga 3	2018-07-26	1428	1991	439	1867	0.7888
Indiana Jones® and the Infernal Machine™	2018-11-16	34	268	47	81	0.7888
Erinye Demo	2018-04-07	23	74	9	32	0.7884000000000001
Infliction	2018-10-18	67	550	108	175	0.7883
Sword of the Guardian	2018-06-17	6	38	3	9	0.7883
Google Spotlight Stories: On Ice	2018-06-06	9	38	3	12	0.7883
Insurgence - Chains of Renegade	2018-11-09	9	38	3	12	0.7883
Meritocracy of the Oni & Blade	2018-09-27	270	342	63	333	0.788
SACRALITH : The Archer`s Tale	2018-05-17	18	218	37	55	0.788
Rebel Forces	2018-12-20	212	1290	277	489	0.7879
HellCat	2018-06-14	11	158	25	36	0.7878000000000001
Amberskull	2018-04-13	5	62	7	12	0.7876000000000001
Cognizer	2018-05-30	15	44	4	19	0.7875
Rosebaker's Icy Treats	2018-02-01	3	24	1	4	0.7875
Yumori Forest	2018-09-14	3	24	1	4	0.7875
Zeroptian Invasion	2018-11-28	3	24	1	4	0.7875
Sipho	2018-11-13	68	132	20	88	0.7874
Cross Racing Championship Extreme	2018-09-18	13	56	6	19	0.7874
Trap Labs	2018-11-27	9	31	2	11	0.7874
Bunny Mahjo	2018-11-09	5	31	2	7	0.7874
Puzzle With Your Friends	2018-04-24	33	137	21	54	0.7873000000000001
Frantic Dimension	2018-12-28	23	50	5	28	0.7873000000000001
TUNNEL DIVERS	2018-07-06	31	111	16	47	0.7872
Temporality	2018-11-12	62	111	16	78	0.7872
Starting the Game	2018-05-08	8	349	65	73	0.7870999999999999
伏雨录	2018-05-12	8	73	9	17	0.7870999999999999
VCB: Why City	2018-11-26	3989	1907	425	4414	0.787
Gay World	2018-01-18	856	616	124	980	0.787
Dark Quest 2	2018-03-06	54	477	93	147	0.787
The Monsters' History Book 怪物的历史书	2018-06-27	8	84	11	19	0.787
We Were Here Too	2018-02-02	1017	5199	1228	2245	0.7869
Battle Squares	2018-08-23	7	16	0	7	0.7869
BlackSimulator	2018-08-31	2	16	0	2	0.7869
Tactics Maiden Remastered	2018-09-28	7	16	0	7	0.7869
Animals Memory: Horses	2018-10-23	3	16	0	3	0.7869
Albion Online	2018-05-16	25863	46176	11708	37571	0.7868
Mother Simulator	2018-05-22	37	490	96	133	0.7868
My Colony	2018-11-01	23	121	18	41	0.7868
Prismata	2018-03-08	122553	930	196	122749	0.7866
Poly Universe	2018-07-20	42	105	15	57	0.7865000000000001
Perseverance: Part 1	2018-07-23	6	89	12	18	0.7865000000000001
VR Regatta - The Sailing Game	2018-01-30	533	141	22	555	0.7864
Garden of Oblivion	2018-03-09	19	151	24	43	0.7863
Healer's Quest	2018-04-18	126	219	38	164	0.7859999999999999
FIREWORK	2018-12-06	4	37	3	7	0.7859999999999999
Pixel Puzzles 2: Christmas	2018-11-27	892	55	6	898	0.7857
The Impure	2018-08-08	19	55	6	25	0.7857
To Trust an Incubus	2018-11-23	85	150	24	109	0.7856000000000001
Monica e a Guarda dos Coelhos	2018-12-04	9	49	5	14	0.7855
Stream Games	2018-07-06	13	43	4	17	0.7855
Glare1more	2018-09-14	35059	213	37	35096	0.7853
Trap welcome to Beryl	2018-05-02	50	179	30	80	0.7852
FIGHTING EX LAYER	2018-11-30	168	501	100	268	0.785
Roman Adventures - Britons. Season 1	2018-09-20	13	30	2	15	0.7848
Light Tracer	2018-01-15	3	30	2	5	0.7848
JuVentures	2018-01-05	4	30	2	6	0.7848
Puppet Fever	2018-04-19	8	30	2	10	0.7848
Conjuror's Eye	2018-03-14	3	30	2	5	0.7848
Jet-Story 2018	2018-07-03	15	30	2	17	0.7848
东方百问~TouHouAsked	2018-10-08	16	30	2	18	0.7848
Slither Link	2018-09-09	15	30	2	17	0.7848
SIMULACRA: Pipe Dreams	2018-10-25	86	601	123	209	0.7847
Oakwood	2018-12-04	9	240	43	52	0.7845000000000001
Nonogram - Master's Legacy	2018-11-08	42	291	54	96	0.7844
Splitter Critters	2018-05-15	6	23	1	7	0.7844
The Midnight Sanctuary	2018-10-03	3	23	1	4	0.7844
Boltzmann Brain	2018-04-06	3	23	1	4	0.7844
Silverworld	2018-04-12	39	23	1	40	0.7844
Mosaics Galore 2	2018-09-03	1358	71	9	1367	0.7843000000000001
Aeon of Sands - The Trail	2018-12-04	15	87	12	27	0.7841
The Mercury Man	2018-05-20	393	484	97	490	0.784
Farm Mania 2	2018-01-15	17	54	6	23	0.784
Synthwave Dream '85	2018-08-31	4	54	6	10	0.784
🧠 OUT OF THE BOX	2018-07-19	85	201	35	120	0.7839
东方大战争 ~ Touhou Big Big Battle	2018-09-10	954	3118	734	1688	0.7837000000000001
Mermaid Mission Titanic	2018-06-06	5	36	3	8	0.7837000000000001
WebbVR: The James Webb Space Telescope Virtual Experience	2018-10-31	9	48	5	14	0.7836
Wild Glory	2018-03-08	6	42	4	10	0.7834000000000001
America's Retribution	2018-04-21	4	42	4	8	0.7834000000000001
keyg	2018-12-13	22	112	17	39	0.7831999999999999
Blast the Past	2018-10-03	481	117	18	499	0.7831
Block Party Sports	2018-05-03	7	15	0	7	0.783
Bedlamball	2018-04-19	52	15	0	52	0.783
Crazy Appliances	2018-02-06	6	15	0	6	0.783
Travel Mosaics 6: Christmas Around the World	2018-12-03	8	15	0	8	0.783
Hostile User Interface	2018-12-15	2	15	0	2	0.783
SpyParty	2018-04-12	307	1023	224	531	0.7829
The Endless Journey	2018-01-19	97	204	36	133	0.7829
Hidden Dragon: Legend	2018-01-22	9	70	9	18	0.7829
Pizza Titan Ultra	2018-04-25	14	70	9	23	0.7829
Kartong	2018-04-04	80	59	7	87	0.7828
Meridian 59	2018-08-28	37	213	38	75	0.7826000000000001
Nick Beard: The Fedora of Destiny	2018-07-09	159	203	36	195	0.7823000000000001
Amber's Airline - High Hopes	2018-09-03	49	101	15	64	0.7823000000000001
Warhammer 40,000: Gladius - Relics of War	2018-07-12	3451	5743	1408	4859	0.7820999999999999
Sword Art Online: Fatal Bullet	2018-02-23	21727	14225	3608	25335	0.782
Book of Demons	2018-12-14	2083	9296	2330	4413	0.7817000000000001
OVERWHELM	2018-06-11	78	169	29	107	0.7817000000000001
Tin Hearts: Prologue	2018-11-08	7	47	5	12	0.7816
Return of Red Riding Hood Enhanced Edition	2018-01-19	235	47	5	240	0.7816
HyperBowl	2018-07-20	6	47	5	11	0.7816
Mist Survival	2018-08-15	3136	8751	2191	5327	0.7815000000000001
Monster Energy Supercross - The Official Videogame	2018-02-13	611	681	145	756	0.7815000000000001
Holyday City: Reloaded	2018-04-23	1813	1214	273	2086	0.7813
Snares of Ruin	2018-01-17	71	41	4	75	0.7813
The 50 States Quiz	2018-07-02	27	41	4	31	0.7813
Picrastination	2018-03-12	11	35	3	14	0.7813
Lets Beats	2018-07-23	46	35	3	49	0.7813
Deported 2: Build That Wall	2018-12-07	5	35	3	8	0.7813
Infectonator 3: Apocalypse	2018-05-10	411	692	148	559	0.7812000000000001
Animals Memory: Cats	2018-02-20	4	58	7	11	0.7812000000000001
Party Hard 2 	2018-10-25	540	1794	416	956	0.7811
Blood of Patriots	2018-02-18	5	22	1	6	0.7811
Colour Box	2018-03-09	9	22	1	10	0.7811
Flat Trip	2018-10-03	14	22	1	15	0.7811
Moe Jigsaw	2018-03-24	372	287	55	427	0.7807
Endless Fables 3: Dark Moor	2018-07-19	20	134	22	42	0.7806000000000001
Viki Spotter: Undersea	2018-02-07	6	63	8	14	0.7804000000000001
Skeletal Dance Party	2018-10-22	15	52	6	21	0.7803
Penkura	2018-12-19	8	52	6	14	0.7803
Season's Beatings	2018-01-23	11	52	6	17	0.7803
DEPLOYMENT	2018-04-10	156	577	122	278	0.7802
POLYGOD	2018-08-17	35	109	17	52	0.7801
The Tower of Beatrice	2018-07-18	10	68	9	19	0.7798999999999999
Call to Arms	2018-04-27	2882	15747	4074	6956	0.7795000000000001
Phantom Signal	2018-01-16	972	123	20	992	0.7795000000000001
MONMUSU	2018-05-12	4291	4121	1015	5306	0.7793000000000001
Fap Queen	2018-10-26	46	1196	273	319	0.7792
女巫与六便士 the sibyl and sixpence	2018-12-31	15	611	131	146	0.7792
Qybe	2018-10-23	5	28	2	7	0.7792
The Art Theft by Jay Doherty	2018-12-03	4	28	2	6	0.7792
ReX	2018-05-17	12	83	12	24	0.7791
七人杀阵 - Seven Sacrifices	2018-09-14	137	756	166	303	0.779
Storm Boy	2018-11-20	6	88	13	19	0.779
SpellKeeper	2018-04-03	6	40	4	10	0.779
Slum Ball VR Tournament	2018-05-16	592	40	4	596	0.779
Future Proof	2018-05-17	28	62	8	36	0.7787999999999999
Eternum EX	2018-10-25	4	34	3	7	0.7787999999999999
Memento of Spring	2018-01-09	6	34	3	9	0.7787999999999999
The Kite	2018-11-19	76	613	132	208	0.7787000000000001
Pan-Dimensional Conga Combat	2018-02-16	4	14	0	4	0.7787000000000001
cityglitch	2018-02-23	3	14	0	3	0.7787000000000001
Drunkenpants	2018-01-05	5	14	0	5	0.7787000000000001
Techno Boy	2018-03-13	6	14	0	6	0.7787000000000001
Warriors of Titus	2018-12-20	9	14	0	9	0.7787000000000001
Lethal Lawns: Competitive Mowing Bloodsport	2018-03-30	8	14	0	8	0.7787000000000001
Lost Borderline	2018-05-03	4	14	0	4	0.7787000000000001
Krystal the Adventurer	2018-06-08	1	14	0	1	0.7787000000000001
Echoes of the Fey: The Last Sacrament	2018-07-10	10	14	0	10	0.7787000000000001
Mendel	2018-09-07	6	14	0	6	0.7787000000000001
Anubis' Challenge	2018-11-16	3	14	0	3	0.7787000000000001
Drone Hero	2018-05-14	4	51	6	10	0.7785
Google Spotlight Stories: Rain or Shine	2018-03-20	15	51	6	21	0.7785
Märchen Forest: Mylne and the Forest Gift	2018-05-17	52	330	66	118	0.7783
SoulWorker	2018-02-26	11017	11519	2977	13994	0.7782
SENRAN KAGURA Peach Beach Splash	2018-03-07	2450	2999	733	3183	0.7781
Versus World	2018-01-31	26	77	11	37	0.7779
Brazilian Root	2018-10-31	6	56	7	13	0.7777
Draw The Way	2018-11-19	647	21	1	648	0.7777
HOT PINK	2018-05-24	6	21	1	7	0.7777
Jigsaw 360	2018-12-07	4	21	1	5	0.7777
Arlo The Rabbit	2018-05-23	5	21	1	6	0.7777
Bubble Burst	2018-12-24	6	21	1	7	0.7777
Pichon	2018-03-15	18	45	5	23	0.7775
Red Faction Guerrilla Re-Mars-tered	2018-07-03	1509	2712	663	2172	0.7772
Black Dream	2018-07-06	7	61	8	15	0.7772
Plug Me	2018-04-05	8	39	4	12	0.7767000000000001
Comrades and Barons: Solitaire of Bloody 1919	2018-02-08	6	39	4	10	0.7767000000000001
Shrinking Pains	2018-04-28	36	162	29	65	0.7766
Spellwake	2018-09-01	48	148	26	74	0.7765000000000001
Panzer Hearts - War Visual Novel	2018-04-25	50	81	12	62	0.7765000000000001
My Life as a Maiden	2018-01-26	13	76	11	24	0.7765000000000001
Masters of Anima	2018-04-10	83	264	52	135	0.7762000000000001
Pushover	2018-04-13	4	33	3	7	0.7762000000000001
Slash or Die 2	2018-07-12	4	27	2	6	0.7762000000000001
pixelBOT EXTREME!	2018-04-20	2	27	2	4	0.7762000000000001
Where Thoughts Go: Prologue	2018-11-08	4	27	2	6	0.7762000000000001
A Story of a Band	2018-06-19	5	27	2	7	0.7762000000000001
Rolling in the Reef	2018-07-13	9	27	2	11	0.7762000000000001
One Hour One Life	2018-11-08	599	2819	697	1296	0.7759
Gulman 5	2018-05-09	6	55	7	13	0.7759
Hop Step Sing! Nozokanaide Naked Heart (HQ Edition)	2018-09-11	7	55	7	14	0.7759
Human Rocket Person	2018-11-14	37	55	7	44	0.7759
Keepsake	2018-04-17	26	237	46	72	0.7758
Fortissimo FA	2018-05-31	366	263	52	418	0.7757
Detective Gallo	2018-05-30	20	119	20	40	0.7757
阿比斯的宝藏 - Treasure of abyss	2018-09-19	348	114	19	367	0.7754000000000001
Joggernauts	2018-10-11	36	90	14	50	0.7754000000000001
Viki Spotter: The Farm	2018-02-01	6	90	14	20	0.7754000000000001
Along Together	2018-05-31	10	44	5	15	0.7754000000000001
BOLSOMITO	2018-10-06	34	205	39	73	0.7752
Fairune Collection	2018-05-16	14	65	9	23	0.7752
Into the Fray	2018-12-05	6	65	9	15	0.7752
Sexy Jigsaw	2018-08-24	49	187	35	84	0.7751000000000001
BAAM SQUAD	2018-04-20	20	80	12	32	0.7751000000000001
Super Destronaut DX	2018-07-13	5	70	10	15	0.7751000000000001
AntVentor	2018-05-17	41	317	65	106	0.7748
USA 2020	2018-06-03	22	155	28	50	0.7748
Conan Exiles	2018-05-08	53402	70784	19538	72940	0.7745000000000001
Guard of Wonderland	2018-11-08	5	49	6	11	0.7745000000000001
Oik 4	2018-06-17	25	208	40	65	0.7744
Inked: A Tale of Love	2018-04-26	28	159	29	57	0.7744
Bad Pad	2018-08-08	12	38	4	16	0.7743000000000001
The Mind's Eclipse	2018-01-25	6	38	4	10	0.7743000000000001
A Case of Distrust	2018-02-08	130	404	86	216	0.7742
Don't Get Hit In The Face	2018-01-01	5	13	0	5	0.7741
NEO Impossible Bosses	2018-02-14	8	13	0	8	0.7741
AstroBlast VR	2018-12-13	4	13	0	4	0.7741
การิน ปริศนาคดีอาถรรพ์ the game : ตอนพิธีเปลี่ยนชีพ	2018-06-13	6	13	0	6	0.7741
CRAZY MAZE	2018-04-06	3	13	0	3	0.7741
Wolf Balls: The Game	2018-05-17	2	13	0	2	0.7741
Yet Another Pushing Puzzler	2018-07-20	4	13	0	4	0.7741
Forward Line	2018-07-09	4	13	0	4	0.7741
BVRGER VAN	2018-07-27	3	13	0	3	0.7741
Memetown USA	2018-08-30	2	13	0	2	0.7741
Verdant Skies	2018-02-12	59	315	65	124	0.774
ADAPTR	2018-10-31	5	20	1	6	0.774
Goaltender VR	2018-02-19	4	20	1	5	0.774
My RC Buggy! VR	2018-06-15	2	20	1	3	0.774
Jack B. Nimble	2018-07-24	5	20	1	6	0.774
Spreadstorm	2018-06-13	4	20	1	5	0.774
Balloonatics	2018-02-13	8	20	1	9	0.774
Maze Of Adventures	2018-01-17	2	20	1	3	0.774
Beach Rules	2018-01-04	3	20	1	4	0.774
The Revenge of Johnny Bonasera: Episode 2	2018-02-05	4	20	1	5	0.774
The Unlikely Legend of Rusty Pup	2018-10-19	8	20	1	9	0.774
The Pizza Delivery Boy Who Saved the World	2018-09-06	5	20	1	6	0.774
One person story	2018-08-23	3	20	1	4	0.774
Gauge Of Rage	2018-09-05	3	20	1	4	0.774
Puppet Blaster	2018-10-16	6	20	1	7	0.774
Doors Quest Demo	2018-04-20	8	84	13	21	0.7739
Hentai Strip Shot	2018-09-22	33	84	13	46	0.7739
NEKOKORO	2018-08-16	5	79	12	17	0.7737999999999999
Rogue Agent	2018-04-30	2191	233	46	2237	0.7737
HELLFRONT: HONEYMOON	2018-12-19	8	64	9	17	0.7736000000000001
Trailer Park Boys: Greasy Money	2018-04-18	1113	1008	237	1350	0.7734000000000001
Geometry Rush	2018-07-13	4	98	16	20	0.7734000000000001
Epic Loon	2018-07-13	6	32	3	9	0.7734000000000001
A Show of Kindness	2018-11-15	4	32	3	7	0.7734000000000001
BOX align	2018-03-01	6	26	2	8	0.773
Ukhar	2018-03-14	7	26	2	9	0.773
One Bit Arena	2018-03-16	9	26	2	11	0.773
One More Roll	2018-11-02	13	26	2	15	0.773
Experience: Colorblindness	2018-11-27	7	26	2	9	0.773
Discovery Tour by Assassin’s Creed: Ancient Egypt	2018-02-20	31	116	20	51	0.7726999999999999
BlazBlue Cross Tag Battle	2018-06-05	2990	3197	814	3804	0.7726000000000001
Jolly Battle	2018-07-27	12	83	13	25	0.7726000000000001
Haimrik	2018-06-19	27	205	40	67	0.7725
Ancestors Legacy	2018-05-22	4940	5703	1492	6432	0.7724
Her Lie I Tried To Believe	2018-04-02	133	781	181	314	0.7724
Achievement printer	2018-03-02	2653	867	203	2856	0.7723000000000001
Animal Super Squad	2018-05-15	90	435	95	185	0.7722
Puzzle Plunder	2018-10-09	19	120	21	40	0.7721
Venture Kid	2018-05-03	363	147	27	390	0.772
Mercury Blue: Mini Episode	2018-06-29	31	92	15	46	0.7719
EPHEMERAL -FANTASY ON DARK-	2018-09-12	10	63	9	19	0.7719
NBA 2K Playgrounds 2	2018-10-16	322	1467	359	681	0.7718
Omni Link	2018-09-04	12	37	4	16	0.7718
Judgment: Apocalypse Survival Simulation	2018-05-03	1277	1611	397	1674	0.7717
Aircraft Evolution	2018-04-03	43	195	38	81	0.7717
Budget Cuts	2018-06-14	421	1361	332	753	0.7715000000000001
AIRHEART	2018-07-24	40	142	26	66	0.7715000000000001
Mouse (Sneaking)	2018-01-16	2122	865	204	2326	0.7713
Dodge Show	2018-04-20	443	292	61	504	0.7713
Mojo	2018-08-03	48	82	13	61	0.7712000000000001
Sword Art Online: Lost Song	2018-11-12	474	1407	345	819	0.7711
The Snowboard Game	2018-04-24	32	258	53	85	0.7711
Ambition of the SLIMES	2018-02-15	7	42	5	12	0.7709
Unworthy	2018-05-29	111	551	125	236	0.7708
Pathfinder: Kingmaker	2018-09-25	22643	23242	6422	29065	0.7706999999999999
Dimetrosaur	2018-09-08	3	31	3	6	0.7706000000000001
Thunder Kid	2018-10-22	2	31	3	5	0.7706000000000001
Cultist Simulator	2018-05-31	3143	7442	1992	5135	0.7705
Chronicles of Magic: Divided Kingdoms	2018-03-22	36	154	29	65	0.7705
Real Pool 3D - Poolians	2018-01-04	2772	6816	1819	4591	0.7704000000000001
Rogues Like Us	2018-05-11	19	47	6	25	0.7704000000000001
Hyper Sentinel	2018-05-11	9	47	6	15	0.7704000000000001
My 1/6 Lover	2018-12-13	271	437	97	368	0.7703
The Fall Part 2: Unbound	2018-02-13	103	481	108	211	0.7702
PIXELMAN	2018-02-28	1773	158	30	1803	0.7702
Behind The Truth	2018-02-14	10	52	7	17	0.7702
Football Manager 2019: The Hashtag United Challenge	2018-12-21	210	52	7	217	0.7702
Mushroom Heroes	2018-05-02	49	127	23	72	0.7701000000000001
Nice Shot! The Gun Golfing Game	2018-11-09	24	57	8	32	0.7701000000000001
Guts and Glory	2018-07-19	257	1868	470	727	0.77
OK/NORMAL	2018-06-18	17	444	99	116	0.77
Spectrum Break	2018-03-29	5	19	1	6	0.77
The Cat and the Coup (4K Remaster)	2018-09-25	3	19	1	4	0.77
Santa's Story of Christmas	2018-11-30	5	19	1	6	0.77
Caveman Chuck	2018-09-20	2	19	1	3	0.77
Achievement Idler Black	2018-04-13	34	268	56	90	0.7698
Endhall	2018-12-04	7	104	18	25	0.7697
Lizard	2018-03-05	7	25	2	9	0.7697
Kite	2018-03-07	4	25	2	6	0.7697
Star Drift	2018-02-22	12	25	2	14	0.7697
The Great Tournament	2018-02-09	15	25	2	17	0.7697
TETRA's Escape	2018-08-10	2	25	2	4	0.7697
Avernum 3: Ruined World	2018-01-31	379	230	47	426	0.7696
Call of Cthulhu	2018-10-29	3449	7782	2100	5549	0.7695000000000001
Muffled Warfare	2018-04-27	23	90	15	38	0.7694
NeverBound	2018-03-27	4	36	4	8	0.7692
ZIQ	2018-08-01	23	12	0	23	0.7690000000000001
Neon the Ninja	2018-03-01	5	12	0	5	0.7690000000000001
Fruit Attacks VR	2018-03-15	5	12	0	5	0.7690000000000001
Lonely Trip	2018-02-05	3	12	0	3	0.7690000000000001
Deadfall Tropics	2018-05-10	2	12	0	2	0.7690000000000001
Gravity Well	2018-06-21	3	12	0	3	0.7690000000000001
Tales From Windy Meadow - Legacy Edition	2018-12-20	3	12	0	3	0.7690000000000001
Oh Boy Cheese	2018-08-03	2	12	0	2	0.7690000000000001
Cat Inside	2018-08-17	3	12	0	3	0.7690000000000001
Super Shopper	2018-09-01	2	12	0	2	0.7690000000000001
Legacy of Lina	2018-11-02	2	12	0	2	0.7690000000000001
Blindia	2018-10-31	2	12	0	2	0.7690000000000001
Blueprint Word: Classroom	2018-12-05	3	12	0	3	0.7690000000000001
Slavistan 2	2018-10-30	3	12	0	3	0.7690000000000001
Alice - Behind the Mirror	2018-04-06	10	112	20	30	0.7685
The Adventure of Magical Girl	2018-06-21	8	103	18	26	0.7685
The Cabinets of Doctor Arcana	2018-10-06	17	41	5	22	0.7685
Chess Sphere	2018-12-07	81	41	5	86	0.7685
Halfquake Trilogy	2018-10-05	38	298	64	102	0.7684000000000001
Dreams of Dali	2018-02-19	12	116	21	33	0.768
President Trump The Way In Uganda	2018-02-06	3	116	21	24	0.768
Laser League: World Arena	2018-05-10	699	1311	328	1027	0.7676000000000001
Escape Game	2018-11-06	10	120	22	32	0.7676000000000001
NYAN DESTROYER	2018-03-30	4	30	3	7	0.7676000000000001
Let's Go Nuts!	2018-06-01	6	30	3	9	0.7676000000000001
Football Manager 2019 Touch	2018-11-02	1792	324	71	1863	0.7673000000000001
CreativeDestruction	2018-08-03	6330	14773	4125	10455	0.7672
The Spiral Scouts	2018-07-12	186	451	103	289	0.7672
Shrouded in Sanity: Freebirth	2018-03-23	43	137	26	69	0.7671
Treasure Adventure World	2018-02-07	65	217	45	110	0.7669
Algo Bot	2018-02-14	1143	106	19	1162	0.7668
Black Moon 黑月	2018-08-01	5	60	9	14	0.7667
Aggressors: Ancient Rome	2018-08-30	139	204	42	181	0.7666
Daemon 9	2018-10-31	14	74	12	26	0.7665000000000001
M.I.A.	2018-04-23	36	35	4	40	0.7665000000000001
Anchorhead	2018-01-31	9	35	4	13	0.7665000000000001
Once upon a Dungeon	2018-01-19	8	35	4	12	0.7665000000000001
Waterside Chirping 水畔空蝉	2018-08-02	7	35	4	11	0.7665000000000001
Aesthetic World	2018-09-19	3	35	4	7	0.7665000000000001
HOST	2018-07-01	3	24	2	5	0.7662000000000001
Mr. Sweet	2018-08-15	3	24	2	5	0.7662000000000001
Midnight Quest	2018-05-18	11	40	5	16	0.7661
Hypergate	2018-12-21	5	40	5	10	0.7661
Eggs 1942	2018-05-31	5	40	5	10	0.7661
Pan Panda	2018-10-11	24	161	32	56	0.7658
The Captives: Plot of the Demiurge	2018-10-11	7	18	1	8	0.7658
Chromasia	2018-07-11	4	18	1	5	0.7658
Posable Heroes	2018-10-25	5	18	1	6	0.7658
Open The Door	2018-11-30	5	18	1	6	0.7658
Finding Light	2018-10-15	3	18	1	4	0.7658
Super BOO Quest	2018-10-21	3	18	1	4	0.7658
Zwei: The Arges Adventure	2018-01-24	67	288	63	130	0.7656999999999999
Bad Dream: Fever	2018-11-15	81	692	167	248	0.7656000000000001
Solo	2018-04-26	21	78	13	34	0.7656000000000001
The Other Half	2018-11-02	6	78	13	19	0.7656000000000001
NO, THANK YOU!!!	2018-11-15	13	96	17	30	0.7655
Creed: Rise to Glory™	2018-09-25	104	1381	352	456	0.7654000000000001
RUSH	2018-07-13	23	169	34	57	0.7654000000000001
Prime World: Defenders 2	2018-11-29	306	1555	401	707	0.7648999999999999
Key Of Impasse	2018-09-05	7	91	16	23	0.7648999999999999
Bunny Minesweeper	2018-08-10	8	59	9	17	0.7648999999999999
Deep Sixed	2018-02-12	43	82	14	57	0.7648
2048	2018-11-01	10	104	19	29	0.7646
The trial of witch	2018-01-06	14	29	3	17	0.7645000000000001
Evolva	2018-01-14	5	29	3	8	0.7645000000000001
Temple of Rust	2018-09-18	40	68	11	51	0.7643000000000001
Ultimate Select Hero / 究极勇者的选择传说	2018-05-03	15	77	13	28	0.7641
Grottesco Absurdus	2018-10-25	4	49	7	11	0.7640000000000001
Deported: Drain the Swamp	2018-11-05	3	49	7	10	0.7640000000000001
MX vs ATV All Out	2018-03-27	308	1132	288	596	0.7637999999999999
Alice's Adventures	2018-06-09	24	44	6	30	0.7637
Google Spotlight Stories: Piggy	2018-06-06	10	34	4	14	0.7637
Paradise	2018-03-23	4	34	4	8	0.7637
The Neon Boy	2018-07-02	5	34	4	9	0.7637
Azurael's Circle: Chapter 1	2018-09-03	17	90	16	33	0.7636000000000001
Starman	2018-06-28	6	63	10	16	0.7636000000000001
Fantasy Quest Solitaire	2018-01-16	12	81	14	26	0.7634000000000001
The Bounty V2	2018-01-08	2	11	0	2	0.7634000000000001
The Adventures of Clive McMulligan on Planet Zeta Four	2018-04-06	2	11	0	2	0.7634000000000001
Audio Forager	2018-03-02	9	11	0	9	0.7634000000000001
Birdcakes	2018-05-29	2	11	0	2	0.7634000000000001
Realm of the Ghost King	2018-01-16	3	11	0	3	0.7634000000000001
Drifting Cloud	2018-04-27	5	11	0	5	0.7634000000000001
Dive	2018-03-08	2	11	0	2	0.7634000000000001
PHOTON CUBE	2018-06-28	5	11	0	5	0.7634000000000001
Apostasy	2018-06-21	2	11	0	2	0.7634000000000001
ZYX STORY	2018-07-18	2	11	0	2	0.7634000000000001
ESCAPE - Secret of the Hidden Room: the Collaborator	2018-08-13	2	11	0	2	0.7634000000000001
Cartoony Cars 2	2018-11-09	6	11	0	6	0.7634000000000001
Emitters	2018-11-04	3	11	0	3	0.7634000000000001
Fiber Twig 2	2018-09-18	5	11	0	5	0.7634000000000001
LOGistICAL 2: Belgium	2018-09-21	24	11	0	24	0.7634000000000001
[it's possible] Classic	2018-11-19	4	11	0	4	0.7634000000000001
Snares of Ruin Zero	2018-12-06	2	11	0	2	0.7634000000000001
Tropical Liquor	2018-03-09	503	578	140	643	0.7629000000000001
Mojo 2: Mia	2018-10-26	289	667	164	453	0.7626999999999999
Loria	2018-11-27	137	190	40	177	0.7626999999999999
Rail Recon	2018-01-23	4	23	2	6	0.7625000000000001
Cosmic Top Secret	2018-11-15	4	23	2	6	0.7625000000000001
7th Deep	2018-03-09	7	23	2	9	0.7625000000000001
Viking Brothers 4	2018-04-30	8	23	2	10	0.7625000000000001
Burden of Proof	2018-07-26	4	23	2	6	0.7625000000000001
Rapid Fire	2018-12-10	8	23	2	10	0.7625000000000001
Angelus Brand VR Experience	2018-11-02	54	23	2	56	0.7625000000000001
Witchkin	2018-01-11	7	53	8	15	0.7624
RESONANCE OF FATE™/END OF ETERNITY™ 4K/HD EDITION	2018-10-17	826	598	146	972	0.7623000000000001
State of Mind	2018-08-15	198	1559	410	608	0.762
Vigilantes	2018-10-03	132	229	50	182	0.762
Pixel Ripped 1989	2018-07-31	20	144	29	49	0.762
Final Theory	2018-09-21	104	276	62	166	0.7618
The Pillage	2018-06-01	602	48	7	609	0.7618
The Inner Friend	2018-09-06	13	48	7	20	0.7618
Terra Feminarum	2018-02-28	13	48	7	20	0.7618
Crossing Souls	2018-02-13	196	1095	282	478	0.7617
Shape of the World	2018-06-05	15	268	60	75	0.7617
Lucid Dream	2018-10-09	15	168	35	50	0.7615000000000001
Time Drifter	2018-07-30	29	84	15	44	0.7614000000000001
ERROR: Human Not Found	2018-01-12	17	43	6	23	0.7613
Amulet Zero 零物语 - Optimize	2018-08-14	6	43	6	12	0.7613
MODSORK	2018-08-16	6	17	1	7	0.7613
Pogo	2018-12-21	10	17	1	11	0.7613
Gambol	2018-03-27	4	17	1	5	0.7613
Chinese Ink Painting Puzzle & Creator	2018-02-15	6	17	1	7	0.7613
Subsideria	2018-08-24	5	17	1	6	0.7613
Oneness	2018-03-29	4	17	1	5	0.7613
SwordBounce	2018-05-19	5	17	1	6	0.7613
Star'Shoot	2018-09-27	6	17	1	7	0.7613
Alien Attack: Pocket Edition	2018-08-01	2	17	1	3	0.7613
Banzo - Marks of Slavery	2018-08-06	4	28	3	7	0.7612000000000001
Core Awaken ~The Yuka~	2018-07-10	5	28	3	8	0.7612000000000001
Zombie Builder Defense	2018-11-02	53	263	59	112	0.7611
Regular Human Basketball	2018-08-01	94	290	66	160	0.761
Scorch	2018-08-15	43	251	56	99	0.761
HENTAI PUZZLE	2018-12-19	7	147	30	37	0.761
Demon's Rise - War for the Deep	2018-04-30	42	88	16	58	0.7609
Last Berserker™ : Endless War	2018-01-11	4	38	5	9	0.7609
PolyCube	2018-11-20	136	38	5	141	0.7609
Watch Me Jump	2018-04-19	4	33	4	8	0.7608
Demon's Rise - Lords of Chaos	2018-04-24	93	126	25	118	0.7606999999999999
mr.Vegan	2018-06-20	6	109	21	27	0.7605
Fishing: Barents Sea	2018-02-07	2075	1811	486	2561	0.7604000000000001
牧剑：化神书(Tale Of Swords: Mystery Scroll)	2018-02-06	69	265	60	129	0.7601000000000001
Next 2	2018-02-01	6	96	18	24	0.7601000000000001
Barro	2018-03-28	2291	3207	888	3179	0.76
CrocoMars	2018-03-05	18	154	32	50	0.76
Speed Brawl	2018-09-18	44	121	24	68	0.7599
Zero Caliber VR	2018-11-09	475	3258	904	1379	0.7598
Dandara: Trials of Fear Edition	2018-02-06	87	764	194	281	0.7598
KOBOLD: Chapter I	2018-11-14	10	217	48	58	0.7595000000000001
Blasted Road Terror	2018-04-19	18	74	13	31	0.7595000000000001
Final Directive	2018-02-01	21	74	13	34	0.7595000000000001
Kenshō	2018-01-31	5	47	7	12	0.7595000000000001
She is Mermaid	2018-09-08	6	47	7	13	0.7595000000000001
Aegis Defenders	2018-02-08	855	1217	321	1176	0.7593000000000001
The Raven Remastered	2018-03-13	40	228	51	91	0.7590000000000001
Artifact Adventure Gaiden	2018-01-09	30	42	6	36	0.7587999999999999
KO Mech	2018-07-19	17	42	6	23	0.7587999999999999
Nantucket	2018-01-18	1261	635	160	1421	0.7587
Wildlife Tycoon: Venture Africa	2018-05-01	6	22	2	8	0.7586
Viking Brothers 3	2018-04-30	8	22	2	10	0.7586
EXAPUNKS: TEC Redshift Player	2018-09-25	5	22	2	7	0.7586
The Operational Art of War IV	2018-10-15	65	215	48	113	0.7582
Math Fun	2018-08-04	9	107	21	30	0.7582
KóterGame	2018-12-11	16	51	8	24	0.7582
Oakwood Academy of Spells and Sorcery	2018-03-27	18	37	5	23	0.7582
Zombie Derby	2018-04-20	8	86	16	24	0.7581
Hero of the Kingdom III	2018-08-30	373	994	261	634	0.7579000000000001
Trash Squad	2018-01-26	10	115	23	33	0.7579000000000001
Twilight Path	2018-10-02	16	119	24	40	0.7578
Lazy Galaxy: Rebel Story	2018-08-22	7	27	3	10	0.7576999999999999
Light Fantastik	2018-03-12	8	27	3	11	0.7576999999999999
Cube Zone	2018-05-15	4	27	3	7	0.7576999999999999
I'm an adventurer	2018-10-23	17	27	3	20	0.7576999999999999
You Have 10 Seconds 3	2018-11-23	5	27	3	8	0.7576999999999999
Despotism 3k	2018-11-08	3341	2370	657	3998	0.7576
Cheap Golf	2018-11-05	1365	127	26	1391	0.7576
Mojo: Hanako	2018-07-28	341	619	157	498	0.7575000000000001
Lucie	2018-03-20	11	77	14	25	0.7574
Eternal Card Game	2018-11-15	2894	5105	1466	4360	0.7573000000000001
Monster League	2018-10-26	12	55	9	21	0.7571
Sphoxie	2018-05-17	785	10	0	785	0.7571
LOGistICAL: Russia	2018-02-09	25	10	0	25	0.7571
Karate Krab	2018-02-16	3	10	0	3	0.7571
Kansei	2018-09-14	2	10	0	2	0.7571
Copierre	2018-01-23	4	10	0	4	0.7571
Aliens Are Rude!	2018-10-10	2	10	0	2	0.7571
Azada: Ancient Magic	2018-04-20	4	10	0	4	0.7571
Quible Sphere	2018-07-13	7	10	0	7	0.7571
Hypersonic Speed Girl / 超速少女	2018-05-08	2	10	0	2	0.7571
HOLONGLIDE	2018-07-19	5	10	0	5	0.7571
Touch Down Football Solitaire	2018-08-28	6	10	0	6	0.7571
Garden Variety Body Horror - Rare Import	2018-11-01	3	10	0	3	0.7571
Witches' Legacy: Lair of the Witch Queen Collector's Edition	2018-10-19	3	10	0	3	0.7571
→SUMETRICK←	2018-01-26	185	323	77	262	0.7569
Sling Ming	2018-04-05	7	16	1	8	0.7564000000000001
Relaxicon	2018-03-20	3	16	1	4	0.7564000000000001
SushiParty	2018-04-25	11	16	1	12	0.7564000000000001
Quaddro 2	2018-03-30	2	16	1	3	0.7564000000000001
Puzzgun	2018-05-09	4	16	1	5	0.7564000000000001
Ink Cipher	2018-07-02	3	16	1	4	0.7564000000000001
AstroViking	2018-08-10	4	16	1	5	0.7564000000000001
Propaganda Llama	2018-11-27	4	16	1	5	0.7564000000000001
Halloween Arkanoid 2	2018-12-07	3	16	1	4	0.7564000000000001
Fossil Hunters	2018-02-13	20	59	10	30	0.7562000000000001
Dreamwalker: Never Fall Asleep	2018-10-18	39	161	35	74	0.7559
The Story Goes On	2018-03-02	43	101	20	63	0.7559
NALOGI	2018-03-17	258	1245	337	595	0.7556999999999999
Anime girl Or Bottle?	2018-02-06	4	109	22	26	0.7556999999999999
Lynne	2018-07-13	86	693	180	266	0.7556
Satellite	2018-02-23	10	113	23	33	0.7556
Heavy Burger	2018-11-02	6	63	11	17	0.7556
RUSSIA BATTLEGROUNDS	2018-07-13	1502	3102	883	2385	0.7555
Mana Spark	2018-09-27	154	463	116	270	0.7555
Labyrinth of Refrain: Coven of Dusk	2018-09-18	495	781	205	700	0.7554000000000001
Achievement Clicker 2019	2018-04-13	25	517	131	156	0.7554000000000001
Windlands 2	2018-11-15	38	301	72	110	0.7554000000000001
Pleasure Puzzle:Sexy Girls	2018-10-01	6	172	38	44	0.7553000000000001
Story of Eve - A Hero's Study	2018-10-16	100	323	78	178	0.7552
Hentai Neighbors	2018-10-18	13	562	144	157	0.755
Awesome Pea	2018-09-19	3	67	12	15	0.755
Ritual on the Eve 前夜祭	2018-08-08	8	54	9	17	0.755
Jalopy	2018-03-28	666	6646	1955	2621	0.7549
Wenjia	2018-10-18	37	300	72	109	0.7549
Golem Gates	2018-03-28	29	92	18	47	0.7549
DERU - The Art of Cooperation	2018-11-07	10	45	7	17	0.7548
Miss Fisher and the Deathly Maze	2018-02-12	10	45	7	17	0.7548
Giraffe Town	2018-10-02	15	236	55	70	0.7547
Super Saurio Fly	2018-04-12	6	31	4	10	0.7545999999999999
VOLTED	2018-07-10	10	120	25	35	0.7545000000000001
Rise of Insanity	2018-03-01	63	818	217	280	0.7544
Gun Club VR	2018-08-28	39	481	122	161	0.7544
Lonely Astronaut	2018-03-16	3	21	2	5	0.7544
Universe Balancing Bureau	2018-02-05	7	21	2	9	0.7544
Rabbit: Jigsaw Puzzles	2018-04-13	4	21	2	6	0.7544
Super Jigsaw Puzzle: Space	2018-10-26	12	21	2	14	0.7544
Wulverblade	2018-01-30	15	163	36	51	0.7543000000000001
Dust and Salt	2018-01-25	17	58	10	27	0.7543000000000001
Physical Exorcism: Case 01	2018-10-31	4	58	10	14	0.7543000000000001
Detective Case and Clown Bot in: The Express Killer	2018-07-19	7	26	3	10	0.7541
Cubiques	2018-02-08	4	26	3	7	0.7541
Squids Odyssey	2018-09-05	4	26	3	7	0.7541
FALL 坠落之后	2018-08-17	12	26	3	15	0.7541
Grompula	2018-09-06	14	26	3	17	0.7541
Change : A Little Story	2018-12-20	4	26	3	7	0.7541
Visitor 来访者	2018-07-07	307	593	154	461	0.7538
Vampyr	2018-06-04	16120	14199	4298	20418	0.7537
Ganbare! Super Strikers	2018-07-26	21	62	11	32	0.7537
Muddledash	2018-07-10	9	49	8	17	0.7537
Gamer Career Tycoon	2018-03-29	103	223	52	155	0.7536
One Deck Dungeon	2018-05-18	266	535	138	404	0.7534000000000001
Ballz: Farm	2018-01-24	4	66	12	16	0.7533
Nya Nya Nya Girls (ʻʻʻ)_(=^･ω･^=)_(ʻʻʻ)	2018-12-08	12757	274	66	12823	0.753
Titanic VR	2018-08-16	27	188	43	70	0.7529000000000001
Seed of Evil	2018-11-02	166	343	85	251	0.7528
X4: Foundations	2018-11-30	15198	12186	3699	18897	0.7526
Golf Galore	2018-07-13	401	251	60	461	0.7526
Heathen - The sons of the law	2018-12-18	14	74	14	28	0.7526
Asterix & Obelix XXL 2	2018-11-29	150	560	146	296	0.7525000000000001
JQ: dogs & cats	2018-03-20	4	78	15	19	0.7524
Go Away My Fat	2018-03-30	4	35	5	9	0.7524
Tales of Nebezem: Elemental Link	2018-02-22	16	35	5	21	0.7524
I’m not a Monster	2018-09-27	1551	924	251	1802	0.7523000000000001
Whack the Serial Killer	2018-04-07	12	44	7	19	0.7523000000000001
AtmaSphere	2018-02-02	6	145	32	38	0.7521
Where the Water Tastes Like Wine	2018-02-28	162	995	273	435	0.7515999999999999
Dead In Vinland	2018-04-12	1353	1171	325	1678	0.7515000000000001
The Great Gaias	2018-06-22	14	65	12	26	0.7514000000000001
On The Western Front	2018-10-05	9	48	8	17	0.7514000000000001
Katy & Bob: Cake Café	2018-12-07	10	48	8	18	0.7514000000000001
Atelier Totori ~The Adventurer of Arland~ DX	2018-12-04	56	208	49	105	0.7512000000000001
Barbearian	2018-08-15	23	69	13	36	0.7512000000000001
Lost in Harmony	2018-06-21	5	30	4	9	0.7512000000000001
Viking Brothers 2	2018-04-30	11	30	4	15	0.7512000000000001
Star Sky 3	2018-09-25	20	30	4	24	0.7512000000000001
Cute Puzzle MAX	2018-11-04	8	73	14	22	0.751
Tribloos 3	2018-07-16	6	15	1	7	0.751
Aliens&Asteroids	2018-03-08	3	15	1	4	0.751
Taco Tom 2	2018-12-14	4	15	1	5	0.751
Heckpoint	2018-04-10	3	15	1	4	0.751
The Singularity Wish	2018-05-29	2	15	1	3	0.751
Skyscrapers Puzzle: Airi's tale	2018-06-28	27	15	1	28	0.751
Drugs to Bee	2018-06-21	3	15	1	4	0.751
The Harbinger's Head	2018-07-19	7	15	1	8	0.751
Thanksgiving Day Mosaic	2018-10-25	5	15	1	6	0.751
The Sea Between	2018-11-13	5	15	1	6	0.751
Crazy Washing Machine	2018-10-10	3	15	1	4	0.751
Grim Tales: Bloody Mary Collector's Edition	2018-11-16	8	15	1	9	0.751
Wanted Killer	2018-05-23	12	105	22	34	0.7509
MOMO.EXE 2	2018-10-05	6	105	22	28	0.7509
Sakura Sakura	2018-11-19	42	39	6	48	0.7509
in My MIND.	2018-09-04	8	39	6	14	0.7509
Viki Spotter: Professions	2018-09-21	3	39	6	9	0.7509
Seed of the Dead	2018-12-15	110	768	208	318	0.7508
巴伦西亚传说：索菲亚的重生 Valencia Saga:Sophia's rebirth	2018-09-30	117	200	47	164	0.7508
MIRAGE	2018-06-21	28	93	19	47	0.7508
Supply Chain Idle	2018-11-09	211	269	66	277	0.7504000000000001
TOMORROW DON'T COME	2018-03-05	4	143	32	36	0.7503000000000001
BattleSky VR	2018-01-19	13	25	3	16	0.7503000000000001
Close Your Eyes -Anniversary Remake-	2018-12-21	11	25	3	14	0.7503000000000001
Beat the Blitz	2018-03-01	7	25	3	10	0.7503000000000001
Cactus Jumper	2018-02-03	4	25	3	7	0.7503000000000001
Merrily Perilly	2018-09-28	3	25	3	6	0.7503000000000001
Camp W	2018-07-25	6	25	3	9	0.7503000000000001
MilMo	2018-08-02	212	457	119	331	0.7501000000000001
LOGistICAL: USA - Wisconsin	2018-03-16	14	9	0	14	0.75
Darkness Restricted	2018-02-27	2	9	0	2	0.75
边境封闭	2018-06-03	3	9	0	3	0.75
Atomic Heist	2018-04-20	3	9	0	3	0.75
NAMELESS	2018-10-25	4	9	0	4	0.75
Cowboy : Attack of Wild Animal	2018-05-17	5	9	0	5	0.75
Cool Headed	2018-09-06	2	9	0	2	0.75
Mirror Angel's Paradise	2018-09-11	4	9	0	4	0.75
覇県を握れ ～47都道府県大戦～	2018-11-23	20	9	0	20	0.75
July the Lost Child	2018-10-01	2	9	0	2	0.75
The Great Voyage	2018-09-16	1	9	0	1	0.75
Voltage Drop	2018-10-18	3	9	0	3	0.75
Distress: A Choice-Driven Sci-Fi Adventure	2018-11-06	3	9	0	3	0.75
GUNS 'n GUTS	2018-11-12	3	9	0	3	0.75
Vampire Bloody Star X	2018-11-08	6	9	0	6	0.75
I'm the Koala	2018-11-06	8	9	0	8	0.75
ECON	2018-12-14	4	9	0	4	0.75
Kukoo Kitchen	2018-11-30	2	9	0	2	0.75
Snow Ash Land	2018-11-27	4	9	0	4	0.75
Super Bit Adventure: Paragons of Life	2018-02-27	6	20	2	8	0.7499
Dark Parables: Return of the Salt Princess Collector's Edition	2018-03-16	9	20	2	11	0.7499
The Technician	2018-12-11	8	20	2	10	0.7499
Candice DeBébé's Scandalous Secrets	2018-11-02	6	20	2	8	0.7499
Cally's Caves 4	2018-01-09	116	108	23	139	0.7498
International Space Station Tour VR	2018-03-23	107	60	11	118	0.7498
ElectricVLab	2018-12-21	12	43	7	19	0.7498
Run Jump Fail	2018-05-02	6	43	7	13	0.7498
It's You: A Breakup Story	2018-08-01	5	43	7	12	0.7498
UnHolY DisAsTeR	2018-07-13	44	253	62	106	0.7495999999999999
The Boogie Man	2018-02-13	9	146	33	42	0.7495
King of the World	2018-10-22	13	96	20	33	0.7495
Dungeons Forever	2018-02-05	64	96	20	84	0.7495
The Free Ones	2018-07-12	82	597	160	242	0.7494
City Of Brass	2018-05-04	136	582	156	292	0.7491
Flash Point: Fire Rescue	2018-03-29	28	119	26	54	0.7491
Escape Doodland	2018-11-30	191	126	28	219	0.7484999999999999
Sounds of Verity	2018-03-27	186	156	36	222	0.7484000000000001
Nephise: Ascension	2018-02-27	7	103	22	29	0.7484000000000001
Realm Royale Reforged	2018-06-05	105440	42007	13420	118860	0.7483
We Happy Few	2018-08-10	3498	9051	2797	6295	0.7483
A Gummy's Life	2018-10-02	26	152	35	61	0.7482
Typical	2018-12-15	22	55	10	32	0.7481
The Darkest Woods	2018-06-28	4	38	6	10	0.748
Tiny Battle Simulator	2018-09-10	12	38	6	18	0.748
Post Scriptum	2018-08-09	7753	14886	4669	12422	0.7479000000000001
COLINA: Legacy	2018-09-13	20	148	34	54	0.7479000000000001
Outside the Lines	2018-07-14	34	133	30	64	0.7479000000000001
The Shapeshifting Detective	2018-11-06	141	1055	298	439	0.7478
Acceleration of SUGURI 2	2018-03-07	374	891	249	623	0.7478
Ancestors Legacy Free Peasant Edition	2018-02-06	1223	662	181	1404	0.7478
Citrouille: Sweet Witches	2018-10-29	83	59	11	94	0.7478
Morning Never Comes	2018-04-06	3	29	4	7	0.7478
Draw It! 2	2018-09-01	6	29	4	10	0.7478
Steel Alcimus	2018-12-28	105	29	4	109	0.7478
Maytroid. I swear it's a nice game too	2018-12-11	101	144	33	134	0.7477
Close Combat: Last Stand Arnhem	2018-11-29	47	83	17	64	0.7477
Kunoichi Tsubaki	2018-10-12	39	67	13	52	0.7476
Elsword Free-to-Play	2018-06-14	294	678	186	480	0.7475
Containment	2018-02-09	12	42	7	19	0.7471
Stonehearth	2018-07-25	1851	8863	2759	4610	0.7469
Little Witch Academia: Chamber of Time	2018-05-15	199	994	282	481	0.7465999999999999
Ria's Hook	2018-04-04	40	367	96	136	0.7465999999999999
BARRAGE	2018-04-18	4	46	8	12	0.7465
Dialing	2018-03-02	3	24	3	6	0.7463
Stickman: Fidget Spinner Rush	2018-04-06	12	24	3	15	0.7463
Don't Play With Dolls	2018-07-21	7	24	3	10	0.7463
Hero Hunters - Jurassic Shooting Sniper	2018-06-13	5	24	3	8	0.7463
Stryker	2018-11-09	12	50	9	21	0.7462000000000001
Vandals	2018-04-12	11	50	9	20	0.7462000000000001
Heroes of Umbra	2018-06-01	23	33	5	28	0.7461
Empire	2018-07-20	11	33	5	16	0.7461
Reigns: Game of Thrones	2018-10-18	515	725	202	717	0.746
Darksiders III	2018-11-27	7730	9959	3129	10859	0.7459
Merchant	2018-10-09	633	393	104	737	0.7459
创史者Hist Maker	2018-06-23	13	54	10	23	0.7459
Tango: The Adventure Game	2018-11-17	6	54	10	16	0.7459
Not Without My Poop	2018-02-02	8	153	36	44	0.7456999999999999
Conflict of Nations: World War 3	2018-03-15	1403	2548	766	2169	0.7454000000000001
SpedV	2018-12-26	588	551	151	739	0.7453000000000001
HATCHICK	2018-04-18	2	14	1	3	0.7453000000000001
Supposedly Wonderful Future	2018-04-18	4	14	1	5	0.7453000000000001
Gem Rush	2018-08-06	6	14	1	7	0.7453000000000001
Splash	2018-05-21	5	14	1	6	0.7453000000000001
Hex Two	2018-06-08	2	14	1	3	0.7453000000000001
Treasure Hunter Man 2	2018-06-16	4	14	1	5	0.7453000000000001
Fallstreak	2018-10-19	18	134	31	49	0.7451000000000001
Spooky Ghosts Dot Com	2018-08-03	4	37	6	10	0.7451000000000001
Puzlogic	2018-11-02	7	37	6	13	0.7451000000000001
qrth-phyl	2018-07-19	8	19	2	10	0.7451000000000001
Varius	2018-06-01	3	19	2	5	0.7451000000000001
Cairo's Tale: The Big Egg	2018-05-30	3	19	2	5	0.7451000000000001
Goinund	2018-07-24	3	19	2	5	0.7451000000000001
Cthulhu Mythos RPG -The Sleeping Girl of the Miasma Sea-	2018-09-27	4	19	2	6	0.7451000000000001
Cat's Puzzle /ᐠ｡ꞈ｡ᐟ\	2018-10-16	4	19	2	6	0.7451000000000001
Override	2018-12-04	159	620	172	331	0.7449
Radical Dungeon Sweeper	2018-02-12	390	152	36	426	0.7448
Magic Scroll Tactics	2018-04-27	92	141	33	125	0.7448
Dot to Dot Puzzles	2018-07-09	74	130	30	104	0.7448
Wrecked	2018-05-21	170	1768	525	695	0.7447
Mahjong Magic Journey	2018-03-09	1289	81	17	1306	0.7447
Way of the Passive Fist	2018-03-06	19	159	38	57	0.7445999999999999
Mega Man X Legacy Collection 2	2018-07-24	364	1150	334	698	0.7444
Eredia: The Diary of Heroes	2018-04-13	11	41	7	18	0.7444
Shape of America: Episode One	2018-02-21	6	41	7	13	0.7444
Voronium - Locust Sols	2018-11-16	7	41	7	14	0.7444
Viki Spotter: Zoo	2018-09-14	3	41	7	10	0.7444
Community College Hero: Knowledge is Power	2018-05-17	63	28	4	67	0.7441
Kilcount	2018-06-15	3	28	4	7	0.7441
Inclement	2018-12-21	6	28	4	10	0.7441
Lovekami -Healing Harem-	2018-11-14	90	151	36	126	0.7439
Loyalty and Blood: Viktor Origins	2018-03-16	23	49	9	32	0.7438
Bombslinger	2018-04-11	38	88	19	57	0.7437
Mega Man X Legacy Collection	2018-07-24	990	2252	681	1671	0.7436
President Yukino	2018-10-12	314	518	143	457	0.7434999999999999
GODS Remastered	2018-12-04	310	125	29	339	0.7434000000000001
Magika Land of Fantasy	2018-04-05	28	84	18	46	0.7434000000000001
Aggelos	2018-06-19	28	311	82	110	0.7431
PROZE: Prologue	2018-08-30	17	80	17	34	0.7431
BQM - BlockQuest Maker	2018-07-27	86	121	28	114	0.743
Fishing Sim World®: Pro Tour	2018-09-18	215	730	208	423	0.7428
Zombie Solitaire 2 Chapter 3	2018-03-06	10	32	5	15	0.7428
Joy Climb	2018-03-02	17	32	5	22	0.7428
The Plant	2018-07-23	4	32	5	9	0.7428
Pato Box	2018-03-16	8	91	20	28	0.7425
Apollo 11 VR HD	2018-11-23	63	192	48	111	0.7424
Earthworms	2018-02-23	9	135	32	41	0.7424
Taekwondo Grand Prix	2018-10-09	23	68	14	37	0.7422
aMAZE Classic	2018-05-10	8	223	57	65	0.7421
Frio2 - Memory of my sister	2018-03-15	12	36	6	18	0.742
Mavi's Journey	2018-02-20	22	36	6	28	0.742
Dodgeball Simulator VR	2018-12-26	8	36	6	14	0.742
Impale	2018-01-25	4	23	3	7	0.742
Speedway Challenge Career	2018-10-05	20	23	3	23	0.742
The Blame	2018-12-21	3	23	3	6	0.742
MoonStrike	2018-08-02	3	8	0	3	0.7419
Chicken Daddy	2018-03-12	2	8	0	2	0.7419
eXplosive Dinosaurs	2018-12-06	4	8	0	4	0.7419
Auto-Staccato	2018-01-01	3	8	0	3	0.7419
Factory Hiro	2018-01-25	2	8	0	2	0.7419
Yousei	2018-09-14	3	8	0	3	0.7419
Silent Footsteps	2018-07-25	3	8	0	3	0.7419
Omnicube	2018-05-31	2	8	0	2	0.7419
Digital Diamond Baseball V7	2018-03-29	8	8	0	8	0.7419
The Great Race	2018-05-17	3	8	0	3	0.7419
Taco Gun	2018-05-17	2	8	0	2	0.7419
Waking Violet	2018-06-29	5	8	0	5	0.7419
Geocells Tricells	2018-08-17	3	8	0	3	0.7419
Danger!Energy	2018-12-20	2	8	0	2	0.7419
AmazeBowl	2018-06-15	2	8	0	2	0.7419
Les 4 Alice: Lorange Journey	2018-08-13	2	8	0	2	0.7419
Mystery of the Ancients: Curse of the Black Water Collector's Edition	2018-09-05	5	8	0	5	0.7419
Space Fox Kimi	2018-09-07	3	8	0	3	0.7419
DoodleVR	2018-10-10	6	8	0	6	0.7419
The Clean Up Clyde Collection	2018-12-20	2	8	0	2	0.7419
Mining Rail	2018-12-25	3	8	0	3	0.7419
Salt	2018-02-06	363	1700	513	876	0.7418000000000001
不落城-Unconquered Castle	2018-10-12	21	109	25	46	0.7418000000000001
MOTHERGUNSHIP	2018-07-17	611	1134	335	946	0.7417
The Wilting Amaranth	2018-06-04	8	60	12	20	0.7417
Road Doom	2018-08-17	7	40	7	14	0.7415999999999999
Immortal Darkness: Curse of The Pale King	2018-10-17	9	40	7	16	0.7415999999999999
A Stickman Reality	2018-10-08	477	40	7	484	0.7415999999999999
Seven days with the Ghost	2018-10-12	9	40	7	16	0.7415999999999999
Platform Builder	2018-08-31	333	56	11	344	0.7415
EW/WE	2018-08-05	3	44	8	11	0.7414000000000001
Zombie Derby 2	2018-01-25	39	90	20	59	0.7411
The Elder Scrolls V: Skyrim VR	2018-04-02	3048	7086	2270	5318	0.741
Orwell: Ignorance is Strength	2018-02-22	375	1155	343	718	0.741
Tee Time Golf	2018-08-31	20	130	31	51	0.741
Star Explorers	2018-05-08	16	126	30	46	0.7404999999999999
Evil Bank Manager	2018-12-08	530	1276	383	913	0.7403000000000001
Rising Dusk	2018-07-26	8	67	14	22	0.7403000000000001
Nova Nukers!	2018-03-15	24	27	4	28	0.7403000000000001
Heads Run	2018-01-12	7	27	4	11	0.7403000000000001
Mahjong Riichi Multiplayer	2018-05-17	13	27	4	17	0.7403000000000001
Event-D	2018-12-17	4	27	4	8	0.7403000000000001
Soul at Stake - 1v4	2018-06-26	2067	6349	2039	4106	0.74
EggTime 2	2018-05-07	2	18	2	4	0.74
Triplicity	2018-03-09	4	18	2	6	0.74
The Bears And The Bees	2018-01-23	7	18	2	9	0.74
Jisei	2018-09-14	2	18	2	4	0.74
Shinobi Bad Buddies	2018-11-28	5	18	2	7	0.74
Uagi-Saba	2018-11-30	7	18	2	9	0.74
Deadly Stigma	2018-08-25	2	18	2	4	0.74
Heartbreak High: A Break-Up Simulator	2018-05-21	4	18	2	6	0.74
oOo: Ascension	2018-09-26	3	18	2	5	0.74
ROGO	2018-12-17	5	18	2	7	0.74
Professional Fishing	2018-11-30	798	2363	733	1531	0.7398
Protonwar	2018-03-15	28	78	17	45	0.7398
kakusankibou / 扩散希望	2018-01-25	16	118	28	44	0.7395999999999999
Silent Tweets	2018-03-05	7	89	20	27	0.7395999999999999
Football Russian 20!8	2018-02-13	5	59	12	17	0.7395999999999999
Warhammer 40,000: Inquisitor - Martyr	2018-06-05	9698	12627	4146	13844	0.7393000000000001
Fighting Fantasy Classics	2018-06-05	49	191	49	98	0.7391
Helium Rain	2018-10-11	97	184	47	144	0.7390000000000001
Fabulous - Angela's Wedding Disaster	2018-04-30	38	51	10	48	0.7390000000000001
aMAZE Valentine	2018-12-28	7	51	10	17	0.7390000000000001
Gnomes Garden: Halloween	2018-10-19	12	35	6	18	0.7389
Rage Quest: The Worst Game	2018-02-01	4	13	1	5	0.7389
Waiting for the Loop	2018-01-11	1	13	1	2	0.7389
They have HORNS	2018-02-14	3	13	1	4	0.7389
Foosball VR	2018-11-09	4	13	1	5	0.7389
BoxCat	2018-03-02	5	13	1	6	0.7389
A Turd's Life	2018-03-14	4	13	1	5	0.7389
Cubiques 2	2018-03-09	2	13	1	3	0.7389
Manaya	2018-05-25	6	13	1	7	0.7389
Fast Food Rampage	2018-04-26	5	13	1	6	0.7389
Novas Las Aventurietas del Robercleiton o Renascimento do TURBO	2018-03-08	7	13	1	8	0.7389
The Four Colour Theorem	2018-03-26	3	13	1	4	0.7389
Hero Go	2018-05-16	4	13	1	5	0.7389
Jack and Sara: Educational game	2018-05-02	5	13	1	6	0.7389
Indentured Servant	2018-06-08	3	13	1	4	0.7389
Washed Up!	2018-10-16	3	13	1	4	0.7389
Secrets of the Past: Dion	2018-11-28	14	13	1	15	0.7389
The Wizards	2018-03-08	56	385	107	163	0.7388
Lazy Galaxy	2018-03-22	78	135	33	111	0.7388
Offendron Warrior	2018-12-28	8	39	7	15	0.7387
Hell Shooter	2018-09-22	7	81	18	25	0.7386
Hentai Shooter 3D	2018-09-01	11995	865	257	12252	0.7382
Hentai 3018	2018-05-31	1494	802	238	1732	0.7377
SCUM	2018-08-29	68322	64275	21929	90251	0.7376
Touhou: Dreaming Butterfly | 东方蝶梦志	2018-10-15	12	58	12	24	0.7375
COSMONAUT	2018-01-12	5	22	3	8	0.7375
Attack of the Gigant Zombie vs Unity chan	2018-07-20	4	22	3	7	0.7375
Alpha & Beta	2018-11-15	2	22	3	5	0.7375
Demolish & Build 2018	2018-03-08	462	1111	337	799	0.7373999999999999
Mandy's Room	2018-09-26	10	87	20	30	0.7366
Making History: The Second World War	2018-04-27	68	191	50	118	0.7365
8-in-1 IQ Scale Bundle	2018-01-05	11	65	14	25	0.7365
Short Circuit VR	2018-11-19	9	94	22	31	0.7363
Knockout League	2018-02-13	33	274	75	108	0.7362000000000001
Cycle 28	2018-03-09	7	42	8	15	0.7359
Expendable	2018-02-27	3	42	8	11	0.7359
Shadowlings	2018-07-17	25	72	16	41	0.7358
Clicker: Glad Valakas	2018-11-26	14	139	35	49	0.7356999999999999
Kebab it Up!	2018-01-04	4	30	5	9	0.7356999999999999
Animals Memory: Dinosaurs	2018-01-05	3	30	5	8	0.7356999999999999
Animals Memory: Birds	2018-01-10	3	30	5	8	0.7356999999999999
Can You find it?	2018-10-06	6	30	5	11	0.7356999999999999
miraclr - Divine Dating Sim	2018-02-14	20	34	6	26	0.7356
GROOD	2018-03-31	4	34	6	10	0.7356
Star Shelter	2018-10-23	22	312	87	109	0.7354999999999999
Hasbro's BATTLESHIP	2018-08-14	72	341	96	168	0.7354
Steel Empire	2018-09-13	15	57	12	27	0.7353000000000001
Clinically Dead	2018-12-06	4	57	12	16	0.7353000000000001
Overchunked	2018-04-12	5	68	15	20	0.7352
Chaos Sector	2018-10-08	11	68	15	26	0.7352
Odysseus Kosmos and his Robot Quest - Episode 1	2018-01-12	1585	308	86	1671	0.7351000000000001
Prosperity	2018-05-28	28	75	17	45	0.7347
Bully Beatdown	2018-11-16	5	53	11	16	0.7347
Dragon Knight	2018-02-09	363	1996	635	998	0.7345
Achievement Lurker: Easiest Cosmetic Numbers	2018-03-21	9	64	14	23	0.7345
Broken Minds	2018-05-28	5	17	2	7	0.7345
Twin Blue Moons	2018-03-07	4	17	2	6	0.7345
The Lone Chameleon	2018-02-27	10	17	2	12	0.7345
Super Weekend Mode 	2018-04-09	3	17	2	5	0.7345
DeathTolls Experience	2018-04-24	3	17	2	5	0.7345
Lucid Path	2018-08-27	3	17	2	5	0.7345
Eternal Space Battles	2018-11-06	3	17	2	5	0.7345
LOST CAVE	2018-11-30	3	17	2	5	0.7345
Money Maker	2018-11-23	136	17	2	138	0.7345
Ctrl CV	2018-05-18	63	205	55	118	0.7343999999999999
Don't Bite Me Bro! +	2018-07-16	45	218	59	104	0.7343000000000001
Good Doggo	2018-05-01	19	89	21	40	0.7342000000000001
PLATI NALOG: Favorite Russian Game	2018-03-01	11	103	25	36	0.7341
Welcome To Bummertown	2018-09-11	7	71	16	23	0.7340000000000001
Shadow of Loot Box	2018-01-30	6	60	13	19	0.7338
aMAZE: Halloween	2018-10-05	4	60	13	17	0.7338
aMAZE Christmas	2018-12-04	5	78	18	23	0.7337
NeonCode	2018-11-22	7	174	46	53	0.7336
MarisaLand Legacy	2018-11-02	29	106	26	55	0.7334999999999999
Apparition	2018-10-31	10	67	15	25	0.7332
Accounting+	2018-10-18	112	668	202	314	0.7329000000000001
HoloLAB Champions	2018-07-10	56	21	3	59	0.7327
Die drei ??? - Rätsel aus der Geisterwelt	2018-03-09	11	21	3	14	0.7327
Unicorn Dungeon	2018-05-24	2	21	3	5	0.7327
Retro Hacker	2018-08-13	5	21	3	8	0.7327
Juliäntli	2018-08-31	3	21	3	6	0.7327
Samozbor: Rebellion	2018-12-08	2	21	3	5	0.7327
Volatile Triangle	2018-03-02	3	7	0	3	0.7326
Wizard Hunter 2348	2018-07-16	2	7	0	2	0.7326
Star Swapper	2018-04-17	3	7	0	3	0.7326
One Watcher	2018-04-26	2	7	0	2	0.7326
ARK -the lost fairytale-	2018-04-14	3	7	0	3	0.7326
While I Sleep I am Debug	2018-02-27	2	7	0	2	0.7326
Fat Foods	2018-01-22	3	7	0	3	0.7326
Recreational Dreaming	2018-01-31	2	7	0	2	0.7326
Survivors of Borridor	2018-12-03	5	7	0	5	0.7326
Scutter	2018-06-06	2	7	0	2	0.7326
Rysen	2018-02-08	4	7	0	4	0.7326
The Idiot's Tale	2018-03-10	3	7	0	3	0.7326
The Plus Point	2018-03-15	2	7	0	2	0.7326
Fleet Star V	2018-10-23	2	7	0	2	0.7326
BoxEngine	2018-03-18	3	7	0	3	0.7326
VR TOON Help Me	2018-08-27	3	7	0	3	0.7326
Cubesc	2018-04-24	2	7	0	2	0.7326
Cranes	2018-05-04	8	7	0	8	0.7326
Color by Numbers - Dinosaurs	2018-05-15	3	7	0	3	0.7326
Vegetaball	2018-08-31	7	7	0	7	0.7326
Alice in Wonderland - 3D Game	2018-06-06	2	7	0	2	0.7326
The Book of Regrets	2018-07-05	2	7	0	2	0.7326
Hell Knights	2018-07-25	4	7	0	4	0.7326
Mercenary Leto	2018-08-28	3	7	0	3	0.7326
Numberline 3	2018-08-03	2	7	0	2	0.7326
Dunderheads	2018-09-03	6	7	0	6	0.7326
Suprapong	2018-11-19	5	7	0	5	0.7326
People Cu3ed	2018-11-02	2	7	0	2	0.7326
MysteryHouse-fivestones-	2018-09-03	1	7	0	1	0.7326
Death and Betrayal in Romania: A Dana Knightstone Novel Collector's Edition	2018-09-10	3	7	0	3	0.7326
ALIEN FIELD	2018-12-22	11	7	0	11	0.7326
Rebound VR	2018-09-13	2	7	0	2	0.7326
Colourless	2018-10-03	3	7	0	3	0.7326
VR CINEMATIC TRAILER: Runes	2018-11-08	4	7	0	4	0.7326
Pool Panic	2018-07-19	173	248	69	242	0.7325
Cute Puzzle	2018-11-01	12	146	38	50	0.7325
Ship Ahoy Open BETA	2018-01-16	11	37	7	18	0.7325
This Is the Police 2	2018-07-31	3451	3969	1313	4764	0.7323999999999999
Achievement Clicker 2018	2018-01-26	17	492	146	163	0.7323999999999999
Hotel Remorse	2018-07-27	8	199	54	62	0.7323999999999999
Tiny Rails	2018-05-28	153	407	119	272	0.7323000000000001
Howard Phillips Lovecar	2018-10-01	3	33	6	9	0.7321
Spire of Sorcery – Character Generator	2018-10-04	35	33	6	41	0.7321
Ripped Pants at Work	2018-01-22	4	25	4	8	0.7320000000000001
FORWARD	2018-05-01	35	25	4	39	0.7320000000000001
MazeBot	2018-05-03	4	25	4	8	0.7320000000000001
My Cabin And I	2018-12-19	4	25	4	8	0.7320000000000001
Coldfall	2018-12-13	7	25	4	11	0.7320000000000001
7	2018-01-26	93	142	37	130	0.7319
初颜 - The Prototype	2018-02-07	7	29	5	12	0.7319
Nicky - The Home Alone Golf Ball	2018-04-13	5	29	5	10	0.7319
The Maestros	2018-10-03	20	12	1	21	0.7319
Ye Fenny - Revenge of the Evil Good Shepherd	2018-01-06	2	12	1	3	0.7319
Burak Bahar's Unseen Anchor	2018-04-02	3	12	1	4	0.7319
Xploquest 2	2018-02-20	2	12	1	3	0.7319
The Rainsdowne Players	2018-09-18	2	12	1	3	0.7319
Little Gold Miner	2018-03-12	3	12	1	4	0.7319
MagicCat	2018-03-11	3	12	1	4	0.7319
Urban	2018-06-28	2	12	1	3	0.7319
Amora	2018-06-08	2	12	1	3	0.7319
Dust and Salt: The Battle for Murk	2018-07-11	3	12	1	4	0.7319
Space Orb	2018-09-06	3	12	1	4	0.7319
Trap Defense	2018-07-02	2	12	1	3	0.7319
Dungeon Rankers	2018-07-24	7	12	1	8	0.7319
Anceder	2018-07-26	3	12	1	4	0.7319
Hotel Transylvania Popstic	2018-09-25	16	12	1	17	0.7319
Lovefield General: Back to Work	2018-11-30	4	12	1	5	0.7319
Jellyfish the Ghost	2018-09-05	2	12	1	3	0.7319
Blade of Acrimony	2018-12-31	2	12	1	3	0.7319
Azurael's Circle: Chapter 3	2018-11-30	3	12	1	4	0.7319
Twinfold	2018-12-05	5	12	1	6	0.7319
Cortex	2018-12-28	6	12	1	7	0.7319
I Hate Running Backwards	2018-05-22	38	165	44	82	0.7316
Hoyeonjigi	2018-11-09	4	48	10	14	0.7316
MY HERO ONE'S JUSTICE	2018-10-25	1243	1541	494	1737	0.7313
RAIN Project	2018-06-04	17	94	23	40	0.7313
GACHIMUCHI M♂NLY PUZZLE	2018-12-13	5	66	15	20	0.7313
Qvabllock	2018-04-30	14	80	19	33	0.7311
Drizzlepath: Deja Vu	2018-05-25	39	131	34	73	0.7309
Crossroad	2018-02-14	23	104	26	49	0.7309
THE KING OF FIGHTERS '97 GLOBAL MATCH	2018-04-03	151	801	249	400	0.7305
BLACK CLOVER: QUARTET KNIGHTS	2018-09-13	84	603	184	268	0.7305
Gunheart	2018-06-04	43	248	70	113	0.7305
The Golf Club™ 2019 Featuring PGA TOUR	2018-08-28	1131	1781	578	1709	0.7304
МЫЛО УРОНИЛ	2018-09-19	6	180	49	55	0.7304
RealFlight 8	2018-03-21	35	62	14	49	0.7304
Shadows: Awakening	2018-08-31	902	1683	545	1447	0.7303000000000001
Achievement Machine	2018-05-25	26	157	42	68	0.7303000000000001
Poker Legends: Tournaments	2018-04-05	134	460	138	272	0.73
Pilam Sky	2018-02-22	2386	40	8	2394	0.73
Bacterium	2018-12-12	14	40	8	22	0.73
Shadow Uprising	2018-12-14	7	40	8	15	0.73
Heavy Metal Machines	2018-09-19	442	2965	985	1427	0.7299
Welcome to Princeland	2018-11-09	48	282	81	129	0.7299
The Frosty Leaves 寒叶下的薄冰	2018-03-10	7	51	11	18	0.7299
THE GREAT GEOMETRIC MULTIVERSE TOUR	2018-08-27	269	269	77	346	0.7298
Soccer Manager 2019	2018-12-19	687	551	168	855	0.7295999999999999
CuberPunk 2089	2018-09-28	11	156	42	53	0.7293999999999999
Calvin Tucker's Farm Animal Racing	2018-03-09	4	58	13	17	0.7293999999999999
Draw It!	2018-04-28	7	58	13	20	0.7293999999999999
North Stars	2018-06-28	16	58	13	29	0.7293999999999999
War Tech Fighters	2018-07-25	82	246	70	152	0.7293000000000001
J-Girl	2018-10-04	32	36	7	39	0.7293000000000001
EMERGENCY 2	2018-11-28	11	36	7	18	0.7293000000000001
Keep in Mind: Remastered	2018-03-08	88	312	91	179	0.7292000000000001
Forest Fortress	2018-04-04	22	116	30	52	0.7290000000000001
Dark Grim Mariupolis	2018-03-20	228	47	10	238	0.7290000000000001
ECHOPLEX	2018-03-15	6	47	10	16	0.7290000000000001
Drunkn Bar Fight on Halloween	2018-10-01	10	47	10	20	0.7290000000000001
Deep Sky Derelicts	2018-09-26	664	1783	584	1248	0.7289
Rigid Force Alpha	2018-08-31	9	89	22	31	0.7289
best game eu	2018-05-14	6	89	22	28	0.7289
Fantasy Versus	2018-05-16	338	395	118	456	0.7287
Super Inefficient Golf	2018-03-15	22	165	45	67	0.7287
Sky Clash: Lords of Clans 3D	2018-09-05	103	152	41	144	0.7287
270 | Two Seventy US Election	2018-05-31	203	581	179	382	0.7286
Fort Zombie	2018-10-29	27	82	20	47	0.7286
Paradox Wrench	2018-01-16	3	32	6	9	0.7286
Subject 264	2018-12-12	272	16	2	274	0.7286
Courtyard Broomball	2018-06-01	15	16	2	17	0.7286
Space God	2018-04-19	6	16	2	8	0.7286
Party Crashers	2018-10-04	6	16	2	8	0.7286
The Path of Motus	2018-07-17	3	16	2	5	0.7286
Dizzy Dungeon	2018-05-07	4	16	2	6	0.7286
Resynth	2018-09-27	4	16	2	6	0.7286
Dark Romance: Heart of the Beast Collector's Edition	2018-04-06	6	16	2	8	0.7286
Save her, from dreams	2018-05-10	3	16	2	5	0.7286
Meteor Shower	2018-06-13	3	16	2	5	0.7286
Mushroom Quest	2018-06-18	4	54	12	16	0.7284
Phantom Doctrine	2018-08-14	2658	3048	1024	3682	0.7282
Milky Way Map	2018-03-09	5	43	9	14	0.728
Sacred Stones	2018-07-23	6	43	9	15	0.728
Co-op SNEK Online	2018-04-13	6	28	5	11	0.7279000000000001
Space Captain McCallery - Episode 1: Crash Landing	2018-07-20	3	28	5	8	0.7279000000000001
Wizard Prison	2018-10-31	12	28	5	17	0.7279000000000001
VR Kanojo	2018-04-09	66	1395	455	521	0.7277
Species: Artificial Life, Real Evolution	2018-09-28	257	653	204	461	0.7277
Afterlife	2018-11-16	7	20	3	10	0.7276
Galactic Shipwright	2018-10-05	9	20	3	12	0.7276
Strategic Command Classic: WWII	2018-04-17	15	20	3	18	0.7276
InfiniPicross 2.0	2018-07-10	9	20	3	12	0.7276
Throw Anything	2018-07-26	9	24	4	13	0.7275
Kill the Dictator	2018-11-07	17	24	4	21	0.7275
Age of Solitaire	2018-12-29	5	24	4	9	0.7275
Mad Crown	2018-09-28	254	118	31	285	0.7273000000000001
Animyst	2018-07-02	14	118	31	45	0.7273000000000001
Umiro	2018-03-29	18	108	28	46	0.7272
Owl Watch	2018-11-12	4	98	25	29	0.7272
Tube Tycoon	2018-03-28	138	415	126	264	0.7270000000000001
Gone Fireflies	2018-02-20	3	39	8	11	0.7270000000000001
DayZ	2018-12-13	63046	249709	91689	154735	0.7264
All Our Asias	2018-02-07	14	120	32	46	0.7258
Dead Maze	2018-02-13	3967	3286	1123	5090	0.7256999999999999
Event Horizon	2018-12-20	18	110	29	47	0.7255
Runes: The Forgotten Path	2018-11-14	138	70	17	155	0.7255
WIN THE GAME: WTF!	2018-06-06	13	155	43	56	0.7254
WARPZONE DRIFTER	2018-11-19	9	80	20	29	0.7252
ReHack	2018-03-23	7	42	9	16	0.7251000000000001
Ashley Clark: Secret of the Ruby	2018-07-06	15	42	9	24	0.7251000000000001
Wartile	2018-02-08	332	503	157	489	0.725
ANYKEY	2018-03-14	23	56	13	36	0.7249
The Scent of Summer	2018-01-23	9	31	6	15	0.7248
Kitten Love Emulator	2018-11-22	4	31	6	10	0.7248
Steampunk Tower 2	2018-04-19	378	245	72	450	0.7247
Smoke and Sacrifice	2018-05-31	97	297	89	186	0.7245999999999999
Eight-Minute Empire	2018-10-13	13	83	21	34	0.7245999999999999
Wish Giver 偿愿人	2018-11-09	41	173	49	90	0.7244
IN-VERT: Definitive Edition	2018-03-02	1092	66	16	1108	0.7243
心之檻	2018-11-10	55	66	16	71	0.7243
Asher	2018-03-12	5	11	1	6	0.7242000000000001
His Chuunibyou Cannot Be Cured!	2018-03-23	5	11	1	6	0.7242000000000001
Flat Worlds	2018-07-20	3	11	1	4	0.7242000000000001
Dungeon Rustlers	2018-03-22	4	11	1	5	0.7242000000000001
LOGistICAL: Brazil	2018-06-15	18	11	1	19	0.7242000000000001
Harambe Kong	2018-02-14	2	11	1	3	0.7242000000000001
TinyWar high-speed	2018-02-22	4	11	1	5	0.7242000000000001
RoboWorlD tactics	2018-05-24	3	11	1	4	0.7242000000000001
Earth Muncher	2018-04-20	2	11	1	3	0.7242000000000001
Packed Train	2018-07-26	4	11	1	5	0.7242000000000001
Joyo Kanji Quiz - 常用漢字	2018-04-25	3	11	1	4	0.7242000000000001
TripTrip	2018-08-17	2	11	1	3	0.7242000000000001
Candy Raid: The Factory	2018-10-01	2	11	1	3	0.7242000000000001
Jetpack Dog	2018-06-21	3	11	1	4	0.7242000000000001
Puzzles By Axis Hyper	2018-09-16	4	11	1	5	0.7242000000000001
Supaplex HARD	2018-08-27	9	11	1	10	0.7242000000000001
Indian Summer	2018-11-20	8	11	1	9	0.7242000000000001
BingoBango	2018-09-10	3	11	1	4	0.7242000000000001
the earth is a better person than me	2018-11-07	2	11	1	3	0.7242000000000001
Ash of Gods: Redemption	2018-03-23	1002	2301	784	1786	0.7240000000000001
Another Sight	2018-09-06	19	128	35	54	0.7238
Internal Light VR	2018-01-18	3	27	5	8	0.7238
My Maid Girlfriend	2018-09-04	6	27	5	11	0.7238
PUZZLE: CATS & DOGS	2018-07-21	7	27	5	12	0.7238
MY 1980's DASHBOARD	2018-02-12	6	52	12	18	0.7236
Reformers Intl Ver	2018-06-06	111	52	12	123	0.7236
Gunsmith	2018-05-25	513	713	230	743	0.7234999999999999
Ink Plane	2018-09-17	5	45	10	15	0.7234999999999999
Remothered: Tormented Fathers	2018-01-30	193	1420	476	669	0.7232999999999999
The Miskatonic	2018-07-20	117	285	86	203	0.723
三国游侠志	2018-02-02	52	62	15	67	0.723
Slab	2018-05-07	10	62	15	25	0.723
The Wastes	2018-04-12	11	23	4	15	0.7228
Forever Space	2018-03-07	4	23	4	8	0.7228
Strangers of the Power 2	2018-05-21	3	23	4	7	0.7228
Fallen Bird	2018-05-25	23	23	4	27	0.7228
Scud Frenzy	2018-06-08	5	23	4	9	0.7228
Quiet as a Stone	2018-11-20	6	23	4	10	0.7228
Closers	2018-02-06	2091	3324	1157	3248	0.7226
OF MICE AND SAND -REVISED-	2018-03-28	201	205	60	261	0.7226
Death Fungeon	2018-08-17	7	85	22	29	0.7225
Pirate Code	2018-04-24	23	15	2	25	0.7222
In Dungeon	2018-05-21	3	15	2	5	0.7222
午餐13	2018-06-13	2	15	2	4	0.7222
Icarus Six Sixty Six	2018-01-04	4	15	2	6	0.7222
Bleeding Knife	2018-03-07	2	15	2	4	0.7222
CyberRebeat -The Fifth Domain of Warfare-	2018-08-24	6	15	2	8	0.7222
KeyBoard Guitar Master	2018-04-11	3	15	2	5	0.7222
Nobunaga's Shadow	2018-06-11	3	15	2	5	0.7222
Second Hazardous Course	2018-07-26	4	15	2	6	0.7222
Space Maze	2018-08-19	3	15	2	5	0.7222
Axe Throw VR	2018-09-17	5	15	2	7	0.7222
TapSonic World Champion VR	2018-06-14	8	48	11	19	0.7221
While You Are Downloading	2018-03-02	3	19	3	6	0.7221
Shadowcrawl	2018-08-08	6	19	3	9	0.7221
Up and Down	2018-01-18	2	19	3	5	0.7221
The Directed	2018-03-07	14	19	3	17	0.7221
What Are You Stupid	2018-04-16	10	19	3	13	0.7221
Blood Money	2018-07-12	45	19	3	48	0.7221
Dog Jam	2018-10-12	5	19	3	8	0.7221
Fruit Tower Defense	2018-08-15	4	19	3	7	0.7221
Kitsune Kitchen	2018-06-01	7	41	9	16	0.7220000000000001
Picross Fairytale - nonogram: Red Riding Hood secret	2018-06-19	1128	319	98	1226	0.7219
Still Not Dead	2018-01-24	103	145	41	144	0.7217
DCR: Drive.Crash.Repeat	2018-08-21	13	6	0	13	0.7217
Witchcraft	2018-05-28	118	6	0	118	0.7217
Interstellar Invaders	2018-05-01	2	6	0	2	0.7217
Ionball 3	2018-05-11	2	6	0	2	0.7217
LOGistICAL: South Africa	2018-01-04	8	6	0	8	0.7217
Galactic Orbital Death Sport	2018-04-06	7	6	0	7	0.7217
贤者挽歌之马略卡协奏曲	2018-06-05	3	6	0	3	0.7217
Hexvade	2018-02-21	5	6	0	5	0.7217
Solar Wind	2018-04-17	2	6	0	2	0.7217
Wolf Gang	2018-01-12	2	6	0	2	0.7217
Fantasy Realm: A Land Torn Asunder	2018-03-27	3	6	0	3	0.7217
A Walk Along the Wall	2018-01-16	2	6	0	2	0.7217
SOS Atlas	2018-07-11	2	6	0	2	0.7217
Candy Snake Master	2018-02-01	2	6	0	2	0.7217
Arc Surfer	2018-05-01	6	6	0	6	0.7217
Tank 51	2018-01-25	2	6	0	2	0.7217
Dinoku	2018-02-12	2	6	0	2	0.7217
Fantasy Mosaics 27: Secret Colors	2018-03-19	5	6	0	5	0.7217
PICNIC	2018-03-04	2	6	0	2	0.7217
Memoir	2018-04-27	3	6	0	3	0.7217
Broken Ties	2018-04-13	3	6	0	3	0.7217
HAMMY	2018-03-20	3	6	0	3	0.7217
EXE: Mainframe	2018-11-20	3	6	0	3	0.7217
Pixel Beef Battle	2018-04-21	2	6	0	2	0.7217
ShellBlast	2018-05-09	2	6	0	2	0.7217
Redemption Cemetery: Grave Testimony Collector’s Edition	2018-06-13	4	6	0	4	0.7217
Opus Mortem	2018-07-06	2	6	0	2	0.7217
Centifeed	2018-11-09	2	6	0	2	0.7217
In Your Realm	2018-08-17	2	6	0	2	0.7217
Erotic Jigsaw Challenge Vol 2	2018-08-07	6	6	0	6	0.7217
Rapid Racing	2018-09-04	4	6	0	4	0.7217
Starkid's Obstacle Course	2018-11-30	3	6	0	3	0.7217
Audio Infection	2018-11-30	2	6	0	2	0.7217
RAZ	2018-09-13	3	6	0	3	0.7217
The Quest for Moe's	2018-12-14	2	6	0	2	0.7217
Evocation	2018-08-30	2	6	0	2	0.7217
Island Maze	2018-10-29	4	6	0	4	0.7217
Christmas Mahjong 2	2018-12-20	5	6	0	5	0.7217
NEONARCADE: adventure puzzle muse	2018-11-05	2	6	0	2	0.7217
Emerald Shores	2018-11-21	2	6	0	2	0.7217
Giant Celebration	2018-12-07	1	6	0	1	0.7217
Shield Impact	2018-08-29	6	58	14	20	0.7216
WWE 2K19	2018-10-09	1496	2768	964	2460	0.7214
LET IT DIE	2018-09-26	1939	3766	1328	3267	0.721
NOSTALGIC TRAIN	2018-06-13	218	135	38	256	0.721
Spacescape	2018-03-28	7	51	12	19	0.721
Citystate	2018-02-22	484	575	186	670	0.7209000000000001
Bacon Man: An Adventure	2018-03-06	12	30	6	18	0.7209000000000001
Heroes of Delum	2018-01-19	13	30	6	19	0.7209000000000001
Starbear: Taxi	2018-05-03	8	30	6	14	0.7209000000000001
Roguebreaker	2018-07-10	5	30	6	11	0.7209000000000001
Swords and Sandals Pirates	2018-11-30	8	30	6	14	0.7209000000000001
Downward Spiral: Horus Station	2018-05-31	15	100	27	42	0.7206999999999999
Poopy Philosophy	2018-11-23	3	37	8	11	0.7205
Meet the Miner - WDR VR Bergwerk	2018-09-20	17	37	8	25	0.7205
Blood Harvest 3	2018-06-05	240	153	44	284	0.7203
Space Battlecruiser	2018-04-27	13	54	13	26	0.7201000000000001
Dr. Cares - Amy's Pet Clinic	2018-05-02	15	54	13	28	0.7201000000000001
Red Alliance	2018-10-10	12	186	55	67	0.7197
Cave Digger	2018-05-09	37	264	81	118	0.7195999999999999
阿达三国志2018	2018-09-19	1861	249	76	1937	0.7195
FLYVALNY 20!8	2018-03-12	4	47	11	15	0.7194
WW Fantasy	2018-05-05	7	47	11	18	0.7194
Pizza Connection 3 - Pizza Creator	2018-04-26	10	47	11	21	0.7194
Super Cat Herding: Totally Awesome Edition	2018-03-09	27	26	5	32	0.7194
Katie	2018-05-07	7	26	5	12	0.7194
PUZZLE: LANDSCAPES	2018-08-08	3	26	5	8	0.7194
Stay or Leave / 留离	2018-08-17	6	26	5	11	0.7194
Das Geisterschiff / The Ghost Ship	2018-11-24	4	26	5	9	0.7194
SaGa SCARLET GRACE: AMBITIONS™	2018-08-02	317	152	44	361	0.7193
Almost Alive	2018-07-17	33	167	49	82	0.7191
CINERIS SOMNIA	2018-10-09	22	133	38	60	0.7188
侠隐行录：困境疑云 - Wuxia archive: Crisis escape	2018-09-26	53	136	39	92	0.7187
Konrad the Kitten - a virtual but real cat	2018-02-23	8	33	7	15	0.7187
The Brink 尘与土的边缘	2018-07-19	7	33	7	14	0.7187
HOT FIT! / フィットしちゃお！～年上女性と汗だくレッスン初体験～	2018-12-01	35	89	24	59	0.7184999999999999
Damsel	2018-10-19	11	60	15	26	0.7184999999999999
Repentant	2018-08-09	12	60	15	27	0.7184999999999999
Horror Girl Puzzle	2018-12-11	4	50	12	16	0.7184
Radiant One	2018-07-30	8	166	49	57	0.7181000000000001
Quest of Vidhuraa	2018-04-27	4	22	4	8	0.7178
All Contact Lost	2018-03-22	8	22	4	12	0.7178
Rhythm Girl	2018-03-21	10	22	4	14	0.7178
A Rite from the Stars	2018-07-19	8	22	4	12	0.7178
Prismatix	2018-03-09	5	22	4	9	0.7178
Zombie Forest 2	2018-05-28	4	22	4	8	0.7178
SPEED BOX	2018-07-24	6	22	4	10	0.7178
Parkan: Iron Strategy	2018-11-06	4	22	4	8	0.7178
Naked Sun	2018-07-17	8	79	21	29	0.7177
Island 359	2018-02-26	47	328	104	151	0.7176
MechCorp	2018-08-02	14	53	13	27	0.7176
Sleep Tight	2018-07-26	63	43	10	73	0.7176
Seek Etyliv	2018-05-19	8	43	10	18	0.7176
To Leave	2018-10-04	5	43	10	15	0.7176
Paratopic	2018-09-06	108	1236	426	534	0.7175
Property	2018-02-02	11	66	17	28	0.7173999999999999
The walking zombie: Dead city	2018-01-19	167	313	99	266	0.7173
God's Basement	2018-10-17	46	843	286	332	0.7170000000000001
谜题姐妹 Puzzle Sisters	2018-06-14	8	56	14	22	0.7169
Don't Notice Me	2018-11-07	11	29	6	17	0.7169
NPCs	2018-12-14	4	29	6	10	0.7169
The Aether: Life as a God	2018-12-18	20	29	6	26	0.7169
Greed: The Mad Scientist	2018-12-17	6	29	6	12	0.7169
Witching Tower	2018-10-25	27	91	25	52	0.7166
Anima Gate of Memories: The Nameless Chronicles	2018-06-19	32	72	19	51	0.7166
Telophase	2018-04-23	11	46	11	22	0.7166
Climb	2018-06-20	162	291	92	254	0.7165
Spaceball	2018-08-20	44	137	40	84	0.7164
Rocket of Whispers: Prologue	2018-09-12	12	164	49	61	0.7162999999999999
Toilet Run	2018-09-27	5	18	3	8	0.7162999999999999
Running King	2018-02-03	52	18	3	55	0.7162999999999999
Crimson Shift	2018-04-29	3	18	3	6	0.7162999999999999
Arevoatl Seven Coins	2018-06-07	4	18	3	7	0.7162999999999999
Azurael's Circle: Chapter 2	2018-09-03	3	18	3	6	0.7162999999999999
Chaordic	2018-12-17	3	18	3	6	0.7162999999999999
Qipa World-Hello Big Adventure	2018-12-17	5	18	3	8	0.7162999999999999
Santa Simulator	2018-12-07	15	18	3	18	0.7162999999999999
Achievement Lurker: Another one bites the dust	2018-04-26	7	75	20	27	0.7162000000000001
Endless Road：Reborn	2018-09-10	356	388	126	482	0.716
Instinct	2018-05-31	6	62	16	22	0.7156999999999999
美少女夏日欢乐!	2018-05-25	15	39	9	24	0.7156999999999999
Lurk	2018-03-08	4	10	1	5	0.7155
Galactic Feud	2018-07-19	13	10	1	14	0.7155
Boxplosion	2018-01-15	3	10	1	4	0.7155
Grimante	2018-02-08	4	10	1	5	0.7155
Wars and Battles: Normandy	2018-02-09	6	10	1	7	0.7155
Cloud Chasers - Journey of Hope	2018-10-15	4	10	1	5	0.7155
RiddleBridge	2018-03-02	3	10	1	4	0.7155
Shatter EVERYTHING	2018-05-14	2	10	1	3	0.7155
Velvet Guard	2018-03-30	5	10	1	6	0.7155
The Capture Worlds	2018-04-20	4	10	1	5	0.7155
Syko Swinger	2018-04-24	2	10	1	3	0.7155
Chicken ~Boiled Egg~	2018-05-18	4	10	1	5	0.7155
The Forest Below	2018-05-18	8	10	1	9	0.7155
Cyadonia	2018-05-07	7	10	1	8	0.7155
Planetary Settlers	2018-05-30	3	10	1	4	0.7155
Solar Explorer: New Dawn	2018-09-17	2	10	1	3	0.7155
Long Road	2018-09-10	4	10	1	5	0.7155
Incel Clicker	2018-11-03	2	10	1	3	0.7155
Drop Up	2018-08-07	5	10	1	6	0.7155
The Anomaly	2018-11-02	5	10	1	6	0.7155
Pixie Panic Garden	2018-10-09	3	10	1	4	0.7155
Sweet Seasons	2018-10-11	5	10	1	6	0.7155
Pumpkin Death Garden	2018-11-30	4	10	1	5	0.7155
Snood	2018-12-25	56	169	51	107	0.7154
Armored Squad	2018-02-06	3	14	2	5	0.7152
ECHOES OF WAR: The Last Heartbeat	2018-08-01	3	14	2	5	0.7152
Sakura Day Mahjong	2018-09-20	5	14	2	7	0.7152
POWERCUT, Inc	2018-11-22	5	14	2	7	0.7152
Tren0	2018-02-23	51	210	65	116	0.7151000000000001
秘封ナイトメアダイアリー ～ Violet Detector.	2018-09-04	167	204	63	230	0.715
aMAZE Classic: Inverted	2018-06-19	4	68	18	22	0.7149
Drumpf: Rise Up, Libertonia!	2018-02-17	7	32	7	14	0.7149
Project Eagle	2018-11-27	197	391	128	325	0.7148000000000001
ROMBIE	2018-03-23	9	25	5	14	0.7148000000000001
Double Switch - 25th Anniversary Edition	2018-12-11	5	25	5	10	0.7148000000000001
Brawlout	2018-08-20	90	579	195	285	0.7145999999999999
Asylamba : Influence	2018-05-23	12	42	10	22	0.7145999999999999
La Camila : A VR Experience	2018-04-06	9	42	10	19	0.7145999999999999
DYING: Reborn 	2018-01-11	72	162	49	121	0.7144
Moral King	2018-09-11	3	55	14	17	0.7144
Hentai Weed PuZZles	2018-09-13	3	114	33	36	0.7143
Hentai Shooter 3D: Christmas Party	2018-11-20	9	200	62	71	0.7141
水时钟	2018-09-06	15	80	22	37	0.7139
Dig Dog	2018-02-08	8	58	15	23	0.7139
Reventa	2018-08-15	8	45	11	19	0.7137000000000001
Star Singularity	2018-10-18	11	45	11	22	0.7137000000000001
OneShift	2018-08-10	4	45	11	15	0.7137000000000001
Legend Of Mercy 神医魔导	2018-04-24	68	337	110	178	0.7134999999999999
Sheep Game	2018-04-27	25	35	8	33	0.7134999999999999
Aborigenus	2018-10-17	1290	98	28	1318	0.7132
Lightfield HYPER Edition	2018-07-31	10	48	12	22	0.713
Nazi	2018-06-27	3	48	12	15	0.713
Megadimension Neptunia VIIR	2018-10-22	234	645	221	455	0.7129000000000001
鬼畜大冒险 Gui Chu Da Mao Xian	2018-09-21	33	169	52	85	0.7127
Guilt Battle Arena	2018-02-14	7	28	6	13	0.7126
Roman The Worm	2018-07-17	6	28	6	12	0.7126
Pro Cycling Manager 2018	2018-06-28	2565	301	98	2663	0.7125
Flappy Arms	2018-01-03	10	21	4	14	0.7125
Senran Meisuishu Tactics / 戦乱命萃酒タクティクス	2018-02-01	6	21	4	10	0.7125
Beyond the Sky	2018-11-14	5	21	4	9	0.7125
Beer and Skittls VR	2018-03-29	3	21	4	7	0.7125
Wars of Succession	2018-06-14	12	21	4	16	0.7125
Pirate Mosaic Puzzle. Caribbean Treasures	2018-08-03	5	21	4	9	0.7125
DinoTrek	2018-09-07	5	21	4	9	0.7125
Another Hardcore Game	2018-10-31	9	21	4	13	0.7125
The Darkest Woods 2	2018-11-16	4	21	4	8	0.7125
RocketGO	2018-11-26	16	21	4	20	0.7125
Mosaics Galore	2018-07-27	1142	79	22	1164	0.7121
Shieldwall Chronicles: Swords of the North	2018-12-17	70	124	37	107	0.7118000000000001
Runner3	2018-05-22	108	194	61	169	0.7117
Pixel Hentai Mosaic	2018-06-28	14	118	35	49	0.7117
The Slater	2018-09-20	44	599	206	250	0.7115
MonsterxMan: Inheritance To Lust	2018-04-24	50	60	16	66	0.7112
Anstorm	2018-11-16	3	44	11	14	0.7107
Dustwind	2018-08-15	143	244	79	222	0.7106
Golfing Over It with Alva Majo	2018-03-28	528	1034	369	897	0.7101999999999999
Realm Revolutions	2018-01-05	1151	249	81	1232	0.7101999999999999
Traffic Giant	2018-06-15	32	90	26	58	0.7101000000000001
Chessaria: The Tactical Adventure	2018-03-08	19	87	25	44	0.7101000000000001
Subaeria	2018-05-09	17	17	3	20	0.71
Super Star Panda	2018-01-19	4	17	3	7	0.71
Crooked Waters	2018-07-13	12	17	3	15	0.71
Rheum	2018-05-22	4	17	3	7	0.71
The World of Labyrinths: Labyronia	2018-06-01	4	17	3	7	0.71
Whip! Whip!	2018-06-28	2	17	3	5	0.71
Angry Troll Simulator 2018	2018-10-11	3	17	3	6	0.71
Astronaut: the moon eclipse	2018-12-28	2	17	3	5	0.71
Zone of Lacryma	2018-07-24	6	24	5	11	0.7099
May	2018-05-10	5	24	5	10	0.7099
Alicia Quatermain 3: The Mystery of the Flaming Gold	2018-12-19	13	34	8	21	0.7098000000000001
Orogenesis	2018-10-16	14	34	8	22	0.7098000000000001
CONCLUSE	2018-06-29	63	318	106	169	0.7095999999999999
King's Heir: Rise to the Throne	2018-05-31	24	125	38	62	0.7094
Instant Death	2018-01-22	7	53	14	21	0.7093
Blade Strangers	2018-08-28	130	188	60	190	0.7090000000000001
Odd Island	2018-10-25	9	37	9	18	0.7088
Chocolate makes you happy 7	2018-07-13	4	37	9	13	0.7088
Puzzle Pirates: Dark Seas	2018-07-06	900	371	126	1026	0.7084999999999999
Achievement Lurker: We Give Up!	2018-01-24	12	71	20	32	0.7084
Mindball Play	2018-07-11	84	68	19	103	0.7084
Hex Empire 3	2018-05-19	18	68	19	37	0.7084
S-COPTER	2018-02-12	4	5	0	4	0.7084
Magic Masks	2018-04-30	4	5	0	4	0.7084
EXIT 4 - Portal	2018-02-13	2	5	0	2	0.7084
Sol Galaxy Defender	2018-02-12	2	5	0	2	0.7084
Showdown at Willow Creek	2018-01-18	5	5	0	5	0.7084
Stinky Snake	2018-06-26	4	5	0	4	0.7084
Redemption: Tyranny of Daetorem	2018-02-12	4	5	0	4	0.7084
Flatwaters	2018-06-29	2	5	0	2	0.7084
Maestro: Notes of Life Collector's Edition	2018-02-02	4	5	0	4	0.7084
Glista	2018-01-27	2	5	0	2	0.7084
PuppetShow: Return to Joyville Collector's Edition	2018-02-05	5	5	0	5	0.7084
Fantasy Mosaics 20: Castle of Puzzles	2018-02-20	6	5	0	6	0.7084
Fantasy Mosaics 24: Deserted Island	2018-03-12	5	5	0	5	0.7084
Life Lessons	2018-05-11	2	5	0	2	0.7084
Super Skull Smash GO! 2 Turbo	2018-07-17	2	5	0	2	0.7084
Perspecto	2018-06-06	4	5	0	4	0.7084
"The ""Quiet, Please!"" Collection"	2018-03-30	2	5	0	2	0.7084
Save Snegurochka	2018-04-26	1	5	0	1	0.7084
Finger Jets	2018-04-24	3	5	0	3	0.7084
Conveyor VR	2018-12-11	2	5	0	2	0.7084
Intelligence: Dinosaurs	2018-07-17	2	5	0	2	0.7084
Mystery Tales: Alaskan Wild Collector's Edition	2018-04-23	4	5	0	4	0.7084
10 seconds	2018-07-16	2	5	0	2	0.7084
HEROES TRIALS	2018-06-20	2	5	0	2	0.7084
Common Hanzi Quiz - Simplified Chinese	2018-05-21	2	5	0	2	0.7084
Harmony of the bravest	2018-06-07	4	5	0	4	0.7084
FlyWarzz	2018-09-03	3	5	0	3	0.7084
Space Toads Mayhem	2018-11-20	3	5	0	3	0.7084
The Goracle	2018-10-31	2	5	0	2	0.7084
SUPER BALL WRESTLE YES	2018-06-19	3	5	0	3	0.7084
Candy	2018-06-19	3	5	0	3	0.7084
Entangled	2018-09-12	3	5	0	3	0.7084
Struggle For Light	2018-07-07	3	5	0	3	0.7084
Sunken	2018-06-28	8	5	0	8	0.7084
Perspectrum	2018-08-09	2	5	0	2	0.7084
Stories In Stone	2018-08-08	1	5	0	1	0.7084
Wandering Owl	2018-09-26	2	5	0	2	0.7084
Lily	2018-12-12	1	5	0	1	0.7084
Trigger Finger	2018-12-14	59	5	0	59	0.7084
Monster Pub	2018-09-03	2	5	0	2	0.7084
Fear for Sale: City of the Past Collector's Edition	2018-09-17	4	5	0	4	0.7084
Battle Of Britain	2018-09-25	1	5	0	1	0.7084
Heavy Recoil	2018-11-30	3	5	0	3	0.7084
To Burn in Memory (Anniversary Edition)	2018-10-16	2	5	0	2	0.7084
Infinity	2018-09-27	3	5	0	3	0.7084
Spirits of Mystery: Chains of Promise Collector's Edition	2018-10-22	3	5	0	3	0.7084
Photo Finish	2018-10-31	2	5	0	2	0.7084
Palace of the Azure Dragon	2018-12-01	1	5	0	1	0.7084
MonGirlTile	2018-12-21	2	5	0	2	0.7084
Santa's Workshop	2018-11-29	2	5	0	2	0.7084
Don't Shoot Rabbit	2018-12-20	3	5	0	3	0.7084
Worshippers	2018-02-27	22	77	22	44	0.7083
Wizards Tourney	2018-09-21	16	27	6	22	0.7081000000000001
Magical Monster Land	2018-10-15	3	27	6	9	0.7081000000000001
ACT IT OUT XL!	2018-03-06	11	43	11	22	0.7076000000000001
Dimension Drifter	2018-09-28	10	43	11	21	0.7076000000000001
Into Oblivion	2018-07-30	5	13	2	7	0.7075
DeDrive	2018-05-30	126	13	2	128	0.7075
Potemkin	2018-05-09	8	13	2	10	0.7075
Medieval Battle: Europe	2018-11-14	4	13	2	6	0.7075
AWAKEN：Gunpowder Adventurer Day.Dream	2018-04-27	5	13	2	7	0.7075
Robo Puzzle Smash	2018-11-15	4	13	2	6	0.7075
HandyCopter	2018-03-16	3	13	2	5	0.7075
MissileDancer	2018-06-01	3	13	2	5	0.7075
Haunted Hotel: Charles Dexter Ward Collector's Edition	2018-06-11	4	13	2	6	0.7075
Double Shot	2018-10-19	3	13	2	5	0.7075
Cavesweeper	2018-07-04	6	13	2	8	0.7075
Phantasmat: The Dread of Oakville Collector's Edition	2018-10-12	5	13	2	7	0.7075
执行人 Executor	2018-11-06	3	13	2	5	0.7075
Cotropitorii	2018-12-27	5	13	2	7	0.7075
Tower climber	2018-03-22	16	100	30	46	0.7072
Dungeon League	2018-11-01	15	46	12	27	0.7072
Royal Battleships	2018-04-06	4	46	12	16	0.7072
GUNS UP!	2018-02-05	2277	4260	1629	3906	0.7070000000000001
Star Control: Origins	2018-09-20	2601	1761	655	3256	0.7070000000000001
Unleash	2018-10-16	44	49	13	57	0.7069
Slave's Sword	2018-12-14	275	462	161	436	0.7068000000000001
Insane Robots	2018-07-12	28	20	4	32	0.7068000000000001
Scuttlers	2018-09-03	10	20	4	14	0.7068000000000001
Animals Memory: Underwater Kingdom	2018-01-22	3	20	4	7	0.7068000000000001
HellStar Squadron	2018-05-07	4	20	4	8	0.7068000000000001
SpaceExile	2018-08-03	4	20	4	8	0.7068000000000001
Count Logica	2018-10-26	4	20	4	8	0.7068000000000001
Pushing Through...	2018-09-21	9	20	4	13	0.7068000000000001
7th Sea: A Pirate's Pact	2018-12-14	18	20	4	22	0.7068000000000001
Your Royal Gayness	2018-01-26	27	88	26	53	0.7067
Royal Casino: Video Poker	2018-01-09	16	82	24	40	0.7066
Chroma : Sexy Hentai Girls	2018-10-02	12	79	23	35	0.7065
Artillery Cats	2018-06-19	10	55	15	25	0.7065
Vectorium	2018-05-03	10	58	16	26	0.7064
Will To Live Online	2018-04-05	3108	10456	4098	7206	0.7062
Gravel	2018-02-27	104	687	246	350	0.7062
NASCAR Heat 3	2018-09-07	248	352	121	369	0.706
Forgotten Places: Regained Castle	2018-01-25	234	105	32	266	0.706
Terraforming Mars	2018-10-17	1667	3772	1446	3113	0.7059000000000001
BREAK ARTS II	2018-02-09	464	508	179	643	0.7059000000000001
Yakuza Kiss	2018-06-19	9	33	8	17	0.7059000000000001
ShyChess	2018-08-03	7	33	8	15	0.7059000000000001
Construction Simulator 2 US - Pocket Edition	2018-09-13	460	411	143	603	0.7058
Kinese	2018-03-16	6	9	1	7	0.7057
Fishing Maniacs	2018-05-01	3	9	1	4	0.7057
Bug Attack!	2018-04-24	3	9	1	4	0.7057
Mapas do Horizonte - Um jogo para conhecer BH	2018-04-13	10	9	1	11	0.7057
Dark Noid	2018-01-05	1	9	1	2	0.7057
Platform Golf	2018-01-02	6	9	1	7	0.7057
Nova Wing	2018-03-07	2	9	1	3	0.7057
Mind Over Mushroom	2018-08-17	22	9	1	23	0.7057
Blackbox	2018-03-24	9	9	1	10	0.7057
Brickfest	2018-05-03	4	9	1	5	0.7057
Forests of Augusta	2018-07-02	3	9	1	4	0.7057
Dungeon Quest	2018-05-08	3	9	1	4	0.7057
Yahrit!	2018-07-13	2	9	1	3	0.7057
Octo Gravity	2018-07-03	4	9	1	5	0.7057
Ruby & Majesty: Treasure Team	2018-08-31	4	9	1	5	0.7057
NSFWare	2018-10-18	2	9	1	3	0.7057
Supaplex WOW!	2018-09-20	8	9	1	9	0.7057
Mystery Trackers: Black Isle Collector's Edition	2018-09-12	5	9	1	6	0.7057
Kai Entity	2018-09-18	2	9	1	3	0.7057
Heart Chain Kitty	2018-11-23	2	9	1	3	0.7057
Evidence of Life	2018-11-20	3	9	1	4	0.7057
Yearning	2018-11-09	3	9	1	4	0.7057
Diaperquest 2055	2018-11-26	2	9	1	3	0.7057
Air Threat	2018-05-08	3989	156	50	4039	0.7056
This Grand Life	2018-04-17	305	167	54	359	0.7054
Escape the Darkness	2018-04-03	4	36	9	13	0.7051999999999999
Hyper Simon X	2018-08-08	3	36	9	12	0.7051999999999999
BORIS the Mutant Bear with a Gun	2018-07-26	3	36	9	12	0.7051999999999999
Nowhere Girl	2018-10-29	9	36	9	18	0.7051999999999999
Aesthetic Arena	2018-04-20	4	39	10	14	0.7048000000000001
Hard Work	2018-09-15	8	39	10	18	0.7048000000000001
Plight	2018-02-02	27	23	5	32	0.7048000000000001
IIN	2018-03-06	3	23	5	8	0.7048000000000001
CRYEP	2018-09-14	27	23	5	32	0.7048000000000001
Erotic Jigsaw Challenge Vol 1	2018-06-02	8	23	5	13	0.7048000000000001
Test your knowledge: Dogs	2018-09-03	3	23	5	8	0.7048000000000001
Chocolate makes you happy: New Year	2018-11-28	4	23	5	9	0.7048000000000001
Shaq Fu: A Legend Reborn	2018-06-05	39	104	32	71	0.7045
Rocketboat - Pilot	2018-04-25	20	42	11	31	0.7044
Bullseye	2018-05-17	5	42	11	16	0.7044
Revenge of the Headless	2018-04-03	17	42	11	28	0.7044
FEAST: Book One «Family Ties»	2018-04-04	12	69	20	32	0.7042
Slizer Battle Management System	2018-05-08	18	45	12	30	0.7042
Curiosity	2018-08-10	76	51	14	90	0.7040000000000001
Space Hulk: Deathwing - Enhanced Edition	2018-05-22	2341	5816	2279	4620	0.7039
You Will Never Get This Achievement	2018-01-10	19	95	29	48	0.7039
VR Benchmark Kanojo	2018-04-18	34	193	64	98	0.7038
Fenrisulfr Puzzle	2018-02-18	10	26	6	16	0.7034
Orch Star	2018-08-16	5	26	6	11	0.7034
Dungeon Gambit Boy	2018-03-21	5	26	6	11	0.7034
Animals Memory: Dogs	2018-01-16	5	26	6	11	0.7034
Animals Memory: Insect	2018-01-26	3	26	6	9	0.7034
Oracle of Forgotten Testament	2018-03-02	6	26	6	12	0.7034
The young mathematician: Easy difficulty	2018-09-20	3	26	6	9	0.7034
CHRONO	2018-12-12	22	86	26	48	0.7033
The Moonstone Equation	2018-08-20	8	16	3	11	0.7033
Mass O' Kyzt	2018-02-02	6	16	3	9	0.7033
Kate's Test	2018-02-17	6	16	3	9	0.7033
Reverie - A Heroes Tale	2018-03-21	11	16	3	14	0.7033
Rosette and Words	2018-04-16	3	16	3	6	0.7033
Storm of Jigsaw Puzzles	2018-10-18	5	16	3	8	0.7033
In Memory	2018-10-11	136	16	3	139	0.7033
Weirdest Thing	2018-10-18	3	16	3	6	0.7033
Hentai IQ Puzzle	2018-09-08	15	80	24	39	0.7029000000000001
Wuxing Master 五行师(CCG)	2018-01-08	124	167	55	179	0.7027
Cursed Lands	2018-05-18	72	77	23	95	0.7027
Magic Technology	2018-01-29	4477	29	7	4484	0.7025
Timore 6	2018-11-16	5	29	7	12	0.7025
FPV Air 2	2018-08-17	49	183	61	110	0.7023
The Bonfire: Forsaken Lands	2018-03-09	170	136	44	214	0.7021
Beasts of Bermuda	2018-12-21	3523	4650	1832	5355	0.7019
Sol705	2018-03-16	36	65	19	55	0.7019
Orphan	2018-10-31	9	32	8	17	0.7019
酒店 The Hotel	2018-09-24	4	32	8	12	0.7019
Pure Farming 2018	2018-03-13	1890	1048	393	2283	0.7018000000000001
Gray Cat	2018-05-08	6	105	33	39	0.7018000000000001
EARTHLOCK	2018-03-08	142	375	133	275	0.7017
Welcome Back To 2007	2018-05-09	12	141	46	58	0.7015000000000001
Final Battle	2018-04-20	13	38	10	23	0.7012999999999999
Hack the Core	2018-08-23	4	38	10	14	0.7012999999999999
TEXT	2018-10-18	7	38	10	17	0.7012999999999999
Re;Lord 1 ~The witch of Herfort and stuffed animals~	2018-03-09	12	50	14	26	0.7012
Odium to the Core	2018-05-11	6	41	11	17	0.7012
MotoGP™18	2018-06-07	626	481	174	800	0.7011000000000001
Baby Hands	2018-07-26	16	47	13	29	0.7011000000000001
Achromatic	2018-09-28	5	47	13	18	0.7011000000000001
Crayola Scoot	2018-10-16	12	44	12	24	0.7011000000000001
Operation Thunderstorm	2018-07-13	15	187	63	78	0.701
One Night	2018-02-17	12	19	4	16	0.7008
Raining blocks	2018-01-04	4	19	4	8	0.7008
Squirrel Sphere	2018-06-29	4	19	4	8	0.7008
SMASH BOY Ver.KZ	2018-08-10	11	19	4	15	0.7008
Epic Skater 2	2018-11-08	5	19	4	9	0.7008
TAL: Jungle	2018-11-20	5	19	4	9	0.7008
Creature Romances: Kokonoe Kokoro	2018-03-02	376	328	116	492	0.7007
Cybarian: The Time Travelling Warrior	2018-11-09	6	93	29	35	0.7007
Destination Primus Vita	2018-08-16	183	73	22	205	0.7005
Pestis	2018-05-10	5	73	22	27	0.7005
103	2018-12-21	8	140	46	54	0.7004
Lake Ridden	2018-05-10	60	205	70	130	0.7001999999999999
Sea Dogs: City of Abandoned Ships	2018-11-02	32	126	41	73	0.7001000000000001
Cadria Item Shop	2018-08-24	1586	1009	382	1968	0.6999
Primitive Shooter	2018-02-07	6	67	20	26	0.6999
Thief of Thieves: Season One	2018-07-16	19	112	36	55	0.6998000000000001
Tales Of Wedding Rings VR	2018-09-24	5	64	19	24	0.6997
Chasm	2018-07-31	1043	1561	603	1646	0.6994
Forbidden Clicker Party	2018-01-29	32	95	30	62	0.6994
JQ: chemistry	2018-04-09	4	95	30	34	0.6994
Dragon Simulator Multiplayer	2018-11-05	10	81	25	35	0.6994
Numgeon	2018-12-15	7	61	18	25	0.6994
Cendric	2018-03-02	12	22	5	17	0.6994
Plat4mer	2018-12-17	8	22	5	13	0.6994
Carried Away: Winter Sports	2018-02-09	63	22	5	68	0.6994
Canek: Quest for Corn	2018-02-16	15	22	5	20	0.6994
Whispering Flames	2018-11-17	2	22	5	7	0.6994
Pixel Girl	2018-09-22	11	22	5	16	0.6994
The Spectrum Retreat	2018-07-13	35	177	60	95	0.6993
Niffelheim	2018-09-26	880	1569	607	1487	0.6992
Unmoor	2018-05-02	26	78	24	50	0.6990999999999999
Visual Out	2018-03-15	6	12	2	8	0.6990999999999999
GRAL	2018-09-24	10	12	2	12	0.6990999999999999
Angelo Skate Away	2018-01-26	7	12	2	9	0.6990999999999999
Flipped On	2018-01-10	5	12	2	7	0.6990999999999999
Super Sonic Racer	2018-03-09	4	12	2	6	0.6990999999999999
The famous diver	2018-03-22	3	12	2	5	0.6990999999999999
Skip's Sanity	2018-05-25	2	12	2	4	0.6990999999999999
Doors Push or Pull	2018-05-21	3	12	2	5	0.6990999999999999
Christmas Mahjong	2018-12-03	5	12	2	7	0.6990999999999999
Dark Parables: The Match Girl's Lost Paradise Collector's Edition	2018-11-02	7	12	2	9	0.6990999999999999
The Lost Legends of Redwall: The Scout Act 1	2018-09-14	20	92	29	49	0.6990000000000001
Dinosaur Hunt Puzzle	2018-06-13	2182	251	88	2270	0.6988
Warring States	2018-01-29	78	75	23	101	0.6988
Goblin Gearshop	2018-01-17	40	152	51	91	0.6986
Foreveracers	2018-03-29	30	25	6	36	0.6985
Downbreak	2018-04-10	7	25	6	13	0.6985
VR RHYTHM ACTION SEIYA	2018-03-14	7	25	6	13	0.6985
Lots of Balls	2018-02-26	5	25	6	11	0.6985
Bang Bang Fruit 3	2018-07-31	3	25	6	9	0.6985
What do you hear?? Yanny vs Laurel	2018-06-09	4	49	14	18	0.6983
Usotsuki Game / 谎言游戏	2018-03-16	133	197	68	201	0.6981
BIG POGO MAN	2018-06-26	17	46	13	30	0.6981
AV-17	2018-10-18	15	46	13	28	0.6981
I, Hope	2018-02-21	7	28	7	14	0.698
Eselmir and the five magical gifts	2018-01-11	6	28	7	13	0.698
Project Pastorate	2018-05-31	4	28	7	11	0.698
Arkhangel: The House of the Seven Stars	2018-07-27	4	43	12	16	0.6979000000000001
Hellmut: The Badass from Hell	2018-02-27	15	37	10	25	0.6977
Dead Rain - New Zombie Virus	2018-03-09	12	31	8	20	0.6977
Supesu	2018-07-06	59	31	8	67	0.6977
ItazuraVR	2018-10-26	11	31	8	19	0.6977
Kitrinos: Inside the Cube	2018-07-16	11	34	9	20	0.6976000000000001
NALOGI 2	2018-05-31	268	222	78	346	0.6969
The Last DeadEnd	2018-05-04	12	74	23	35	0.6968000000000001
Card Crawl	2018-02-07	27	126	42	69	0.6966
Beauty and the Beast	2018-08-08	37	57	17	54	0.6966
Perfect Heist	2018-08-17	95	315	114	209	0.6965000000000001
Labirinto	2018-01-10	4	96	31	35	0.6965000000000001
Bighead Runner	2018-06-07	3	96	31	34	0.6965000000000001
Bunker Punks	2018-05-28	87	299	108	195	0.6962
Coaster	2018-01-19	7	15	3	10	0.6959000000000001
Knight King Assassin	2018-07-11	2	15	3	5	0.6959000000000001
WitchAction	2018-11-22	2	15	3	5	0.6959000000000001
Punch Pad Workout	2018-08-14	4	15	3	7	0.6959000000000001
THE E BALL	2018-08-31	2	15	3	5	0.6959000000000001
The Lost Soul	2018-11-11	12	15	3	15	0.6959000000000001
Vicious Attack Llama Apocalypse	2018-02-26	18	51	15	33	0.6958
Maidens of a Hollow Dream	2018-03-30	11	51	15	26	0.6958
Farm Manager 2018	2018-04-06	3940	1882	748	4688	0.6954000000000001
After Dreams	2018-05-07	38	149	51	89	0.6954000000000001
DragonFangZ	2018-02-28	119	117	39	158	0.6954000000000001
Frio- Lost in old town	2018-02-05	25	48	14	39	0.6954000000000001
Mines and Magic	2018-07-09	10	48	14	24	0.6954000000000001
Loot Box Simulator	2018-07-27	30	62	19	49	0.6950000000000001
FOX n FORESTS	2018-05-17	46	122	41	87	0.6949
Crypt	2018-03-09	28	103	34	62	0.6947
One Gun: Cat	2018-10-19	75	73	23	98	0.6947
ZONE OF THE ENDERS THE 2nd RUNNER : MARS / ANUBIS ZONE OF THE ENDERS : MARS	2018-09-04	165	591	225	390	0.6945
Darkness and Flame: The Dark Side f2p	2018-12-26	46	135	46	92	0.6945
Vilmonic	2018-11-05	11	59	18	29	0.6945
Ingnomia	2018-08-24	29	156	54	83	0.6944
Lost God	2018-02-07	7	18	4	11	0.6944
The Quest for the BIG KEY	2018-05-15	3	18	4	7	0.6944
Color Circle	2018-03-30	2	18	4	6	0.6944
Colony Prospector	2018-04-25	6	18	4	10	0.6944
Unfolding Engine: Paint a Game	2018-12-03	189	18	4	193	0.6944
CosmoDrive:Zero	2018-11-29	4	18	4	8	0.6944
Levantera: Tale of The Winds	2018-04-02	6	8	1	7	0.6944
摩尼遊戯TOKOYO	2018-03-25	7	8	1	8	0.6944
Slime Sports	2018-02-22	6	8	1	7	0.6944
Witchball	2018-01-02	2	8	1	3	0.6944
Xtreme Paddleball	2018-03-08	2	8	1	3	0.6944
Awakening: The Skyward Castle Collector's Edition	2018-03-09	6	8	1	7	0.6944
Goroons	2018-05-17	4	8	1	5	0.6944
Plants	2018-06-05	2	8	1	3	0.6944
Spoorky	2018-11-08	4	8	1	5	0.6944
Sumo	2018-12-08	5	8	1	6	0.6944
Astraeus	2018-06-07	3	8	1	4	0.6944
Achaem	2018-07-18	4	8	1	5	0.6944
Neotrie VR	2018-12-07	4	8	1	5	0.6944
Cabins: Jigsaw Puzzles	2018-07-05	2	8	1	3	0.6944
Me Smart Orc	2018-08-28	3	8	1	4	0.6944
The Legend of Protey	2018-08-15	2	8	1	3	0.6944
Ghosting Gun S	2018-08-24	1	8	1	2	0.6944
七夜怪谈 都市校园禁锢传说	2018-09-20	5	8	1	6	0.6944
Mariner Accident	2018-10-10	2	8	1	3	0.6944
Fly High	2018-10-19	2	8	1	3	0.6944
Ancient Frontier: Steel Shadows BETA	2018-11-24	8	8	1	9	0.6944
Coloring Book	2018-12-05	4	8	1	5	0.6944
Social Club VR : Casino Nights	2018-06-21	19	39	11	30	0.6943
Gleaner Heights	2018-02-21	187	252	91	278	0.6942
Future GPX CyberFormula SIN VIER	2018-12-12	20	70	22	42	0.6942
Fatal Velocity: Physics Combat	2018-03-29	18	36	10	28	0.6939000000000001
Pranky Cat	2018-11-28	4	36	10	14	0.6939000000000001
Azure Saga: Pathfinder	2018-03-13	48	67	21	69	0.6937000000000001
Escape The Pacific	2018-02-23	191	446	168	359	0.6936
Ultimate Sudoku Collection	2018-05-18	55	105	35	90	0.6936
RealmCraft	2018-02-19	15	33	9	24	0.6936
Legion's Crawl	2018-08-30	11	33	9	20	0.6936
Bouncing Over It with friends	2018-08-08	13	33	9	22	0.6936
The Thin Silence	2018-04-27	9	21	5	14	0.6936
Portarius	2018-04-26	4	21	5	9	0.6936
Car Puzzler	2018-01-25	3	21	5	8	0.6936
Mosaic: Game of Gods II	2018-04-27	4	21	5	9	0.6936
Heliophobia	2018-10-18	8	21	5	13	0.6936
I love the money	2018-10-11	5	21	5	10	0.6936
三国古战略	2018-12-20	22	21	5	27	0.6936
The Wall	2018-11-02	154	261	95	249	0.6934
Nazi Bunker	2018-07-20	5	134	46	51	0.6933
PIXEL ZUMBI	2018-02-02	853	27	7	860	0.6933
Paint It Black	2018-03-20	4	27	7	11	0.6933
VESTIGE	2018-11-30	5	27	7	12	0.6933
Destructions	2018-07-03	3	24	6	9	0.6933
De'Vine: World of Shadows	2018-05-04	8	24	6	14	0.6933
I, Cyborg	2018-06-28	41	24	6	47	0.6933
Innocent Forest: The Bird of Light	2018-10-05	3	24	6	9	0.6933
Depth of Extinction	2018-09-27	125	147	51	176	0.6931999999999999
Running Through Russia 2	2018-06-15	7	75	24	31	0.6931999999999999
TheNightfall	2018-01-12	39	99	33	72	0.6926000000000001
Villager's Biography	2018-06-13	18	72	23	41	0.6926000000000001
Virtual Fighting Championship	2018-09-22	12	128	44	56	0.6924
Zhmyshenko Valery Albertovich	2018-04-26	5	80	26	31	0.6923
Xenocite Clad	2018-06-29	3	4	0	3	0.6920000000000001
Tekling	2018-02-05	136	4	0	136	0.6920000000000001
Bee Aware! 2.0	2018-09-01	2	4	0	2	0.6920000000000001
Hunters Life	2018-12-14	2	4	0	2	0.6920000000000001
Collide	2018-03-15	3	4	0	3	0.6920000000000001
The Word Is Not The Thing	2018-11-01	2	4	0	2	0.6920000000000001
The Reaction	2018-03-18	4	4	0	4	0.6920000000000001
The Finnish Virtual Art Gallery	2018-10-17	77	4	0	77	0.6920000000000001
Alma	2018-01-17	1	4	0	1	0.6920000000000001
Red Hot Ricochet	2018-03-06	4	4	0	4	0.6920000000000001
Thetaball	2018-08-01	4	4	0	4	0.6920000000000001
Jelly Escape	2018-04-19	1	4	0	1	0.6920000000000001
Crystals and Curses	2018-03-30	3	4	0	3	0.6920000000000001
AI Anomaly	2018-02-01	1	4	0	1	0.6920000000000001
Stick Adventures: Wizard Madness: Chapter 1	2018-01-29	2	4	0	2	0.6920000000000001
Dash Blitz	2018-03-20	2	4	0	2	0.6920000000000001
Shallow Swing	2018-10-01	1	4	0	1	0.6920000000000001
Fairly Certain Doom	2018-04-03	2	4	0	2	0.6920000000000001
Yozakura Wizard VR	2018-03-03	3	4	0	3	0.6920000000000001
橙天の銀翼　～スカイランドの魔女と巫女～	2018-05-11	2	4	0	2	0.6920000000000001
Fantasy Mosaics 19: Edge of the World	2018-02-13	5	4	0	5	0.6920000000000001
varBlocks	2018-03-20	1	4	0	1	0.6920000000000001
Fantasy Mosaics 22: Summer Vacation	2018-03-05	4	4	0	4	0.6920000000000001
Fantasy Mosaics 23: Magic Forest	2018-03-08	5	4	0	5	0.6920000000000001
Fantasy Mosaics 26: Fairytale Garden	2018-03-16	6	4	0	6	0.6920000000000001
Love Chronicles: Salvation Collector's Edition	2018-03-02	3	4	0	3	0.6920000000000001
Lanterns	2018-03-14	2	4	0	2	0.6920000000000001
Guiding Hand VR	2018-03-07	3	4	0	3	0.6920000000000001
Anark.io	2018-04-05	3	4	0	3	0.6920000000000001
Inzo	2018-04-27	2	4	0	2	0.6920000000000001
Mama Farm	2018-04-10	3	4	0	3	0.6920000000000001
City Sweeper - Clean it Fast!	2018-06-26	3	4	0	3	0.6920000000000001
Slamoids!	2018-08-08	2	4	0	2	0.6920000000000001
Tactical Mind	2018-04-27	2	4	0	2	0.6920000000000001
Shadow Wolf Mysteries: Cursed Wedding Collector's Edition	2018-04-30	4	4	0	4	0.6920000000000001
Semi-Sweet Tofu	2018-05-03	4	4	0	4	0.6920000000000001
Highscore Processing Unit	2018-05-04	3	4	0	3	0.6920000000000001
Dragon Defense	2018-10-12	2	4	0	2	0.6920000000000001
Тридевятые земли(Свет или тьма)	2018-05-20	2	4	0	2	0.6920000000000001
Star Speeder	2018-05-11	4	4	0	4	0.6920000000000001
Toybit Quest	2018-07-12	3	4	0	3	0.6920000000000001
Deep Voyage	2018-05-04	3	4	0	3	0.6920000000000001
Boo Boo Bananas	2018-05-29	2	4	0	2	0.6920000000000001
Itsy Blitzy	2018-09-19	2	4	0	2	0.6920000000000001
BULLY STORE	2018-11-07	3	4	0	3	0.6920000000000001
Doctor Tsunami	2018-11-17	1	4	0	1	0.6920000000000001
Heavenly Duels	2018-07-20	4	4	0	4	0.6920000000000001
Love Story: The Way Home	2018-06-08	3	4	0	3	0.6920000000000001
Salty Seabird Bay	2018-09-11	3	4	0	3	0.6920000000000001
Detective Failure	2018-07-30	1	4	0	1	0.6920000000000001
Vosaria: Lair of the Forgotten	2018-06-22	2	4	0	2	0.6920000000000001
WISGR	2018-07-06	2	4	0	2	0.6920000000000001
Trooper 2 - Alien justice	2018-07-02	2	4	0	2	0.6920000000000001
Rocket Island	2018-07-02	3	4	0	3	0.6920000000000001
Munchies	2018-08-01	2	4	0	2	0.6920000000000001
Maestro: Music from the Void Collector's Edition	2018-07-11	3	4	0	3	0.6920000000000001
Suitchi	2018-10-26	2	4	0	2	0.6920000000000001
A Gentlemanly Adventure	2018-11-03	3	4	0	3	0.6920000000000001
Maze Quest 1: The Forest	2018-08-31	2	4	0	2	0.6920000000000001
Crime Stories: Days of Vengeance	2018-07-21	4	4	0	4	0.6920000000000001
Swing the cat	2018-10-15	1	4	0	1	0.6920000000000001
Captain:Training	2018-08-08	1	4	0	1	0.6920000000000001
BigBoy - Visual Crime Novel	2018-08-14	1	4	0	1	0.6920000000000001
Hipster Attack	2018-08-23	5	4	0	5	0.6920000000000001
Super Streaker Plus	2018-08-31	1	4	0	1	0.6920000000000001
Prehistoria	2018-08-09	2	4	0	2	0.6920000000000001
CatCatch	2018-09-03	2	4	0	2	0.6920000000000001
Rascals	2018-10-17	2	4	0	2	0.6920000000000001
Space Cowboy	2018-09-15	4	4	0	4	0.6920000000000001
Navyblue and the Spectrum Killers	2018-09-04	2	4	0	2	0.6920000000000001
Crystal Path	2018-09-05	4	4	0	4	0.6920000000000001
В поисках Атлантиды	2018-11-02	2	4	0	2	0.6920000000000001
Core Rescue	2018-12-24	2	4	0	2	0.6920000000000001
Rento Fortune VR	2018-11-20	4	4	0	4	0.6920000000000001
Sacred Earth - Promise	2018-10-24	5	4	0	5	0.6920000000000001
Colette's Sugar Madness	2018-10-05	1	4	0	1	0.6920000000000001
Dungeons and Dinners	2018-10-14	4	4	0	4	0.6920000000000001
Combo Jumper	2018-10-24	1	4	0	1	0.6920000000000001
战术狂想3-枪战足球(Chimera of Tactics 3-Gun and Soccer)	2018-10-23	1	4	0	1	0.6920000000000001
Shooting Chicken Insanity Chickens	2018-10-05	3	4	0	3	0.6920000000000001
Armored Fighter	2018-11-14	3	4	0	3	0.6920000000000001
Ralf	2018-11-20	2	4	0	2	0.6920000000000001
Spider Lander	2018-11-15	3	4	0	3	0.6920000000000001
Solitaire: Learn the Flags!	2018-12-07	3	4	0	3	0.6920000000000001
Fant Kids Matching Game	2018-12-03	3	4	0	3	0.6920000000000001
SHELL	2018-11-08	3	4	0	3	0.6920000000000001
Predicate	2018-11-16	2	4	0	2	0.6920000000000001
Dr. Schplot's Nanobots	2018-11-28	2	4	0	2	0.6920000000000001
Shadow Wolf Mysteries: Under the Crimson Moon Collector's Edition	2018-11-27	3	4	0	3	0.6920000000000001
Epic of Serinor: Dawnshadow	2018-12-21	2	4	0	2	0.6920000000000001
Boundless	2018-09-11	1160	1910	776	1936	0.6915000000000001
Stayin' Alive	2018-05-17	577	202	73	650	0.6912999999999999
Mini Thief	2018-10-12	992	313	117	1109	0.6912
Broken Ground	2018-04-12	709	308	115	824	0.6912
Super Slime Arena	2018-01-23	17	41	12	29	0.6912
The 7th Circle	2018-09-10	15	41	12	27	0.6912
TT Isle of Man: Ride on the Edge	2018-03-27	468	887	351	819	0.6911
祛魅·教化（祛魅1）	2018-05-08	8	63	20	28	0.6908
Bird Game	2018-02-22	16	52	16	32	0.6907
Grand Class Melee 2	2018-07-20	99	38	11	110	0.6907
Alchemia	2018-09-28	23	38	11	34	0.6907
Demon King Domination: Deluxe Edition	2018-09-30	5275	116	40	5315	0.6904000000000001
Path to Mnemosyne	2018-09-26	147	152	54	201	0.6901
Of Gods and Men: The Daybreak Empire	2018-11-09	11	35	10	21	0.6900000000000001
Hatsune Miku VR	2018-03-09	58	427	164	222	0.6899
Please Love My Computer Game	2018-02-19	27	113	39	66	0.6899
Chocolate makes you happy 3	2018-02-06	4	92	31	35	0.6899
Time Carnage VR	2018-04-10	9	68	22	31	0.6898000000000001
The MagiCats Best Of	2018-03-22	20	68	22	42	0.6898000000000001
Graveball	2018-07-31	16	11	2	18	0.6897
Guts and Syringes	2018-03-30	8	11	2	10	0.6897
D.R.I.L.L.	2018-01-24	12	11	2	14	0.6897
John Lazarus - Episode 1: Dead Man's Origin	2018-03-09	3	11	2	5	0.6897
Abha	2018-10-23	2	11	2	4	0.6897
LONELINESS AFTER: Chapter 1	2018-03-01	2	11	2	4	0.6897
World of Islands - Treasure Hunt	2018-06-12	2	11	2	4	0.6897
Platform Challenge	2018-04-20	3	11	2	5	0.6897
The Land of the Seazogs	2018-10-31	2	11	2	4	0.6897
Sanctus Mortem	2018-11-16	7	11	2	9	0.6897
Kinkshamed	2018-08-05	6	11	2	8	0.6897
Steel Dungeon 钢铁地牢	2018-10-03	4	11	2	6	0.6897
You Shall Not Break!	2018-12-06	4	11	2	6	0.6897
Duality	2018-12-21	2	11	2	4	0.6897
SMOKED	2018-12-03	6	11	2	8	0.6897
Late'O'Clock	2018-11-09	3	11	2	5	0.6897
Corridor Z	2018-01-08	283	225	83	366	0.6895
Awkward	2018-06-05	66	57	18	84	0.6894
My Coloring Book: Professions	2018-01-10	6	32	9	15	0.6894
BattleCON: Online	2018-09-03	176	202	74	250	0.6892
Primordian	2018-01-20	23	81	27	50	0.6890999999999999
Together	2018-05-01	16	156	56	72	0.6889000000000001
Non-Linear Text Quests	2018-07-25	17	29	8	25	0.6888
The Eerie Inn	2018-04-19	3	29	8	11	0.6888
Welcome To... Chichester 2 : The Spy Of Chichester And The Eager Tourist Guide	2018-08-03	2	29	8	10	0.6888
Dude Cops	2018-09-05	4	29	8	12	0.6888
Micro Pico Racers	2018-04-19	7	26	7	14	0.6883
WEscape	2018-08-17	13	26	7	20	0.6883
Just Beat Em Up : World of Fury	2018-08-30	3	26	7	10	0.6883
Miami Cruise	2018-12-21	5	26	7	12	0.6883
Oops!!! I Slept With Your Mom	2018-09-21	6	26	7	13	0.6883
Funk Unplugged	2018-05-25	9	14	3	12	0.688
Digital Domain’s Monkey King™	2018-02-06	4	14	3	7	0.688
Fire and Fury: English Civil War	2018-12-19	5	14	3	8	0.688
Kill the Superweapon	2018-03-05	2	14	3	5	0.688
Cross of Auria	2018-01-01	3	14	3	6	0.688
Lisssn	2018-01-31	8	14	3	11	0.688
Desert of Vice	2018-04-13	4	14	3	7	0.688
The Take	2018-04-02	4	14	3	7	0.688
Mercury Race	2018-11-30	2	14	3	5	0.688
Space Slingshot VR	2018-04-03	3	14	3	6	0.688
Soccer Battle Royale	2018-11-03	26	14	3	29	0.688
Awakening: Moonfell Wood	2018-08-10	6	14	3	9	0.688
Devil Girl Needs Massages	2018-10-29	2	14	3	5	0.688
Puzzles for smart: Birds	2018-10-27	4	14	3	7	0.688
1001 Jigsaw. Legends of Mystery	2018-12-24	5	14	3	8	0.688
Leviathan ~A Survival RPG~	2018-11-30	161	155	56	217	0.6878000000000001
Chocolate makes you happy 4	2018-03-14	7	109	38	45	0.6878000000000001
Battery Jam	2018-05-17	5	23	6	11	0.6878000000000001
Hexanome	2018-12-10	3	23	6	9	0.6878000000000001
Stifled	2018-07-10	25	75	25	50	0.6877
RUSH: A Disney • PIXAR Adventure	2018-09-14	59	180	66	125	0.6876000000000001
MatchyGotchy	2018-01-31	27	114	40	67	0.6876000000000001
Singularity 5	2018-12-21	6	59	19	25	0.6876000000000001
Queen's Quest 4: Sacred Truce	2018-04-26	23	101	35	58	0.6875
VR Mini Bowling	2018-12-05	7	20	5	12	0.6875
Subscribe & Punch!	2018-10-31	5	20	5	10	0.6875
Armor Contest	2018-05-22	3	20	5	8	0.6875
Exoplanet	2018-07-25	8	20	5	13	0.6875
The Great Emu War	2018-12-11	5	20	5	10	0.6875
Molecats	2018-08-28	5	17	4	9	0.6875
Tears - 9, 10	2018-01-31	3	17	4	7	0.6875
Wheelchair Simulator	2018-06-12	3	17	4	7	0.6875
Space Maze	2018-06-12	2	17	4	6	0.6875
The Last Wizard	2018-08-04	33	17	4	37	0.6875
Horde: Zombie Outbreak	2018-07-30	8	17	4	12	0.6875
Simplex Mundi	2018-09-09	11	17	4	15	0.6875
RED: The Lucid Nightmare	2018-10-09	6	17	4	10	0.6875
The Mysteries of Baroque	2018-09-20	30	17	4	34	0.6875
Iron League	2018-03-15	507	578	229	736	0.6874
Sherlock Holmes: Trap for the Hunter	2018-03-24	8	48	15	23	0.687
The Outer Rim: Survivor	2018-04-03	16	48	15	31	0.687
Don't Sink	2018-04-13	97	149	54	151	0.6868000000000001
Squally	2018-11-07	6	64	21	27	0.6868000000000001
Mecha-Tokyo Rush	2018-07-13	23	64	21	44	0.6868000000000001
Lady's Hentai Mosaic	2018-12-24	8	56	18	26	0.6868000000000001
太吾绘卷 The Scroll Of Taiwu	2018-09-20	72533	39024	17246	89779	0.6863
The Mage's Tale	2018-03-23	29	113	40	69	0.6862
Die for Valhalla!	2018-05-29	33	95	33	66	0.6861
Debtor	2018-02-23	12	82	28	40	0.6859999999999999
8 Ball	2018-03-25	8	82	28	36	0.6859999999999999
Cold Iron	2018-01-30	7	34	10	17	0.6859999999999999
Phantom Halls	2018-10-31	9	34	10	19	0.6859999999999999
Death Mark Vol.1	2018-06-01	17	34	10	27	0.6859999999999999
Awake Episode One	2018-12-05	13	34	10	23	0.6859999999999999
Test Subject 901	2018-09-12	11	34	10	21	0.6859999999999999
Trash Story	2018-05-30	9	272	104	113	0.6859000000000001
Fuel Renegades	2018-07-31	14	61	20	34	0.6859000000000001
My Lovely Daughter	2018-03-08	914	784	318	1232	0.6858
Snake Classic	2018-02-05	20	170	63	83	0.6851999999999999
Sorcery Saga: Curse of the Great Curry God	2018-06-04	41	79	27	68	0.6851999999999999
Ninja Tycoon	2018-02-26	139	290	112	251	0.685
Rhythm World - Master Project	2018-02-13	8	58	19	27	0.685
ASSAULT GUNNERS HD EDITION	2018-03-20	24	84	29	53	0.6849
Sloppy Goat	2018-03-29	6	71	24	30	0.6848000000000001
Captain Nemo	2018-02-03	14	81	28	42	0.6840999999999999
School of the Dead: Anastasia	2018-11-27	3	28	8	11	0.6840999999999999
Protocol	2018-11-20	70	198	75	145	0.6837000000000001
Shining Resonance Refrain	2018-07-10	427	826	340	767	0.6835
Gran Skrea Online	2018-06-16	109	188	71	180	0.6835
Debugger 3.16: Hack'n'Run	2018-02-22	110	25	7	117	0.6831
The Corridor: On Behalf Of The Dead	2018-08-30	22	25	7	29	0.6831
Orb Labs, Inc.	2018-06-11	3	25	7	10	0.6831
TAL: Arctic 3	2018-09-17	2	25	7	9	0.6831
Tempest Citadel	2018-04-17	48	36	11	59	0.6829999999999999
Abo Khashem	2018-02-22	81	36	11	92	0.6829999999999999
The Outpost Nine	2018-07-27	5	36	11	16	0.6829999999999999
High School Simulator 2018	2018-01-03	32	175	66	98	0.6828000000000001
The Mine	2018-08-08	12	93	33	45	0.6827
Battle Princess Madelyn	2018-12-06	39	103	37	76	0.6826000000000001
Riddles of the Owls Kingdom	2018-09-13	129	103	37	166	0.6826000000000001
a Museum of Dubious Splendors	2018-03-06	102	113	41	143	0.6825
Zula Global	2018-01-12	1088	4056	1764	2852	0.6824
Secret of Mana	2018-02-15	3261	1641	697	3958	0.6823
上帝之城 I：监狱帝国 [City of God I - Prison Empire]	2018-07-09	3284	1318	556	3840	0.6823
Choose Wisely	2018-01-12	1186	75	26	1212	0.6823
OVERVIEW: a Walk Through the Universe	2018-03-01	15	80	28	43	0.6820999999999999
Void Vikings	2018-04-04	62	22	6	68	0.682
Luna and the Moonling	2018-09-21	6	22	6	12	0.682
Beer!	2018-02-14	6	22	6	12	0.682
ALASKA	2018-02-22	3	22	6	9	0.682
Strange Encounter	2018-11-09	4	22	6	10	0.682
#CuteSnake 2	2018-04-20	10	49	16	26	0.6819
A Total War Saga: Thrones of Britannia	2018-05-03	22797	8754	3877	26674	0.6818000000000001
Germination	2018-04-13	113	33	10	123	0.6818000000000001
Warlords Awakening	2018-11-29	917	389	156	1073	0.6817000000000001
Cefore	2018-11-09	12	41	13	25	0.6817000000000001
PLANET ALPHA	2018-09-04	118	648	267	385	0.6815000000000001
Myst IV: Revelation	2018-09-25	40	137	51	91	0.6815000000000001
Lootfest Wars	2018-03-01	3	7	1	4	0.6815000000000001
Tower Bombarde	2018-02-23	2	7	1	3	0.6815000000000001
Duralumin Wind	2018-01-09	1	7	1	2	0.6815000000000001
Ender Story: Chapter 1	2018-01-01	3	7	1	4	0.6815000000000001
Sink or Skim	2018-01-12	3	7	1	4	0.6815000000000001
Advanced Mechanized Spacecraft	2018-01-01	2	7	1	3	0.6815000000000001
The Seven Districts of Sin: The Tail Makes the Fox - Episode 1	2018-02-08	5	7	1	6	0.6815000000000001
Haunted Hotel: Lonely Dream	2018-01-22	3	7	1	4	0.6815000000000001
Rite of Passage: Hide and Seek Collector's Edition	2018-01-31	5	7	1	6	0.6815000000000001
Animosity	2018-08-20	3	7	1	4	0.6815000000000001
Casino Blackjack	2018-02-23	2	7	1	3	0.6815000000000001
Are You Alone?	2018-07-11	4	7	1	5	0.6815000000000001
Stack & Crack	2018-04-12	3	7	1	4	0.6815000000000001
Graveyard Birds	2018-03-08	3	7	1	4	0.6815000000000001
Firebird - Steam version	2018-04-03	2	7	1	3	0.6815000000000001
Hazmat Hijinks	2018-08-01	2	7	1	3	0.6815000000000001
Atex Brawl	2018-08-16	11	7	1	12	0.6815000000000001
Gamer Sensei's Range Royale	2018-09-17	10	7	1	11	0.6815000000000001
Hallo Spaceboy	2018-06-05	2	7	1	3	0.6815000000000001
Rio Rex	2018-06-05	2	7	1	3	0.6815000000000001
Witch of the Woods	2018-10-24	3	7	1	4	0.6815000000000001
Brath: Brain and Math	2018-07-13	3	7	1	4	0.6815000000000001
Pythagoras' Perpetual Motion Machine	2018-11-13	2	7	1	3	0.6815000000000001
Save The Cookie	2018-10-30	3	7	1	4	0.6815000000000001
Mystic Ruins	2018-07-21	2	7	1	3	0.6815000000000001
Farjob	2018-08-21	1	7	1	2	0.6815000000000001
Panco's Journey	2018-09-15	3	7	1	4	0.6815000000000001
Entre-Deux: Cursed	2018-09-12	2	7	1	3	0.6815000000000001
A Sun Of Salt	2018-08-28	4	7	1	5	0.6815000000000001
ROLL!	2018-10-03	2	7	1	3	0.6815000000000001
Spec Defense	2018-11-08	6	7	1	7	0.6815000000000001
The Horologist's Legacy	2018-10-24	3	7	1	4	0.6815000000000001
WayDown	2018-11-06	2	7	1	3	0.6815000000000001
Dear Apothecary	2018-11-30	2	7	1	3	0.6815000000000001
Julie's Sweets	2018-11-23	6	7	1	7	0.6815000000000001
Super Captain 3D	2018-11-12	2	7	1	3	0.6815000000000001
Grooming Adventure	2018-11-22	2	7	1	3	0.6815000000000001
Retro Wing Prime	2018-12-11	2	7	1	3	0.6815000000000001
City of the Shroud	2018-08-09	29	19	5	34	0.6809999999999999
Handball Action Total	2018-02-16	5	19	5	10	0.6809999999999999
Trains VR	2018-08-30	7	19	5	12	0.6809999999999999
Austen Translation	2018-05-01	8	19	5	13	0.6809999999999999
Unrect	2018-01-17	8	19	5	13	0.6809999999999999
Give Me Your Coins	2018-11-28	6	19	5	11	0.6809999999999999
Caveman Stories	2018-11-23	4	19	5	9	0.6809999999999999
Marvellous Inc.	2018-04-28	7	19	5	12	0.6809999999999999
Huge Enemy - Worldbreakers	2018-09-07	11	19	5	16	0.6809999999999999
SUM	2018-07-28	3	19	5	8	0.6809999999999999
Romance of the Three Kingdoms XII with Power Up Kit	2018-01-17	208	173	66	274	0.6809000000000001
Patent9	2018-03-11	5	46	15	20	0.6807
Dying Light: Bad Blood	2018-09-13	1374	2530	1098	2472	0.6806
YUMENIKKI -DREAM DIARY-	2018-02-23	823	835	350	1173	0.6803
Abasralsa	2018-01-12	10	327	131	141	0.6802
Hentai Temple	2018-08-03	80	397	161	241	0.68
Defend the Highlands: World Tour	2018-01-26	5	16	4	9	0.68
Pixel Arcade	2018-04-02	15	16	4	19	0.68
Cheitha	2018-03-07	5	16	4	9	0.68
The Hardest Dungeon	2018-11-29	4	16	4	8	0.68
Ashes	2018-10-26	3	16	4	7	0.68
Stormbound	2018-05-15	265	729	305	570	0.6797
NoReload Heroes	2018-04-27	12	56	19	31	0.6797
Jellyfish Season	2018-09-27	477	56	19	496	0.6797
Street Fighter 30th Anniversary Collection	2018-05-29	1735	1503	646	2381	0.6796
Hentai Case Opening	2018-09-27	18	191	74	92	0.6796
PWND	2018-04-06	600	632	263	863	0.6795
Deathmatch Soccer	2018-07-11	6	13	3	9	0.6793000000000001
Super Pillow Fight	2018-05-16	4	13	3	7	0.6793000000000001
Cross-Stitch Puzzle	2018-03-26	4	13	3	7	0.6793000000000001
Chop It	2018-09-15	5	13	3	8	0.6793000000000001
Castle Agony	2018-04-06	3	13	3	6	0.6793000000000001
Arca's Path VR	2018-12-04	4	13	3	7	0.6793000000000001
New Ice York	2018-07-04	3	13	3	6	0.6793000000000001
Weyrwood	2018-11-29	17	13	3	20	0.6793000000000001
Breakout	2018-11-09	3	13	3	6	0.6793000000000001
尘沙的选择 THE CHOICE OF SAND	2018-11-22	5	13	3	8	0.6793000000000001
Heavy Memories	2018-12-01	2	13	3	5	0.6793000000000001
Paper Shakespeare: To Date Or Not To Date?	2018-04-04	3	10	2	5	0.6793000000000001
Neon Defense 1 : Pink Power	2018-06-22	4	10	2	6	0.6793000000000001
Wars and Battles: October War	2018-11-28	5	10	2	7	0.6793000000000001
Baseball Mogul 2018	2018-04-24	16	10	2	18	0.6793000000000001
Neonwall	2018-09-13	2	10	2	4	0.6793000000000001
The Day I Died	2018-05-10	2	10	2	4	0.6793000000000001
无法传达的话语（Words cannot convey）	2018-08-03	3	10	2	5	0.6793000000000001
Lab.Gen.	2018-08-29	2	10	2	4	0.6793000000000001
DinoKnights	2018-08-23	23	10	2	25	0.6793000000000001
Buddinpals - Take One Home With You !!	2018-11-15	3	10	2	5	0.6793000000000001
AO International Tennis	2018-05-07	94	257	102	196	0.6792
Chocolate makes you happy 5	2018-04-24	4	66	23	27	0.6792
Catan VR	2018-06-13	21	66	23	44	0.6792
Hero Academy 2	2018-05-29	249	81	29	278	0.6790999999999999
Mussoumano: Ataque dos Haters	2018-04-10	5	27	8	13	0.6790999999999999
Transference	2018-09-18	23	285	114	137	0.679
Marching Simulator	2018-07-30	15	35	11	26	0.679
Echo Of Soul	2018-12-07	297	329	133	430	0.6787000000000001
Do you know de way	2018-03-15	7	166	64	71	0.6787000000000001
Apex Construct	2018-03-20	27	154	59	86	0.6787000000000001
The Castle Disaster	2018-04-01	26	83	30	56	0.6781999999999999
Sausage Sports Club	2018-07-19	10	24	7	17	0.6776000000000001
San Matias - Mafia City	2018-02-13	4	24	7	11	0.6776000000000001
BELOW	2018-12-14	765	802	341	1106	0.6775
Kickshot	2018-05-04	14	45	15	29	0.6775
SUFFER	2018-12-11	5	45	15	20	0.6775
Uncharted Waters Online - Steam	2018-12-19	179	235	94	273	0.6769
Oh Trap!	2018-12-27	21	55	19	40	0.6769
Eternal Dread	2018-03-03	17	37	12	29	0.6765000000000001
Changeover: Decisions	2018-05-18	6	37	12	18	0.6765000000000001
Defense: Abominations	2018-08-24	6	37	12	18	0.6765000000000001
Zeal	2018-09-24	779	311	127	906	0.6764
Pukan Bye Bye	2018-03-27	13	104	39	52	0.6764
The Islander	2018-02-13	35	283	115	150	0.6763
DON'T touch the walls	2018-02-26	3	21	6	9	0.6759000000000001
Parker & Lane: Twisted Minds	2018-12-21	13	29	9	22	0.6758
Exorder	2018-03-19	19	47	16	35	0.6757
Sea Dogs	2018-01-14	13	89	33	46	0.6756000000000001
.T.E.S.T: Expected Behaviour	2018-05-03	12	62	22	34	0.6756000000000001
Marble Run 2D	2018-03-05	2602	62	22	2624	0.6756000000000001
CRAKEN	2018-12-14	10	52	18	28	0.6755
All Walls Must Fall	2018-02-23	42	177	70	112	0.6754000000000001
The King's Bird	2018-08-23	29	355	147	176	0.6753
Death Toll	2018-04-11	64	200	80	144	0.675
Monkey Slap	2018-02-15	202	91	34	236	0.6748000000000001
Woodpunk	2018-11-22	72	122	47	119	0.6746
Mahjong Club	2018-08-30	76	234	95	171	0.6744
Dungeon Crowley	2018-10-11	10	59	21	31	0.6742
Raging Justice	2018-05-08	15	93	35	50	0.6741
SKIPCHASER	2018-06-04	596	49	17	613	0.6741
IMAZE.EXE	2018-11-24	6	44	15	21	0.6741
Hex Gambit	2018-10-15	9	18	5	14	0.674
Kingdoms of Marazia: Classic	2018-08-06	14	18	5	19	0.674
Eternal Man: Village	2018-03-19	14	18	5	19	0.674
Glaive: Brick Breaker	2018-04-26	3	18	5	8	0.674
Digital Jigsaw Puzzle	2018-08-03	8	18	5	13	0.674
立方杀阵（Cubic Kill Array）	2018-08-02	5	18	5	10	0.674
NightKnight	2018-08-28	5	18	5	10	0.674
Fish Duel	2018-09-26	8	18	5	13	0.674
Necromancer Returns	2018-02-02	51	76	28	79	0.6739
Hide and go boom	2018-02-17	9	26	8	17	0.6739
Kitty Play	2018-08-30	4	26	8	12	0.6739
Adventures Of Pipi 2 Save Hype	2018-05-24	3	26	8	11	0.6739
ASCENT: Crash Landing	2018-11-09	3	26	8	11	0.6739
Art of Murder - Hunt for the Puppeteer	2018-07-13	18	88	33	51	0.6738
Apocalipsis	2018-02-28	32	290	120	152	0.6734
Oh, you touch my balls ( ͡° ͜ʖ ͡°)	2018-10-10	16	95	36	52	0.6734
Zombie Desperation	2018-03-23	5	66	24	29	0.6733
Training aim	2018-02-27	5	31	10	15	0.6729999999999999
祛魅·入灭（祛魅2） - Disenchantment Nirvana	2018-11-15	5	31	10	15	0.6729999999999999
A tractor	2018-08-15	33	97	37	70	0.6727
Annotation of Love	2018-03-28	22	73	27	49	0.6727
三国英雄列传 (Legendary Heros in the Three Kingdoms)	2018-04-27	35	46	16	51	0.6724
TITANIC Shipwreck Exploration	2018-10-29	6	46	16	22	0.6724
Quanect	2018-04-13	7	41	14	21	0.6724
Score a goal 2 (Physical football)	2018-03-16	3	68	25	28	0.6723
The Spatials: Galactology	2018-04-18	234	176	71	305	0.6720999999999999
Shrug Island - The Meeting	2018-05-09	3	15	4	7	0.672
Asemblance: Oversight	2018-05-15	7	15	4	11	0.672
Red Rover	2018-06-19	6	15	4	10	0.672
Free road	2018-04-24	3	15	4	7	0.672
EnHanced	2018-11-08	2	15	4	6	0.672
Doodle Farm	2018-11-15	4	15	4	8	0.672
I Misteri di Maggia	2018-03-05	10	23	7	17	0.6718000000000001
Tombeaux	2018-11-06	3	23	7	10	0.6718000000000001
Heaven & Hell	2018-12-11	5	23	7	12	0.6718000000000001
Escape From Tethys	2018-07-13	168	287	120	288	0.6716
BattleRush	2018-03-27	434	1979	895	1329	0.6714
Claybook	2018-08-31	120	173	70	190	0.6714
Bombix	2018-03-02	630	934	413	1043	0.6713
Cine Tracer	2018-09-28	39	293	123	162	0.6711
Galactic Force	2018-11-16	11	65	24	35	0.6709
Electromaze Defense	2018-02-01	5	28	9	14	0.6709
Drink 'Em	2018-10-13	9	28	9	18	0.6709
STAY	2018-05-16	164	344	146	310	0.6708
Groove Coaster	2018-07-17	544	1016	452	996	0.6707
Volleying	2018-05-16	2983	236	98	3081	0.6707
Road Scars: Origins	2018-04-03	2834	170	69	2903	0.6707
The Dark Occult	2018-09-25	123	719	316	439	0.6706000000000001
Negligee: Love Stories (adult ver)	2018-09-14	139	140	56	195	0.6706000000000001
Merlin vs Zombies	2018-04-03	5	43	15	20	0.6706000000000001
Howlville: The Dark Past	2018-05-11	11	43	15	26	0.6706000000000001
Fat City	2018-10-22	1	3	0	1	0.6706000000000001
EGG HUNT VR	2018-04-03	2	3	0	2	0.6706000000000001
DinoBlaster	2018-01-03	2	3	0	2	0.6706000000000001
Excursion	2018-08-18	3	3	0	3	0.6706000000000001
Bricks In The Box	2018-07-12	4	3	0	4	0.6706000000000001
Space Zombies Invasion	2018-03-02	2	3	0	2	0.6706000000000001
Temple of Spikes	2018-03-08	2	3	0	2	0.6706000000000001
Tale of Alamar	2018-03-01	2	3	0	2	0.6706000000000001
Impossibox	2018-01-22	3	3	0	3	0.6706000000000001
Rockochet	2018-08-06	3	3	0	3	0.6706000000000001
Brazilian Adventure	2018-03-19	2	3	0	2	0.6706000000000001
CRAZY BIGHEADS	2018-03-14	11	3	0	11	0.6706000000000001
Quirky Crook	2018-03-27	1	3	0	1	0.6706000000000001
The Tension	2018-11-30	2	3	0	2	0.6706000000000001
Domino Effect	2018-02-13	2	3	0	2	0.6706000000000001
Yoltrund	2018-01-31	2	3	0	2	0.6706000000000001
Boomer Rampage	2018-01-01	2	3	0	2	0.6706000000000001
Queen's Tales: Sins of the Past Collector's Edition	2018-01-19	3	3	0	3	0.6706000000000001
Off The Record: Liberty Stone Collector's Edition	2018-01-12	3	3	0	3	0.6706000000000001
Hill Quest	2018-01-26	2	3	0	2	0.6706000000000001
Vector's Adventures	2018-06-01	1	3	0	1	0.6706000000000001
Powerless	2018-01-19	2	3	0	2	0.6706000000000001
Drumming VR	2018-02-06	1	3	0	1	0.6706000000000001
R Academy	2018-02-05	3	3	0	3	0.6706000000000001
Technolites: Episode 1	2018-10-31	2	3	0	2	0.6706000000000001
Admine	2018-02-16	2	3	0	2	0.6706000000000001
Karloman and His Iced Muffins	2018-12-31	2	3	0	2	0.6706000000000001
Aurora	2018-03-02	1	3	0	1	0.6706000000000001
Porcelain Panic	2018-02-19	1	3	0	1	0.6706000000000001
Monktastic	2018-01-31	2	3	0	2	0.6706000000000001
Riddles of Fate: Memento Mori Collector's Edition	2018-02-09	4	3	0	4	0.6706000000000001
Fantasy Mosaics 25: Wedding Ceremony	2018-03-14	4	3	0	4	0.6706000000000001
Alea	2018-02-20	1	3	0	1	0.6706000000000001
Spencer	2018-03-23	2	3	0	2	0.6706000000000001
Whispered Secrets: Into the Wind Collector's Edition	2018-02-20	4	3	0	4	0.6706000000000001
Mayan Prophecies: Blood Moon Collector's Edition	2018-02-28	3	3	0	3	0.6706000000000001
European Mystery: Flowers of Death Collector's Edition	2018-03-05	3	3	0	3	0.6706000000000001
Surface: Alone in the Mist Collector's Edition	2018-03-07	3	3	0	3	0.6706000000000001
Wall Walker	2018-09-27	2	3	0	2	0.6706000000000001
Spirits of Mystery: The Silver Arrow Collector's Edition	2018-03-30	4	3	0	4	0.6706000000000001
Metis One	2018-06-01	2	3	0	2	0.6706000000000001
Laws of Machine	2018-04-18	1	3	0	1	0.6706000000000001
The Stroke of Midnight	2018-04-26	3	3	0	3	0.6706000000000001
The Blobs Fight	2018-06-22	5	3	0	5	0.6706000000000001
2260	2018-08-08	4	3	0	4	0.6706000000000001
Leder Panzer	2018-08-17	5	3	0	5	0.6706000000000001
Data Ball	2018-06-27	3	3	0	3	0.6706000000000001
greenTech+	2018-05-09	2	3	0	2	0.6706000000000001
Hungry Piggy vs Chicken	2018-04-30	2	3	0	2	0.6706000000000001
Catsapults	2018-06-12	2	3	0	2	0.6706000000000001
Stabby Machine	2018-07-31	2	3	0	2	0.6706000000000001
Deflection Dimension	2018-06-08	2	3	0	2	0.6706000000000001
Discs of Steel Party	2018-10-15	2	3	0	2	0.6706000000000001
The Enthralling Realms	2018-07-10	6	3	0	6	0.6706000000000001
Bot Tales: The Crashed	2018-06-13	2	3	0	2	0.6706000000000001
3, 2, 1, SURVIVE !	2018-06-02	2	3	0	2	0.6706000000000001
Drops: Rhythm Garden	2018-06-07	4	3	0	4	0.6706000000000001
Solitude - Escape of Head	2018-06-12	2	3	0	2	0.6706000000000001
Myths of the World: Of Fiends and Fairies Collector's Edition	2018-06-18	3	3	0	3	0.6706000000000001
The Stones of Yalmrith	2018-09-21	2	3	0	2	0.6706000000000001
Brathian	2018-06-15	2	3	0	2	0.6706000000000001
Polymatic	2018-06-27	2	3	0	2	0.6706000000000001
The change	2018-06-28	1	3	0	1	0.6706000000000001
Vanguardian	2018-06-22	4	3	0	4	0.6706000000000001
Zodicat	2018-08-30	3	3	0	3	0.6706000000000001
MultiBall	2018-06-18	2	3	0	2	0.6706000000000001
Ninja SpeedRush	2018-07-18	2	3	0	2	0.6706000000000001
For the Revenge	2018-08-16	3	3	0	3	0.6706000000000001
Love Chronicles: A Winter's Spell Collector's Edition	2018-08-03	4	3	0	4	0.6706000000000001
Urban Explorer Golf	2018-07-30	1	3	0	1	0.6706000000000001
Warlords.IO	2018-11-21	4	3	0	4	0.6706000000000001
Fortified Swiss	2018-11-23	3	3	0	3	0.6706000000000001
Aether Drift	2018-08-27	3	3	0	3	0.6706000000000001
Beast Modon	2018-09-01	2	3	0	2	0.6706000000000001
Tanks With Hands: Armed and Treaded	2018-09-07	3	3	0	3	0.6706000000000001
Don't touch me	2018-09-08	1	3	0	1	0.6706000000000001
Rescale	2018-09-03	3	3	0	3	0.6706000000000001
DoC God Mode Edition	2018-09-04	3	3	0	3	0.6706000000000001
Arcane Trials	2018-09-20	1	3	0	1	0.6706000000000001
Mochi Mochi Boy	2018-12-19	2	3	0	2	0.6706000000000001
Falling Plus	2018-11-30	2	3	0	2	0.6706000000000001
Shoot'n'Scroll 3D	2018-10-03	1	3	0	1	0.6706000000000001
Jewel Tree	2018-10-03	3	3	0	3	0.6706000000000001
Space Ashes	2018-10-08	1	3	0	1	0.6706000000000001
Sable Maze: Twelve Fears Collector's Edition	2018-10-26	3	3	0	3	0.6706000000000001
Washed Up Wizard	2018-10-09	3	3	0	3	0.6706000000000001
Little Memories	2018-09-28	2	3	0	2	0.6706000000000001
El Pansas	2018-10-11	1	3	0	1	0.6706000000000001
Swap Swap	2018-10-01	1	3	0	1	0.6706000000000001
Bohrdom	2018-12-20	2	3	0	2	0.6706000000000001
Fallen Threats	2018-12-28	2	3	0	2	0.6706000000000001
Stick to the end	2018-11-08	1	3	0	1	0.6706000000000001
Symphonic Mayhem	2018-10-22	7	3	0	7	0.6706000000000001
Light Up the Holidays	2018-12-03	2	3	0	2	0.6706000000000001
TOLTEC AND THE MYSTERIES OF THE SECRET ISLAND	2018-11-28	1	3	0	1	0.6706000000000001
IScream	2018-11-06	2	3	0	2	0.6706000000000001
Ponkle	2018-11-09	2	3	0	2	0.6706000000000001
Spark Five	2018-11-14	1	3	0	1	0.6706000000000001
Bots Rush	2018-11-30	4	3	0	4	0.6706000000000001
Case Simulator Weapons and Armors	2018-11-15	2	3	0	2	0.6706000000000001
Condition Red	2018-11-19	1	3	0	1	0.6706000000000001
Tank Blazers	2018-12-19	4	3	0	4	0.6706000000000001
Super Blackout	2018-12-14	1	3	0	1	0.6706000000000001
Anime Girl Slide Puzzle	2018-12-31	1	3	0	1	0.6706000000000001
A Christmas Peril	2018-12-30	3	3	0	3	0.6706000000000001
Spirit Animal Survival	2018-06-07	24	91	35	59	0.6705
Godly Corp	2018-12-13	5	38	13	18	0.6705
SpaceWorms	2018-12-28	7	12	3	10	0.6698000000000001
Asura Valley	2018-01-24	3	12	3	6	0.6698000000000001
DarkDIRE	2018-12-11	4	12	3	7	0.6698000000000001
Cosmic Snake 8473/3671	2018-05-24	7	12	3	10	0.6698000000000001
BULLETLINE	2018-06-04	3	12	3	6	0.6698000000000001
Distorted Illusions	2018-10-19	3	12	3	6	0.6698000000000001
SquareWorld Unpixeled	2018-10-26	5	12	3	8	0.6698000000000001
Empires Apart	2018-03-29	659	1525	691	1350	0.6697
Fable Fortune	2018-02-22	562	382	164	726	0.6697
No Way Out - A Dead Realm Tale	2018-10-26	5	20	6	11	0.6694
Crazy Soccer	2018-06-28	11	20	6	17	0.6694
MONMUSU * FIGHT!	2018-05-01	4	20	6	10	0.6694
Achievement Lurker: Ballad of the Shimapan Warrior - King of Panties	2018-06-19	2	20	6	8	0.6694
Obliteracy	2018-09-14	11	20	6	17	0.6694
Farplane Relic	2018-10-17	10	20	6	16	0.6694
Koropokkur in Love ~A Little Fairy’s Tale~	2018-09-27	5	20	6	11	0.6694
Russian Roads	2018-01-04	1989	111	44	2033	0.6689
Basingstoke	2018-04-27	85	247	104	189	0.6688
TSUKUMOHIME	2018-01-25	143	97	38	181	0.6687000000000001
Industry Giant	2018-10-02	14	40	14	28	0.6687000000000001
Rampage VR	2018-04-05	19	52	19	38	0.6683
WORLD HENTAI	2018-09-01	10	52	19	29	0.6683
Chiaro and the Elixir of Life	2018-09-14	8	30	10	18	0.6683
Super Golf 2018	2018-06-11	6	30	10	16	0.6683
[MARS] Total Warfare	2018-12-01	42	71	27	69	0.6681999999999999
LifeZ - Survival	2018-03-29	35	163	67	102	0.6681
Battle Carnival	2018-04-26	593	828	371	964	0.668
TENET	2018-08-27	7	47	17	24	0.6677
Space Stories: Darth Star	2018-02-13	731	47	17	748	0.6677
Escape Legacy : Ancient Scrolls	2018-10-15	12	47	17	29	0.6677
Buried Alive VR	2018-04-03	1	9	2	3	0.6676000000000001
The Communist Dogifesto	2018-01-31	3	9	2	5	0.6676000000000001
Soul for two	2018-01-26	2	9	2	4	0.6676000000000001
TURRET SYNDROME VR	2018-01-25	3	9	2	5	0.6676000000000001
Galactic Delivery	2018-03-23	3	9	2	5	0.6676000000000001
The Real Laser Ball	2018-08-21	135	9	2	137	0.6676000000000001
Strategic Command Classic: Global Conflict	2018-02-08	16	9	2	18	0.6676000000000001
ESPER	2018-07-06	3	9	2	5	0.6676000000000001
Boxing Apocalypse	2018-04-20	5	9	2	7	0.6676000000000001
BeeFender	2018-06-25	3	9	2	5	0.6676000000000001
Spectrubes Infinity	2018-04-20	2	9	2	4	0.6676000000000001
The Bell Chimes for Gold	2018-04-06	11	9	2	13	0.6676000000000001
Elude	2018-04-06	4	9	2	6	0.6676000000000001
Exoder	2018-04-23	3	9	2	5	0.6676000000000001
VRGROUND : Crazy Farm	2018-07-17	5	9	2	7	0.6676000000000001
The Legend of Monster Mountain	2018-09-07	2	9	2	4	0.6676000000000001
DomiCard	2018-08-17	4	9	2	6	0.6676000000000001
Bleeding Sun	2018-07-13	3	9	2	5	0.6676000000000001
Supaplex SQUARES	2018-08-21	5	9	2	7	0.6676000000000001
Shudder	2018-08-30	3	9	2	5	0.6676000000000001
Urban Lockdown	2018-08-15	2	9	2	4	0.6676000000000001
Mahjongg The Ultimate Collection 2	2018-08-13	15	9	2	17	0.6676000000000001
DEFENDER 3D	2018-10-23	2	9	2	4	0.6676000000000001
Steven the Sperm	2018-09-12	4	9	2	6	0.6676000000000001
Bibi Blocksberg - Big Broom Race 3	2018-11-19	5	9	2	7	0.6676000000000001
Fit it	2018-10-16	4	9	2	6	0.6676000000000001
DotX	2018-10-18	2	9	2	4	0.6676000000000001
Rogue Rails	2018-11-20	4	9	2	6	0.6676000000000001
Tippy Tree	2018-12-04	5	9	2	7	0.6676000000000001
1001 Jigsaw. Home Sweet Home	2018-12-10	4	9	2	6	0.6676000000000001
stepbystep	2018-11-22	1	9	2	3	0.6676000000000001
Tomato Way 2	2018-07-11	4	73	28	32	0.6674
Gunman Tales	2018-08-01	4	54	20	24	0.6670999999999999
BFF or Die	2018-09-13	11	42	15	26	0.6670999999999999
WARIUM	2018-03-01	4	17	5	9	0.6666
Bridge Trek	2018-03-12	5	17	5	10	0.6666
Count Dookie Fart	2018-03-05	3	17	5	8	0.6666
Mad Restaurant People	2018-09-09	4	17	5	9	0.6666
Juan v Juan	2018-08-03	15	17	5	20	0.6666
Laser Party	2018-12-29	5	17	5	10	0.6666
Rena And Elin	2018-08-03	10	37	13	23	0.6665000000000001
Tesla: The Weather Man	2018-05-17	2	6	1	3	0.6662
Mister Mart	2018-08-30	2	6	1	3	0.6662
Anicon - Animal Complex - Sheep's Path	2018-08-04	5	6	1	6	0.6662
Kitty Hawk	2018-01-03	2	6	1	3	0.6662
quadrantica	2018-04-06	2	6	1	3	0.6662
Gates of Horn and Ivory	2018-09-07	4	6	1	5	0.6662
Ancient Future	2018-01-26	4	6	1	5	0.6662
RoboVDino	2018-06-19	2	6	1	3	0.6662
Arcade Love	2018-06-19	4	6	1	5	0.6662
Defense Warfare	2018-01-18	5	6	1	6	0.6662
Snowglobe	2018-02-08	3	6	1	4	0.6662
Outrealm	2018-02-06	5	6	1	6	0.6662
Ninja Striker!	2018-04-18	3	6	1	4	0.6662
D.C. S#*!storm	2018-02-19	2	6	1	3	0.6662
Haunted Halls: Fears from Childhood Collector's Edition	2018-02-16	4	6	1	5	0.6662
Tactical Chronicle	2018-04-18	2	6	1	3	0.6662
PingPong Kings VR	2018-03-15	15	6	1	16	0.6662
Hardway Party	2018-10-05	4	6	1	5	0.6662
Nova Wing II	2018-04-11	2	6	1	3	0.6662
Jelly Bomber	2018-09-05	3	6	1	4	0.6662
Humble Pie	2018-05-08	4	6	1	5	0.6662
Mad Carnage	2018-08-02	2	6	1	3	0.6662
Galaxy Ball Defender	2018-04-25	3	6	1	4	0.6662
Guardian of Immortal Mountain(仙山守卫者)	2018-05-10	3	6	1	4	0.6662
Mushroom: The Ruckus	2018-05-01	1	6	1	2	0.6662
Sky Conqueror	2018-05-04	2	6	1	3	0.6662
Aeroplanoui	2018-07-18	4	6	1	5	0.6662
Midnight Awake	2018-06-20	3	6	1	4	0.6662
Freddy's Journey	2018-06-15	2	6	1	3	0.6662
Sumerian Blood: Gilgamesh against the Gods	2018-07-01	3	6	1	4	0.6662
Ammo Pigs: Armed and Delicious	2018-08-27	1	6	1	2	0.6662
Clouded	2018-12-13	2	6	1	3	0.6662
BrutalAliens	2018-08-21	3	6	1	4	0.6662
Fractal Chicken	2018-07-25	2	6	1	3	0.6662
PuppetShow™: Destiny Undone Collector's Edition	2018-07-18	3	6	1	4	0.6662
ZOLO - Zombies Only Live Once	2018-12-10	2	6	1	3	0.6662
Hags Castle	2018-08-02	2	6	1	3	0.6662
Caves of Plague	2018-08-14	5	6	1	6	0.6662
LoveBug	2018-08-31	3	6	1	4	0.6662
Goalkeeper Legend	2018-08-17	2	6	1	3	0.6662
Prank Masters	2018-08-16	4	6	1	5	0.6662
John Black: Memories	2018-08-22	2	6	1	3	0.6662
Infommi	2018-09-14	2	6	1	3	0.6662
DUCK CASINO: BULLET	2018-10-11	2	6	1	3	0.6662
Survival Ball	2018-11-08	3	6	1	4	0.6662
Burger Lord	2018-11-06	3	6	1	4	0.6662
Innocent Forest 2: The Bed in the Sky	2018-10-05	2	6	1	3	0.6662
Infinity Disk	2018-11-07	3	6	1	4	0.6662
VR Party Club	2018-10-15	2	6	1	3	0.6662
Leopoldo Manquiseil	2018-12-20	2	6	1	3	0.6662
Dark Dimensions: Homecoming Collector's Edition	2018-11-09	3	6	1	4	0.6662
Trivia Clash: Adult Film Star Edition	2018-11-05	5	6	1	6	0.6662
RoboSnakes: Core Wars Legacy	2018-12-26	3	6	1	4	0.6662
Rogalia	2018-10-15	140	342	149	289	0.6661
Rym 9000	2018-01-15	12	84	33	45	0.6661
aMAZE Gears	2018-03-02	5	77	30	35	0.6659999999999999
Survive in Angaria	2018-03-22	7	32	11	18	0.6659999999999999
AirMech Wastelands	2018-07-06	165	245	105	270	0.6657
THE WARRIORLOCK	2018-09-13	373	27	9	382	0.6657
Kingdom of the Dragon	2018-02-02	4	27	9	13	0.6657
Voxel Tanks	2018-06-05	4	27	9	13	0.6657
The Blue Box	2018-05-04	148	22	7	155	0.6657
Illusion: A Tale of the Mind	2018-06-01	12	22	7	19	0.6657
Lozenge	2018-03-02	3	22	7	10	0.6657
Reignman	2018-08-24	8	22	7	15	0.6657
Submerged: VR Escape the Room	2018-09-06	5	22	7	12	0.6657
Puppy Chef Academy	2018-09-07	3	22	7	10	0.6657
Chain Reaction : Sexy Hentai Girls	2018-12-26	4	22	7	11	0.6657
Miniballist	2018-03-13	1070	44	16	1086	0.6656000000000001
Doodle Date	2018-04-19	52	200	85	137	0.665
Seven Mysteries: The Last Page	2018-02-05	6	39	14	20	0.6648999999999999
Lust for Darkness	2018-06-12	288	2865	1353	1641	0.6647
A Boy and His Beard	2018-02-09	23	46	17	40	0.6643000000000001
War Of The Zombie	2018-04-05	44	46	17	61	0.6643000000000001
Float Night	2018-11-10	6	46	17	23	0.6643000000000001
Outbreak: The Nightmare Chronicles	2018-04-02	32	60	23	55	0.6642
Skautfold: Usurper	2018-02-21	46	210	90	136	0.6641
Swords and Soldiers 2 Shawarmageddon	2018-11-06	150	177	75	225	0.6641
NetHack: Legacy	2018-08-10	7	34	12	19	0.6641
Battle Summoners VR Basic	2018-06-22	10	34	12	22	0.6641
The Spirit Master of Retarnia -Conqueror of the Labyrinth-	2018-12-06	65	34	12	77	0.6641
Ling	2018-02-03	10	69	27	37	0.6636
Farstorm	2018-09-18	6	41	15	21	0.6634000000000001
LOGistICAL 2	2018-10-19	34	62	24	58	0.6633
Flamebound	2018-06-27	38	29	10	48	0.6633
Clark | HOOVA VR	2018-01-25	8	14	4	12	0.6633
Smogpunk	2018-09-14	3	14	4	7	0.6633
Mortal Manor	2018-01-15	6	14	4	10	0.6633
CRUSH 	2018-05-31	3	14	4	7	0.6633
MRS SNAKE	2018-03-19	3	14	4	7	0.6633
Round Mars	2018-03-27	3	14	4	7	0.6633
Avalon Legends Solitaire 3	2018-06-04	8	14	4	12	0.6633
BARDO	2018-10-01	5	14	4	9	0.6633
Hacktag	2018-02-14	77	274	120	197	0.6631
MARVEL END TIME ARENA	2018-04-30	1189	338	150	1339	0.6628000000000001
Mirage of Dragon	2018-01-26	3	24	8	11	0.6627
RoboBall	2018-11-16	6	24	8	14	0.6627
Silent Descent	2018-02-06	8	89	36	44	0.6626000000000001
Aces of the Luftwaffe - Squadron	2018-07-24	10	64	25	35	0.6626000000000001
Paralysis	2018-03-23	12	19	6	18	0.6625
Block Heads: Instakill	2018-08-14	12	19	6	18	0.6625
Hentai Puzzle X	2018-09-21	4	19	6	10	0.6625
Lost Artifacts: Time Machine	2018-11-02	9	19	6	15	0.6625
Around the World in 80 Days	2018-04-03	6	36	13	19	0.6624
Boxes Inc.	2018-05-07	17	57	22	39	0.6623
Adult Math	2018-12-26	4	57	22	26	0.6623
Sailaway - The Sailing Simulator	2018-02-27	163	644	295	458	0.6622
Just One Line	2018-09-12	33	82	33	66	0.6620999999999999
Legrand Legacy	2018-01-24	421	298	132	553	0.6619
Immortal: Unchained	2018-09-07	245	531	242	487	0.6617000000000001
The Unwelcomed	2018-01-30	7	31	11	18	0.6614
Blood 'n Bikinis	2018-10-17	16	31	11	27	0.6614
Last Encounter	2018-05-08	17	31	11	28	0.6614
ValeGuard	2018-08-23	93	115	48	141	0.6613
Freefall Tournament	2018-06-16	14	68	27	41	0.6612
Magic Nations - Card Game	2018-09-20	35	86	35	70	0.6611
Bravium	2018-01-04	26	52	20	46	0.6611
Otaku's Fantasy 2	2018-03-30	304	468	213	517	0.6609999999999999
Wer weiß denn sowas?	2018-10-18	33	45	17	50	0.6609
Infinite Gravity	2018-03-22	11	38	14	25	0.6609
Kuchisake Onna - 口裂け女	2018-10-09	6	38	14	20	0.6609
Woman's body	2018-12-06	3	38	14	17	0.6609
Silenced: The House	2018-03-07	6	61	24	30	0.6607
!Anyway!	2018-06-06	2498	304	136	2634	0.6604000000000001
lilGunBois	2018-06-03	30	26	9	39	0.6603
Bullet Witch	2018-04-25	86	365	165	251	0.6601
Dakar 18	2018-09-25	281	695	323	604	0.66
STONE	2018-09-21	5	63	25	30	0.66
Yuzi Lims: Hentai	2018-10-30	5	63	25	30	0.66
Black Jack Story	2018-04-25	4	47	18	22	0.6598999999999999
All-Star Fruit Racing	2018-07-13	27	151	65	92	0.6597
KNACK	2018-02-27	5	40	15	20	0.6596
Seeking Dawn	2018-07-12	73	527	243	316	0.6595000000000001
Flotilla 2	2018-08-17	4	21	7	11	0.6593000000000001
Balls and Magnets	2018-02-02	3	21	7	10	0.6593000000000001
MLB Home Run Derby VR	2018-04-26	7	21	7	14	0.6593000000000001
Shennong: Taste of Illusion	2018-12-18	3	21	7	10	0.6593000000000001
Mechsprofit: Mech Tycoon Simulator	2018-05-04	3	11	3	6	0.6593000000000001
Toy Generals	2018-04-19	4	11	3	7	0.6593000000000001
Super Hyperactive Ninja	2018-05-22	4	11	3	7	0.6593000000000001
Sacred Four	2018-02-15	3	11	3	6	0.6593000000000001
弹炸人2222	2018-01-04	4	11	3	7	0.6593000000000001
Purgatory Fell	2018-03-30	2	11	3	5	0.6593000000000001
Math Hero	2018-02-13	3	11	3	6	0.6593000000000001
The Geology Game	2018-03-05	2	11	3	5	0.6593000000000001
Ants! Mission of the salvation	2018-05-25	2	11	3	5	0.6593000000000001
Through The Tomb	2018-06-15	4	11	3	7	0.6593000000000001
Brotherhood United	2018-06-15	4	11	3	7	0.6593000000000001
Crimson Light	2018-06-18	59	11	3	62	0.6593000000000001
Watching Delusion	2018-08-03	2	11	3	5	0.6593000000000001
Antiquitas	2018-09-29	12	11	3	15	0.6593000000000001
Ah, Love!	2018-10-01	3	11	3	6	0.6593000000000001
FlyingMetalSuit	2018-11-20	3	11	3	6	0.6593000000000001
Jet Racing Extreme	2018-05-17	2248	825	388	2636	0.6589
Evil Labs	2018-06-15	22	58	23	45	0.6587000000000001
SpaceWalker	2018-01-03	15	16	5	20	0.6586
The Adventurous Four	2018-03-22	3	16	5	8	0.6586
Pang & Bang	2018-10-25	5	16	5	10	0.6586
Enchanted Path	2018-12-28	3	16	5	8	0.6586
Sit on bottle	2018-01-11	5	42	16	21	0.6585
Achievement Lurker: You are going to have to work for these nuts	2018-06-19	5	42	16	21	0.6585
HUBE: Seeker of Achievements	2018-05-16	9	124	53	62	0.6584000000000001
Cube Life: Island Survival	2018-04-20	70	113	48	118	0.6581999999999999
Simon the Sorcerer: 25th Anniversary Edition	2018-04-03	15	69	28	43	0.6581999999999999
My Little Bomb	2018-01-05	3	69	28	31	0.6581999999999999
Roguemance	2018-02-14	19	35	13	32	0.6581999999999999
Ancient Frontier: Steel Shadows	2018-12-11	13	28	10	23	0.6581999999999999
The Balcony	2018-03-26	5	28	10	15	0.6581999999999999
catAnod	2018-04-23	3	28	10	13	0.6581999999999999
Dreadnought	2018-10-14	3727	4125	2029	5756	0.658
Sarcophag	2018-04-05	436	171	75	511	0.658
Fortissimo FA INTL Ver	2018-08-24	256	93	39	295	0.6576000000000001
Catastronauts	2018-09-28	45	134	58	103	0.6573000000000001
Sanguo Warriors VR 三国虎将传VR	2018-09-27	5	53	21	26	0.6573000000000001
Miscreated	2018-12-18	5159	21084	10657	15816	0.657
Mechanism	2018-07-19	25	97	41	66	0.657
Eternal Fantasy	2018-10-19	31	37	14	45	0.6569
Grimmwood Open beta	2018-05-08	214	189	84	298	0.6568
Prank Bros	2018-07-31	181	64	26	207	0.6568
BlubBlub: Quest of the Blob	2018-05-29	6	23	8	14	0.6567000000000001
Holiday Escape	2018-08-18	94	23	8	102	0.6567000000000001
Sophie's Guardian	2018-10-31	14	46	18	32	0.6565000000000001
Evasion	2018-10-09	16	46	18	34	0.6565000000000001
Paper Dungeons Crawler	2018-07-17	11	30	11	22	0.6565000000000001
Battle of Kings VR	2018-02-01	7	30	11	18	0.6565000000000001
Go Guess	2018-04-27	8	30	11	19	0.6565000000000001
Ramen	2018-03-30	43	30	11	54	0.6565000000000001
Zquirrels Jump	2018-11-26	16	30	11	27	0.6565000000000001
Depression The Game	2018-07-07	15	188	84	99	0.6559
NOBUNAGA'S AMBITION: Tenkasousei with Power Up Kit	2018-01-17	127	79	33	160	0.6559
Border of her Heart	2018-02-14	5	48	19	24	0.6557
Super Sportmatchen	2018-05-24	25	39	15	40	0.6557
Returner 77	2018-04-11	8	39	15	23	0.6557
Void Monsters: Spring City Tales	2018-03-06	14	39	15	29	0.6557
The God	2018-05-18	5	39	15	20	0.6557
Freezeer	2018-06-21	19	124	54	73	0.6554000000000001
Art of Murder - FBI Confidential	2018-07-13	22	126	55	77	0.6552
Alone	2018-05-01	3	18	6	9	0.6551
Test your knowledge: Cities	2018-06-14	3	18	6	9	0.6551
Royal Roads	2018-11-23	7	18	6	13	0.6551
Achtung! Cthulhu Tactics	2018-10-04	79	145	64	143	0.655
R-COIL	2018-02-05	6	32	12	18	0.655
Fritz Chess 16 Steam Edition	2018-04-03	26	32	12	38	0.655
Initial 2 : New Stage	2018-10-19	109	287	132	241	0.6548999999999999
JQ: Beautiful Japan	2018-08-23	3	61	25	28	0.6547
AENTITY	2018-04-14	5	41	16	21	0.6547
Paper Fire Rookie	2018-09-20	6	41	16	22	0.6547
Cat's Bar	2018-03-12	5	25	9	14	0.6546
AstronTycoon	2018-06-06	8	25	9	17	0.6546
Snake, snake, snake!	2018-05-18	3	25	9	12	0.6546
NUMERIC	2018-07-02	9	25	9	18	0.6546
Dead Prison	2018-09-13	9	25	9	18	0.6546
Life in the Dorms	2018-08-01	3	8	2	5	0.6542
Dragons Never Cry	2018-02-28	4	8	2	6	0.6542
Train Crisis	2018-02-08	5	8	2	7	0.6542
Gimbal Gravity	2018-01-25	3	8	2	5	0.6542
NewTypes	2018-02-19	3	8	2	5	0.6542
Rise:30 Minutes to Extinction	2018-09-19	2	8	2	4	0.6542
DEAD TARGET VR: Zombie Intensified	2018-01-09	2	8	2	4	0.6542
Progeny VR	2018-01-16	3	8	2	5	0.6542
Choices, The Game	2018-02-01	2	8	2	4	0.6542
Shoppe Keep 2 Character Creator Preview	2018-02-05	6	8	2	8	0.6542
Find the Gnome	2018-06-28	4	8	2	6	0.6542
Risky Wings	2018-07-31	2	8	2	4	0.6542
Light Borrower	2018-06-28	4	8	2	6	0.6542
Last Stanza	2018-11-09	4	8	2	6	0.6542
Etherian	2018-11-08	3	8	2	5	0.6542
The Stray Cat	2018-05-10	11	8	2	13	0.6542
Drive Switch Evade	2018-07-12	3	8	2	5	0.6542
The Skeleton	2018-07-10	2	8	2	4	0.6542
AceSpeeder3	2018-07-10	2	8	2	4	0.6542
Crime Girl	2018-09-17	3	8	2	5	0.6542
The Sky Climber	2018-11-10	3	8	2	5	0.6542
Throne Quest	2018-12-19	4	8	2	6	0.6542
Puzzle game for kids	2018-12-27	4	8	2	6	0.6542
Lilipalace	2018-07-13	43	76	32	75	0.6541
Bird Watcher	2018-02-19	6	43	17	23	0.6537999999999999
LOGistICAL: ABC Islands	2018-05-04	40	43	17	57	0.6537999999999999
Ghostly Horizon	2018-04-04	6	13	4	10	0.6537999999999999
YangBo Adventure	2018-01-26	10	13	4	14	0.6537999999999999
Super Jet Juck	2018-11-23	3	13	4	7	0.6537999999999999
Sword of the Black Stone	2018-05-25	4	13	4	8	0.6537999999999999
Castle: Jigsaw Puzzles	2018-05-24	4	13	4	8	0.6537999999999999
Necro Immortallis	2018-05-31	3	13	4	7	0.6537999999999999
GIPHY World VR	2018-08-30	4	13	4	8	0.6537999999999999
Write word	2018-10-30	1	13	4	5	0.6537999999999999
Wild West Saga	2018-12-18	470	489	232	702	0.6537000000000001
Angel, Devil, Elf and Me!	2018-11-07	14	34	13	27	0.6537000000000001
WIN THE GAME!	2018-04-06	22	194	88	110	0.6536
TAVERN GUARDIANS: BANQUET	2018-11-30	10	54	22	32	0.6536
Coffee Crisis	2018-05-05	666	116	51	717	0.653
Chinese inn	2018-01-11	36	56	23	59	0.653
Nautical Life	2018-04-06	7	27	10	17	0.6529
Azuran Tales: Trials	2018-06-01	4	27	10	14	0.6529
Cute Cats PuZZles	2018-06-19	3	27	10	13	0.6529
True Puzzle	2018-06-22	31	120	53	84	0.6527
The Bard's Tale IV	2018-09-18	2102	986	482	2584	0.6526000000000001
HEXION	2018-05-31	13	20	7	20	0.6525
Miazma or the Devil's Stone	2018-05-02	6	20	7	13	0.6525
Bomb Hunter MT	2018-04-03	2	20	7	9	0.6525
Long Arm of the Law	2018-11-29	7	20	7	14	0.6525
Big Breezy Boat	2018-10-23	6	20	7	13	0.6525
Firmament Wars	2018-09-03	8	38	15	23	0.6517000000000001
Beckett	2018-02-27	10	94	41	51	0.6516
Creepy Road	2018-05-18	18	94	41	59	0.6516
Mugsters	2018-07-17	27	62	26	53	0.6516
The Royal Marines Commando	2018-07-13	9	115	51	60	0.6515000000000001
Element	2018-07-27	115	29	11	126	0.6514
Deadstep	2018-03-10	9	29	11	20	0.6514
Ball Grabbers	2018-07-13	7	29	11	18	0.6514
Coregrounds	2018-04-30	23	51	21	44	0.6511
Selenophobia	2018-03-29	277	127	57	334	0.6507
Chicken Labyrinth Puzzles	2018-03-26	1980	133	60	2040	0.6504000000000001
Short Life	2018-11-14	15	108	48	63	0.6503
Alter Army	2018-08-06	5	22	8	13	0.6503
Winning Post 8 2018	2018-03-15	1207	22	8	1215	0.6503
Tennis Arcade VR	2018-07-20	4	22	8	12	0.6503
Till the dawn, waiting	2018-01-12	6	22	8	14	0.6503
Dwarf Defense	2018-05-28	3	22	8	11	0.6503
Tennis Story	2018-10-05	12	22	8	20	0.6503
Knights of the Card Table	2018-12-28	6	22	8	14	0.6503
The Goatman	2018-09-03	22	294	139	161	0.6502
Elium - Prison Escape	2018-02-28	11	31	12	23	0.6502
CityBattle | Virtual Earth	2018-10-02	638	1048	520	1158	0.65
The Homestead Invasion	2018-01-10	3	15	5	8	0.65
PROJECT MAZE	2018-05-28	5	15	5	10	0.65
NetStars - VR Goalie Trainer	2018-03-29	3	15	5	8	0.65
CubeRun	2018-03-16	7	15	5	12	0.65
The Basilisk	2018-07-24	4	15	5	9	0.65
Badminton Warrior	2018-11-15	3	15	5	8	0.65
CandyVenture	2018-12-14	5	15	5	10	0.65
Refight: Burning Engine	2018-10-15	81	275	130	211	0.6497
Planet of the Apes: Last Frontier	2018-08-24	20	118	53	73	0.6497
The Watson-Scott Test	2018-10-19	60	470	228	288	0.6492
TERRORHYTHM (TRRT)	2018-10-26	30	59	25	55	0.6492
Milanoir	2018-05-31	16	78	34	50	0.6491
HIVE	2018-05-02	573	61	26	599	0.6489
Dead Secret Circle	2018-05-01	6	46	19	25	0.6489
Black Desert (Retired)	2018-05-17	14584	11009	5746	20330	0.6487
Code51:Mecha Arena	2018-08-28	9	24	9	18	0.6487
破音乱斗Ouch!War	2018-06-20	19	24	9	28	0.6487
Anderson	2018-05-29	94	24	9	103	0.6487
Range Ball	2018-08-13	8	24	9	17	0.6487
Sophisticated Puzzles	2018-08-02	43	24	9	52	0.6487
MOLOCH (Zero)	2018-10-26	4	24	9	13	0.6487
Time Gap	2018-01-15	68	115	52	120	0.6483
Trafic Road Rush	2018-11-30	9	35	14	23	0.6483
EARTH DEFENSE FORCE 4.1 WINGDIVER THE SHOOTER	2018-04-26	34	121	55	89	0.648
Hikari! Clover Rescue	2018-12-17	17	50	21	38	0.6479
Brocat: the B Game	2018-11-09	3	5	1	4	0.6478
Build It	2018-09-17	4	5	1	5	0.6478
Fragmentum	2018-05-01	3	5	1	4	0.6478
Harmonium	2018-03-28	4	5	1	5	0.6478
VR Hockey League	2018-09-25	4	5	1	5	0.6478
Oneirogen	2018-05-22	1	5	1	2	0.6478
Koikoi	2018-07-18	3	5	1	4	0.6478
Kingdom of Blades	2018-02-24	3	5	1	4	0.6478
Fenix Box	2018-01-12	4	5	1	5	0.6478
The Painter's Apprentice	2018-05-31	3	5	1	4	0.6478
Z: The End	2018-06-15	2	5	1	3	0.6478
Beer Ranger	2018-02-19	3	5	1	4	0.6478
Aplestia	2018-02-19	3	5	1	4	0.6478
FriendZoned Archer	2018-02-27	2	5	1	3	0.6478
Ball Platformer	2018-03-12	4	5	1	5	0.6478
Fierce Tales: Feline Sight Collector's Edition	2018-02-26	3	5	1	4	0.6478
Just One Color	2018-03-04	3	5	1	4	0.6478
Awkward Date Hero	2018-10-01	2	5	1	3	0.6478
HeadON!	2018-03-30	2	5	1	3	0.6478
Yuso	2018-07-05	3	5	1	4	0.6478
Floor By Floor	2018-03-17	4	5	1	5	0.6478
Vadine: Bite-Man	2018-10-30	1	5	1	2	0.6478
Stonetowers	2018-11-07	8	5	1	9	0.6478
The Platformer Gun	2018-04-19	1	5	1	2	0.6478
Calm Cards - Klondike	2018-06-14	4	5	1	5	0.6478
Highway Junkie	2018-06-20	2	5	1	3	0.6478
Cherry in the Sky	2018-12-20	3	5	1	4	0.6478
Vagrant Fury	2018-09-24	1	5	1	2	0.6478
Nocturne of Steel	2018-09-28	3	5	1	4	0.6478
ParkourMan	2018-07-24	4	5	1	5	0.6478
Navigator	2018-07-30	2	5	1	3	0.6478
Super Zombie Arcade	2018-10-06	2	5	1	3	0.6478
Nutrients for Life	2018-09-14	10	5	1	11	0.6478
Super Frog's Quest	2018-08-16	2	5	1	3	0.6478
Polygone	2018-10-05	2	5	1	3	0.6478
A.L.A.N.: Rift Breakers	2018-09-05	2	5	1	3	0.6478
Construction Charlie	2018-09-10	3	5	1	4	0.6478
Angel and Devil,ninja,sushi,tempura,panda and the statue of liverty	2018-09-14	2	5	1	3	0.6478
Ape Hit	2018-08-31	2	5	1	3	0.6478
Burning Instinct	2018-09-10	10	5	1	11	0.6478
Prototype TD	2018-09-18	4	5	1	5	0.6478
Tiska Buska	2018-09-13	2	5	1	3	0.6478
Taco Truck Madness	2018-09-27	1	5	1	2	0.6478
Tank survival Game	2018-10-25	1	5	1	2	0.6478
Journey Through Memories	2018-10-20	2	5	1	3	0.6478
Halfway Home	2018-11-04	5	5	1	6	0.6478
Whimsical Quest	2018-12-03	2	5	1	3	0.6478
Hentai Memorama	2018-11-30	5	5	1	6	0.6478
CYPEST Underground	2018-12-18	2	5	1	3	0.6478
BattleMore	2018-11-16	3	5	1	4	0.6478
拖拉机	2018-12-05	8	5	1	9	0.6478
Atrocity	2018-12-19	3	5	1	4	0.6478
Puzzles for smart: Underwater Kingdom	2018-12-01	2	5	1	3	0.6478
Hir Corruption	2018-11-28	3	5	1	4	0.6478
Voxel Sword	2018-12-28	3	5	1	4	0.6478
Calcul8²	2018-12-17	3	5	1	4	0.6478
Sally's Salon: Kiss & Make-Up	2018-06-28	34	69	30	64	0.6476999999999999
公主的逃脱日常	2018-03-08	6	10	3	9	0.6476000000000001
Music Boy 3D	2018-03-29	7	10	3	10	0.6476000000000001
Untouchable	2018-05-21	3	10	3	6	0.6476000000000001
Laser Ball	2018-03-30	3	10	3	6	0.6476000000000001
All You Can Feed: Sushi Bar	2018-04-20	4	10	3	7	0.6476000000000001
VR Hero Sentry	2018-11-06	110	10	3	113	0.6476000000000001
The Outlaw, The Drunk, & The Whore	2018-05-19	3	10	3	6	0.6476000000000001
Office Race	2018-06-11	3	10	3	6	0.6476000000000001
Witch's Tales	2018-11-09	5	10	3	8	0.6476000000000001
Roguelite	2018-12-04	8	10	3	11	0.6476000000000001
Super Hero Fight Club: Reloaded	2018-12-27	3	10	3	6	0.6476000000000001
The Cooking Game VR	2018-07-13	9	37	15	24	0.6475
Super Blasting Boy	2018-10-27	6	52	22	28	0.6474
Cash Rush	2018-08-17	8	26	10	18	0.6473000000000001
Noahmund	2018-08-02	7	17	6	13	0.6473000000000001
Minaurs	2018-06-28	5	17	6	11	0.6473000000000001
A Fine Mess	2018-02-23	2	17	6	8	0.6473000000000001
Molecule - a chemical challenge	2018-03-02	4	17	6	10	0.6473000000000001
灵文西游	2018-07-31	9	17	6	15	0.6473000000000001
Chase	2018-08-17	136	17	6	142	0.6473000000000001
Deep Space Shooter	2018-11-15	3	17	6	9	0.6473000000000001
Reach 50 : Sexy Hentai Girls	2018-12-20	4	17	6	10	0.6473000000000001
Runes of Magic	2018-08-29	625	768	383	1008	0.6472
Tourist Bus Simulator	2018-12-06	459	1882	962	1421	0.647
A Dump in the Dark	2018-01-24	983	239	114	1097	0.6468
Mentai Uncensored	2018-10-19	4	39	16	20	0.6468
Found Horror Game 11.exe	2018-08-16	69	41	17	86	0.6463
SCALPERS: Turtle & the Moonshine Gang	2018-03-29	704	28	11	715	0.6462000000000001
Drunk-Fu: Wasted Masters	2018-08-17	17	28	11	28	0.6462000000000001
Highway Madness	2018-02-01	14	28	11	25	0.6462000000000001
Dungeon Of Zaar	2018-04-16	153	89	40	193	0.6459999999999999
Unearned Bounty	2018-08-22	142	214	102	244	0.6459
VR2: Vacate 2 Rooms	2018-07-16	13	19	7	20	0.6452
Zombie City	2018-01-17	6	19	7	13	0.6452
Grim Wanderings	2018-02-27	8	19	7	15	0.6452
Mobile Wars X	2018-12-28	11	19	7	18	0.6452
Heat Guardian: Re-Frozen Edition	2018-05-10	21	70	31	52	0.6451000000000001
Space Escape	2018-03-26	11	47	20	31	0.6448999999999999
Fast Beat Loop Racer GT	2018-05-17	127	370	182	309	0.6448
Rise: Race The Future	2018-11-01	7	74	33	40	0.6448
Time Splatter	2018-11-20	3	49	21	24	0.6446
Strike of Horror	2018-12-20	17	80	36	53	0.6444
Darwin's Test	2018-12-07	15	32	13	28	0.6444
Blind	2018-09-18	49	82	37	86	0.6443000000000001
Multibombers	2018-09-23	48	82	37	85	0.6443000000000001
SG/ZH: School Girl/Zombie Hunter	2018-06-05	163	308	151	314	0.644
Battle Fleet Ground Assault	2018-05-01	17	34	14	31	0.6437999999999999
BlackShield: Upora Story	2018-01-17	7	34	14	21	0.6437999999999999
Pixelpunk XL	2018-04-20	5	34	14	19	0.6437999999999999
Mysteries of Neverville: The Runestone of Light	2018-12-21	5	34	14	19	0.6437999999999999
Life Forge - Reborn ORPG	2018-11-26	294	237	115	409	0.6437
To the Core	2018-07-23	77	156	74	151	0.6436000000000001
Age of Gladiators II: Rome	2018-08-21	135	154	73	208	0.6436000000000001
Skool Daze Reskooled	2018-06-07	7	21	8	15	0.6436000000000001
Gravity Light	2018-05-15	3	21	8	11	0.6436000000000001
Socketeer	2018-08-21	4	21	8	12	0.6436000000000001
From Village to Empire	2018-05-25	8	21	8	16	0.6436000000000001
Crazy Alchemist	2018-09-06	6	21	8	14	0.6436000000000001
Baobabs Mausoleum Ep.2: 1313 Barnabas Dead End Drive	2018-02-27	10	12	4	14	0.6435
Brew-Ha	2018-03-19	10	12	4	14	0.6435
Stop! Dictator.	2018-05-10	2	12	4	6	0.6435
Romancing Monarchy	2018-07-24	6	12	4	10	0.6435
Find Differences	2018-10-22	4	12	4	8	0.6435
30 seconds to jail	2018-05-04	7	59	26	33	0.6433
DIVE: Starpath	2018-02-06	11	36	15	26	0.6432
AIdol	2018-04-23	48	36	15	63	0.6432
18+	2018-07-03	11	399	199	210	0.6428
Master of the Harem Guild	2018-10-02	36	67	30	66	0.6428
The Longest Five Minutes	2018-02-13	12	38	16	28	0.6426999999999999
Final Warrior Quest	2018-04-12	7	23	9	16	0.6424
Stockpile	2018-09-21	9	23	9	18	0.6424
Hang Up	2018-10-16	7	23	9	16	0.6424
My Magical Demon Lover	2018-10-02	8	40	17	25	0.6423000000000001
Hentai Space	2018-10-08	11	89	41	52	0.6421
Swords and Sandals 5 Redux	2018-01-09	24	103	48	72	0.642
Hunahpu Quest. Mechanoid	2018-01-14	4	25	10	14	0.6414
Resume: The Video Game	2018-03-03	11	25	10	21	0.6414
Neverliria	2018-08-22	9	25	10	19	0.6414
Miracle Circus 奇迹马戏团	2018-10-05	4	25	10	14	0.6414
METAL GEAR SURVIVE	2018-02-22	7713	3376	1795	9508	0.6412000000000001
SINNER: Sacrifice for Redemption	2018-10-23	50	523	266	316	0.6409999999999999
Need to Know	2018-08-28	293	179	87	380	0.6408
Longshot Universe	2018-02-20	2	2	0	2	0.6408
Dream UniVRse	2018-08-23	1	2	0	1	0.6408
Perigee	2018-03-01	1	2	0	1	0.6408
Crucial Throw	2018-03-23	3	2	0	3	0.6408
Air Traffic Disruptor	2018-01-31	3	2	0	3	0.6408
GameDevDan vs Life	2018-03-15	2	2	0	2	0.6408
Square Route	2018-05-04	1	2	0	1	0.6408
Mad Farm	2018-03-10	4	2	0	4	0.6408
Twisted: Enhanced Edition	2018-04-27	3	2	0	3	0.6408
Silentium 2D	2018-08-13	2	2	0	2	0.6408
Time Barbarian Extreme!!	2018-09-03	3	2	0	3	0.6408
Nogard	2018-03-29	2	2	0	2	0.6408
Gates of Avalon	2018-07-27	3	2	0	3	0.6408
Combine War Toys	2018-10-30	2	2	0	2	0.6408
Kentucky Dash	2018-07-19	3	2	0	3	0.6408
Winter's Symphonies	2018-12-28	2	2	0	2	0.6408
The Z Axis: Continuum	2018-07-31	2	2	0	2	0.6408
GyroShooter	2018-02-20	2	2	0	2	0.6408
Raymond's Obstacle Course	2018-01-31	3	2	0	3	0.6408
Planet Guardian VR	2018-01-23	1	2	0	1	0.6408
Brick Breaker Bunch	2018-03-09	2	2	0	2	0.6408
ANti: Virus Destroyer	2018-07-24	2	2	0	2	0.6408
Oh No! Ninjas!	2018-01-05	6	2	0	6	0.6408
Quarto	2018-06-27	3	2	0	3	0.6408
Love Story: The Beach Cottage	2018-01-17	3	2	0	3	0.6408
Committed: Mystery at Shady Pines	2018-02-20	3	2	0	3	0.6408
VR Soccer '96	2018-01-19	3	2	0	3	0.6408
hOSHIs Elektronauts	2018-01-14	3	2	0	3	0.6408
Entertainment Hero	2018-01-16	1	2	0	1	0.6408
Champ Against Chumps Upgrade Edition	2018-04-21	2	2	0	2	0.6408
BRIKS 2	2018-03-13	2	2	0	2	0.6408
DRONES AND RUINS	2018-05-22	1	2	0	1	0.6408
Seek & Destroy - Steampunk Arcade	2018-01-31	2	2	0	2	0.6408
Keys	2018-02-02	1	2	0	1	0.6408
American Farmer	2018-04-20	1	2	0	1	0.6408
Galaxy Wide Domination	2018-02-17	1	2	0	1	0.6408
Puzzles By Axis	2018-02-15	2	2	0	2	0.6408
Mortal box	2018-02-13	1	2	0	1	0.6408
glutton man	2018-02-22	2	2	0	2	0.6408
Zombie Serial Killer Incident	2018-04-19	1	2	0	1	0.6408
Star-Pit Starship	2018-04-10	2	2	0	2	0.6408
ばるばろっさ! ～すすめ? 赤軍少女旅団～(全年齢版)	2018-02-09	2	2	0	2	0.6408
Trick Shot	2018-03-13	1	2	0	1	0.6408
Why War?	2018-02-28	2	2	0	2	0.6408
SpellShokked!	2018-06-15	2	2	0	2	0.6408
Star Clash	2018-03-02	2	2	0	2	0.6408
Angles	2018-03-07	3	2	0	3	0.6408
Swapper Tiles	2018-05-07	2	2	0	2	0.6408
Dark Tales™: Edgar Allan Poe's The Mystery of Marie Roget Collector's Edition	2018-02-22	5	2	0	5	0.6408
My Racing Career	2018-03-17	1	2	0	1	0.6408
Torque: Simulation Begins	2018-03-24	2	2	0	2	0.6408
The Final Days: Blood Dawn	2018-03-07	1	2	0	1	0.6408
Samba Shooter	2018-04-19	3	2	0	3	0.6408
Bump Bump Bump	2018-08-09	1	2	0	1	0.6408
Vector Born	2018-04-07	2	2	0	2	0.6408
AngelShooter	2018-05-04	1	2	0	1	0.6408
Cheese Maze	2018-05-09	2	2	0	2	0.6408
The Witch's Apprentice: A Magical Mishap	2018-06-11	4	2	0	4	0.6408
Golf Cart Drive	2018-04-02	1	2	0	1	0.6408
Croc's World Construction Kit	2018-04-20	2	2	0	2	0.6408
VR GAME-Brick of War	2018-05-02	4	2	0	4	0.6408
Hard Way To Heaven	2018-04-20	2	2	0	2	0.6408
Dark Dimensions: Somber Song Collector's Edition	2018-04-18	3	2	0	3	0.6408
Real Winners: Victoryball	2018-10-08	3	2	0	3	0.6408
Psycho Squirrels	2018-05-15	1	2	0	1	0.6408
Vortex Rush	2018-05-07	2	2	0	2	0.6408
Trapped	2018-05-11	2	2	0	2	0.6408
Suki's Spooky Romance	2018-06-14	2	2	0	2	0.6408
Bitsy Bits	2018-05-30	1	2	0	1	0.6408
MODERN ROAD-LIKE	2018-06-16	2	2	0	2	0.6408
Heart of Dixie	2018-07-02	1	2	0	1	0.6408
Not Without You	2018-08-15	2	2	0	2	0.6408
Sweet Treats	2018-07-17	2	2	0	2	0.6408
Little Comet	2018-12-14	2	2	0	2	0.6408
STAR BARON - VR Beast combat game	2018-07-07	3	2	0	3	0.6408
CPRC: Apex Hunters	2018-07-17	5	2	0	5	0.6408
Delve	2018-06-01	2	2	0	2	0.6408
Orc Island	2018-06-01	1	2	0	1	0.6408
Destiny of a Wizard 2: Beyond the Vale	2018-06-07	2	2	0	2	0.6408
SAVANNA SHOT VR	2018-05-30	2	2	0	2	0.6408
Aztec Number	2018-06-11	2	2	0	2	0.6408
TapRPG - Homeland	2018-06-02	3	2	0	3	0.6408
Tales of Mahabharata	2018-08-14	3	2	0	3	0.6408
CROSSING MAN	2018-06-12	2	2	0	2	0.6408
The Fiend's Tavern	2018-06-15	2	2	0	2	0.6408
Color by Numbers - Flowers	2018-07-10	3	2	0	3	0.6408
The Movie Trivia Challenge	2018-06-23	4	2	0	4	0.6408
Sarah in the Sky	2018-07-04	1	2	0	1	0.6408
Plumber: the Pipe Rush	2018-07-07	2	2	0	2	0.6408
Thievery	2018-07-13	1	2	0	1	0.6408
Jelly Wrestle	2018-07-28	3	2	0	3	0.6408
Kill The Monster	2018-07-13	1	2	0	1	0.6408
Invaders! From Outer Space	2018-09-11	2	2	0	2	0.6408
Surface: Return to Another World Collector's Edition	2018-08-06	4	2	0	4	0.6408
Algae	2018-08-21	2	2	0	2	0.6408
Adventure Portal	2018-10-31	6	2	0	6	0.6408
Divine Miracle Defense	2018-08-16	3	2	0	3	0.6408
Draw Light	2018-08-09	2	2	0	2	0.6408
The Odd Battle	2018-08-24	1	2	0	1	0.6408
Mummy on the run	2018-09-25	2	2	0	2	0.6408
TeleBlast	2018-10-25	2	2	0	2	0.6408
Here Nya	2018-08-22	2	2	0	2	0.6408
Find The Balance	2018-09-28	2	2	0	2	0.6408
Project GR-5LYR: Galactic Relocation	2018-08-25	3	2	0	3	0.6408
Kingpin Royale	2018-10-02	2	2	0	2	0.6408
Sabreurs - A Noble Duel	2018-09-14	4	2	0	4	0.6408
Nuclear Powered Toaster	2018-10-25	4	2	0	4	0.6408
怪奇幻想夢物語 怪獣綺譚 朧十夜	2018-09-12	1	2	0	1	0.6408
Little World Of Creatures	2018-10-02	4	2	0	4	0.6408
2nd Circle - Powerful Magic	2018-10-18	2	2	0	2	0.6408
Galactic Tree Frog	2018-09-25	1	2	0	1	0.6408
Ribbon Racer	2018-10-10	2	2	0	2	0.6408
Lantern of Worlds - The First Quest	2018-10-17	2	2	0	2	0.6408
Color by Numbers - Christmas	2018-11-13	3	2	0	3	0.6408
Flank That Tank!	2018-10-17	2	2	0	2	0.6408
Metamorph	2018-11-02	2	2	0	2	0.6408
Antitetrise	2018-12-14	1	2	0	1	0.6408
There Is No Turning Back!	2018-11-02	2	2	0	2	0.6408
Red Blue	2018-11-01	1	2	0	1	0.6408
Intersolar Overdrive	2018-11-22	3	2	0	3	0.6408
Fight for Gold II	2018-11-27	1	2	0	1	0.6408
Spice Pirates in Space: A Retro RPG	2018-12-03	1	2	0	1	0.6408
BEAK SQUADRON	2018-12-18	1	2	0	1	0.6408
Eurobi Racing	2018-12-13	2	2	0	2	0.6408
Damnaze	2018-12-28	2	2	0	2	0.6408
BLASTER LiLO	2018-12-28	1	2	0	1	0.6408
Sky Is Arrows	2018-01-09	182	14	5	187	0.6406999999999999
Food Truck VR	2018-07-12	5	14	5	10	0.6406999999999999
COMPLEX	2018-01-08	3	14	5	8	0.6406999999999999
Football Heroes Turbo	2018-09-06	6	14	5	11	0.6406999999999999
Charlie II	2018-02-19	6	14	5	11	0.6406999999999999
Island Tribe 3	2018-03-22	7	14	5	12	0.6406999999999999
Wheelchair Simulator VR	2018-05-08	4	14	5	9	0.6406999999999999
Echoes III	2018-09-05	3	14	5	8	0.6406999999999999
Project RAT	2018-05-29	6	14	5	11	0.6406999999999999
Sweeper Zero	2018-08-24	12	14	5	17	0.6406999999999999
Geometry Defense: Infinite	2018-07-06	13	14	5	18	0.6406999999999999
One Hunt	2018-07-25	3	14	5	8	0.6406999999999999
Dare Course	2018-07-30	6	14	5	11	0.6406999999999999
Tale of the Fragmented Star: Single Fragment Version / 星の欠片の物語、ひとかけら版	2018-11-21	6	14	5	11	0.6406999999999999
RAZED	2018-09-14	6	27	11	17	0.6406000000000001
Devil and the Fairy	2018-02-12	5	27	11	16	0.6406000000000001
Seek Or Die	2018-04-28	53	110	52	105	0.6404000000000001
Space Battle VR	2018-12-14	7	60	27	34	0.6404000000000001
Griefer	2018-04-20	4	62	28	32	0.6403
Mumps	2018-01-22	3	80	37	40	0.6401000000000001
The American Dream	2018-03-14	14	76	35	49	0.6401000000000001
Strikers Edge	2018-01-30	94	76	35	129	0.6401000000000001
Girl X Mushrooms(少女X蘑菇)	2018-03-13	12	139	67	79	0.6397
Crest	2018-03-08	60	245	122	182	0.6393
Starlight Drifter	2018-06-29	34	33	14	48	0.6391
Supermedium	2018-03-06	11	33	14	25	0.6391
HUNTER BRICK BALL	2018-06-21	11	33	14	25	0.6391
Crystal Vibes feat. Ott.	2018-07-16	2	7	2	4	0.6389
APEX Tournament	2018-02-09	4	7	2	6	0.6389
Medieval Steve	2018-09-20	4	7	2	6	0.6389
Death Runner	2018-05-15	4	7	2	6	0.6389
MazeQuest 2	2018-12-26	4	7	2	6	0.6389
STAX	2018-02-01	2	7	2	4	0.6389
Time Gate: Knight Chase	2018-02-08	2	7	2	4	0.6389
Element Industry	2018-02-06	2	7	2	4	0.6389
City of sky	2018-03-01	4	7	2	6	0.6389
The Sandbox of God	2018-05-09	3	7	2	5	0.6389
Wrecking Towers	2018-05-18	1	7	2	3	0.6389
Frqncy	2018-07-30	2	7	2	4	0.6389
Minako	2018-06-06	4	7	2	6	0.6389
BowmanVSZombies	2018-09-21	7	7	2	9	0.6389
Take Care of the Paperwork	2018-07-06	2	7	2	4	0.6389
HyperZen Training	2018-07-17	136	7	2	138	0.6389
TheEdgeBall	2018-07-03	3	7	2	5	0.6389
DollKart	2018-08-01	4	7	2	6	0.6389
Inn: the Countryside	2018-08-14	3	7	2	5	0.6389
Fatal Hour: Petroleum	2018-08-22	2	7	2	4	0.6389
Living Legends: Wrath of the Beast Collector's Edition	2018-09-14	5	7	2	7	0.6389
Cat Fu Mi	2018-09-26	2	7	2	4	0.6389
Shadow Play	2018-09-20	4	7	2	6	0.6389
DJ Whip VR	2018-11-09	2	7	2	4	0.6389
Talk to Yuno	2018-10-26	3	7	2	5	0.6389
隐龙传：影踪(Hidden Dragon Legend: ShadowTrace)	2018-03-13	274	275	138	412	0.6388
War Machines	2018-11-28	129	150	73	202	0.6388
Overclocked: The Aclockalypse	2018-04-27	15	35	15	30	0.6388
Melancholy Republic	2018-04-13	10	16	6	16	0.6388
Eat All The Things	2018-11-05	7	16	6	13	0.6388
Regenesis Arcade	2018-09-07	4	16	6	10	0.6388
Hellbreaker	2018-02-16	7	16	6	13	0.6388
Dead Ground:Arena	2018-09-03	4	16	6	10	0.6388
Les Misérables: Jean Valjean	2018-04-03	6	16	6	12	0.6388
Bladequest	2018-08-10	4	16	6	10	0.6388
MachiaVillain	2018-05-16	1084	466	239	1323	0.6386000000000001
Happy toys	2018-12-14	11	103	49	60	0.6386000000000001
Ironbound	2018-01-04	59	171	84	143	0.6385000000000001
Hentai: The Shell Game	2018-09-24	6	37	16	22	0.6385000000000001
FlyInside Flight Simulator	2018-12-20	16	97	46	62	0.6384000000000001
The Subject	2018-11-30	10	41	18	28	0.6381
Dehumanized	2018-07-12	127	85	40	167	0.638
An Aspie Life	2018-03-29	25	83	39	64	0.638
大逃亡专家/Escape Expert	2018-12-03	9	45	20	29	0.6378
Diaspora Mass Exodus	2018-12-22	69	122	59	128	0.6377
The Way of Life: DEFINITIVE EDITION	2018-03-15	28	69	32	60	0.6376
End Space	2018-03-29	13	63	29	42	0.6376
Dead Dust	2018-03-21	5	51	23	28	0.6376
WorldQuest	2018-04-30	20	57	26	46	0.6375000000000001
PIDO1	2018-07-18	8	57	26	34	0.6375000000000001
Cosmi-Cave 64	2018-08-07	7	18	7	14	0.6375000000000001
Super Potato Bruh	2018-10-20	3	18	7	10	0.6375000000000001
Sanatorium Purgatorium	2018-11-01	3	18	7	10	0.6375000000000001
Blood Waves	2018-05-11	36	114	55	91	0.6374000000000001
BattleRush 2	2018-10-18	186	416	214	400	0.6373
Earthfall	2018-07-13	587	1460	780	1367	0.6369
Inhumanus	2018-04-28	6	20	8	14	0.6365
EXCHANGE	2018-10-12	8	20	8	16	0.6365
Tiny Hands Adventure	2018-08-10	3	20	8	11	0.6365
Zombie school-丧尸学院	2018-10-15	27	20	8	35	0.6365
RGB RUN	2018-11-27	3	20	8	11	0.6365
Isle of Skye	2018-07-26	71	90	43	114	0.6362
God Awe-full Clicker	2018-09-20	1015	241	122	1137	0.6361
Balls! Virtual Reality Cricket	2018-02-07	4	22	9	13	0.6358
The 9th Gate	2018-10-18	7	22	9	16	0.6358
Grave Prosperity - part 1	2018-05-01	10	22	9	19	0.6358
Danger Room VR	2018-09-01	12	22	9	21	0.6358
Sword Legacy Omen	2018-08-13	138	421	219	357	0.6353
LINX BATTLE ARENA	2018-01-29	10	24	10	20	0.6353
Women's Soccer Manager (WSM)	2018-07-17	39	66	31	70	0.635
Tempest 4000	2018-07-17	20	99	48	68	0.6349
Chocolate makes you happy 6	2018-05-30	6	64	30	36	0.6349
Plastic Soldiers	2018-11-16	28	120	59	87	0.6347
Unlight:SchizoChronicle	2018-05-22	103	60	28	131	0.6347
Outbreak: The New Nightmare	2018-01-05	20	177	89	109	0.6346
Dodge	2018-01-09	4	28	12	16	0.6346
Brother Perro	2018-04-26	9	28	12	21	0.6346
Furwind	2018-10-25	6	28	12	18	0.6346
RiftStar Raiders	2018-02-28	5	9	3	8	0.6345000000000001
Pixel Stories of Dungeon	2018-05-07	3	9	3	6	0.6345000000000001
SiegeVR	2018-03-21	5	9	3	8	0.6345000000000001
Kaet Must Die!	2018-04-05	4	9	3	7	0.6345000000000001
YBit	2018-01-15	2	9	3	5	0.6345000000000001
Meanwhile: An Interactive Comic Book	2018-01-17	3	9	3	6	0.6345000000000001
Cross Pixels	2018-04-17	9	9	3	12	0.6345000000000001
VR Dunhuang	2018-01-10	3	9	3	6	0.6345000000000001
VRQ Test	2018-04-12	12	9	3	15	0.6345000000000001
AeroChopper	2018-04-29	2	9	3	5	0.6345000000000001
The Steadfast VR Challenge	2018-09-25	3	9	3	6	0.6345000000000001
Grim Tales: The Stone Queen Collector's Edition	2018-04-27	7	9	3	10	0.6345000000000001
Lords of Strife	2018-05-22	3	9	3	6	0.6345000000000001
Color Path	2018-05-11	3	9	3	6	0.6345000000000001
Kokorogawari	2018-08-31	10	9	3	13	0.6345000000000001
Rugosi	2018-08-08	2	9	3	5	0.6345000000000001
Pro Strategy Football 2019	2018-08-28	11	9	3	14	0.6345000000000001
Sokoban: The RPG	2018-09-06	4	9	3	7	0.6345000000000001
Amethlion	2018-08-27	4	9	3	7	0.6345000000000001
Skater Cally	2018-09-25	3	9	3	6	0.6345000000000001
Strategist	2018-08-30	3	9	3	6	0.6345000000000001
Shining Orb Prequel	2018-11-06	4	9	3	7	0.6345000000000001
Dark Romance: The Swan Sonata Collector's Edition	2018-10-15	4	9	3	7	0.6345000000000001
Puzzles for smart: Horses	2018-11-13	2	9	3	5	0.6345000000000001
Buttle Tank	2018-12-22	2	9	3	5	0.6345000000000001
Antigraviator	2018-06-06	61	156	78	139	0.6344
Island Time	2018-04-03	11	52	24	35	0.6344
The Warrior Of Treasures	2018-01-03	3	30	13	16	0.6344
Escape First	2018-05-10	71	261	134	205	0.6342
Classic Card Games 3D	2018-11-27	25	48	22	47	0.6342
GARAGE: Bad Trip	2018-07-06	72	402	210	282	0.6341
Christmas Clicker: Idle Gift Builder	2018-12-15	55	44	20	75	0.6341
Mahjong Solitaire	2018-05-11	7	40	18	25	0.6341
Trivia Quiz: All about everything!	2018-08-04	19	40	18	37	0.6341
Space Hulk: Tactics	2018-10-09	658	527	278	936	0.634
Downtown Mafia: Gang Wars	2018-07-26	46	83	40	86	0.6338
Race	2018-01-09	8	106	52	60	0.6337
Rad Rodgers	2018-02-21	22	104	51	73	0.6336
Gazing from beyond	2018-02-08	386	310	161	547	0.6334000000000001
Russian roulette	2018-11-07	6	77	37	43	0.6334000000000001
PLAY WITH ME	2018-01-17	562	243	125	687	0.6333
Panzer Strategy	2018-08-31	195	306	159	354	0.6332
INFERNIUM	2018-04-03	21	117	58	79	0.633
Unstoppable Hamster	2018-01-24	5	96	47	52	0.6329
Holy Potatoes! A Spy Story?!	2018-11-07	54	96	47	101	0.6329
New World: The Tupis	2018-03-21	2	11	4	6	0.6321
Escort Commander	2018-02-22	5	11	4	9	0.6321
The Hardest Thing	2018-01-17	3	11	4	7	0.6321
Empty Town	2018-06-05	4	11	4	8	0.6321
Guns&Notes	2018-01-26	3	11	4	7	0.6321
Twisted Sails	2018-03-27	14	11	4	18	0.6321
Fantastic Sea	2018-02-07	4	11	4	8	0.6321
ADR-Labelling Game	2018-04-12	1	11	4	5	0.6321
The Road to Canterbury	2018-04-26	25	11	4	29	0.6321
Delta Horizon	2018-09-06	31	11	4	35	0.6321
Samurai Wish	2018-09-12	2	11	4	6	0.6321
goto	2018-08-17	3	11	4	7	0.6321
Welcome Above	2018-12-14	4	11	4	8	0.6321
Super Grower	2018-12-28	3	11	4	7	0.6321
IMAZE.EXE 2	2018-12-14	2	11	4	6	0.6321
Fugue in Void	2018-08-03	5	122	61	66	0.632
Demon Hunter 4: Riddles of Light	2018-02-22	51	101	50	101	0.6317
Project AURA	2018-04-18	120	438	233	353	0.6312
BlueberryNOVA	2018-04-05	6	72	35	41	0.6307
Pendula Swing Episode 1 - Tired and Retired	2018-08-15	15	47	22	37	0.6307
校园恋物语|Love in School	2018-07-28	26	47	22	48	0.6307
SALVATOR	2018-05-03	2	13	5	7	0.6306
Blood Drift	2018-02-25	5	13	5	10	0.6306
Cluster Dust	2018-03-14	2	13	5	7	0.6306
Infecto	2018-04-14	3	13	5	8	0.6306
Arrowborn	2018-07-24	10	13	5	15	0.6306
The Legend of Evil	2018-10-19	7	13	5	12	0.6306
Mind Labyrinth VR Dreams	2018-10-14	3	13	5	8	0.6306
Nelson and the Magic Cauldron	2018-11-20	4	13	5	9	0.6306
Recursive Pain	2018-11-16	6	13	5	11	0.6306
Knights of Pen and Paper 2: Free Edition	2018-02-21	84	149	76	160	0.6305
Open Sewer	2018-12-11	19	45	21	40	0.6305
Azorian Kings	2018-06-21	16	89	44	60	0.6304
Transports	2018-01-18	80	68	33	113	0.6302000000000001
Daemonical	2018-08-15	88	145	74	162	0.6301
ANOIX	2018-04-21	11	41	19	30	0.6301
Foto Flash 2	2018-09-06	19	41	19	38	0.6301
Chicken Rider	2018-07-31	20	39	18	38	0.63
SuperTrucks Offroad	2018-01-13	15	37	17	32	0.6298
Queen of Seas 2	2018-06-05	4	37	17	21	0.6298
Match Point	2018-10-09	5	15	6	11	0.6298
God is a Cube: Programming Robot Cubes	2018-10-11	9	15	6	15	0.6298
Mutation Mayhem	2018-06-12	7	15	6	13	0.6298
SpaceTone	2018-09-25	5	15	6	11	0.6298
VIDEO GAME	2018-11-12	5	15	6	11	0.6298
Loveless cat	2018-10-30	2	15	6	8	0.6298
Combat Tested	2018-03-23	9	62	30	39	0.6295000000000001
Elea	2018-09-06	15	62	30	45	0.6295000000000001
幻想三國誌５/Fantasia Sango 5	2018-08-15	185	174	90	275	0.6294
Frozen Synapse 2	2018-09-13	413	150	77	490	0.6294
Simon the Sorcerer 2: 25th Anniversary Edition	2018-04-03	9	33	15	24	0.6294
Princess Maker 5	2018-05-04	184	300	159	343	0.6293
Redrum: Time Lies	2018-11-07	19	17	7	26	0.6293
Revoke	2018-07-25	4	17	7	11	0.6293
Grotoro	2018-06-12	230	17	7	237	0.6293
炎黄战纪[Legacy of YanHuang]	2018-02-01	67	183	95	162	0.6292
Poly Island	2018-12-28	3	31	14	17	0.6292
MMMmmm... Cake!	2018-08-31	5	31	14	19	0.6292
Mermaid Adventures: The Frozen Time	2018-02-16	32	29	13	45	0.6291
Pirates of the Polygon Sea	2018-11-30	49	77	38	87	0.629
Prototype Mansion - Used No Cover	2018-07-19	5	27	12	17	0.629
Box Maze 2 : Agent Cubert	2018-01-05	4	19	8	12	0.629
HENTAI SHADOW	2018-11-29	5	19	8	13	0.629
Escape Legacy VR	2018-12-20	7	19	8	15	0.629
You Are The Apple Of My Eye 研磨时光	2018-05-04	8	25	11	19	0.6289
Wheelz2	2018-05-19	11	21	9	20	0.6289
Solenars Edge Heroes	2018-05-04	3	21	9	12	0.6289
HANZ!	2018-10-17	6	21	9	15	0.6289
Ground Runner: Trials	2018-10-25	6	23	10	16	0.6288
40 Winks	2018-10-22	4	23	10	14	0.6288
ZEROCAR: Future Motorsport	2018-09-20	4	23	10	14	0.6288
つんつんVR / TSUN-TSUN VR	2018-08-01	6	23	10	16	0.6288
Survisland	2018-07-16	695	839	461	1156	0.6286
Idle Adventure	2018-04-14	1062	277	147	1209	0.6285000000000001
Ball laB	2018-03-08	2043	532	289	2332	0.6284000000000001
Tsundere Idol	2018-05-29	76	54	26	102	0.6284000000000001
FPS Training	2018-12-14	29	52	25	54	0.6281
TOGETHER VR	2018-04-02	12	207	109	121	0.6277
Tunnels of Despair	2018-03-16	16	44	21	37	0.6268
Weable 2	2018-02-05	3	44	21	24	0.6268
Dragon World	2018-12-06	10	44	21	31	0.6268
Mike was Cursed	2018-04-19	946	61	30	976	0.6267
Bad Day	2018-03-02	75	122	63	138	0.6264000000000001
RideOp - VR Thrill Ride Experience	2018-11-29	17	42	20	37	0.6264000000000001
Another Otter	2018-07-17	4	85	43	47	0.6261
V-Rally 4	2018-09-25	92	487	267	359	0.626
Relic Raiders	2018-10-26	29	57	28	57	0.626
Wauies	2018-01-10	147	196	104	251	0.6258
Vietnam War PuZZles	2018-04-25	3	38	18	21	0.6257
Enlightenment	2018-07-24	107	296	160	267	0.6255
Epic Snowday Adventure	2018-03-10	3	4	1	4	0.6251
A Divided Light	2018-04-03	9	4	1	10	0.6251
Scrapper	2018-01-25	4	4	1	5	0.6251
900	2018-11-30	1	4	1	2	0.6251
Crucible Trails: Initial Rupture	2018-03-03	3	4	1	4	0.6251
Cosmic Trail	2018-05-09	6	4	1	7	0.6251
Tanks Meet Zombies	2018-02-14	2	4	1	3	0.6251
Kamboja	2018-03-16	2	4	1	3	0.6251
Super Dashmatch	2018-05-31	5	4	1	6	0.6251
The Treasure Seekers of Lady Luck	2018-01-18	7	4	1	8	0.6251
The SOL Device	2018-07-09	4	4	1	5	0.6251
LOA : Me And Angel	2018-01-25	2	4	1	3	0.6251
bLogic Blox	2018-11-13	2	4	1	3	0.6251
Baptize Billy	2018-04-18	2	4	1	3	0.6251
VR_PlayRoom : Episode1(Escape Room - Horror)	2018-02-03	2	4	1	3	0.6251
Space Ball	2018-03-30	2	4	1	3	0.6251
Neon Valley: Revenge	2018-02-28	6	4	1	7	0.6251
Fantasy Mosaics 21: On the Movie Set	2018-02-27	4	4	1	5	0.6251
Toon War	2018-03-01	2	4	1	3	0.6251
Poly World	2018-03-24	3	4	1	4	0.6251
oldTail	2018-05-03	3	4	1	4	0.6251
Witches' Legacy: Hunter and the Hunted Collector's Edition	2018-03-28	4	4	1	5	0.6251
Majula Frontier	2018-09-19	3	4	1	4	0.6251
Swingy Sword	2018-03-26	3	4	1	4	0.6251
ZYTERNION	2018-04-07	2	4	1	3	0.6251
Try to seize me	2018-04-17	5	4	1	6	0.6251
BitBreaker	2018-05-15	2	4	1	3	0.6251
Dragonward	2018-04-07	2	4	1	3	0.6251
ELDR LEGACY	2018-06-30	1	4	1	2	0.6251
Synthrally	2018-07-31	2	4	1	3	0.6251
Bishi and the Alien Slime Invasion!	2018-04-23	2	4	1	3	0.6251
Dynamite Bunny	2018-04-27	2	4	1	3	0.6251
Asimov Laws	2018-05-16	2	4	1	3	0.6251
Realistic Illusion	2018-05-04	1	4	1	2	0.6251
Red Spider3: A Heroine Never Dies	2018-05-22	1	4	1	2	0.6251
What's My Gender?	2018-06-01	1	4	1	2	0.6251
E3.14CENTER	2018-12-05	1	4	1	2	0.6251
The Lost Sky	2018-06-15	2	4	1	3	0.6251
kicker	2018-06-14	57	4	1	58	0.6251
HexTrains	2018-06-12	3	4	1	4	0.6251
Shepard Fairey VR - DAMAGED	2018-10-14	3	4	1	4	0.6251
Fruit Hoop	2018-06-29	3	4	1	4	0.6251
探灵警探	2018-06-26	2	4	1	3	0.6251
Kick Them Out!!!	2018-06-15	4	4	1	5	0.6251
Lovestory	2018-08-30	1	4	1	2	0.6251
Seed of Amaranth	2018-09-07	1	4	1	2	0.6251
Two Wars	2018-07-09	2	4	1	3	0.6251
Ghostman: The Council Calamity	2018-07-26	2	4	1	3	0.6251
Whispered Secrets: Golden Silence Collector's Edition	2018-07-30	3	4	1	4	0.6251
Volcanic Blocks	2018-08-31	3	4	1	4	0.6251
BattleBlade	2018-08-31	2	4	1	3	0.6251
Professor Chuckenhope	2018-11-16	3	4	1	4	0.6251
Shahrzad - The Storyteller	2018-08-17	2	4	1	3	0.6251
Jar Sam	2018-10-04	2	4	1	3	0.6251
Soul-Ivy: C0	2018-10-11	2	4	1	3	0.6251
Grim Facade: The Artist and The Pretender Collector's Edition	2018-10-17	5	4	1	6	0.6251
Fallen Sky Online	2018-10-19	3	4	1	4	0.6251
Zero spring episode 1 English translation version	2018-10-24	1	4	1	2	0.6251
Su Hack	2018-11-02	3	4	1	4	0.6251
A Flappy Bird in Real Life	2018-10-31	2	4	1	3	0.6251
VRetired	2018-12-07	2	4	1	3	0.6251
Siam Twinstick	2018-11-15	5	4	1	6	0.6251
Campido	2018-11-18	2	4	1	3	0.6251
Elite Archery	2018-11-29	2	4	1	3	0.6251
Thirty Two	2018-11-20	2	4	1	3	0.6251
Muzzleloaded	2018-12-21	2	4	1	3	0.6251
One minute of death	2018-12-19	3	4	1	4	0.6251
Make A Jigsaw Puzzle	2018-12-28	2	4	1	3	0.6251
Scribble Plus	2018-12-27	4	4	1	5	0.6251
Chop is dish	2018-11-28	3	34	16	19	0.6249
Hypatia	2018-08-29	20	32	15	35	0.6245
Shalnor Legends: Sacred Lands	2018-01-26	8	32	15	23	0.6245
Timber Tennis: Versus	2018-11-08	761	49	24	785	0.6244
Dungeon Brewmaster	2018-05-24	14	62	31	45	0.6242
Sargon's Lair	2018-09-05	14	30	14	28	0.624
Murderous Pursuits	2018-04-26	149224	1766	1009	150233	0.6239
Art of Murder - Cards of Destiny	2018-07-13	22	82	42	64	0.6236
Laserium	2018-06-20	11	82	42	53	0.6236
Doll of Resurrection	2018-09-22	13	28	13	26	0.6235
Abalyte	2018-10-16	479	129	68	547	0.6233
Bring to Light	2018-07-14	5	26	12	17	0.6231
HotFloor	2018-05-30	3	26	12	15	0.6231
MUTATION PHASE	2018-10-05	4	26	12	16	0.6231
Three Kingdoms 2018 阿达三国志2018 简体中文 竖版	2018-11-30	33	26	12	45	0.6231
Project Skylab 2	2018-10-05	481	43	21	502	0.623
Destined	2018-05-19	62	225	122	184	0.6229
Fantasy Battles	2018-09-28	483	98	51	534	0.6228
L.S.S	2018-04-05	8	24	11	19	0.6226
Ark Noir	2018-07-12	18	24	11	29	0.6226
Deadly Delivery	2018-06-20	8	24	11	19	0.6226
Jack the Barbarian	2018-05-21	6	24	11	17	0.6226
Babycar Driver	2018-05-22	6	24	11	17	0.6226
Beer Pong League	2018-11-30	7	22	10	17	0.6221
Gates Of Nowhere	2018-07-06	5	39	19	24	0.6219
Next Day: Survival	2018-05-21	4511	6384	3752	8263	0.6218
Coffence	2018-10-25	7	20	9	16	0.6215
Legends of the Universe - Cosmic Bounty	2018-01-16	4	20	9	13	0.6215
PRE:ONE	2018-04-25	3	20	9	12	0.6215
WAY HOME	2018-04-06	2	20	9	11	0.6215
And You're There, Too	2018-11-24	10	20	9	19	0.6215
Slightly Heroes VR	2018-12-11	18	50	25	43	0.6214000000000001
PixelJunk™ Monsters 2	2018-05-25	101	149	80	181	0.6213000000000001
Quest room: Hanon	2018-10-25	10	90	47	57	0.6213000000000001
Attractorache	2018-09-28	7	37	18	25	0.6213000000000001
Alien Worms Invasion	2018-03-13	8	18	8	16	0.621
Mine Royale - Battle Royale	2018-11-15	5	18	8	13	0.621
Undead Legions II	2018-07-30	3	6	2	5	0.621
Dungeons of Tal'Doria	2018-07-12	7	6	2	9	0.621
Dog Theatre	2018-01-30	3	6	2	5	0.621
Data Thief	2018-04-10	3	6	2	5	0.621
Famousity	2018-04-03	4	6	2	6	0.621
Snowmania	2018-01-05	2	6	2	4	0.621
The mysterious ship	2018-05-26	2	6	2	4	0.621
Soul Reaper: Unreap Commander	2018-04-24	5	6	2	7	0.621
Trinity	2018-09-12	2	6	2	4	0.621
Dig and Shoot	2018-02-06	3	6	2	5	0.621
The Protocons	2018-04-10	2	6	2	4	0.621
Questery	2018-04-30	2	6	2	4	0.621
Couch Party Game Night	2018-09-27	2	6	2	4	0.621
Lost in Spice	2018-06-07	3	6	2	5	0.621
TRIGGER	2018-06-17	3	6	2	5	0.621
HarmonyTD	2018-07-31	6	6	2	8	0.621
Shiver: The Lily's Requiem Collector's Edition	2018-06-04	4	6	2	6	0.621
That Which Binds Us	2018-06-25	2	6	2	4	0.621
Pac Adventures 3D	2018-07-20	2	6	2	4	0.621
Ones and Zeroes	2018-07-11	3	6	2	5	0.621
GeoGebra Mixed Reality	2018-10-12	5	6	2	7	0.621
Flow Dot	2018-08-01	2	6	2	4	0.621
JUMP AND RUN - DON'T FALL	2018-09-18	3	6	2	5	0.621
Repeat the image: Animals	2018-08-04	2	6	2	4	0.621
Death Race	2018-10-18	2	6	2	4	0.621
Roving in the Dark	2018-08-03	2	6	2	4	0.621
Poltergeist Treasure	2018-10-04	2	6	2	4	0.621
Supaplex THINK!	2018-09-19	7	6	2	9	0.621
Reflections of Life: Tree of Dreams Collector's Edition	2018-10-08	3	6	2	5	0.621
ForzeBreak	2018-10-31	9	6	2	11	0.621
Desolate Sands	2018-10-15	2	6	2	4	0.621
Intelligence: Dogs	2018-09-14	2	6	2	4	0.621
Poly and the Marble Maze	2018-12-18	2	6	2	4	0.621
Blackfoot Burrows	2018-10-20	4	6	2	6	0.621
Acropolis: The Archaic Age	2018-11-13	3	6	2	5	0.621
Hell Breaker	2018-12-19	5	6	2	7	0.621
Mò The Frog	2018-11-16	2	6	2	4	0.621
Case Opener Guns	2018-11-21	2	6	2	4	0.621
Door	2018-06-28	34	88	46	80	0.6209
RedEyes 赤瞳之勋	2018-08-10	8	35	17	25	0.6207
Planetoid Pioneers	2018-02-08	236	245	135	371	0.6204999999999999
Lock Her Up: The Trump Supremacy	2018-04-27	4	16	7	11	0.6204999999999999
Streets Ablaze	2018-09-07	3	16	7	10	0.6204999999999999
Zombie Commander	2018-05-14	3	16	7	10	0.6204999999999999
Linear Chicken	2018-05-07	3	16	7	10	0.6204999999999999
Feed the Pets Origins	2018-10-01	5	16	7	12	0.6204999999999999
Géants disparus VR	2018-11-29	16	16	7	23	0.6204999999999999
DOJAGI: The Korean Pottery	2018-12-10	9	14	6	15	0.62
Super Asteroids	2018-03-09	2	14	6	8	0.62
Bomber-un	2018-04-05	5	14	6	11	0.62
Fish Catcher	2018-07-13	2	14	6	8	0.62
Zenith Hunter	2018-09-14	9	14	6	15	0.62
Mech Rage	2018-12-14	3	14	6	9	0.62
Away	2018-10-31	6	153	83	89	0.6197
QuiVr Vanguard	2018-11-19	17	8	3	20	0.6197
The Cathedral: Allison's Diary	2018-02-14	3	8	3	6	0.6197
Robo Boop	2018-03-14	5	8	3	8	0.6197
Project Myriad	2018-07-18	3	8	3	6	0.6197
Negative World	2018-08-21	2	8	3	5	0.6197
Naughty study for exams with a ghost	2018-11-15	2	8	3	5	0.6197
Vein Hotel	2018-06-15	3	8	3	6	0.6197
Proficient Paddles	2018-07-22	3	8	3	6	0.6197
L-Way	2018-07-26	2	8	3	5	0.6197
Gimel Dimension	2018-09-03	2	8	3	5	0.6197
Київ: з ранку до світанку з Lenovo Explorer	2018-09-14	3	8	3	6	0.6197
Island Invasion	2018-12-08	4	8	3	7	0.6197
Empyrean Frontier	2018-08-31	5	12	5	10	0.6196
King of the Eggs	2018-02-15	4	12	5	9	0.6196
Icky	2018-02-06	5	12	5	10	0.6196
Porcuball	2018-04-18	7	12	5	12	0.6196
Poker Simulator	2018-04-06	4	12	5	9	0.6196
Cross Country Skiing VR	2018-04-12	8	12	5	13	0.6196
Fly of butterfly	2018-08-30	5	12	5	10	0.6196
Supaplex GO!	2018-08-31	7	12	5	12	0.6196
Monster MIX	2018-09-06	5	12	5	10	0.6196
Mystery Case Files: The Countess Collector's Edition	2018-11-27	7	12	5	12	0.6196
Insidia	2018-02-27	97	144	78	175	0.6195
Mech League Boxing	2018-01-10	7	10	4	11	0.6195
Ventura Inc	2018-06-01	12	10	4	16	0.6195
Dreams of Greatness	2018-03-01	4	10	4	8	0.6195
Light of the Mountain	2018-02-02	5	10	4	9	0.6195
Ancient Battle: Hannibal	2018-12-07	4	10	4	8	0.6195
Montero	2018-05-15	3	10	4	7	0.6195
Kill 'Em All	2018-05-31	2	10	4	6	0.6195
Vera Swings	2018-10-11	7	10	4	11	0.6195
Whitevale Defender	2018-05-23	3	10	4	7	0.6195
President Pig	2018-05-21	4	10	4	8	0.6195
Fantasy Raiders	2018-07-25	8	10	4	12	0.6195
Magic Blast VR	2018-09-23	5	10	4	9	0.6195
Egg Teacher VR	2018-10-04	17	10	4	21	0.6195
American University Life ~Welcome Week!~	2018-08-01	2	10	4	6	0.6195
Doggo Dig Down	2018-11-12	3	10	4	7	0.6195
W. T. B.	2018-08-09	3	10	4	7	0.6195
GIRAL	2018-09-05	2	10	4	6	0.6195
Educator 2076: Basics in Education	2018-11-16	4	10	4	8	0.6195
Pixel Maze	2018-09-18	5	10	4	9	0.6195
Chuckie Egg 2017	2018-10-16	4	10	4	8	0.6195
Indiana Boy Steam Edition	2018-12-13	2	10	4	6	0.6195
The Dark Inside Me	2018-06-06	15	105	56	71	0.6193
Mini Battlegrounds	2018-08-21	160	366	206	366	0.6192000000000001
Unknown Fate	2018-09-06	7	42	21	28	0.619
War Robots	2018-04-04	2342	10546	6317	8659	0.6187
The Master	2018-01-29	5	51	26	31	0.6186
Kawaii Rainbow Portal	2018-03-27	3	29	14	17	0.6186
The Dummy Experiment	2018-01-19	332	159	87	419	0.6185
Light in the dark	2018-01-09	11	60	31	42	0.6185
Doodle God: Mighty Trio	2018-05-04	57	85	45	102	0.6184000000000001
Filthy Hands	2018-03-29	14	49	25	39	0.618
Torn	2018-08-28	42	134	73	115	0.6178
ShadowSide	2018-08-17	58	231	129	187	0.6176
Last Tide	2018-08-27	998	731	423	1421	0.6175
You have a drunk friend	2018-11-09	87	196	109	196	0.6172
Axis Football 2018	2018-09-14	175	88	47	222	0.6172
The Sibling Experiment	2018-05-26	11	25	12	23	0.6169
IronBorn	2018-09-12	983	25	12	995	0.6169
Witch Sword	2018-01-08	3	25	12	15	0.6169
AI Escort	2018-04-13	109	86	46	155	0.6168
_dive	2018-07-05	4	54	28	32	0.6165999999999999
Switchblade	2018-08-29	309	131	72	381	0.616
Vreal	2018-06-27	31	23	11	42	0.616
Arkane Rush	2018-10-19	5	23	11	16	0.616
Dots Pop : Sexy Hentai Girls	2018-12-17	7	23	11	18	0.616
Mittelborg	2018-11-30	77	73	39	116	0.6152000000000001
Hentai Dojo	2018-08-24	14	113	62	76	0.615
Hollow Steps	2018-02-28	5	41	21	26	0.615
Hentai Forest	2018-11-13	7	41	21	28	0.615
Love Room VR	2018-11-22	6	32	16	22	0.615
Bane of Asphodel	2018-04-21	32	57	30	62	0.6149
Another Sight - Hodge's Journey	2018-11-14	13	57	30	43	0.6149
S.P.I.K.E: ARENA	2018-04-23	3	21	10	13	0.6149
MOAI V: Collector’s Edition	2018-03-29	15	21	10	25	0.6149
Sniper 3D Assassin: Shoot to Kill	2018-09-19	272	870	512	784	0.6148
众生	2018-02-28	109	292	167	276	0.6147
魔物讨伐团	2018-08-15	1012	241	137	1149	0.6145
George VS Bonny PP Wars	2018-07-27	20	48	25	45	0.6144
DRONE The Game	2018-12-17	551	845	499	1050	0.614
National Rugby Manager	2018-02-16	21	30	15	36	0.614
Omae Wa Mou Shindeiru	2018-05-07	2	30	15	17	0.614
Dominus 2	2018-08-06	36	30	15	51	0.614
Adventure Boy Cheapskate DX	2018-12-08	9	30	15	24	0.614
Phantom Thief Celianna	2018-11-16	214	174	98	312	0.6139
5 Minutes Rage	2018-03-02	206	19	9	215	0.6138
Ghostly Matter	2018-07-12	10	28	14	24	0.6129
The Swords of Ditto: Mormo's Curse	2018-04-24	1893	1366	819	2712	0.6128
Snail Racer Extreme	2018-07-17	11	72	39	50	0.6127
Blueprint Word	2018-06-17	4	17	8	12	0.6125
Impossible Runner	2018-02-13	155	147	83	238	0.6121
Yet another tower defence	2018-11-02	82	89	49	131	0.6121
Xion	2018-08-29	5	35	18	23	0.6121
Defense Task Force	2018-06-19	21	35	18	39	0.6121
eSports Legend / 电竞传奇	2018-10-16	3960	725	431	4391	0.612
Sea Dogs: Caribbean Tales	2018-03-15	25	63	34	59	0.6119
Super Treasure Arena	2018-12-24	118	42	22	140	0.6118
Geometry Boxer	2018-05-01	24	42	22	46	0.6118
Mad Dojo	2018-06-15	1109	26	13	1122	0.6118
Crisis on the Planet of the Apes	2018-04-03	22	26	13	35	0.6118
Deadly Escape	2018-02-10	7	49	26	33	0.6117
Simple Story - Alex	2018-03-22	425	354	207	632	0.6115
Zoo Tycoon	2018-09-14	409	1018	611	1020	0.6114
WORLDS AT WAR (Monitor & VR)	2018-03-09	11	104	58	69	0.6113000000000001
In Between Games	2018-01-26	4	15	7	11	0.6111
Acute Art VR Museum	2018-04-04	22	15	7	29	0.6111
Hinterhalt 2	2018-10-08	7	15	7	14	0.6111
XL1-ClippingPoint	2018-02-21	13	54	29	42	0.6109
Vaporwave Simulator	2018-01-01	6	54	29	35	0.6109
Super Steampunk Pinball 2D	2018-01-19	9	47	25	34	0.6108
Dangerous Level	2018-01-30	2	24	12	14	0.6104999999999999
Setup Developer Tool 2018	2018-05-17	9	24	12	21	0.6104999999999999
Highway of death	2018-12-18	2	24	12	14	0.6104999999999999
Medieval Shopkeeper Simulator	2018-05-11	50	154	88	138	0.6103000000000001
Anime And Your Life	2018-11-16	15	59	32	47	0.6103000000000001
Astonia Reborn	2018-08-20	98	93	52	150	0.6098
Catify VR	2018-06-28	7	31	16	23	0.6098
Nazi 2	2018-07-21	3	31	16	19	0.6098
Scamp: High Hat Havoc	2018-12-07	26	81	45	71	0.6096
Cold Blooded Cube	2018-10-15	2261	57	31	2292	0.6095
Waba	2018-07-10	4	13	6	10	0.6095
Catch the Thief, If you can!	2018-01-19	3	13	6	9	0.6095
RPG Merchant	2018-02-15	3	13	6	9	0.6095
Welcome To... Chichester 0 - Preview	2018-06-30	11	13	6	17	0.6095
Pixel Draw	2018-08-22	5	13	6	11	0.6095
Super Turbo Sudoku	2018-11-02	5	13	6	11	0.6095
Dragon Spear	2018-08-16	640	553	331	971	0.6093000000000001
Lovecraft Quest - A Comix Game	2018-11-14	11	50	27	38	0.6091
Hoverloop	2018-01-29	15	22	11	26	0.609
Golem	2018-05-29	10	22	11	21	0.609
Panzer Doctrine	2018-09-03	11	22	11	22	0.609
SpellFront	2018-10-24	10	29	15	25	0.6085
Fallen Legion: Rise to Glory	2018-01-05	31	48	26	57	0.6081000000000001
Just Cause 4	2018-12-04	9571	15284	9640	19211	0.6078
Dark Forester	2018-07-27	36	41	22	58	0.6077
A Salem Witch Trial	2018-02-23	4	41	22	26	0.6077
Play Cube with Uncle Billy	2018-02-24	4	11	5	9	0.6076
Army of Squirrels	2018-02-27	3	11	5	8	0.6076
Shadow of the Black Dragon	2018-02-27	3	11	5	8	0.6076
Highway Wars	2018-03-15	25	11	5	30	0.6076
Pillage	2018-08-13	5	11	5	10	0.6076
Smile'N'Slide	2018-08-03	2	11	5	7	0.6076
Adventure Delivery Service	2018-06-15	2	11	5	7	0.6076
Dungeon Rush	2018-08-09	4	11	5	9	0.6076
Charm Tale	2018-07-31	6	11	5	11	0.6076
High Cats	2018-07-27	8	11	5	13	0.6076
RevelationTrestan-尸忆岛	2018-10-10	4	11	5	9	0.6076
unBorn	2018-07-15	4	20	10	14	0.6074
Thunderbolt 2	2018-05-10	8	20	10	18	0.6074
Evolution	2018-06-03	10	20	10	20	0.6074
Save One More	2018-05-30	9	105	60	69	0.6071
Goat Life	2018-05-25	6	95	54	60	0.6071
过关攒将	2018-12-18	12	27	14	26	0.6071
Dark SASI	2018-05-19	12	204	120	132	0.6069
Cabals: Magic & Battle Cards	2018-02-06	50	39	21	71	0.6065
CoffeeBiz Tycoon	2018-10-31	9	39	21	30	0.6065
Radical Heights	2018-04-10	12757	6115	3852	16609	0.6064
Dissimilated Land	2018-08-17	109	111	64	173	0.606
MineSweep	2018-07-13	6	44	24	30	0.6059
XXX Puzzle	2018-06-16	187	253	151	338	0.6055
Vivez Versailles	2018-07-05	11	25	13	24	0.6055
Absolute Blue	2018-04-21	3	25	13	16	0.6055
Die drei ??? und der Riesenkrake	2018-03-09	15	18	9	24	0.6055
Psychopathics	2018-03-02	2	18	9	11	0.6055
Badminton Kings VR	2018-03-13	11	18	9	20	0.6055
Pixel Xiuzhen	2018-08-09	9	18	9	18	0.6055
Test your knowledge: Cats	2018-08-27	3	18	9	12	0.6055
Girls Dance	2018-07-28	14	54	30	44	0.6054
Battlecursed	2018-02-07	5	9	4	9	0.6054
Online Circle Pong	2018-01-12	7	9	4	11	0.6054
Fisherones	2018-01-18	5	9	4	9	0.6054
Tomato Jones - Episode 3	2018-02-07	3	9	4	7	0.6054
Coffee Crawl	2018-03-21	18	9	4	22	0.6054
The Nature	2018-09-26	3	9	4	7	0.6054
The Risers	2018-05-24	3	9	4	7	0.6054
MDF	2018-06-25	7	9	4	11	0.6054
Welcome to the Pool Hall	2018-08-13	5	9	4	9	0.6054
Rampage of the Dead	2018-07-20	3	9	4	7	0.6054
NOCE	2018-11-26	2	9	4	6	0.6054
Kamasutra Connect : Sexy Hentai Girls	2018-11-13	42	37	20	62	0.6052000000000001
Third Front: WWII	2018-05-11	131	223	133	264	0.6049
Scions of Fate	2018-01-30	129	87	50	179	0.6043999999999999
Mr.Jezko	2018-02-21	21	77	44	65	0.6043000000000001
UAYEB: The Dry Land - Episode 1	2018-01-31	44	52	29	73	0.6043000000000001
SAWKOBAN	2018-01-12	658	57	32	690	0.6042000000000001
Bitcoin Trading Master	2018-05-31	27	136	80	107	0.604
Rules Of Survival	2018-05-31	7484	3156	1998	9482	0.6038
~necromancy~Emily's Escape	2018-12-21	48	283	171	219	0.6038
Liminal	2018-07-23	9	35	19	28	0.6038
King of Phoenix	2018-09-27	14	23	12	26	0.6037
WIN THE GAME: DO IT!	2018-05-02	24	207	124	148	0.6035
A Front Too Far: Normandy	2018-12-20	12	121	71	83	0.6035
Blood Ancestors	2018-08-16	19	16	8	27	0.6034
A Dream For Aaron	2018-03-09	3	16	8	11	0.6034
BLIK	2018-02-06	6	16	8	14	0.6034
夜雪冰娇	2018-03-30	5	16	8	13	0.6034
Horse World	2018-03-26	9	16	8	17	0.6034
Blake and Mortimer: The Curse of the Thirty Denarii	2018-03-06	3	16	8	11	0.6034
Solas and the White Winter	2018-04-13	4	16	8	12	0.6034
Scary defense	2018-04-24	2	16	8	10	0.6034
Car Demolition Clicker	2018-07-05	282	93	54	336	0.6032000000000001
PRO EVOLUTION SOCCER 2019 LITE	2018-12-13	2451	1595	1004	3455	0.603
Akihabara - Feel the Rhythm Remixed	2018-11-28	2	7	3	5	0.6028
Tile Battle	2018-04-04	3	7	3	6	0.6028
Deadly Cryptids	2018-04-11	3	7	3	6	0.6028
Dummy!	2018-12-20	8	7	3	11	0.6028
Oedipus Dating Sim	2018-03-12	2	7	3	5	0.6028
Gamma Blast	2018-12-07	2	7	3	5	0.6028
Chess Cubed	2018-09-01	4	7	3	7	0.6028
Assembly Required	2018-12-17	6	7	3	9	0.6028
Sunburnt	2018-03-27	13	7	3	16	0.6028
Doctor Flow	2018-06-27	3	7	3	6	0.6028
Paradox of the Cryptomancers	2018-05-26	47	7	3	50	0.6028
BlindMaze	2018-04-20	2	7	3	5	0.6028
Bullet Hell ADVANCED	2018-05-18	3	7	3	6	0.6028
Exo TD	2018-08-02	3	7	3	6	0.6028
Rabbit and the moon	2018-07-15	2	7	3	5	0.6028
Slime Kingdom	2018-06-14	3	7	3	6	0.6028
Guess Da Meme	2018-06-16	3	7	3	6	0.6028
Dead Mayhem	2018-07-19	8	7	3	11	0.6028
Dead in time	2018-10-12	3	7	3	6	0.6028
Exodus: Proxima Centauri	2018-08-17	9	7	3	12	0.6028
The Chronicles of Noah's Ark	2018-07-19	5	7	3	8	0.6028
automobiles and the eisenhower hiway system the game	2018-11-01	27	7	3	30	0.6028
Killing random dudes online	2018-10-17	7	7	3	10	0.6028
CasinoRPG	2018-01-16	121	148	88	209	0.6026
Stickman Jetpack	2018-01-16	3	33	18	21	0.6023
City Builder	2018-05-27	4	33	18	22	0.6023
Epic Roller Coasters	2018-03-07	67	338	207	274	0.6022
Ashley Clark: The Secrets of the Ancient Temple	2018-08-31	15	38	21	36	0.6021
Dokkaebi Hentai Adventures	2018-02-28	4	53	30	34	0.6020000000000001
Type Defense	2018-07-18	3	53	30	33	0.6020000000000001
Bubble Ghost	2018-02-08	2	21	11	13	0.6017
太平洋之嵐6 ～ 史上最大的激戰諾曼第攻防戰！	2018-11-30	7	21	11	18	0.6017
The Cage 笼	2018-09-21	5	21	11	16	0.6017
Love is Dead	2018-05-31	219	144	86	305	0.6016
Deluded Mind	2018-06-15	18	61	35	53	0.6013000000000001
Survived By	2018-12-05	3454	770	483	3937	0.6012
Special Warfare	2018-08-29	9	51	29	38	0.6009000000000001
Woeful Woebots	2018-08-31	5	14	7	12	0.6009000000000001
Panacea: Last Will	2018-01-22	6	14	7	13	0.6009000000000001
The Last Operator	2018-09-05	7	14	7	14	0.6009000000000001
 Space Raiders RPG	2018-10-11	3	14	7	10	0.6009000000000001
Meme Supreme ¯\_(ツ)_/¯	2018-06-12	7	14	7	14	0.6009000000000001
Maze And Dagger	2018-06-19	2	14	7	9	0.6009000000000001
DeepWeb	2018-09-20	4	14	7	11	0.6009000000000001
Dice Warrior	2018-09-30	10	14	7	17	0.6009000000000001
Block Pooper 9	2018-12-04	7	14	7	14	0.6009000000000001
ReCore: Definitive Edition	2018-09-14	389	747	469	858	0.6008
Alien Hostage	2018-10-01	4015	124	74	4089	0.6006
RC Simulation 2.0	2018-07-16	18	148	89	107	0.6005
InnerSpace	2018-01-16	46	159	96	142	0.6003000000000001
The Alpha Device	2018-02-14	11	54	31	42	0.5999
Pocket Waifu	2018-11-13	178	386	240	418	0.5998
Roses and Gems	2018-10-05	3	5	2	5	0.5997
Nothin' But Net	2018-05-28	5	5	2	7	0.5997
Futurejam	2018-08-06	3	5	2	5	0.5997
Dolla World	2018-07-21	4	5	2	6	0.5997
Castle Clamber	2018-04-12	5	5	2	7	0.5997
RANDOM rooms	2018-11-12	3	5	2	5	0.5997
Parkland	2018-06-01	2	5	2	4	0.5997
Tisnart Shapes	2018-03-26	3	5	2	5	0.5997
Minitime	2018-05-08	2	5	2	4	0.5997
Wallrunners	2018-10-12	2	5	2	4	0.5997
Paws 'n Claws VR	2018-05-21	3	5	2	5	0.5997
YOMOTSU	2018-10-17	2	5	2	4	0.5997
Sea Explorer	2018-05-29	3	5	2	5	0.5997
Revenant Dogma	2018-10-04	4	5	2	6	0.5997
Lost Legend	2018-07-02	2	5	2	4	0.5997
Universally Loved	2018-08-03	2	5	2	4	0.5997
Bunny Battle Arena	2018-09-12	1	5	2	3	0.5997
The Pirates of Sector 7	2018-06-29	57	5	2	59	0.5997
The Chambers	2018-07-02	5	5	2	7	0.5997
FAN'CIE VEER! (Fish Are Nasty, Cake Is Excellent Vektor Evading Emblazed Rapture)	2018-07-14	2	5	2	4	0.5997
Cosmic Ray	2018-09-28	2	5	2	4	0.5997
GrabBag	2018-08-15	2	5	2	4	0.5997
VOID	2018-11-28	2	5	2	4	0.5997
Bomb Riders	2018-08-29	2	5	2	4	0.5997
SHEEP SLING	2018-09-27	4	5	2	6	0.5997
Ball run and rush	2018-09-27	2	5	2	4	0.5997
Metanormal Demo	2018-09-13	3	5	2	5	0.5997
Torii Path	2018-12-14	2	5	2	4	0.5997
Slime Quest	2018-10-04	3	5	2	5	0.5997
Jam Studio VR - Education & Health Care Edition	2018-10-24	3	5	2	5	0.5997
Magicae Mundi	2018-10-17	3	5	2	5	0.5997
Surge	2018-12-04	5	5	2	7	0.5997
Deathdays End	2018-12-26	2	5	2	4	0.5997
Millidor	2018-03-16	81	96	57	138	0.5995
EXIST	2018-03-26	5	44	25	30	0.5994
darkcase : the basement	2018-06-05	2	19	10	12	0.5994
SosSurvival	2018-10-31	7	19	10	17	0.5994
Casey Powell Lacrosse 18	2018-04-17	15	19	10	25	0.5994
Spiritlands	2018-03-29	14	19	10	24	0.5994
Eternal Man: Forest	2018-02-13	12	19	10	22	0.5994
Toddler Simulator	2018-03-05	3	19	10	13	0.5994
Royal Adventure	2018-04-19	14	19	10	24	0.5994
Little Marisa's Disaster Journey	2018-04-29	4	19	10	14	0.5994
URO	2018-11-22	7	19	10	17	0.5994
Fun Hospital	2018-06-22	310	294	182	492	0.5993
Solitaire Knights	2018-04-05	22	34	19	41	0.5989
Multicellular	2018-10-18	8	34	19	27	0.5989
Henri's Secret	2018-08-29	13	24	13	26	0.5989
Qubika	2018-02-14	3	24	13	16	0.5989
RPGolf	2018-05-10	11	24	13	24	0.5989
Bustories	2018-04-14	3	29	16	19	0.5988
Fable of the Sword	2018-02-09	281	94	56	337	0.5987
MagiCats Builder	2018-07-10	115	121	73	188	0.5984
Underlight	2018-12-14	23	68	40	63	0.5981000000000001
ZEscape	2018-07-20	18	12	6	24	0.598
Volantia	2018-05-03	17	12	6	23	0.598
Lucky VS Aliens	2018-04-06	8	12	6	14	0.598
Sandbox Showdown	2018-06-08	5	12	6	11	0.598
Chroma Shift	2018-10-13	6	12	6	12	0.598
Unmanned helicopter	2018-07-20	4	12	6	10	0.598
DareSora: Tears for an Unknown Sky	2018-09-14	6	12	6	12	0.598
Hentai Dreams	2018-12-11	5	12	6	11	0.598
Stickman in the portal	2018-08-23	5	42	24	29	0.5979
Reborn In Wild City 迷城重生	2018-11-06	215	190	117	332	0.5977
rOt	2018-03-01	7	37	21	28	0.5975
Criminal Bundle	2018-02-13	12	32	18	30	0.5971000000000001
Module TD. Sci-Fi Tower Defense	2018-06-28	15	32	18	33	0.5971000000000001
This Child Of Mine - Demo	2018-03-12	9	45	26	35	0.5969
美少女麻将接龙	2018-08-08	11	27	15	26	0.5968
I was rebuilt	2018-06-28	17	17	9	26	0.5968
Tanks VR	2018-04-06	11	17	9	20	0.5968
Clumsy Knights : Threats of Dragon	2018-01-25	20	17	9	29	0.5968
UpBreakers	2018-11-15	21	17	9	30	0.5968
Scraper: First Strike	2018-11-21	4	17	9	13	0.5968
死亡投票_Death Voting Game	2018-10-15	10	17	9	19	0.5968
The Monster	2018-10-26	5	17	9	14	0.5968
逗国科举 | Douguo Keju	2018-12-07	3	17	9	12	0.5968
Bright Bob	2018-02-03	2	22	12	14	0.5966
Visceral Cubes	2018-05-04	3	22	12	15	0.5966
GROW: Wild West	2018-05-24	7	22	12	19	0.5966
Bomber 95	2018-08-04	15	22	12	27	0.5966
Epic Car Factory	2018-04-09	44	134	82	126	0.5965
Ultimate Spider Hero	2018-01-26	10	61	36	46	0.5965
The Arcslinger	2018-05-07	2	3	1	3	0.596
Panic Pump - Can you save them ALL?	2018-03-28	4	3	1	5	0.596
Umpire Simulator	2018-02-20	2	3	1	3	0.596
Tubular Rift	2018-04-07	2	3	1	3	0.596
Unexpected End	2018-12-03	4	3	1	5	0.596
dsync	2018-06-15	2	3	1	3	0.596
Haste Heist	2018-02-28	3	3	1	4	0.596
The Turdler	2018-08-30	4	3	1	5	0.596
STAR SHREDDERS	2018-01-29	2	3	1	3	0.596
Shooting Sports Gun Club	2018-05-15	3	3	1	4	0.596
IndustrialVR - Hoover Dam	2018-12-20	2	3	1	3	0.596
Dream On The Moon	2018-02-20	6	3	1	7	0.596
Disjoint	2018-05-31	3	3	1	4	0.596
Puzzle Lab	2018-09-25	3	3	1	4	0.596
Warawara Invaders	2018-03-22	2	3	1	3	0.596
Monster RPG 3	2018-04-23	2	3	1	3	0.596
Nothing To God	2018-03-12	3	3	1	4	0.596
Satan's Castle	2018-03-08	1	3	1	2	0.596
Beyond The Heavens	2018-07-02	3	3	1	4	0.596
Volotic	2018-03-10	1	3	1	2	0.596
China VS Roman	2018-03-21	1	3	1	2	0.596
The Rhys510 Flash Back	2018-03-26	1	3	1	2	0.596
Asteroid Deflector XL	2018-03-23	1	3	1	2	0.596
Patternis	2018-08-30	4	3	1	5	0.596
Mortal Squad: Portal to Hell	2018-04-17	1	3	1	2	0.596
Downhill Deceits	2018-04-03	2	3	1	3	0.596
Roller Coaster Apocalypse VR	2018-04-17	3	3	1	4	0.596
Bouncy Butter Ball	2018-05-31	2	3	1	3	0.596
Ball Escape	2018-04-25	2	3	1	3	0.596
Bomight	2018-04-30	2	3	1	3	0.596
Adventures in the Light & Dark	2018-07-25	1	3	1	2	0.596
Z.W!	2018-05-15	1	3	1	2	0.596
Dawn of the Celestialpod	2018-06-12	2	3	1	3	0.596
Betweenside	2018-09-12	2	3	1	3	0.596
Sakura and Crit: The Mock Game	2018-08-10	2	3	1	3	0.596
Gull Kebap VR	2018-06-13	2	3	1	3	0.596
FINSummerVR	2018-06-27	2	3	1	3	0.596
Cryptozookeeper	2018-06-29	2	3	1	3	0.596
Factory of Monsters	2018-06-18	2	3	1	3	0.596
Bookers: Underground Chapter	2018-06-28	2	3	1	3	0.596
STARSHIP AVENGER Operation: Take Back Earth/スターシップアベンジャー地球奪還大作戦	2018-08-09	3	3	1	4	0.596
Cybrus	2018-08-23	3	3	1	4	0.596
Egony	2018-06-27	1	3	1	2	0.596
Immortals	2018-07-14	5	3	1	6	0.596
Mercs	2018-07-19	4	3	1	5	0.596
Dragonfly Chronicles	2018-08-10	2	3	1	3	0.596
Retro Snake Adventures	2018-08-21	2	3	1	3	0.596
Team A.R.G. Anthology	2018-07-30	2	3	1	3	0.596
Hungry Kitty Donuts Mania	2018-08-02	1	3	1	2	0.596
Turing Tumble VR	2018-08-01	2	3	1	3	0.596
Chiptune DJ	2018-08-17	1	3	1	2	0.596
Serenade of the Sirens	2018-10-24	2	3	1	3	0.596
Age Of Forays	2018-08-18	2	3	1	3	0.596
Beating A Dead Horse With A One-Trick Pony	2018-11-21	2	3	1	3	0.596
Pirate Island Rescue	2018-09-17	2	3	1	3	0.596
Sakura Day 2 Mahjong	2018-10-19	4	3	1	5	0.596
Tabletop Basketball VR	2018-11-23	1	3	1	2	0.596
A Mars Journey: Redturtle	2018-09-26	2	3	1	3	0.596
Stickman Maverick : Bad Boys Killer	2018-11-07	2	3	1	3	0.596
Orc Towers VR	2018-12-24	2	3	1	3	0.596
Maze 4D	2018-12-13	1	3	1	2	0.596
Hyperborean Charter	2018-12-11	2	3	1	3	0.596
Apartment of Love	2018-03-15	330	152	94	424	0.5954
Distortions	2018-03-02	14	108	66	80	0.5952000000000001
Aim Master	2018-11-21	12	30	17	29	0.5952000000000001
Last Anime Boy 2: Hentai Zombie Hell	2018-04-16	3	38	22	25	0.5947
20.000 Leagues Under The Sea - Captain Nemo	2018-03-15	5	25	14	19	0.5946
Aladin & the Enchanted Lamp	2018-03-29	4	25	14	18	0.5946
Ray of Light	2018-07-12	3	25	14	17	0.5946
Turret Tech	2018-08-02	5	25	14	19	0.5946
Super Tony Land	2018-04-19	8	10	5	13	0.5943
Stunt Corgi VR	2018-01-15	5	10	5	10	0.5943
Archimedes	2018-08-30	9	10	5	14	0.5943
The Beanstalk	2018-01-25	10	10	5	15	0.5943
Meow Wars: Card Battle	2018-08-31	4	10	5	9	0.5943
Origin of Decay	2018-11-26	4	10	5	9	0.5943
Stronghold: A Hero’s Fate	2018-11-16	36	10	5	41	0.5943
Amanda's Sticker Book	2018-12-17	4	10	5	9	0.5943
TileDynasty FPS Arena	2018-01-01	2	1	0	2	0.5942000000000001
Khufu's Delivery Service	2018-01-19	1	1	0	1	0.5942000000000001
Abraxas Interactive's PUSH	2018-03-23	2	1	0	2	0.5942000000000001
Juke	2018-05-09	1	1	0	1	0.5942000000000001
Funny Fingers	2018-04-27	2	1	0	2	0.5942000000000001
Infinite Sunshine Dust	2018-07-30	2	1	0	2	0.5942000000000001
Prisoner	2018-03-15	3	1	0	3	0.5942000000000001
Martha Madison: Electricity	2018-02-08	1	1	0	1	0.5942000000000001
Battlemage Training	2018-01-18	1	1	0	1	0.5942000000000001
Rocka Feller	2018-11-30	2	1	0	2	0.5942000000000001
Hordiaz	2018-12-03	2	1	0	2	0.5942000000000001
Musician	2018-03-20	2	1	0	2	0.5942000000000001
Pivot Puzzles	2018-02-23	1	1	0	1	0.5942000000000001
Orbits	2018-03-21	1	1	0	1	0.5942000000000001
Neon VR	2018-11-02	1	1	0	1	0.5942000000000001
Green Blood	2018-06-03	2	1	0	2	0.5942000000000001
Steel Eagle	2018-01-23	1	1	0	1	0.5942000000000001
Get Dis Money	2018-03-09	1	1	0	1	0.5942000000000001
Sector 452	2018-03-02	4	1	0	4	0.5942000000000001
Tile Typer	2018-01-23	2	1	0	2	0.5942000000000001
Hexed	2018-02-19	2	1	0	2	0.5942000000000001
Synced Warriors	2018-01-17	1	1	0	1	0.5942000000000001
Bubblien Pop	2018-01-06	1	1	0	1	0.5942000000000001
Defense of the Fantasy Robots	2018-10-05	1	1	0	1	0.5942000000000001
Slime-san: Sheeple’s Sequel	2018-02-05	4	1	0	4	0.5942000000000001
Agent X: Equation Rider	2018-01-04	2	1	0	2	0.5942000000000001
Lowpoly Hero	2018-01-24	1	1	0	1	0.5942000000000001
Army of Tentacles: (Not) A Cthulhu Dating Sim: Black GOAT of the Woods Edition	2018-01-04	1	1	0	1	0.5942000000000001
Banshee Force	2018-02-01	2	1	0	2	0.5942000000000001
Sorcerer's Path	2018-03-05	1	1	0	1	0.5942000000000001
The Placebos	2018-02-17	2	1	0	2	0.5942000000000001
HorD: High or Die	2018-02-19	2	1	0	2	0.5942000000000001
Magical Star Pillars	2018-04-28	2	1	0	2	0.5942000000000001
Survival Space: Unlimited Shooting	2018-01-31	1	1	0	1	0.5942000000000001
Neon	2018-02-06	1	1	0	1	0.5942000000000001
CONTAINMENT	2018-04-24	1	1	0	1	0.5942000000000001
Sea of Lies: Burning Coast Collector's Edition	2018-01-26	4	1	0	4	0.5942000000000001
Myths of the World: Spirit Wolf Collector's Edition	2018-01-29	4	1	0	4	0.5942000000000001
Internal Storm	2018-03-28	1	1	0	1	0.5942000000000001
Brick vs. Paddle	2018-04-06	2	1	0	2	0.5942000000000001
Edvog Explorer Game	2018-04-21	1	1	0	1	0.5942000000000001
Mortar and Pestle	2018-02-20	1	1	0	1	0.5942000000000001
NCradle	2018-03-01	1	1	0	1	0.5942000000000001
Splash Adventure: The Maze of Morla	2018-03-15	1	1	0	1	0.5942000000000001
Rainbow Cult	2018-10-25	2	1	0	2	0.5942000000000001
Iridescence	2018-12-08	1	1	0	1	0.5942000000000001
Lost In 80s II	2018-03-20	1	1	0	1	0.5942000000000001
Danse Macabre: Deadly Deception Collector's Edition	2018-02-14	3	1	0	3	0.5942000000000001
Radiant Melodia	2018-02-26	3	1	0	3	0.5942000000000001
Neon Spaceboard	2018-10-08	5	1	0	5	0.5942000000000001
RTAG rise	2018-02-22	2	1	0	2	0.5942000000000001
Space Fighters	2018-04-02	6	1	0	6	0.5942000000000001
GOHOROBO	2018-03-21	3	1	0	3	0.5942000000000001
Hidden Life	2018-03-16	2	1	0	2	0.5942000000000001
various fighters	2018-03-27	1	1	0	1	0.5942000000000001
NickProject	2018-03-09	1	1	0	1	0.5942000000000001
Contrasted	2018-11-30	1	1	0	1	0.5942000000000001
AngeliaLost	2018-06-14	2	1	0	2	0.5942000000000001
CubicPanic	2018-05-04	1	1	0	1	0.5942000000000001
Five Seconds of Bad Music	2018-09-28	1	1	0	1	0.5942000000000001
Isolated	2018-05-01	1	1	0	1	0.5942000000000001
Escape!	2018-03-15	2	1	0	2	0.5942000000000001
FAUCET VR	2018-03-07	1	1	0	1	0.5942000000000001
Game of Stones	2018-03-28	4	1	0	4	0.5942000000000001
Outsider Strategist～異世界で軍師になる～	2018-03-29	2	1	0	2	0.5942000000000001
Space Duty	2018-03-22	1	1	0	1	0.5942000000000001
Slam Land	2018-08-07	3	1	0	3	0.5942000000000001
Face au train	2018-03-27	2	1	0	2	0.5942000000000001
Go Go Poncho!	2018-03-26	4	1	0	4	0.5942000000000001
SShield Reborn	2018-03-23	1	1	0	1	0.5942000000000001
FlappyU	2018-04-18	1	1	0	1	0.5942000000000001
BLOCK CAT SPACE GOLF	2018-06-15	2	1	0	2	0.5942000000000001
Zombie Teacher	2018-05-15	2	1	0	2	0.5942000000000001
Dark Canvas: A Murder Exposed Collector's Edition	2018-04-02	3	1	0	3	0.5942000000000001
Haunted Manor: Painted Beauties Collector's Edition	2018-04-04	3	1	0	3	0.5942000000000001
Sable Maze: Forbidden Garden Collector's Edition	2018-04-11	3	1	0	3	0.5942000000000001
Stargazer program	2018-05-23	2	1	0	2	0.5942000000000001
Basketball Hero VR	2018-06-20	1	1	0	1	0.5942000000000001
Snowball Saves Summer	2018-09-26	3	1	0	3	0.5942000000000001
Noonie	2018-05-02	2	1	0	2	0.5942000000000001
I Pay No Rent	2018-05-16	2	1	0	2	0.5942000000000001
Play Top Frag	2018-10-11	11	1	0	11	0.5942000000000001
DiyMachinery	2018-05-16	2	1	0	2	0.5942000000000001
Endless Horizon	2018-05-01	1	1	0	1	0.5942000000000001
BATTER BURST	2018-05-07	2	1	0	2	0.5942000000000001
Maze Madness 3D FPS	2018-05-09	2	1	0	2	0.5942000000000001
Space Drop	2018-05-25	1	1	0	1	0.5942000000000001
Star Tower	2018-05-25	1	1	0	1	0.5942000000000001
SlimeGear	2018-08-06	1	1	0	1	0.5942000000000001
The Amazing Adventures of Lady Fanny Featherstone	2018-07-14	1	1	0	1	0.5942000000000001
Omega Commando	2018-05-21	1	1	0	1	0.5942000000000001
D.F.R.: The Light VR	2018-05-14	1	1	0	1	0.5942000000000001
Claw Breaker	2018-08-23	2	1	0	2	0.5942000000000001
ChameleonMan	2018-07-31	1	1	0	1	0.5942000000000001
360 No Scope!	2018-08-28	2	1	0	2	0.5942000000000001
FrogStatue	2018-06-13	2	1	0	2	0.5942000000000001
Road Z Survival: The Last Winter	2018-07-27	2	1	0	2	0.5942000000000001
Lands Of The Lost	2018-06-08	2	1	0	2	0.5942000000000001
Keep Running	2018-06-13	2	1	0	2	0.5942000000000001
Destiny of Altrais	2018-10-19	4	1	0	4	0.5942000000000001
Grid Games: Color Coded	2018-09-06	2	1	0	2	0.5942000000000001
Final Missions	2018-06-14	1	1	0	1	0.5942000000000001
CanYouSurvive?	2018-06-29	1	1	0	1	0.5942000000000001
ATMOTECH EPISODE PRAELUDIUM	2018-10-01	1	1	0	1	0.5942000000000001
Don't Feed The Slimes!	2018-06-23	1	1	0	1	0.5942000000000001
1 HIT KILL	2018-07-19	1	1	0	1	0.5942000000000001
The treasure of the lost temple	2018-07-04	2	1	0	2	0.5942000000000001
The Grid	2018-09-13	1	1	0	1	0.5942000000000001
GolemRush	2018-07-20	1	1	0	1	0.5942000000000001
6-in-1 IQ Scale Bundle	2018-07-13	5	1	0	5	0.5942000000000001
Epic Helicopter	2018-07-04	1	1	0	1	0.5942000000000001
BoxRunner	2018-08-17	2	1	0	2	0.5942000000000001
Space Hamster in Turmoil	2018-07-24	1	1	0	1	0.5942000000000001
Echoes World	2018-10-31	1	1	0	1	0.5942000000000001
Whacker Guy: Distance Hunter	2018-08-30	1	1	0	1	0.5942000000000001
Actionpaint VR	2018-09-11	1	1	0	1	0.5942000000000001
Stalked at Night	2018-07-26	1	1	0	1	0.5942000000000001
The Chaotic Workshop	2018-09-04	3	1	0	3	0.5942000000000001
Symphonics	2018-09-06	2	1	0	2	0.5942000000000001
Omicroid	2018-09-11	1	1	0	1	0.5942000000000001
Avem888	2018-07-26	2	1	0	2	0.5942000000000001
Free Throw	2018-08-20	2	1	0	2	0.5942000000000001
MONOWARS: Red Zone	2018-08-14	1	1	0	1	0.5942000000000001
Puzzle Noid	2018-08-11	1	1	0	1	0.5942000000000001
Slay The Dragon	2018-08-22	3	1	0	3	0.5942000000000001
Antox vs. Free Radicals	2018-11-13	1	1	0	1	0.5942000000000001
ChromaSquares	2018-09-14	1	1	0	1	0.5942000000000001
Ducks and Gooobers	2018-08-17	2	1	0	2	0.5942000000000001
PlatBall	2018-08-14	2	1	0	2	0.5942000000000001
Boom Bits	2018-09-14	1	1	0	1	0.5942000000000001
Surge	2018-08-24	1	1	0	1	0.5942000000000001
Koi Solitaire	2018-09-01	2	1	0	2	0.5942000000000001
Zettavolt Trigger	2018-09-05	1	1	0	1	0.5942000000000001
TailzFromTheGrave	2018-08-22	1	1	0	1	0.5942000000000001
Cube Full of Mines	2018-09-12	2	1	0	2	0.5942000000000001
Slime-san: Creator	2018-12-08	2	1	0	2	0.5942000000000001
Lot'zAmonsters	2018-09-04	2	1	0	2	0.5942000000000001
Twin Synth	2018-10-15	1	1	0	1	0.5942000000000001
Duck's Inferno	2018-11-05	2	1	0	2	0.5942000000000001
Duck Hunting Challenge	2018-12-17	2	1	0	2	0.5942000000000001
M-Plan	2018-09-21	1	1	0	1	0.5942000000000001
怪奇幻想夢物語 怪獣綺譚 桜蛇伝	2018-09-26	1	1	0	1	0.5942000000000001
Singularity Shooter	2018-12-24	1	1	0	1	0.5942000000000001
Cubeverse	2018-10-09	2	1	0	2	0.5942000000000001
Impixable	2018-11-13	2	1	0	2	0.5942000000000001
The Necklace Of Blood Part II	2018-09-28	1	1	0	1	0.5942000000000001
TRIP	2018-10-09	1	1	0	1	0.5942000000000001
Jake and the Giant	2018-12-24	2	1	0	2	0.5942000000000001
Scraps and Patches	2018-11-19	1	1	0	1	0.5942000000000001
Bad Day Betsy	2018-09-24	1	1	0	1	0.5942000000000001
Lolly Pang VR	2018-10-12	4	1	0	4	0.5942000000000001
Goalkeeper VR Challenge	2018-11-28	6	1	0	6	0.5942000000000001
The Adventures of Team Australia	2018-10-29	1	1	0	1	0.5942000000000001
Surrogate	2018-10-23	1	1	0	1	0.5942000000000001
Temple Scramble	2018-11-10	1	1	0	1	0.5942000000000001
BlockDoc	2018-10-31	2	1	0	2	0.5942000000000001
Silver Child	2018-10-30	1	1	0	1	0.5942000000000001
Second World: Air War S	2018-12-15	2	1	0	2	0.5942000000000001
Rope Racer O'Neon	2018-12-03	3	1	0	3	0.5942000000000001
Ultimate Legends	2018-12-24	2	1	0	2	0.5942000000000001
Time Virus	2018-11-07	1	1	0	1	0.5942000000000001
Space Gladiator	2018-11-16	1	1	0	1	0.5942000000000001
Galactic Incoming	2018-11-14	2	1	0	2	0.5942000000000001
Haunted Legends: The Dark Wishes Collector's Edition	2018-12-07	3	1	0	3	0.5942000000000001
Juggly	2018-12-26	2	1	0	2	0.5942000000000001
No Crossing	2018-11-24	2	1	0	2	0.5942000000000001
Mahjong Fest: Winterland	2018-12-19	3	1	0	3	0.5942000000000001
Caracoland	2018-12-14	2	1	0	2	0.5942000000000001
Jumper Tree	2018-12-11	1	1	0	1	0.5942000000000001
Greedy Crush	2018-12-22	3	1	0	3	0.5942000000000001
FIT IN	2018-12-18	1	1	0	1	0.5942000000000001
Trigger Table	2018-12-10	1	1	0	1	0.5942000000000001
Christmas Wonderland	2018-12-30	3	1	0	3	0.5942000000000001
PsyShift	2018-12-20	1	1	0	1	0.5942000000000001
Northern Tales	2018-12-24	1	1	0	1	0.5942000000000001
The Black Knight	2018-12-19	1	1	0	1	0.5942000000000001
OO.Inc	2018-12-28	1	1	0	1	0.5942000000000001
Bartender VR Simulator	2018-02-09	28	87	53	81	0.5941
The Cursed Tower	2018-02-06	31	57	34	65	0.594
GoatPunks	2018-11-30	13	20	11	24	0.594
勇士冲冲冲	2018-03-27	21	20	11	32	0.594
Suna	2018-03-12	10	20	11	21	0.594
Scrash	2018-06-30	101	20	11	112	0.594
Season Up	2018-04-06	57	20	11	68	0.594
Ilhumia	2018-12-21	29	20	11	40	0.594
Murnatan	2018-03-24	54	68	41	95	0.5938
Arakion: Book One	2018-05-15	13	15	8	21	0.5937
Violet Cycle	2018-02-02	11	15	8	19	0.5937
Draw Near	2018-04-15	15	15	8	23	0.5937
Corral	2018-09-27	4	15	8	12	0.5937
Rent-a-Vice	2018-05-24	39	15	8	47	0.5937
Roads of Rome: New Generation 2	2018-11-02	16	15	8	24	0.5937
World Warfare	2018-04-03	215	104	64	279	0.5936
Ragnania HD	2018-10-18	958	679	441	1399	0.5934
Need a packet?	2018-08-20	5	28	16	21	0.593
Happy Empire - A Bouquet for the Princess	2018-01-15	104	44	26	130	0.5929
Call of Bitcoin	2018-04-23	5	44	26	31	0.5929
Outback Survival	2018-09-20	5	36	21	26	0.5928
Victory At Sea Pacific	2018-09-14	414	356	229	643	0.5926
INSOMNIA: The Ark	2018-09-27	641	703	460	1101	0.5920000000000001
Pivross	2018-04-16	19	50	30	49	0.5917
One-way Ticket · 单程票	2018-10-25	262	233	149	411	0.5916
Harvest Seasons	2018-02-23	755	219	140	895	0.5913
Fluffy Horde	2018-11-07	114	225	144	258	0.5912
Ecchi Puzzle	2018-08-23	5	42	25	30	0.5912
Reficul	2018-05-10	3	18	10	13	0.5910000000000001
The Quiet Sleep	2018-01-30	8	18	10	18	0.5910000000000001
Ahlman Arcade 2018	2018-08-11	19	18	10	29	0.5910000000000001
You Can(Not) Survive	2018-12-12	8	18	10	18	0.5910000000000001
懒人修仙传	2018-11-14	1522	765	504	2026	0.5909000000000001
Champions of Titan	2018-08-10	158	84	52	210	0.5909000000000001
Riverhill Trials	2018-04-12	9	34	20	29	0.5908
Chronicles of Mystery - The Tree of Life	2018-07-13	11	34	20	31	0.5908
Smart Cube	2018-07-31	4	26	15	19	0.5906
Red Riding Hood - Star Crossed Lovers	2018-04-04	6	48	29	35	0.5901
Halloween Pumpkin Story	2018-04-26	6	13	7	13	0.59
XBall Champion	2018-02-13	4	13	7	11	0.59
Neon Force Pushers	2018-04-25	9	13	7	16	0.59
TRAGO	2018-07-17	2	13	7	9	0.59
Unnatural	2018-07-19	20	13	7	27	0.59
Pachansky Mathematics 2+2=8	2018-08-21	2	13	7	9	0.59
Poisoner	2018-10-10	7	13	7	14	0.59
Bad Note 破碎的笔记	2018-11-30	5	13	7	12	0.59
Rocket Valley Tycoon	2018-06-01	230	105	66	296	0.5898
PAPA'S TIME MACHINE	2018-04-02	3	8	4	7	0.5897
Kingdom Watcher	2018-05-28	3	8	4	7	0.5897
Teleporter	2018-09-25	13	8	4	17	0.5897
Atoms	2018-02-07	4	8	4	8	0.5897
NOSTOI	2018-09-28	3	8	4	7	0.5897
The Villa: Allison's Diary	2018-03-21	2	8	4	6	0.5897
Peccator: Chapter 1	2018-04-13	3	8	4	7	0.5897
Cube Universe	2018-04-24	2	8	4	6	0.5897
The Amazing Bernard	2018-04-11	2	8	4	6	0.5897
A Typewriter’s Story	2018-06-22	1	8	4	5	0.5897
Running Naked Simulator 2019	2018-10-22	5	8	4	9	0.5897
CastleGuard	2018-11-02	3	8	4	7	0.5897
Super Jigsaw Puzzle: Anime	2018-11-12	12	8	4	16	0.5897
Big Bash Boom	2018-12-21	6	8	4	10	0.5897
Spartan Fist	2018-05-15	19	29	17	36	0.5895
Infected Battlegrounds	2018-08-02	9	29	17	26	0.5895
Animal Jam	2018-12-11	5009	1955	1315	6324	0.5893
S.F.77	2018-09-14	13	21	12	25	0.5892000000000001
Dubstep Abasralsa	2018-05-31	3	57	35	38	0.589
303 Squadron: Battle of Britain	2018-08-31	49	228	148	197	0.5885
Chocolate makes you happy: Halloween	2018-09-27	4	46	28	32	0.5885
STARBO - The Story of Leo Cornell	2018-01-04	4	66	41	45	0.5883
Alien Crusader	2018-03-09	38	49	30	68	0.5881000000000001
Desire	2018-05-10	8	49	30	38	0.5881000000000001
DARCO - Reign of Elements	2018-05-04	21	35	21	42	0.588
Orbos	2018-05-03	45	35	21	66	0.588
Lost in the Dungeon	2018-03-12	80	72	45	125	0.5879
Siege Saga	2018-02-28	12	24	14	26	0.5879
Dragon Hunt	2018-04-26	5	55	34	39	0.5875
Eternal Man: Jump	2018-04-26	7	16	9	16	0.5875
Soul Smith of the Kingdom	2018-05-04	538	90	57	595	0.5872999999999999
Laplace：拉普拉斯的神子	2018-10-02	110	64	40	150	0.5870000000000001
Picross Fairytale: Legend of the Mermaid	2018-08-01	72	41	25	97	0.5870000000000001
Wars of Seignior	2018-12-27	10	27	16	26	0.5870000000000001
Putin Run Away From Trump	2018-06-01	2	44	27	29	0.5867
2084	2018-12-13	13	73	46	59	0.5866
ORIX!	2018-05-29	9	82	52	61	0.5864
Steel Rats	2018-11-07	862	718	483	1345	0.5863
Abstractanoid	2018-03-26	5	30	18	23	0.5863
Titty Crush	2018-05-03	15	50	31	46	0.5861999999999999
Tyr: Chains of Valhalla	2018-05-08	13	19	11	24	0.5859000000000001
Arboreal	2018-07-16	14	19	11	25	0.5859000000000001
JUST DASH	2018-08-18	7	19	11	18	0.5859000000000001
Ninja Code	2018-10-07	4	19	11	15	0.5859000000000001
Run Naked Woman Run	2018-12-07	2	19	11	13	0.5859000000000001
Pandemic: The Board Game	2018-08-24	169	385	257	426	0.5855
Thrust & Shoot : Flight School	2018-02-14	3	11	6	9	0.5855
Cyberoque	2018-11-26	3	11	6	9	0.5855
Guard of Wonderland VR	2018-04-17	3	11	6	9	0.5855
The Great Tournament 2	2018-02-26	15	11	6	21	0.5855
The Land of Glass	2018-03-27	3	11	6	9	0.5855
Expedia Cenote Experience	2018-10-01	10	11	6	16	0.5855
Sharp	2018-09-01	6	11	6	12	0.5855
Time Carnage	2018-09-12	5	11	6	11	0.5855
morphe	2018-10-05	3	11	6	9	0.5855
ARTé: Mecenas®	2018-11-16	5	11	6	11	0.5855
Beach Pong	2018-10-16	2	11	6	8	0.5855
TendyTrainer	2018-12-03	8	11	6	14	0.5855
Automobile Tycoon	2018-09-04	9	36	22	31	0.5853
National Machine	2018-06-29	9	36	22	31	0.5853
The Moment We Met	2018-10-16	258	147	96	354	0.5849000000000001
Drakkhen	2018-02-08	4	22	13	17	0.5849000000000001
Eternal Man: Mountain	2018-04-06	8	22	13	21	0.5849000000000001
Ero Date	2018-09-06	7	22	13	20	0.5849000000000001
Tyler: Model 005	2018-08-21	267	45	28	295	0.5846
Crusaders of Light	2018-03-08	1008	351	235	1243	0.5845
Don't Stand Out	2018-05-31	39	48	30	69	0.5844
The Council of Hanwell	2018-03-14	12	48	30	42	0.5844
Hentai no Hero	2018-10-10	3	51	32	35	0.5843
东方驾考模拟器|Chinese Driving License Test	2018-12-29	10	54	34	44	0.5842
Age of Viking Conquest	2018-09-19	15	25	15	30	0.5841
ButcherBoy	2018-07-11	5	66	42	47	0.584
Luminescence	2018-03-31	5	28	17	22	0.5836
Medical verdict	2018-10-01	5	28	17	22	0.5836
Lil' Arena	2018-11-16	41	28	17	58	0.5836
心の闇の先に Trial VersionⅡ	2018-01-15	11	14	8	19	0.5833
Drift Stunt Racing 2019	2018-09-26	2	14	8	10	0.5833
Termite	2018-12-10	8	14	8	16	0.5833
The Chronicles of King Arthur - Episode 1: Excalibur	2018-12-23	5	14	8	13	0.5833
VR Darts	2018-05-09	2	6	3	5	0.5833
BlowOut	2018-03-06	2	6	3	5	0.5833
Hollow Throne	2018-01-29	3	6	3	6	0.5833
Live the Guitar	2018-03-09	1	6	3	4	0.5833
Jingle	2018-12-11	5	6	3	8	0.5833
Ativeil	2018-02-15	3	6	3	6	0.5833
The Agency of Anomalies: Mind Invasion Collector's Edition	2018-02-07	5	6	3	8	0.5833
Gun Rage	2018-09-17	2	6	3	5	0.5833
Ride To Canada	2018-05-11	3	6	3	6	0.5833
战术狂想2(Chimera of Tactics 2)	2018-07-18	2	6	3	5	0.5833
The Outsiders	2018-06-18	2	6	3	5	0.5833
Nurikabe	2018-08-01	3	6	3	6	0.5833
Robbotto	2018-08-16	3	6	3	6	0.5833
O.C.D. - On Completeness & Dissonance	2018-07-20	2	6	3	5	0.5833
VirtuaCreature (Legacy Version)	2018-08-07	3	6	3	6	0.5833
Obstruction	2018-09-13	2	6	3	5	0.5833
Mixed Estate	2018-11-02	11	6	3	14	0.5833
Aim Theory - Trainer	2018-11-21	4	6	3	7	0.5833
Slave Ghost	2018-11-29	1	6	3	4	0.5833
The.Thend.End	2018-12-19	2	6	3	5	0.5833
Valthirian Arc: Hero School Story	2018-10-02	288	182	121	409	0.5827
RAW FOOTAGE	2018-08-15	5	43	27	32	0.5826
Mortars VR	2018-01-03	15	98	64	79	0.5822999999999999
Scrap Attack	2018-01-18	3	17	10	13	0.5821000000000001
Frankenstein: Beyond the Time	2018-08-01	4	17	10	14	0.5821000000000001
Top Down Racer	2018-12-12	201	17	10	211	0.5821000000000001
Dungeon Hunter Champions	2018-12-19	374	318	215	589	0.5820000000000001
Ready Player One: OASIS beta	2018-04-17	84	293	198	282	0.5818
Linch	2018-01-02	17	102	67	84	0.5815
Falling words	2018-05-16	4	74	48	52	0.5815
Logos	2018-06-13	6	20	12	18	0.5814
Les Misérables: Cosette's Fate	2018-04-03	5	20	12	17	0.5814
Play With Kizami	2018-08-10	272	182	122	394	0.5810000000000001
One Wish	2018-06-07	8234	90	59	8293	0.5810000000000001
Russian Prison Sport: OCHKO	2018-04-30	4	23	14	18	0.5809000000000001
Putinoids VS Navalnyats - Путиноиды Против Навальнят	2018-05-16	2	23	14	16	0.5809000000000001
Alone	2018-06-21	5	23	14	19	0.5809000000000001
Basketball Hoop	2018-08-11	4	23	14	18	0.5809000000000001
Attrition: Tactical Fronts	2018-03-06	7	26	16	23	0.5807
ASH OF WAR™	2018-11-03	5	38	24	29	0.5805
Dream Alone	2018-06-28	9	32	20	29	0.5805
Nono's magic general shop	2018-09-29	39	35	22	61	0.5804
Bomb Royale	2018-12-13	1858	75	49	1907	0.5803
DimensionsVS	2018-08-20	46	72	47	93	0.5802
Cyber Surf	2018-02-27	8	9	5	13	0.5796
BSL Winter Game Challenge	2018-03-07	4	9	5	9	0.5796
Mad Frost	2018-05-14	3	9	5	8	0.5796
Number Guesser	2018-05-09	2	9	5	7	0.5796
Shopping Clutter 2: Christmas Square	2018-12-03	5	9	5	10	0.5796
The Trials of Olympus	2018-12-13	7	9	5	12	0.5796
Shaverma: Ravshan Edition	2018-12-13	2	9	5	7	0.5796
Data mining 4	2018-12-24	3	9	5	8	0.5796
Deathtrap Dungeon Trilogy	2018-07-11	57	60	39	96	0.5795
Bastard	2018-05-14	57	86	57	114	0.5787
Dead Ground	2018-02-14	14	64	42	56	0.5784
The other side of the screen	2018-05-28	3	42	27	30	0.5784
Anime Girl Or Boy?	2018-08-15	2	42	27	29	0.5784
Return to Planet X	2018-09-07	3	12	7	10	0.5782
Timbertales	2018-06-12	7	12	7	14	0.5782
Witch Thief	2018-09-21	4	12	7	11	0.5782
Dongo Adventure	2018-12-07	2	12	7	9	0.5782
Techwars Deathmatch	2018-04-17	5	12	7	12	0.5782
Freebot : Battle for FreeWeb	2018-06-18	2	12	7	9	0.5782
巭孬嫑毖	2018-11-30	24	12	7	31	0.5782
Mushroom rain	2018-09-08	3	12	7	10	0.5782
Sanguo Warriors VR2 三国虎将传VR2	2018-10-09	2	12	7	9	0.5782
Hanz Puppetguns	2018-08-16	33	61	40	73	0.5781000000000001
SinVR	2018-12-21	155	675	472	627	0.5779
Tactics & Strategy Master:Joan of Arc	2018-04-10	10	30	19	29	0.5777
Find & Destroy: Tank Strategy	2018-06-12	50	71	47	97	0.5776
Moon Bullet	2018-02-13	3	15	9	12	0.5776
Puzzles for smart: Cats	2018-06-22	3	15	9	12	0.5776
Love Hentai: Sexy Body	2018-10-01	2	15	9	11	0.5776
Christmas Defence	2018-12-18	3	15	9	12	0.5776
Darkheart: Flight of the Harpies	2018-12-15	7	15	9	16	0.5776
After Hours	2018-12-20	6	15	9	15	0.5776
Swipe Fruit Smash	2018-06-25	5	27	17	22	0.5775
Before Nightfall	2018-07-28	8	52	34	42	0.5774
7-in-1 Brain Sharpness Bundle	2018-05-17	6	24	15	21	0.5774
Blazing Core	2018-10-18	22	24	15	37	0.5774
Song of Memories	2018-02-28	25	68	45	70	0.5773
Starman's VR Experience	2018-03-20	12	21	13	25	0.5773
Fatal Stormer	2018-04-04	4	18	11	15	0.5773
BattleCry: World At War	2018-10-02	16	18	11	27	0.5773
Little hidden city	2018-02-28	9	150	102	111	0.5772
Russian AYE Horror	2018-04-18	4	81	54	58	0.5772
Idle Hunter	2018-08-23	54	49	32	86	0.5771000000000001
Noir Chronicles: City of Crime	2018-01-25	53	114	77	130	0.5770000000000001
ALIENS INVADED OUR PLANET	2018-06-15	8	46	30	38	0.5768
Uptasia	2018-01-10	120	121	82	202	0.5767
WeakWood Throne	2018-01-30	19	43	28	47	0.5765
Cricket Captain 2018	2018-07-13	222	43	28	250	0.5765
Robert Rodriguez’s The Limit: An Immersive Cinema Experience	2018-11-22	10	43	28	38	0.5765
Forged Battalion	2018-08-14	442	617	435	877	0.5759000000000001
Westard	2018-01-10	12	34	22	34	0.5754
1943 Deadly Desert	2018-05-15	84	47	31	115	0.5750000000000001
Putin takes taxes	2018-02-20	3	28	18	21	0.5746
Sierra Madre: The Wild West	2018-12-17	12	28	18	30	0.5746
Bounce	2018-04-02	4	54	36	40	0.5743
American Railroads - Summit River & Pine Valley	2018-04-20	17	101	69	86	0.5740999999999999
Removed	2018-04-13	610	25	16	626	0.5740999999999999
The Road Trip	2018-05-27	12	25	16	28	0.5740999999999999
Huckleberry Falls	2018-09-20	4	4	2	6	0.5739
Stunt Island	2018-11-16	3	4	2	5	0.5739
King Erik	2018-12-25	2	4	2	4	0.5739
ReallyGoodBattle	2018-02-15	4	4	2	6	0.5739
Starcaster	2018-07-26	2	4	2	4	0.5739
Entropic Shop VR	2018-01-24	2	4	2	4	0.5739
GyroCube VR	2018-09-19	1	4	2	3	0.5739
LVL99: AxeRage	2018-01-31	2	4	2	4	0.5739
The Eerie Adventures Of Kally	2018-05-31	2	4	2	4	0.5739
Flying Turkey	2018-02-09	3	4	2	5	0.5739
The Great Fantasy Struggle	2018-09-26	4	4	2	6	0.5739
Multi-Quest	2018-01-27	2	4	2	4	0.5739
Talk to Saki	2018-01-20	3	4	2	5	0.5739
For Rent: Haunted House	2018-01-18	4	4	2	6	0.5739
R.A.F.A.	2018-04-07	1	4	2	3	0.5739
Choice of the Vampire: The Fall of Memphis	2018-02-09	7	4	2	9	0.5739
Cannon Crew	2018-02-01	3	4	2	5	0.5739
Critical Mess	2018-01-24	4	4	2	6	0.5739
Just a Jumping Square	2018-03-05	4	4	2	6	0.5739
Fuse Balls	2018-03-09	1	4	2	3	0.5739
Divided: Soul Theft	2018-03-14	2	4	2	4	0.5739
Corpse Mob	2018-06-04	2	4	2	4	0.5739
Vertigo FPS	2018-06-27	3	4	2	5	0.5739
Tharn	2018-05-17	2	4	2	4	0.5739
Match Connect Challenge	2018-05-11	4	4	2	6	0.5739
The Firlyn Stones	2018-05-01	2	4	2	4	0.5739
Turn-Based Champion	2018-06-02	4	4	2	6	0.5739
Camp Grizzly VR	2018-07-04	3	4	2	5	0.5739
Keiko Everlasting	2018-06-11	1	4	2	3	0.5739
Vive le Roi 2	2018-06-21	2	4	2	4	0.5739
Escape the Grid VR	2018-06-15	3	4	2	5	0.5739
Deep Noise	2018-07-13	16	4	2	18	0.5739
Dragon`s Checkers	2018-09-15	2	4	2	4	0.5739
Fortune & Gloria	2018-07-24	2	4	2	4	0.5739
Life After The Living	2018-07-24	2	4	2	4	0.5739
LUXO Buddies	2018-08-11	4	4	2	6	0.5739
We Happy Few - Soundtrack and Digital Goods Bundle	2018-08-29	2	4	2	4	0.5739
Intelligence: Cats	2018-08-11	2	4	2	4	0.5739
Gamble of Gods	2018-11-09	3	4	2	5	0.5739
Sparticles	2018-08-27	2	4	2	4	0.5739
Enter The Moon	2018-09-08	2	4	2	4	0.5739
The Twiggles VR	2018-09-24	2	4	2	4	0.5739
Vulcan Sacrifice	2018-10-08	137	4	2	139	0.5739
Thrill Rollercoasters	2018-09-28	4	4	2	6	0.5739
Joe's Wrath	2018-10-29	2	4	2	4	0.5739
Intelligence: Underwater Kingdom	2018-10-24	2	4	2	4	0.5739
Prixel	2018-11-01	2	4	2	4	0.5739
Perfect Life VR	2018-11-15	2	4	2	4	0.5739
WatchFamily	2018-11-20	2	4	2	4	0.5739
Auri's Tales	2018-12-12	2	4	2	4	0.5739
Stick Arena	2018-07-24	33	71	48	81	0.5738000000000001
Beyond the Invisible: Darkness Came	2018-03-01	8	22	14	22	0.5736
Bunny adventure	2018-02-14	5	22	14	19	0.5736
Baby's on fire: 99 virgins	2018-04-04	3	22	14	17	0.5736
Beat	2018-09-17	49	22	14	63	0.5736
Deep Space	2018-08-30	25	58	39	64	0.5733
Nightmare Of Melanie 梅兰妮的噩梦	2018-08-15	6	35	23	29	0.5731
Soldiers Lost Forever (1914-1918)	2018-07-06	3114	19	12	3126	0.5731
Desperate game	2018-02-14	17	19	12	29	0.5731
The path to domination	2018-08-29	3	19	12	15	0.5731
Sexbot Quality Assurance Simulator	2018-10-02	24	89	61	85	0.5727000000000001
Out of Reach	2018-07-13	437	1730	1254	1691	0.5726
A Collection of Bad Moments	2018-01-12	8	16	10	18	0.5726
 Chamber of the Sci-Mutant Priestess	2018-02-08	3	16	10	13	0.5726
Virus Petya	2018-02-13	3	16	10	13	0.5726
DIASTONE: Memories	2018-12-12	5	16	10	15	0.5726
Agony UNRATED	2018-10-30	522	1914	1389	1911	0.5725
Tell Me Everything	2018-05-29	52	32	21	73	0.5725
3Buttons	2018-10-25	9	32	21	30	0.5725
HYPERGUN	2018-08-23	37	42	28	65	0.5723
Explomania	2018-02-22	3	13	8	11	0.5721
Alter Cosmos	2018-07-10	3	13	8	11	0.5721
Keeplanet	2018-04-06	4	13	8	12	0.5721
Nemesis Realms	2018-04-06	5	13	8	13	0.5721
Survivor Island	2018-03-08	6	13	8	14	0.5721
Mystery Case Files: Rewind Collector's Edition	2018-07-23	7	13	8	15	0.5721
SAMS	2018-12-24	3	13	8	11	0.5721
Next Hero	2018-03-16	11	29	19	30	0.5719
Yafti	2018-04-12	3	29	19	22	0.5719
Sexy Serial Killer	2018-01-30	9	132	92	101	0.5718
Power War - The First Men	2018-03-22	6	7	4	10	0.5718
Survival Simulator	2018-09-19	4	7	4	8	0.5718
NeuroMatrix	2018-09-14	1	7	4	5	0.5718
Planetarium 2 - Zen Odyssey	2018-01-03	3	7	4	7	0.5718
Draft Day Sports: College Basketball 2018	2018-03-13	25	7	4	29	0.5718
Adelanto 4 Aztec Skulls	2018-03-22	9	7	4	13	0.5718
ICED VR	2018-05-29	4	7	4	8	0.5718
SixGenerals | 六小将传说	2018-05-17	4	7	4	8	0.5718
Director of Football	2018-09-20	5	7	4	9	0.5718
Great Old One - Arrival	2018-12-03	4	7	4	8	0.5718
1000 Stages	2018-07-13	2	7	4	6	0.5718
BRANE™: Prototype	2018-07-01	86	7	4	90	0.5718
Super Seeker	2018-11-12	10	7	4	14	0.5718
Mad Factory	2018-09-20	4	7	4	8	0.5718
Swords with spice	2018-10-11	3	7	4	7	0.5718
Sniper Rust VR	2018-06-19	2	10	6	8	0.5717
Hotel Transylvania 3: Monsters Overboard	2018-07-11	2	10	6	8	0.5717
Bikour!	2018-01-22	5	10	6	11	0.5717
Elevator Ritual	2018-03-18	4	10	6	10	0.5717
Intelligence	2018-04-19	3	10	6	9	0.5717
Virtual telescope	2018-07-16	3	10	6	9	0.5717
BR Logic Pack	2018-09-29	3	10	6	9	0.5717
Sniper Strike : Special Ops	2018-07-27	120	168	118	238	0.5715
Treasure Hunter Simulator	2018-12-06	330	756	546	876	0.5713
Roun	2018-08-24	25	26	17	42	0.5712
My Free Farm 2	2018-04-03	233	336	240	473	0.5710000000000001
Aim Trainer Pro	2018-01-25	59	77	53	112	0.5710000000000001
JQ: countries	2018-02-16	7	67	46	53	0.5706
Bottle of truth	2018-08-25	13	43	29	42	0.5705
Endersite	2018-05-25	13	23	15	28	0.5703
TAL: Arctic 2	2018-08-03	2	23	15	17	0.5703
噬元之主	2018-06-22	30	40	27	57	0.5698
Deep Dark Dungeon	2018-05-08	10	30	20	30	0.5694
Blazing Core (beta)	2018-09-07	34	30	20	54	0.5694
Battle Royale Survival	2018-08-31	5	20	13	18	0.5694
Tiny-Tasy Town	2018-10-15	93	115	81	174	0.5690999999999999
Battle Royale Trainer	2018-01-04	1313	959	703	2016	0.5688000000000001
THE DAY Online	2018-04-04	420	339	245	665	0.5687
魔物娘物语	2018-05-19	23	27	18	41	0.5684
aMAZE Frozen	2018-04-04	4	62	43	47	0.5683
Casual Penalty	2018-05-16	12	62	43	55	0.5683
The Lonely Gorilla	2018-11-16	4	17	11	15	0.5683
Never Stop Sneakin'	2018-02-26	9	17	11	20	0.5683
ToaZZle	2018-03-20	3	17	11	14	0.5683
Glitchball	2018-04-24	11	17	11	22	0.5683
Existential Kitty Cat RPG	2018-04-05	5	17	11	16	0.5683
Hentai Defense	2018-09-25	3	17	11	14	0.5683
Franchise Hockey Manager 5	2018-10-05	206	91	64	270	0.5681
利刃	2018-12-20	81	41	28	109	0.568
Hentai 2+2=4	2018-10-05	4	59	41	45	0.5676
Hentai Lady	2018-10-19	8	70	49	57	0.5674
VRobot	2018-09-12	9	52	36	45	0.5674
Star Advent	2018-03-10	7	63	44	51	0.5671
Alice in Wonderland - Hidden Objects	2018-03-06	6	38	26	32	0.5671
Flying Bacon: Ukrainian Air Force	2018-01-12	4	31	21	25	0.5671
Hand of the Gods	2018-02-20	1773	738	544	2317	0.5669
Escape from Monkey Island™	2018-11-16	54	293	213	267	0.5669
Star Trek Adversaries	2018-07-25	149	171	123	272	0.5669
Sea Battle: Through the Ages	2018-02-20	4	14	9	13	0.5669
Evil Cogs	2018-03-28	6	14	9	15	0.5669
Not Heaven	2018-10-31	8	14	9	17	0.5669
Daddy	2018-06-05	4	71	50	54	0.5663
MY FIGHT	2018-05-22	5578	42	29	5607	0.5663
Drake of the 99 Dragons	2018-03-07	8	53	37	45	0.5660000000000001
Pixel Traffic: Highway Racing	2018-06-06	5	35	24	29	0.5660000000000001
Hillbilly Apocalypse	2018-11-30	1822	21	14	1836	0.5660000000000001
Enoch: Underground	2018-03-22	19	21	14	33	0.5660000000000001
属性与生活	2018-09-26	16	21	14	30	0.5660000000000001
Monster Farm	2018-09-11	9	21	14	23	0.5660000000000001
Epic Cards Battle 2-Dragons Rising(TCG)	2018-09-07	41	68	48	89	0.5657
Rogue Harvest	2018-04-17	6	39	27	33	0.5653
Amazing Trivia	2018-01-25	8	11	7	15	0.5653
Oracle: Threads of Fate	2018-03-30	14	11	7	21	0.5653
Alchemy Classic	2018-10-27	10	11	7	17	0.5653
InkSplosion	2018-05-09	3	11	7	10	0.5653
RollerCoaster Legends 2: Thor's Hammer	2018-06-05	6	11	7	13	0.5653
Sniper Fodder	2018-06-22	2	11	7	9	0.5653
Time	2018-09-13	3	11	7	10	0.5653
Unblock: The Parking	2018-07-23	3	11	7	10	0.5653
Kitten and food: adventure park	2018-08-17	3	11	7	10	0.5653
Land of an Endless Journey	2018-09-26	5	11	7	12	0.5653
VR Rome	2018-11-06	12	11	7	19	0.5653
黑暗料理	2018-11-27	6	11	7	13	0.5653
Logout	2018-05-01	12	25	17	29	0.5645
3D Gravity Rocket	2018-06-12	34	25	17	51	0.5645
War Heroes: Invasion	2018-05-15	187	18	12	199	0.5644
Thirdmage	2018-04-30	15	18	12	27	0.5644
Piwall	2018-01-18	13	18	12	25	0.5644
Space Force	2018-06-01	4	18	12	16	0.5644
Slavicus	2018-10-18	3	18	12	15	0.5644
Zap Zap Zombie Cats	2018-05-09	17	36	25	42	0.5640999999999999
Parker & Lane	2018-02-27	31	36	25	56	0.5640999999999999
HELLGATE: London	2018-11-15	1336	1122	842	2178	0.564
Operation Lone Wolf	2018-10-01	7	29	20	27	0.5636
Need for Spirit: Drink & Drive Simulator	2018-09-05	7	78	56	63	0.5633
Keep Watching	2018-05-02	5	8	5	10	0.5632
SQUAREHEAD	2018-05-03	4	8	5	9	0.5632
BadLands RoadTrip	2018-04-05	4	8	5	9	0.5632
The Ino Chronicles: Ascension	2018-03-29	5	8	5	10	0.5632
Ragtag Adventurers	2018-03-01	37	8	5	42	0.5632
Royal Tumble	2018-01-09	6	8	5	11	0.5632
Posthuman: Sanctuary	2018-07-27	6	8	5	11	0.5632
Soccer Nations Battle	2018-05-17	5	8	5	10	0.5632
DiveReal	2018-06-19	7	8	5	12	0.5632
Jorji and Impossible Forest	2018-07-11	2	8	5	7	0.5632
End War RTS	2018-07-31	2	8	5	7	0.5632
Puzzles for smart: Dogs	2018-09-06	2	8	5	7	0.5632
Pixel Robot Hunter	2018-10-31	2	8	5	7	0.5632
Detective escape1	2018-11-23	4	8	5	9	0.5632
Luvocious	2018-01-22	2	22	15	17	0.5629
Commanager Tycoon	2018-05-01	6	15	10	16	0.5625
Slingshot Explorer: The Twelve Tower	2018-10-02	2	15	10	12	0.5625
Devil's Toy	2018-11-06	5	15	10	15	0.5625
Bit-Boom	2018-02-13	6	41	29	35	0.562
Trivia Vault Olympics Trivia	2018-02-28	3	41	29	32	0.562
Ice and Fire of Maiden	2018-11-13	6	26	18	24	0.562
LOST SPHEAR	2018-01-23	245	104	76	321	0.5615
The Experiment: Escape Room	2018-11-22	36	141	104	140	0.5611
Horse Farm	2018-07-17	110	134	99	209	0.5606
Booty Calls	2018-09-18	367	1901	1456	1823	0.5605
Snailiens	2018-11-20	9	5	3	12	0.5605
The Incredible VR Game Show	2018-04-12	3	5	3	6	0.5605
Steve's Pub - Soda on tap	2018-09-20	12	5	3	15	0.5605
Ski Hard: Lorsbruck 1978	2018-02-09	4	5	3	7	0.5605
Paradise Lost	2018-01-17	2	5	3	5	0.5605
INSPACE 2980	2018-10-12	5	5	3	8	0.5605
Missing Road	2018-01-31	2	5	3	5	0.5605
AlpenCROSS	2018-04-05	2	5	3	5	0.5605
STARWAY VR	2018-12-20	3	5	3	6	0.5605
Pokka Man	2018-04-02	2	5	3	5	0.5605
Mage Fort	2018-05-10	6	5	3	9	0.5605
Make Route	2018-10-06	2	5	3	5	0.5605
LOGistICAL: Caribbean	2018-05-18	13	5	3	16	0.5605
Hectic Void	2018-08-10	2	5	3	5	0.5605
Paris: Jigsaw Puzzles	2018-06-13	2	5	3	5	0.5605
One Day for Revenge	2018-07-19	3	5	3	6	0.5605
Three life	2018-08-10	2	5	3	5	0.5605
Fairy Rescue	2018-08-03	2	5	3	5	0.5605
Hentai City	2018-12-04	4	5	3	7	0.5605
The Orphaned Soul	2018-09-17	2	5	3	5	0.5605
Super Strawberry Man	2018-11-02	2	5	3	5	0.5605
Rocket Swords	2018-09-11	3	5	3	6	0.5605
苍夜	2018-09-05	2	5	3	5	0.5605
Choice of Broadsides: HMS Foraker	2018-09-06	7	5	3	10	0.5605
Formula XD	2018-09-20	4	5	3	7	0.5605
The Cells	2018-10-23	2	5	3	5	0.5605
Escape From The Dragons	2018-11-21	2	5	3	5	0.5605
Kings' Cross	2018-11-27	2	5	3	5	0.5605
Burning Out	2018-12-12	2	5	3	5	0.5605
Fire Place	2018-09-21	14	46	33	47	0.5603
Blackjack In Space	2018-02-27	3	23	16	19	0.5602
Floor Massacre	2018-09-06	4	23	16	20	0.5602
Gods and Kings	2018-12-24	26	23	16	42	0.5602
Warmonger	2018-06-14	347	168	125	472	0.5601
Go-Kart Racing	2018-04-25	5	78	57	62	0.5601
Bitcoin Tycoon - Mining Simulation Game	2018-08-01	32	54	39	71	0.5601
Crimson Keep	2018-11-29	7	12	8	15	0.56
Super Knockoff! VS	2018-03-23	9	12	8	17	0.56
Monkey King: Master of the Clouds	2018-09-14	3	12	8	11	0.56
Feelin	2018-08-23	7	12	8	15	0.56
Master of Mutations	2018-10-05	3	12	8	11	0.56
Battle Brawlers	2018-06-19	196	111	82	278	0.5597
Masked Forces 3	2018-07-19	8	27	19	27	0.5597
PostCollapse	2018-01-12	11	71	52	63	0.5590999999999999
Zup! Arena	2018-12-20	22	55	40	62	0.559
Big Day	2018-10-02	57	84	62	119	0.5586
Progetto Ustica	2018-09-06	10	16	11	21	0.5586
FARHOME	2018-04-05	10	16	11	21	0.5586
Beyond the Void	2018-10-24	50	72	53	103	0.5583
Choice of the Vampire	2018-02-09	19	20	14	33	0.5579999999999999
OrcCraft	2018-04-22	11	20	14	25	0.5579999999999999
Stick War: Castle Defence	2018-03-16	10	20	14	24	0.5579999999999999
Kolumno	2018-11-15	2	20	14	16	0.5579999999999999
Danger Zone 2	2018-07-13	18	48	35	53	0.5577000000000001
Dungeon Girl	2018-07-30	45	24	17	62	0.5577000000000001
ASTRAL	2018-11-26	9	77	57	66	0.5576
Underwater hunting	2018-06-20	5	40	29	34	0.5575
Defense the Farm	2018-06-05	20	36	26	46	0.5575
Bernie’s Nightmare	2018-07-28	5	36	26	31	0.5575
Backyard Brawl	2018-11-05	41	36	26	67	0.5575
Pembrey	2018-02-19	460	32	23	483	0.5575
Last Rites	2018-04-13	6	28	20	26	0.5575
Macroboy Y	2018-07-19	2	2	1	3	0.5569
Hexaverse	2018-08-17	6	2	1	7	0.5569
Orbit: Satellite Defense	2018-03-26	2	2	1	3	0.5569
Fear Of Traffic	2018-12-06	2	2	1	3	0.5569
Crazy Bowling	2018-04-03	2	2	1	3	0.5569
Kiitsu	2018-04-18	9	2	1	10	0.5569
Ganbatte	2018-04-19	5	2	1	6	0.5569
Boratium Wars	2018-02-05	4	2	1	5	0.5569
WIL	2018-05-31	2	2	1	3	0.5569
Starcats	2018-05-16	3	2	1	4	0.5569
The redemption of pancakes	2018-08-03	1	2	1	2	0.5569
ATV Simulator VR	2018-03-20	2	2	1	3	0.5569
Two Inns at Miller's Hollow	2018-05-18	6	2	1	7	0.5569
Dog Fight Super Ultra Deluxe	2018-12-16	6	2	1	7	0.5569
Rogue Buddies - Aztek Gold	2018-04-20	2	2	1	3	0.5569
Super Bugman Extreme Ultra	2018-03-30	3	2	1	4	0.5569
Beard & Axe	2018-07-12	2	2	1	3	0.5569
Namaste Virtual Yoga Retreat	2018-01-13	2	2	1	3	0.5569
Fleets of Ascendancy	2018-04-06	2	2	1	3	0.5569
Entropy 2120	2018-05-18	2	2	1	3	0.5569
Run Dorothy Run	2018-03-13	1	2	1	2	0.5569
The Rising of the Rose Ocelot	2018-02-02	1	2	1	2	0.5569
Bomb Bay	2018-02-11	2	2	1	3	0.5569
Ricko's Island	2018-03-30	3	2	1	4	0.5569
Gladiators Of The Arena	2018-03-02	1	2	1	2	0.5569
Tommyknockers	2018-03-15	2	2	1	3	0.5569
挙式VR 鴻上大和 編 Wedding VR : Yamato	2018-03-09	2	2	1	3	0.5569
Amaranthine Voyage: The Shadow of Torment Collector's Edition	2018-02-12	3	2	1	4	0.5569
Ultimate Panic Flight	2018-03-05	2	2	1	3	0.5569
Capsule Jump	2018-02-20	2	2	1	3	0.5569
Monkey Rush	2018-02-24	2	2	1	3	0.5569
MOVIT	2018-03-14	4	2	1	5	0.5569
Survival Planet	2018-03-26	2	2	1	3	0.5569
Destiny of Light	2018-03-10	5	2	1	6	0.5569
Gripper's Adventure	2018-03-21	2	2	1	3	0.5569
Quickshot	2018-03-12	3	2	1	4	0.5569
Digital Runner	2018-03-26	2	2	1	3	0.5569
Dead Reckoning: The Crescent Case Collector's Edition	2018-03-12	4	2	1	5	0.5569
Hotel Spring	2018-04-14	2	2	1	3	0.5569
HIGHER GROUND	2018-07-25	1	2	1	2	0.5569
School Fab Lab	2018-05-10	2	2	1	3	0.5569
Unleashed	2018-10-17	3	2	1	4	0.5569
recoil	2018-05-19	2	2	1	3	0.5569
Ocean Wonder VR	2018-05-09	1	2	1	2	0.5569
Poop Slinger	2018-08-07	2	2	1	3	0.5569
A Tale of Pirates: A Dummy Mutiny	2018-05-23	2	2	1	3	0.5569
Alone In The Forest VR	2018-05-17	2	2	1	3	0.5569
Seul (Alone): The entrée	2018-08-30	1	2	1	2	0.5569
Demolition Ball	2018-06-15	2	2	1	3	0.5569
Permission VR	2018-08-24	1	2	1	2	0.5569
Ales Dash	2018-06-07	2	2	1	3	0.5569
Off the Record: The Final Interview Collector's Edition	2018-06-06	4	2	1	5	0.5569
Noble Crusade	2018-11-13	3	2	1	4	0.5569
Allergenium	2018-10-26	3	2	1	4	0.5569
Living with Jaguars VR	2018-06-20	2	2	1	3	0.5569
Zen Space Flight - VR Showcase	2018-07-05	2	2	1	3	0.5569
Sort the Cube	2018-08-04	2	2	1	3	0.5569
PowerUp Elevation	2018-08-23	2	2	1	3	0.5569
魔装術師アカネ / Magic MechSuit Akane	2018-07-27	2	2	1	3	0.5569
The Battle Of Ages	2018-09-08	2	2	1	3	0.5569
Pif Paf	2018-07-16	2	2	1	3	0.5569
HellMaze	2018-07-10	2	2	1	3	0.5569
Rite of Passage: The Lost Tides Collector's Edition	2018-07-09	3	2	1	4	0.5569
Amaranthine Voyage: The Obsidian Book Collector's Edition	2018-07-20	4	2	1	5	0.5569
Danse Macabre: Thin Ice Collector's Edition	2018-07-25	3	2	1	4	0.5569
Forest Rabbit	2018-07-27	1	2	1	2	0.5569
Deplau	2018-07-27	2	2	1	3	0.5569
Solar Fighters	2018-10-01	1	2	1	2	0.5569
Whirlygig	2018-07-25	1	2	1	2	0.5569
Marbledrome: Crazy Stunt Balls	2018-08-13	2	2	1	3	0.5569
Metal Brigade Tactics	2018-08-27	2	2	1	3	0.5569
Shadow Fear™ Path to Insanity	2018-10-29	2	2	1	3	0.5569
Sheepageddon	2018-08-23	1	2	1	2	0.5569
Drymir Cave under Richmordnom	2018-08-23	1	2	1	2	0.5569
Happy Block	2018-09-04	2	2	1	3	0.5569
Parkour Polygon	2018-09-21	2	2	1	3	0.5569
Angry Ball VR	2018-12-05	2	2	1	3	0.5569
Get To A Gun	2018-10-09	1	2	1	2	0.5569
Croquet Pro	2018-11-16	4	2	1	5	0.5569
Source beginning	2018-11-07	3	2	1	4	0.5569
The Man with the Dog	2018-10-31	4	2	1	5	0.5569
Cards of Knight	2018-11-17	2	2	1	3	0.5569
The Earth Dies Screaming	2018-10-29	2	2	1	3	0.5569
Optica	2018-11-08	4	2	1	5	0.5569
Spicy Deck	2018-10-11	3	2	1	4	0.5569
Color by Numbers - Animals	2018-11-22	4	2	1	5	0.5569
Ocean's Treasures	2018-11-09	4	2	1	5	0.5569
Bomb N' Bats	2018-12-11	1	2	1	2	0.5569
ELASH	2018-12-21	2	2	1	3	0.5569
Spinheads	2018-12-05	1	2	1	2	0.5569
Yo My Yo!	2018-12-02	1	2	1	2	0.5569
Allied Nations	2018-12-25	3	2	1	4	0.5569
Waifu Hunter - Secret of Pirates	2018-11-29	3	2	1	4	0.5569
Killer Clowns	2018-12-04	2	2	1	3	0.5569
The Agency: Chapter 2	2018-03-08	2	9	6	8	0.5566
Dear Leader	2018-04-20	2	9	6	8	0.5566
Larkin building by Frank Lloyd Wright	2018-05-26	7	9	6	13	0.5566
Money Master	2018-09-14	6	9	6	12	0.5566
Tower Behind the Moon	2018-12-20	22	9	6	28	0.5566
Clicker Heroes 2	2018-07-16	9582	1508	1175	10757	0.5563
Pain of War	2018-02-02	12	45	33	45	0.5563
PROTEST	2018-10-03	5	45	33	38	0.5563
Gravity Wars	2018-11-15	178	149	113	291	0.5559000000000001
Space Rocket	2018-02-07	5	37	27	32	0.5559000000000001
FACE	2018-03-06	5	58	43	48	0.5558
Trivia Vault: Movie Trivia	2018-04-27	5	33	24	29	0.5557
Kontrakt	2018-10-22	5	29	21	26	0.5555
Shinrin-yoku	2018-01-19	8	13	9	17	0.5555
Snow White Solitaire. Legacy of Dwarves	2018-04-20	5	13	9	14	0.5555
Drift 4000	2018-05-18	13	13	9	22	0.5555
Fancy Skiing 2: Online	2018-07-13	18	13	9	27	0.5555
Anamorphine	2018-07-31	12	25	18	30	0.5553
Lifeblood	2018-08-08	18	25	18	36	0.5553
Word Typing Game	2018-04-05	10	25	18	28	0.5553
Freakshow:Anniversary	2018-04-24	9	21	15	24	0.5552
Trippy Jump	2018-05-23	5	21	15	20	0.5552
Entwined: The Perfect Murder	2018-11-12	5	17	12	17	0.5552
Overhead	2018-05-15	3	17	12	15	0.5552
Crazy Machines VR	2018-10-25	9	17	12	21	0.5552
Bob The Cube	2018-05-21	21	17	12	33	0.5552
Call of Booty	2018-08-06	10	46	34	44	0.555
Horny Fighter	2018-07-24	2	42	31	33	0.5547
DOOMED	2018-06-03	5	81	61	66	0.5546
Slay.one	2018-04-12	261	77	58	319	0.5543
Z1 Battle Royale	2018-02-28	151239	115005	92076	243315	0.554
Fish Tycoon 2: Virtual Aquarium	2018-05-17	50	114	87	137	0.5536
Dissolution	2018-12-14	118	105	80	198	0.5536
Trivia Vault: Hockey Trivia	2018-04-03	6	43	32	38	0.5534
Zeus' Battlegrounds	2018-09-29	718	509	398	1116	0.5533
Rhombus Legends	2018-09-24	28	26	19	47	0.5532
Alpha Mike Foxtrot	2018-05-07	24	52	39	63	0.5531
CombatArms: Reloaded	2018-10-31	531	1506	1195	1726	0.5522
RC Fun City	2018-01-06	15	18	13	28	0.5522
Jump Jumpz	2018-12-05	14	18	13	27	0.5522
Onii-Chan	2018-03-27	9	85	65	74	0.5519
Desert Child	2018-12-11	78	160	124	202	0.5518
Love Bites	2018-06-01	9	14	10	19	0.5517000000000001
Tesseract VR	2018-05-02	12	14	10	22	0.5517000000000001
Good Boy!	2018-05-02	2	14	10	12	0.5517000000000001
Project Reset	2018-12-20	12	14	10	22	0.5517000000000001
Running Man 3D Part2	2018-08-23	3	14	10	13	0.5517000000000001
Blonde Driver	2018-04-10	22	137	106	128	0.5516
The Emulator	2018-12-22	15	49	37	52	0.5516
Olorun: Theocracy	2018-08-20	21	40	30	51	0.5516
Splash Blast Panic	2018-08-28	6	6	4	10	0.5514
Endurance	2018-01-16	1012	6	4	1016	0.5514
Empire - Wargame of new Century	2018-11-06	6	6	4	10	0.5514
Loot Run	2018-06-01	4	6	4	8	0.5514
全民王者	2018-01-26	10	6	4	14	0.5514
Bounce Rescue!	2018-02-01	4	6	4	8	0.5514
The Same Crime	2018-03-19	5	6	4	9	0.5514
Dead Mist	2018-05-24	3	6	4	7	0.5514
Maze Walker	2018-01-15	1	6	4	5	0.5514
Endlessness	2018-01-23	2	6	4	6	0.5514
Undercover Agent	2018-01-25	20	6	4	24	0.5514
Archery Kings VR	2018-04-11	7	6	4	11	0.5514
The Fielder's Choice	2018-02-22	18	6	4	22	0.5514
TurbOT Racing	2018-04-13	2	6	4	6	0.5514
Space Drift Squad	2018-08-01	3	6	4	7	0.5514
Afelhem	2018-11-26	5	6	4	9	0.5514
Burgerwise the Clown	2018-05-28	1	6	4	5	0.5514
Hardcore Weapon Challenge - FPS Action	2018-06-14	4	6	4	8	0.5514
BAD DAY	2018-07-18	3	6	4	7	0.5514
Astro Bouncer	2018-06-29	2	6	4	6	0.5514
Bigger Guns	2018-10-10	6	6	4	10	0.5514
Construct PRO	2018-11-19	4	6	4	8	0.5514
Dungeons of Necromancers	2018-11-07	4	6	4	8	0.5514
Adventures of Dragon	2018-12-20	4	10	7	11	0.5513
Pure Football 2018	2018-01-17	5	10	7	12	0.5513
Spacepowers	2018-02-16	5	10	7	12	0.5513
UNHALLOWED: THE CABIN	2018-08-24	2	10	7	9	0.5513
Moon Castle	2018-08-01	6	10	7	13	0.5513
District 112 Incident: Bowling Alley	2018-05-09	24	10	7	31	0.5513
Content Creator Simulator	2018-03-10	8	10	7	15	0.5513
Mob War	2018-04-04	2	10	7	9	0.5513
Knockdown the Ball	2018-04-24	3	10	7	10	0.5513
iterform	2018-06-12	4	10	7	11	0.5513
Cute Girls	2018-09-22	6	10	7	13	0.5513
NeoSticks	2018-04-20	10	54	41	51	0.5511
Doctor Who Infinity	2018-08-08	63	36	27	90	0.551
PUGNite	2018-09-07	17	78	60	77	0.5505
The Way of Kings: Escape the Shattered Plains!	2018-03-02	6	23	17	23	0.5505
Led It Rain	2018-12-12	3	19	14	17	0.5496
Disdoored	2018-05-31	13	19	14	27	0.5496
ZKILLER	2018-07-25	7	19	14	21	0.5496
Bewitched game	2018-12-27	7	19	14	21	0.5496
Neko Dungeon	2018-08-17	4	28	21	25	0.5494
Archery Blast	2018-04-14	3	28	21	24	0.5494
Wwbit	2018-08-18	1326	656	525	1851	0.5489
恋爱模拟器 Love Simulation	2018-04-30	233	577	462	695	0.5485
Gravity Jump	2018-06-12	2	24	18	20	0.5484
Hentai Hexa Mosaic	2018-09-14	4	24	18	22	0.5484
Exotic Matter	2018-07-06	12	15	11	23	0.5484
VR Trivia Battle	2018-10-23	15	15	11	26	0.5484
Save me Mr Tako: Tasukete Tako-San	2018-10-30	15	15	11	26	0.5484
Christmas Race 2	2018-12-13	11	15	11	22	0.5484
Hero Plus	2018-01-22	144	116	91	235	0.5483
Dude Simulator 2	2018-07-27	5737	1088	877	6614	0.5482
Hotel Dracula	2018-02-09	11	34	26	37	0.5473
Eon Fleet	2018-04-19	3	20	15	18	0.5471
How to be Best Russian Game Developer	2018-06-22	4	20	15	19	0.5471
Valkyries	2018-09-17	17	11	8	25	0.5468999999999999
Marco Polo	2018-02-08	3	11	8	11	0.5468999999999999
Tank Slam	2018-11-28	53	11	8	61	0.5468999999999999
Lightning War	2018-02-08	3	11	8	11	0.5468999999999999
1st Core - The Zombie Killing Cyborg	2018-06-30	2	11	8	10	0.5468999999999999
Notified	2018-08-31	8	11	8	16	0.5468999999999999
Kolkhoz: The Red Wedge	2018-10-20	3	11	8	11	0.5468999999999999
Mahjong Magic Journey 2	2018-11-16	25	11	8	33	0.5468999999999999
Chieftain	2018-12-22	7	11	8	15	0.5468999999999999
RideOp	2018-10-18	19	69	54	73	0.5467000000000001
Energy Invasion	2018-01-10	3114	25	19	3133	0.5465
Trivia Vault: Tennis Trivia	2018-04-19	4	25	19	23	0.5465
Railroad Tracks	2018-09-14	11	25	19	30	0.5465
Cosa Nostra	2018-11-13	4	25	19	23	0.5465
Mobile Empire	2018-01-25	1584	813	660	2244	0.5462
Affliction	2018-06-25	619	35	27	646	0.546
Without Escape	2018-04-24	8	16	12	20	0.5455
Galactic Harvester	2018-03-23	5	16	12	17	0.5455
Detached: Non-VR Edition	2018-07-24	5	16	12	17	0.5455
Little Dragons Cafe	2018-11-15	23	56	44	67	0.545
Helping Hand	2018-07-26	11	21	16	27	0.545
Study of Unusual: Forest of Secrets	2018-07-24	7	21	16	23	0.545
Midair	2018-05-03	766	465	378	1144	0.5448
Trivia Vault: Health Trivia Deluxe	2018-01-23	6	41	32	38	0.5448
Calico & Co	2018-05-30	16	7	5	21	0.5448
3D Mahjong worlds	2018-04-16	3	7	5	8	0.5448
Carnage in Space: Ignition	2018-01-01	3	7	5	8	0.5448
Zahalia	2018-03-06	2	7	5	7	0.5448
Super X Chess	2018-10-24	3	7	5	8	0.5448
Trial of the Gods	2018-06-02	3	7	5	8	0.5448
Another Brick in Space	2018-04-11	3	7	5	8	0.5448
七神物语	2018-06-26	5	7	5	10	0.5448
Barrel Boot Camp	2018-05-18	3	7	5	8	0.5448
Whiskered Away	2018-07-12	12	7	5	17	0.5448
Easy Racing	2018-12-17	2	7	5	7	0.5448
Slime Age: Parody MMORPG Clicker	2018-08-22	4	7	5	9	0.5448
SpaBerry VR Experience	2018-12-18	3	7	5	8	0.5448
The m0rg VS keys	2018-03-29	6	31	24	30	0.5447
Subsiege	2018-09-07	100	52	41	141	0.5441
TAL: Arctic	2018-07-11	4	52	41	45	0.5441
Grimmwood	2018-08-02	272	133	107	379	0.5438000000000001
TOXIC PLUMBING	2018-01-13	10	69	55	65	0.5433
Temptation	2018-03-29	3	32	25	28	0.5433
Silent Depth 3D Submarine Simulation	2018-08-21	12	32	25	37	0.5433
PlatONIR	2018-07-04	4	32	25	29	0.5433
Castle Wars VR	2018-05-09	4	12	9	13	0.5433
Damascus Gear Operation Osaka HD Edition	2018-03-07	12	12	9	21	0.5433
Minion Forest	2018-01-29	9	12	9	18	0.5433
Struggle For Survival VR	2018-04-25	6	12	9	15	0.5433
Planet Unknown Runner	2018-05-28	2	12	9	11	0.5433
Knife Flipping	2018-07-09	3	12	9	12	0.5433
Fireflies	2018-08-28	4	12	9	13	0.5433
Data mining 3	2018-11-22	2	12	9	11	0.5433
blue.	2018-03-21	19	53	42	61	0.5432
Veil of Crows	2018-10-18	176	253	206	382	0.5431
RAMS	2018-09-20	8	48	38	46	0.543
Super Poop	2018-02-06	4	22	17	21	0.543
Chaos Control	2018-02-08	2	17	13	15	0.543
Horror Fish Simulator	2018-04-16	4	38	30	34	0.5424
Home Security	2018-09-21	6	33	26	32	0.542
Bug Invaders	2018-01-23	2	3	2	4	0.5417000000000001
The Seven Stages	2018-07-25	1	3	2	3	0.5417000000000001
Meteorite Defense Command	2018-06-01	2	3	2	4	0.5417000000000001
紅蜘蛛外伝：暗戦	2018-05-19	1	3	2	3	0.5417000000000001
Arbiter	2018-06-05	6	3	2	8	0.5417000000000001
Yeti's Parole Officer	2018-01-18	7	3	2	9	0.5417000000000001
Alpha/Omega: The Christian RPG	2018-05-10	8	3	2	10	0.5417000000000001
Pale Lands VR	2018-03-06	4	3	2	6	0.5417000000000001
The Little Slime	2018-02-11	2	3	2	4	0.5417000000000001
Funny Wings VR	2018-03-30	2	3	2	4	0.5417000000000001
Nobody Knows	2018-04-03	1	3	2	3	0.5417000000000001
Luminous Combat	2018-07-27	3	3	2	5	0.5417000000000001
Alice In VR	2018-11-14	2	3	2	4	0.5417000000000001
Hyper Fighter Boost Mode ON	2018-05-04	2	3	2	4	0.5417000000000001
Devious	2018-07-26	3	3	2	5	0.5417000000000001
Indian Mutiny: Little Sepoy	2018-05-21	2	3	2	4	0.5417000000000001
Total Singu	2018-06-13	2	3	2	4	0.5417000000000001
Catch'em	2018-08-10	1	3	2	3	0.5417000000000001
Automatum	2018-07-30	4	3	2	6	0.5417000000000001
ClusterDisaster	2018-07-20	2	3	2	4	0.5417000000000001
Vortex Of Pain	2018-11-01	3	3	2	5	0.5417000000000001
Pitch Perfect Ear Training	2018-07-10	2	3	2	4	0.5417000000000001
Grand Kokoro - Episode 1	2018-07-25	2	3	2	4	0.5417000000000001
Majin Woman	2018-08-02	2	3	2	4	0.5417000000000001
Toy Gun Office Simulator	2018-08-29	4	3	2	6	0.5417000000000001
Smoker The Car Game	2018-09-14	2	3	2	4	0.5417000000000001
World Enduro Rally	2018-11-16	4	3	2	6	0.5417000000000001
Cinderella VR	2018-11-05	6	3	2	8	0.5417000000000001
The last soldier	2018-09-25	1	3	2	3	0.5417000000000001
Tiger Striker	2018-10-01	1	3	2	3	0.5417000000000001
We Must Praise Our Glorious Leader The Flumf	2018-11-06	2	3	2	4	0.5417000000000001
Animal Force	2018-11-23	2	3	2	4	0.5417000000000001
Curfew	2018-11-23	4	3	2	6	0.5417000000000001
Spot The Oddity	2018-11-08	2	3	2	4	0.5417000000000001
Next Up Hero	2018-06-28	85	100	81	166	0.5415
PaperDolls	2018-05-28	5	50	40	45	0.5413
Dupio	2018-03-06	3	23	18	21	0.5412
Super GTR Racing	2018-05-18	4	23	18	22	0.5412
Make Sail	2018-03-30	37	56	45	82	0.5409
Guess who ?	2018-07-05	5	56	45	50	0.5409
Mind Portal	2018-01-12	3	18	14	17	0.5407000000000001
MOBA GM	2018-06-29	138	18	14	152	0.5407000000000001
DrillsVR	2018-06-29	13	18	14	27	0.5407000000000001
Casino Mega Collection	2018-07-02	13	18	14	27	0.5407000000000001
Just a Game	2018-10-23	3	18	14	17	0.5407000000000001
WEED	2018-01-28	10	120	98	108	0.5405
Acro FS	2018-05-23	13	97	79	92	0.5404
Welcome Back To 2007 2	2018-09-11	227	246	203	430	0.5403
SYMMETRY	2018-02-20	78	115	94	172	0.5402
NOGIBATOR	2018-02-15	3	29	23	26	0.5402
Gladio	2018-09-20	8	29	23	31	0.5402
Anime show	2018-06-22	5	13	10	15	0.5402
PixelRPG	2018-10-22	10	13	10	20	0.5402
Modern Combat 5	2018-10-24	1097	3025	2543	3640	0.5401
Mini World: Block Art	2018-04-28	939	2008	1686	2625	0.5399
McRogue	2018-02-03	4	8	6	10	0.5398
Eternam	2018-02-08	3	8	6	9	0.5398
web spice	2018-07-16	7	8	6	13	0.5398
Nogalious	2018-08-08	3	8	6	9	0.5398
Rise of Crustaceans	2018-05-28	3	8	6	9	0.5398
Trainiac	2018-05-28	3	8	6	9	0.5398
The Great Story of a Mighty Hero - Remastered	2018-06-05	6	8	6	12	0.5398
Buy Low Sell High	2018-09-28	2	8	6	8	0.5398
Hexen Hegemony	2018-11-11	6	8	6	12	0.5398
Solitaire Mystery: Four Seasons	2018-12-05	5	8	6	11	0.5398
Super Bomberman R	2018-06-12	91	309	257	348	0.5391
音灵 INVAXION	2018-12-20	5350	3369	2851	8201	0.5386
Trivia Vault Basketball Trivia	2018-03-03	2	36	29	31	0.5386
Trailblazers	2018-05-08	19	42	34	53	0.5384000000000001
The Last Hope: Atomic Bomb - Crypto War	2018-04-06	4	54	44	48	0.5382
Deliverace - Battle Racing	2018-10-19	26	25	20	46	0.538
Mines of Mars	2018-09-10	7	31	25	32	0.5377000000000001
Trials of the Gauntlet	2018-03-16	10	31	25	35	0.5377000000000001
PRO EVOLUTION SOCCER 2019	2018-08-30	6551	3198	2718	9269	0.5376
Rig or Skill: PC Brawl	2018-03-09	10	14	11	21	0.5375
Marius	2018-01-05	10	14	11	21	0.5375
Biotix: Phage Genesis	2018-04-16	17	14	11	28	0.5375
Unsolved Stories	2018-03-14	4	14	11	15	0.5375
Blacksmith: Dark Times	2018-07-20	5	14	11	16	0.5375
Sexy Girls Puzzle	2018-10-02	6	14	11	17	0.5375
Kingdom Clicker	2018-03-30	13	20	16	29	0.5368
Shards the Deckbuilder	2018-12-04	21	20	16	37	0.5368
Operasyon: PARS	2018-02-01	230	141	118	348	0.5361
Hue Defense	2018-07-06	92	9	7	99	0.5359
LightStrike	2018-01-02	6	9	7	13	0.5359
Zanshin	2018-01-30	3	9	7	10	0.5359
JumpStream	2018-09-19	11	9	7	18	0.5359
Intelligence: Anime girls	2018-06-02	3	9	7	10	0.5359
My Bingo	2018-07-12	3	9	7	10	0.5359
春风 | Spring Breeze	2018-01-19	8	33	27	35	0.5355
Action Alien: Tropical Mayhem	2018-09-01	3	15	12	15	0.5352
SKULL FEAST	2018-09-13	7	15	12	19	0.5352
Dictator's dreams	2018-04-23	5	15	12	17	0.5352
Ultra Pig	2018-12-04	21	15	12	33	0.5352
Roulette Simulator 2	2018-12-31	3	15	12	15	0.5352
Undead Factory	2018-04-17	55	46	38	93	0.5351
Chaos Of East	2018-08-09	34	46	38	72	0.5351
Tower Keepers	2018-11-11	99	73	61	160	0.5345000000000001
Paralines The Last paladin	2018-06-06	50	48	40	90	0.5337
Wunderwaffe	2018-07-27	124	22	18	142	0.5337
Gnomes Garden Lost King	2018-06-11	12	42	35	47	0.5332
The Forgotten Void	2018-05-08	14	4	3	17	0.5332
Moon Landing VR	2018-11-07	10	4	3	13	0.5332
Seishin - Virtual Rhythm	2018-02-20	2	4	3	5	0.5332
VR_Play Room	2018-01-12	2	4	3	5	0.5332
Hyperbolic Ignition	2018-02-12	2	4	3	5	0.5332
Stranded Alone	2018-01-23	2	4	3	5	0.5332
VR Soccer Training	2018-03-20	6	4	3	9	0.5332
RoboHeist VR	2018-04-13	2	4	3	5	0.5332
Hummingz - Retro Arcade action revised	2018-04-20	2	4	3	5	0.5332
Trainpunk Run	2018-03-19	2	4	3	5	0.5332
Infinite Vector	2018-04-16	1	4	3	4	0.5332
Speed Car Fighter	2018-05-01	2	4	3	5	0.5332
How About Spikes	2018-11-09	3	4	3	6	0.5332
Forgotten Realm RPG	2018-06-01	3	4	3	6	0.5332
Сartoonway: Mini Cars	2018-05-18	2	4	3	5	0.5332
RuneTech	2018-05-28	3	4	3	6	0.5332
Street Level: Windows Edition	2018-06-06	2	4	3	5	0.5332
Echoes of the Past: Wolf Healer Collector's Edition	2018-06-01	3	4	3	6	0.5332
Turn up jeans	2018-06-02	2	4	3	5	0.5332
Fly Killer VR	2018-06-10	2	4	3	5	0.5332
Poverty is a Choice	2018-09-17	2	4	3	5	0.5332
Zombie Head	2018-07-26	1	4	3	4	0.5332
JOYDOOR	2018-08-25	1	4	3	4	0.5332
Expedition Oregon	2018-11-07	81	4	3	84	0.5332
Color by Numbers - Halloween	2018-10-16	3	4	3	6	0.5332
Hulì The Mage	2018-12-11	2	4	3	5	0.5332
Tank raid	2018-12-18	1	4	3	4	0.5332
Cardboard Wars	2018-06-25	8	16	13	21	0.5331
Preventive Strike	2018-06-15	2	16	13	15	0.5331
Football Nation VR 2018	2018-06-07	7	16	13	20	0.5331
Card Games Mega Collection	2018-06-13	38	16	13	51	0.5331
Bladeline VR	2018-11-12	4	10	8	12	0.5327000000000001
Command: The Silent Service	2018-03-01	21	10	8	29	0.5327000000000001
Hide The Body	2018-03-02	3	10	8	11	0.5327000000000001
Zombie Murder Hell Arrives	2018-03-16	3	10	8	11	0.5327000000000001
Crazzers	2018-03-18	3	10	8	11	0.5327000000000001
Bounty Hunter: Stampede	2018-04-03	2	10	8	10	0.5327000000000001
Spaceship Commander	2018-05-23	4	10	8	12	0.5327000000000001
Ninja Midori	2018-06-07	5	10	8	13	0.5327000000000001
A Roll-Back Story	2018-08-31	9	10	8	17	0.5327000000000001
Main Character Simulator	2018-09-21	3	10	8	11	0.5327000000000001
Papper Balls	2018-10-12	3	10	8	11	0.5327000000000001
CHECKMATE : Battle Arenas	2018-12-21	29	10	8	37	0.5327000000000001
Wings of Virtus	2018-12-03	2	10	8	10	0.5327000000000001
NeonBall	2018-02-24	23	36	30	53	0.5326
Squares	2018-01-31	6	36	30	36	0.5326
ROS	2018-06-02	4	36	30	34	0.5326
Harts	2018-01-05	6	43	36	42	0.5325
Trivia Vault Baseball Trivia	2018-03-02	4	43	36	40	0.5325
Burst Into	2018-04-04	5	30	25	30	0.5319
Fairy Escape	2018-04-27	5	30	25	30	0.5319
Please close the doors	2018-01-30	8	51	43	51	0.5317000000000001
Sansar	2018-12-05	283	322	278	561	0.5313
Dungeon Stars	2018-04-26	22	17	14	36	0.5313
TSA Frisky VR	2018-05-18	136	17	14	150	0.5313
江湖求生	2018-11-13	107	119	102	209	0.5309
KARTOFELKA	2018-01-11	23	31	26	49	0.5309
Super Robolom	2018-01-30	3	39	33	36	0.5302
Unfinished Battle	2018-03-12	4	11	9	13	0.53
Lunapark VR	2018-03-09	4	11	9	13	0.53
Analistica Academy	2018-04-06	5	11	9	14	0.53
Cut The Ex-Girlfriends	2018-06-06	2	11	9	11	0.53
Adva-lines	2018-07-27	4	11	9	13	0.53
Legendary DXP	2018-01-23	28	47	40	68	0.5297999999999999
富豪密码	2018-08-16	10	18	15	25	0.5297
My Sweet Waifu	2018-03-07	8	18	15	23	0.5297
Kitten Life Simulator	2018-04-23	4	18	15	19	0.5297
NeoBalls	2018-01-03	9	48	41	50	0.5292
Stay Alive: Apocalypse	2018-01-15	15	87	75	90	0.529
Battle Simulator	2018-09-27	18	88	76	94	0.5287
WARMA	2018-06-19	33	123	107	140	0.528
Idol Quest VR	2018-03-26	4	12	10	14	0.5278
ORE	2018-05-01	5	12	10	15	0.5278
Time Tenshi Paradox: Episode 2	2018-04-13	13	12	10	23	0.5278
ROAD HOMEWARD	2018-06-25	4	12	10	14	0.5278
We Are Terror: The First Days	2018-09-01	8	12	10	18	0.5278
Flight 732	2018-05-15	2	5	4	6	0.5278
NeoCube	2018-01-19	2	5	4	6	0.5278
System Siege	2018-06-12	2	5	4	6	0.5278
Operation Chromite 1950 VR	2018-02-05	4	5	4	8	0.5278
Stickman Annihilation 2	2018-02-13	3	5	4	7	0.5278
The Base	2018-05-25	2	5	4	6	0.5278
Dead Climb	2018-10-29	2	5	4	6	0.5278
Outbreak in Space VR	2018-04-25	3	5	4	7	0.5278
EverHero	2018-04-06	4	5	4	8	0.5278
LIGHT	2018-04-05	2	5	4	6	0.5278
Arena of the Gods	2018-03-22	2	5	4	6	0.5278
HomestarVR	2018-05-01	4	5	4	8	0.5278
Trail Breaking	2018-06-25	4	5	4	8	0.5278
Lighter Than AR	2018-04-30	1	5	4	5	0.5278
Skinscape	2018-06-09	137	5	4	141	0.5278
Sea of memories	2018-06-01	3	5	4	7	0.5278
Tower Stacker	2018-07-02	3	5	4	7	0.5278
My Farm	2018-08-23	4	5	4	8	0.5278
Kids Learn	2018-07-31	4	5	4	8	0.5278
Space Wars	2018-07-23	2	5	4	6	0.5278
Haunted Halls: Revenge of Doctor Blackmore Collector's Edition	2018-07-27	3	5	4	7	0.5278
Escape Black Orion VR	2018-09-25	2	5	4	6	0.5278
BinaryBotsVR	2018-11-22	9	5	4	13	0.5278
Khospis	2018-10-13	2	5	4	6	0.5278
Raptor: Cretaceous Island	2018-11-23	2	5	4	6	0.5278
JUMP UP	2018-12-21	2	5	4	6	0.5278
One Night 2: The Beyond	2018-11-29	138	5	4	142	0.5278
CCCP CALLS!	2018-05-22	11	118	103	114	0.5273
R.O.V.E.R.	2018-08-17	5	20	17	22	0.527
Let's Go There And Wander Nowhere	2018-07-05	4	20	17	21	0.527
Trivia Vault: Mixed Trivia 2	2018-02-13	6	37	32	38	0.5261
Russian AYE Race	2018-02-22	3	29	25	28	0.526
Armada Skies	2018-01-31	2	13	11	13	0.5259
Conquer	2018-02-22	5	13	11	16	0.5259
The last Baron's stunt	2018-03-23	2	13	11	13	0.5259
EXAELLA	2018-05-15	5	13	11	16	0.5259
Antirocketh	2018-08-16	3	13	11	14	0.5259
PINPIN BALLBALL	2018-11-02	3	13	11	14	0.5259
Rabbit of Destiny	2018-09-28	3	13	11	14	0.5259
Kick The Puppet	2018-12-08	3	13	11	14	0.5259
Trivia Vault Football Trivia	2018-02-27	3	38	33	36	0.5255
FinalFire	2018-05-10	31	73	64	95	0.5254
My Little Farmies	2018-02-27	199	210	186	385	0.5253
The Watchmaker	2018-05-17	6	39	34	40	0.5249
Walhall	2018-01-26	3	22	19	22	0.5246999999999999
Lawnmower Game 3: Horror	2018-10-10	3	22	19	22	0.5246999999999999
Runewards: Strategy Card Game	2018-02-13	42	31	27	69	0.5244
The Misfits	2018-08-20	166	180	160	326	0.5243
Heroes of Arzar	2018-08-16	85	40	35	120	0.5243
#CuteSnake	2018-03-15	13	40	35	48	0.5243
Trivia Vault: Business Trivia	2018-05-17	7	40	35	42	0.5243
Ishmael	2018-12-10	8	40	35	43	0.5243
New Dawn	2018-09-10	68	86	76	144	0.5242
Floresia I : Intemporel	2018-01-24	4	14	12	16	0.5242
The Great Escape	2018-04-13	11	14	12	23	0.5242
Shopkeeper Simulator VR	2018-09-19	3	14	12	15	0.5242
Fobia	2018-06-20	2	14	12	14	0.5242
Cute Girls	2018-10-21	7	14	12	19	0.5242
御俠客 Wuxia Master	2018-09-30	1055	252	225	1280	0.5239
VROOM KABOOM	2018-08-14	52	59	52	104	0.5239
Sanguo: War Under Heaven	2018-12-17	8	6	5	13	0.5239
Tank of War-VR	2018-01-03	4	6	5	9	0.5239
DMD Mars Mission	2018-02-23	2	6	5	7	0.5239
Quests Unlimited	2018-02-13	19	6	5	24	0.5239
Innocent	2018-03-13	3	6	5	8	0.5239
HellCrunch	2018-03-16	2	6	5	7	0.5239
Eat Your Words	2018-12-25	3	6	5	8	0.5239
Kolb Antarctica Experience	2018-04-17	171	6	5	176	0.5239
Sleeping Dawn VR	2018-09-28	4	6	5	9	0.5239
Fast Dust	2018-08-22	3	6	5	8	0.5239
MUSEUM	2018-11-05	3	6	5	8	0.5239
Beer'em Up	2018-11-09	6	6	5	11	0.5239
NekoCharm	2018-11-14	9	6	5	14	0.5239
Running Tadpoles	2018-12-22	3	6	5	8	0.5239
League of Pirates	2018-03-13	27	32	28	55	0.5236999999999999
Prison Test	2018-05-29	2	23	20	22	0.5236999999999999
Trivia Vault: TV Trivia	2018-05-03	6	33	29	35	0.523
Wagers of War	2018-08-08	61	33	29	90	0.523
aMAZE Untouchable	2018-01-11	4	52	46	50	0.5229
Check Your 6!	2018-03-15	30	15	13	43	0.5228
CMD 2048	2018-08-30	6	15	13	19	0.5228
Red and Blue ~ Cycles of Existence	2018-09-25	2	15	13	15	0.5228
Trivia Vault: Celebrity Trivia	2018-05-02	5	34	30	35	0.5224
Russian Gangsta In HELL	2018-05-09	3	25	22	25	0.522
Trivia Vault: Golf Trivia	2018-03-29	4	35	31	35	0.5218
Fractured Lands	2018-07-31	183	223	201	384	0.5217
Drink Pro Tycoon	2018-03-05	17	45	40	57	0.5217
Ecchi Cards	2018-07-13	8	45	40	48	0.5217
Shroud of the Avatar: Forsaken Virtues	2018-03-27	624	1542	1403	2027	0.5215
Thirsty Bubble	2018-02-06	3	16	14	17	0.5215
Legend of Assassin: Siberia	2018-09-05	4	16	14	18	0.5215
Hentai Puzzle Classic	2018-11-10	3	16	14	17	0.5215
POSTWORLD	2018-08-31	50	46	41	91	0.5213
Retro Snake	2018-06-20	4	26	23	27	0.5212
Pirate	2018-11-26	3	7	6	9	0.5211
Bold Blade	2018-01-29	4	7	6	10	0.5211
Cross And Crush	2018-03-23	3	7	6	9	0.5211
Coin-Op Kingdom	2018-08-09	7	7	6	13	0.5211
What A Trash Game	2018-07-25	4	7	6	10	0.5211
999	2018-06-29	2	7	6	8	0.5211
Everyday Baseball VR	2018-09-13	9	7	6	15	0.5211
Simple Racing	2018-08-13	4	7	6	10	0.5211
Dojini	2018-08-30	8	7	6	14	0.5211
Dream Walker	2018-10-30	5	7	6	11	0.5211
Assault on Hyperion Base	2018-11-12	7	7	6	13	0.5211
Stonies	2018-02-21	271	199	180	451	0.5209
Apocryph	2018-04-27	24	155	140	164	0.5208
Trivia Vault: Auto Racing Trivia	2018-03-28	5	37	33	38	0.5207
Loader	2018-04-13	7	27	24	31	0.5205
Struckd - 3D Game Creator	2018-02-02	235	204	185	420	0.5204
Glitch	2018-07-18	108	192	174	282	0.5204
The Piano	2018-06-04	7	17	15	22	0.5203
The Bad Gravedigger	2018-06-14	3	17	15	18	0.5203
Trivia Vault: Boxing Trivia	2018-03-24	3	38	34	37	0.5201
Travel Riddles: Mahjong	2018-08-31	17	18	16	33	0.5193
Lucius III	2018-12-13	109	525	481	590	0.5191
Episicava - Vol. I	2018-04-04	4	8	7	11	0.5189
DESPOILER	2018-03-30	6	8	7	13	0.5189
desTRUCKtors: Warfare Showdown	2018-03-16	2	8	7	9	0.5189
Geography Quiz	2018-03-13	3	8	7	10	0.5189
Tidy Your Room Simulator	2018-03-12	4	8	7	11	0.5189
Beasts & Chests	2018-07-15	2	8	7	9	0.5189
Galactic Dominion	2018-09-07	5	8	7	12	0.5189
Running Man 3D	2018-08-21	11	53	48	59	0.5186
Russian Prisoner VS Nazi Zombies	2018-03-21	3	42	38	41	0.5183
Blocky Snake	2018-10-10	32	31	28	60	0.518
Beer Bar	2018-11-20	3	31	28	31	0.518
Fog Of War - Free Edition	2018-02-22	404	898	829	1233	0.5179
LAST WAR 2044	2018-03-09	5	20	18	23	0.5176
Data mining	2018-08-06	2	20	18	20	0.5176
NeoBalls2	2018-02-15	17	32	29	46	0.5175
Bubble Strike	2018-03-28	3	32	29	32	0.5175
BE THE HERO	2018-08-25	8	9	8	16	0.5171
Reframed	2018-04-27	3	9	8	11	0.5171
SPACE HUNT	2018-06-22	4	9	8	12	0.5171
Round Ways	2018-06-08	2	9	8	10	0.5171
Factory Manager	2018-08-17	18	9	8	26	0.5171
The Adventures of Mr. Fluffykins	2018-09-17	3	9	8	11	0.5171
Vinylove	2018-09-10	3	9	8	11	0.5171
Full Body Workout	2018-10-24	5	9	8	13	0.5171
Bomber Arena	2018-11-15	2	9	8	10	0.5171
Soviet Lunapark VR	2018-07-23	14	33	30	44	0.517
Cloudborn	2018-03-02	5	22	20	25	0.5161
Jack Is Missing	2018-08-28	9	63	58	67	0.5158
AUTOCROSS MADNESS	2018-04-13	16	36	33	49	0.5157
Constricted VR	2018-07-11	3	10	9	12	0.5156000000000001
SkiFy	2018-01-24	2	10	9	11	0.5156000000000001
Dab on 'em Haterz	2018-01-16	2	10	9	11	0.5156000000000001
TRAFICO	2018-01-11	3	10	9	12	0.5156000000000001
RŌA	2018-06-02	2	10	9	11	0.5156000000000001
BunkerRush	2018-05-18	5	10	9	14	0.5156000000000001
Putinization	2018-06-09	3	10	9	12	0.5156000000000001
Cars Arena	2018-11-06	14	10	9	23	0.5156000000000001
LO-OP	2018-07-29	4	10	9	13	0.5156000000000001
Seat of War	2018-08-24	5	10	9	14	0.5156000000000001
Girls Dance VR	2018-08-25	5	10	9	14	0.5156000000000001
My Sunny Resort	2018-05-03	136	108	100	236	0.5154
Jagged Alliance: Rage!	2018-12-06	308	228	212	520	0.5153
E-Startup	2018-04-26	17	80	74	91	0.5152
AXYOS	2018-08-01	2243	1180	1104	3347	0.515
Tale of Toast	2018-02-23	828	389	363	1191	0.5149
WannaMine	2018-02-28	4	25	23	27	0.5144
Keatz: The Lonely Bird	2018-01-17	2	11	10	12	0.5144
15 seconds	2018-05-31	4	11	10	14	0.5144
幻世情缘 FANTASY LOVE STORY	2018-06-13	4	11	10	14	0.5144
Train Simulator: London Subway	2018-07-05	4	11	10	14	0.5144
Bibi & Tina - Adventures with Horses	2018-11-12	6	11	10	16	0.5144
Hentai Plus Girl	2018-11-09	3	11	10	13	0.5144
Quantum Replica	2018-05-31	9	56	52	61	0.514
Trivia Vault: Food Trivia	2018-05-30	4	41	38	42	0.5139
EEP 14 Basic	2018-06-14	11	12	11	22	0.5134000000000001
Stratego® Multiplayer	2018-01-26	14	12	11	25	0.5134000000000001
The Dreamlands: Aisling's Quest	2018-04-10	4	12	11	15	0.5134000000000001
Professor Watts Memory Match: Fresh Fruit	2018-08-11	3	12	11	14	0.5134000000000001
Archery	2018-09-13	7	44	41	48	0.513
Claws of Furry	2018-09-04	4	13	12	16	0.5125
Air Raid Over Britain	2018-03-22	5	13	12	17	0.5125
crazy maze	2018-11-02	1420	13	12	1432	0.5125
Modern Tanks	2018-02-27	124	141	133	257	0.5119
Band of Defenders	2018-04-05	240	199	188	428	0.5118
Peace Duke	2018-03-26	5	50	47	52	0.5115999999999999
Chamber of Darkness	2018-10-10	5	32	30	35	0.5115
Life and Debt: A Real Life Simulator	2018-02-28	11	15	14	25	0.511
Suncore Chronicles: The Tower	2018-04-10	14	16	15	29	0.5104
The Apartment	2018-01-26	15	16	15	30	0.5104
Seeking Dawn - Free to Play Edition	2018-11-01	20	16	15	35	0.5104
Big Crown Showdown	2018-12-14	8	16	15	23	0.5104
Legend of Assassin: Egypt	2018-09-05	4	16	15	19	0.5104
18 Floors	2018-07-04	8	17	16	24	0.5099
WarZone Flashpoint	2018-12-14	31	39	37	68	0.5096
荒漠求生	2018-07-02	4	18	17	21	0.5094
Steampunker	2018-07-06	3	19	18	21	0.509
Starman in space	2018-02-27	3	19	18	21	0.509
Voxel Race	2018-11-06	8	44	42	50	0.5086
Build Wars	2018-04-20	23	20	19	42	0.5086
Kill Him! Online Wars	2018-06-08	13	20	19	32	0.5086
Bike Dash Excite!	2018-07-10	6	21	20	26	0.5082
Hangover	2018-01-09	9	73	70	79	0.5081
Countryballs: Over The World	2018-01-31	46	131	126	172	0.5079
Thunderbolt	2018-02-26	4	23	22	26	0.5075999999999999
Spaceguy	2018-02-15	5	54	52	57	0.5071
Drift Tuner 2019	2018-03-27	18	119	115	133	0.5069
D.A.T.A	2018-10-07	25	56	54	79	0.5069
Hard Place	2018-02-20	3	26	25	28	0.5068
The Road to Hades	2018-04-12	10	26	25	35	0.5068
Clash of Castle	2018-02-07	4	27	26	30	0.5065999999999999
Trivia Vault: Soccer Trivia	2018-04-23	8	28	27	35	0.5064
Mini Golf Arena	2018-04-22	203	250	243	446	0.506
Chinbu's Adventure	2018-01-26	6	30	29	35	0.506
Islands of Nyne: Battle Royale	2018-07-12	9281	3457	3370	12651	0.5059
Until None Remain	2018-01-18	14	81	79	93	0.5049
Gangsta Sniper	2018-11-12	6	38	37	43	0.5049
Police Helicopter Simulator	2018-11-08	21	42	41	62	0.5044
Winions: Mana Champions	2018-04-12	819	54	53	872	0.5035000000000001
Uventa	2018-08-24	25	82	81	106	0.5024000000000001
LOTUS-Simulator	2018-09-14	170	305	302	472	0.5021
无主之地:银河 4X-Galaxy	2018-12-21	147	121	121	268	0.5
EV3 - Drag Racing	2018-02-26	58	105	105	163	0.5
Elven Love	2018-03-16	31	68	68	99	0.5
Click and Manage Tycoon	2018-09-19	10	43	43	53	0.5
Melting World Online	2018-10-04	25	37	37	62	0.5
Temple of Xiala	2018-02-15	33	35	35	68	0.5
Trivia Vault: Art Trivia	2018-05-05	4	32	32	36	0.5
Trials of Ascension: Exile	2018-07-26	35	29	29	64	0.5
V.T.	2018-12-18	15	28	28	43	0.5
Mighty Gemstones	2018-02-01	5	26	26	31	0.5
Yeli Orog	2018-07-13	4	25	25	29	0.5
Magical Fable: The Princess of Light	2018-09-20	61	21	21	82	0.5
Mahjong Pretty Manga Girls	2018-07-23	10	20	20	30	0.5
We Walked In Darkness	2018-01-12	22	19	19	41	0.5
Forex Trading Master: Simulator	2018-12-10	23	19	19	42	0.5
Adventurer Guild	2018-11-15	20	18	18	38	0.5
BugOut	2018-09-15	7	17	17	24	0.5
NaziShootout	2018-03-08	3	17	17	20	0.5
March to Glory	2018-04-13	42	15	15	57	0.5
Inca Blocks	2018-03-02	3	15	15	18	0.5
Data mining 2	2018-10-25	3	15	15	18	0.5
Exposure	2018-07-04	6	14	14	20	0.5
Virtual Families 2	2018-06-25	7	14	14	21	0.5
Defending Camelot	2018-10-03	7	14	14	21	0.5
The Perfect Sniper	2018-01-22	5	13	13	18	0.5
War of Conquest	2018-09-20	17	13	13	30	0.5
Zombie Murder	2018-03-12	3	13	13	16	0.5
Neon Universe	2018-07-02	2	12	12	14	0.5
Drowning	2018-11-07	3	11	11	14	0.5
Extreme Formula Championship	2018-05-11	2	11	11	13	0.5
How long can human beings exist	2018-09-30	3	11	11	14	0.5
Atomic Rancher	2018-10-29	9	11	11	20	0.5
Dead Moon - Revenge on Phobos	2018-12-19	2	10	10	12	0.5
Dread station	2018-02-22	2	10	10	12	0.5
Tunnel B1	2018-04-13	3	10	10	13	0.5
DEEP SPACE | Space-Platformer	2018-05-09	3	10	10	13	0.5
The Last Train	2018-10-11	4	10	10	14	0.5
Armored Train	2018-09-12	3	10	10	13	0.5
Trekking and Camping Sketch Edition | 远足与露营草图版	2018-07-29	2	10	10	12	0.5
Battleships and Carriers - WW2 Battleship Game	2018-11-15	10	10	10	20	0.5
Judge Dredd 95	2018-05-23	3	9	9	12	0.5
Where Time Stood Still	2018-04-13	2	9	9	11	0.5
The Three Musketeers - D'Artagnan & the 12 Jewels	2018-04-03	4	9	9	13	0.5
Tracon!2012:SE	2018-02-08	4	8	8	12	0.5
Frequent Flier: A Long Distance Love Story	2018-03-12	3	8	8	11	0.5
FINAL MATCH	2018-05-10	2	8	8	10	0.5
Fury Race	2018-05-16	5	8	8	13	0.5
Trip in HELL	2018-09-05	3	8	8	11	0.5
Apocalypse Mechanism	2018-06-11	2	7	7	9	0.5
The Tower	2018-02-16	3	7	7	10	0.5
Draft Day Sports: Pro Football 2018	2018-01-31	13	7	7	20	0.5
Homeworld Defense	2018-02-08	2	7	7	9	0.5
Hawaii Resort	2018-03-09	4	7	7	11	0.5
Oscillatron: Alien Frequency	2018-04-16	2	7	7	9	0.5
The Lift	2018-10-31	3	7	7	10	0.5
Disc Golf VR	2018-05-28	10	7	7	17	0.5
Master Pyrox Wizard Smackdown	2018-06-09	8	7	7	15	0.5
Limouzik	2018-06-18	4	7	7	11	0.5
Degeneration	2018-08-13	3	7	7	10	0.5
Drunk Puppet	2018-10-06	9	7	7	16	0.5
Chronicles of Lurra	2018-10-21	11	7	7	18	0.5
Central Intelligence	2018-04-13	2	6	6	8	0.5
Geeste	2018-04-18	4	6	6	10	0.5
Dinosaur Hunter	2018-05-02	2	6	6	8	0.5
Argos	2018-05-31	3	6	6	9	0.5
Echoes in White	2018-10-17	3	6	6	9	0.5
The Ball Encounter	2018-09-03	8	6	6	14	0.5
Trip Troupe	2018-11-05	11	6	6	17	0.5
Dafen Oil Painting Village: An Immersive Reality	2018-11-15	11	6	6	17	0.5
Mean Routine	2018-12-07	2	6	6	8	0.5
NatureFly	2018-02-18	2	5	5	7	0.5
Psychoballs	2018-03-10	3	5	5	8	0.5
Factory pirates	2018-08-24	4	5	5	9	0.5
Virtual Reality Experiment Framework	2018-06-13	11	5	5	16	0.5
Die In The Dark	2018-07-20	2	5	5	7	0.5
100 Chests	2018-06-15	3	5	5	8	0.5
Stick Spartans	2018-06-16	4	5	5	9	0.5
Korean Scary Folk Tales VR : The Forbidden Book	2018-06-15	6	5	5	11	0.5
Hat Hunters	2018-06-30	14	5	5	19	0.5
Slider	2018-08-15	2	5	5	7	0.5
Coffee Trainer VR	2018-09-21	105	5	5	110	0.5
Perverts Society	2018-10-08	3	5	5	8	0.5
Asdivine Hearts II	2018-12-19	5	5	5	10	0.5
Galaxity Beta	2018-11-12	13	5	5	18	0.5
DREAM GIRLS VR	2018-11-17	5	5	5	10	0.5
Lamplight Station	2018-10-12	5	4	4	9	0.5
Project Glitch	2018-01-23	2	4	4	6	0.5
Vinhomes Metropolis VR Interior	2018-07-20	6	4	4	10	0.5
Neon Knight: Vengeance From The Grave	2018-11-30	5	4	4	9	0.5
Epiphany!	2018-05-25	2	4	4	6	0.5
Containment Initiative: PC Standalone	2018-04-27	3	4	4	7	0.5
Tomb Exploration VR	2018-03-09	2	4	4	6	0.5
Blackbeard's Cove	2018-04-27	2	4	4	6	0.5
Crazy Science Long Run	2018-04-17	1	4	4	5	0.5
Galaxy Ball	2018-04-27	2	4	4	6	0.5
Ghost Mountain Roller Coaster	2018-05-09	3	4	4	7	0.5
Small person	2018-06-13	1	4	4	5	0.5
Debit And Credit:A Walk Through Accounting Hell	2018-06-18	38	4	4	42	0.5
ZOOMnBOOM	2018-08-29	3	4	4	7	0.5
Rage of the Pumpkins	2018-07-02	1	4	4	5	0.5
Deadly Silence	2018-08-01	1	4	4	5	0.5
Shimmer	2018-10-03	6	4	4	10	0.5
The Twelve Trials	2018-09-27	20	4	4	24	0.5
In your Shadow	2018-12-03	7	4	4	11	0.5
Star Destroyer	2018-12-26	2	4	4	6	0.5
One Bullet left	2018-02-26	4	3	3	7	0.5
Pixel To The West	2018-02-08	1	3	3	4	0.5
Archers	2018-01-18	8	3	3	11	0.5
Astro Joust	2018-03-28	4	3	3	7	0.5
Edepth Angel: Pinocchio's Murder	2018-03-12	2	3	3	5	0.5
PROJECT VELOCITY	2018-02-22	3	3	3	6	0.5
Fleazer	2018-02-14	1	3	3	4	0.5
Battleship Lonewolf 2	2018-03-08	4	3	3	7	0.5
The Necklace Of Blood	2018-03-27	1	3	3	4	0.5
Golden8bits	2018-05-21	2	3	3	5	0.5
Xenoform	2018-08-01	2	3	3	5	0.5
Star Plantation	2018-03-05	5	3	3	8	0.5
Boxing Fighter : Super Punch	2018-04-02	3	3	3	6	0.5
Age of Giants	2018-04-16	4	3	3	7	0.5
Naturallandscape - Threegorges (自然景观系列-长江三峡)	2018-03-16	2	3	3	5	0.5
Turbo Soccer VR	2018-06-14	3	3	3	6	0.5
Zombie Hotel	2018-05-19	2	3	3	5	0.5
Trek: Travel Around the World	2018-07-12	2	3	3	5	0.5
Brick Breaker Premium	2018-06-16	2	3	3	5	0.5
RollTheEarth	2018-06-30	3	3	3	6	0.5
Shooting over it : to be a star	2018-06-27	9	3	3	12	0.5
Dog's Quest	2018-07-06	1	3	3	4	0.5
Horror Rollercoaster	2018-07-26	3	3	3	6	0.5
The Mystery of Happyville	2018-07-19	4	3	3	7	0.5
Tiger Fighter 1931	2018-08-15	2	3	3	5	0.5
Evening Star	2018-09-13	4	3	3	7	0.5
Master of Rogues - The Seven Artifacts	2018-09-17	2	3	3	5	0.5
GameEllen	2018-11-03	2	3	3	5	0.5
Draft Day Sports: Pro Football 2019	2018-11-21	10	3	3	13	0.5
Happy Vampire Girl	2018-11-30	2	3	3	5	0.5
PASKA BATTLE STYLE!	2018-12-17	1	3	3	4	0.5
Inexplicable Geeks: Dawn of Just Us	2018-05-03	2	2	2	4	0.5
Sick Coaster	2018-01-30	2	2	2	4	0.5
MEET.HUNTER	2018-05-25	2	2	2	4	0.5
Viking Village	2018-04-24	3	2	2	5	0.5
Cosmic Buddies Town	2018-01-05	5	2	2	7	0.5
S.U.B.	2018-02-04	3	2	2	5	0.5
Lordian: Karma	2018-05-29	12	2	2	14	0.5
Haunted Legends: The Undertaker Collector's Edition	2018-01-10	4	2	2	6	0.5
Prism	2018-02-08	2	2	2	4	0.5
Asteion Nights	2018-02-28	2	2	2	4	0.5
Dungeon Puzzle VR - Solve it or die	2018-10-23	2	2	2	4	0.5
DJ Mole	2018-03-08	2	2	2	4	0.5
VAD	2018-06-30	2	2	2	4	0.5
Bomb Bomb! My Friends	2018-05-17	7	2	2	9	0.5
Starbucket	2018-03-20	5	2	2	7	0.5
Archer's story	2018-04-13	2	2	2	4	0.5
Chronus Arc	2018-11-15	5	2	2	7	0.5
Final Cut: The True Escapade Collector's Edition	2018-04-25	4	2	2	6	0.5
Pi is Everything	2018-05-02	1	2	2	3	0.5
FantasyDynasty: Le château DERETIC	2018-04-30	1	2	2	3	0.5
DotLine	2018-09-21	2	2	2	4	0.5
Imperi II	2018-05-10	1	2	2	3	0.5
Apartment 3301	2018-09-21	2	2	2	4	0.5
Vertical Fall	2018-12-09	1	2	2	3	0.5
Party Poopers	2018-12-14	6	2	2	8	0.5
The Lost And Forgotten	2018-08-31	2	2	2	4	0.5
Cat's Yarn	2018-07-09	2	2	2	4	0.5
Beyond Tokyo	2018-07-30	1	2	2	3	0.5
ELECTRONIC STOCK TRADING SYSTEM 	2018-09-01	2	2	2	4	0.5
Temple of the Lost	2018-09-11	2	2	2	4	0.5
Defenders of Ekron - Definitive Edition	2018-08-07	2	2	2	4	0.5
Chicken VR	2018-09-01	5	2	2	7	0.5
The Eerie Inn VR	2018-08-23	1	2	2	3	0.5
Lost Letters	2018-11-01	1	2	2	3	0.5
Groundless	2018-09-06	4	2	2	6	0.5
Dark Asylum	2018-09-18	4	2	2	6	0.5
Snake VR	2018-10-04	1	2	2	3	0.5
Glassteroids	2018-11-13	1	2	2	3	0.5
BreakHack	2018-09-26	3	2	2	5	0.5
SparkChess	2018-10-18	4	2	2	6	0.5
A Killer's Sorrow	2018-10-24	1	2	2	3	0.5
Gold Magic 800	2018-09-25	2	2	2	4	0.5
The detective ChuLin	2018-09-28	2	2	2	4	0.5
NIGHT FALLEN	2018-10-25	2	2	2	4	0.5
Werewolf Hunter X	2018-12-28	2	2	2	4	0.5
Wildest of the Wild	2018-11-01	1	2	2	3	0.5
Final Cut: Fame Fatale Collector's Edition	2018-11-12	3	2	2	5	0.5
Evolo.SpiderSim	2018-10-18	2	2	2	4	0.5
Backgammon, Chess & Checkers	2018-10-29	3	2	2	5	0.5
Color Chain	2018-11-23	1	2	2	3	0.5
Kobold Slayer	2018-11-25	2	2	2	4	0.5
Starquake Academy	2018-12-10	1	2	2	3	0.5
Dinosaurus Life VR	2018-12-07	2	2	2	4	0.5
Color Knight	2018-12-20	2	2	2	4	0.5
Helidefence	2018-12-05	2	2	2	4	0.5
A More Beautiful World - A Visual Novel	2018-09-28	2	1	1	3	0.5
Aperion Cyberstorm	2018-02-08	4	1	1	5	0.5
SaberSaw VR	2018-12-12	1	1	1	2	0.5
VRemedies - MRI Procedure Experience	2018-05-10	1	1	1	2	0.5
In The Dark	2018-07-31	2	1	1	3	0.5
Cassandra's Fabulous Foray	2018-02-07	2	1	1	3	0.5
IRO HERO	2018-07-30	3	1	1	4	0.5
Assembly League	2018-08-23	1	1	1	2	0.5
Peter World	2018-08-17	1	1	1	2	0.5
Jingo	2018-04-06	1	1	1	2	0.5
Galactic Pocket Billiards	2018-03-08	2	1	1	3	0.5
Glory & Honor	2018-11-16	2	1	1	3	0.5
Private Detective Punch Drunk	2018-01-18	1	1	1	2	0.5
Keyboard Warrior	2018-02-23	1	1	1	2	0.5
Blitz Freak	2018-08-06	5	1	1	6	0.5
Botanica: Earthbound Collector's Edition	2018-01-08	3	1	1	4	0.5
Neckbeards: Silly Squadron	2018-01-09	2	1	1	3	0.5
Flinch	2018-02-10	1	1	1	2	0.5
DwarVRs	2018-02-01	3	1	1	4	0.5
Rotator	2018-02-09	2	1	1	3	0.5
Log Challenge	2018-01-04	1	1	1	2	0.5
Deadly Blue	2018-03-28	2	1	1	3	0.5
STAR SAGA ONE - RISE OF THE DOMINATORS	2018-01-19	2	1	1	3	0.5
STAR SOD	2018-03-30	2	1	1	3	0.5
Steel Knight 1513	2018-04-26	1	1	1	2	0.5
Realshot	2018-01-25	3	1	1	4	0.5
Behind Walls	2018-05-03	1	1	1	2	0.5
Food Monster and Animals Memory Match	2018-01-30	2	1	1	3	0.5
Grim Facade: A Wealth of Betrayal Collector's Edition	2018-03-14	3	1	1	4	0.5
OutOfColors	2018-05-03	2	1	1	3	0.5
Adventure Game	2018-07-13	1	1	1	2	0.5
Boom! Maze	2018-09-06	1	1	1	2	0.5
Wendy’s Mart 3D	2018-02-15	2	1	1	3	0.5
Let's Kill Zombies VR	2018-03-30	3	1	1	4	0.5
Super Nosebleed Land	2018-07-26	1	1	1	2	0.5
Puzzle 3D	2018-03-01	2	1	1	3	0.5
挙式VR 伊達政宗 編 Wedding VR : Masamune	2018-03-09	1	1	1	2	0.5
Dissimilation	2018-02-15	2	1	1	3	0.5
IMM Defense	2018-02-22	3	1	1	4	0.5
Baseball Kings VR	2018-04-11	23	1	1	24	0.5
Sphera Turris	2018-03-05	1	1	1	2	0.5
Blood Moon: The Last Stand	2018-03-20	1	1	1	2	0.5
Zap, Blast, Loot	2018-11-01	1	1	1	2	0.5
Zombie Town Online : Premium	2018-06-05	1	1	1	2	0.5
Alice Must Find The Key To Escape (Hidden Objects)	2018-03-26	1	1	1	2	0.5
TENKYU	2018-03-28	2	1	1	3	0.5
Crypto Quest	2018-03-30	2	1	1	3	0.5
Pathosis	2018-04-10	2	1	1	3	0.5
Time Skip	2018-04-12	2	1	1	3	0.5
Falling Slime	2018-06-12	3	1	1	4	0.5
Haunted Legends: The Stone Guest Collector's Edition	2018-05-02	4	1	1	5	0.5
Kemonomichi-White Moment-	2018-05-03	2	1	1	3	0.5
Odyssee	2018-05-04	1	1	1	2	0.5
Monster Truck Drive	2018-05-02	3	1	1	4	0.5
Lazergoat: Invasion	2018-05-14	1	1	1	2	0.5
Bug Splatt	2018-07-12	1	1	1	2	0.5
Valerian Tales	2018-07-02	2	1	1	3	0.5
Paper Shakespeare: Stick Merchant of Venice	2018-05-11	2	1	1	3	0.5
Generic Jumper	2018-08-30	1	1	1	2	0.5
Black Roses	2018-05-28	1	1	1	2	0.5
SPACE BLASTER 8 BIT	2018-05-16	1	1	1	2	0.5
Cubelz	2018-05-27	1	1	1	2	0.5
Math Classroom Challenge	2018-06-07	2	1	1	3	0.5
Kogent Defender	2018-06-16	2	1	1	3	0.5
A Quiet Mind	2018-06-04	1	1	1	2	0.5
Quiz Time	2018-07-05	2	1	1	3	0.5
Blueprint	2018-05-31	1	1	1	2	0.5
Jumponaut	2018-06-16	2	1	1	3	0.5
Hum Drum Experiences	2018-09-28	2	1	1	3	0.5
Greenspawn Restaurant	2018-07-20	1	1	1	2	0.5
Adventure Hero	2018-07-17	1	1	1	2	0.5
One Jump Bomb	2018-09-06	4	1	1	5	0.5
Ticktock	2018-06-25	5	1	1	6	0.5
Meower's Quest: Jasper's Tale	2018-06-19	2	1	1	3	0.5
Chess Multiple Boards	2018-07-02	3	1	1	4	0.5
Retro Racers 2	2018-07-04	1	1	1	2	0.5
PSI Magic	2018-08-11	129	1	1	130	0.5
Ultimate War	2018-08-03	1	1	1	2	0.5
Malfortune	2018-07-31	2	1	1	3	0.5
SUPER GMA	2018-08-17	1	1	1	2	0.5
Trumpy Wall	2018-08-10	1	1	1	2	0.5
Starless Night	2018-07-31	2	1	1	3	0.5
Switcher	2018-08-09	3	1	1	4	0.5
Grid Gunner	2018-07-27	2	1	1	3	0.5
PackageRun	2018-08-03	2	1	1	3	0.5
conNEcT01	2018-07-28	1	1	1	2	0.5
HotHead	2018-10-05	1	1	1	2	0.5
建筑大冒险	2018-08-14	2	1	1	3	0.5
Mio Garden	2018-10-05	2	1	1	3	0.5
Veccol	2018-11-09	1	1	1	2	0.5
Evemnesis	2018-08-15	2	1	1	3	0.5
Gallery One	2018-08-10	1	1	1	2	0.5
Wet Warfare	2018-09-28	2	1	1	3	0.5
Triteckka: The pure shooter	2018-09-30	1	1	1	2	0.5
Escape The Labyrinth	2018-09-15	2	1	1	3	0.5
Robikon	2018-09-13	1	1	1	2	0.5
Plunder Squad	2018-09-24	4	1	1	5	0.5
PsyBurst	2018-09-06	2	1	1	3	0.5
Space Pirate Amai	2018-09-17	1	1	1	2	0.5
WWTF	2018-10-07	1	1	1	2	0.5
RIFF VR for Arcades	2018-11-08	2	1	1	3	0.5
Sword of Rapier	2018-11-17	2	1	1	3	0.5
Legends of Koyannis	2018-11-15	1	1	1	2	0.5
Tactics Rogue	2018-09-28	1	1	1	2	0.5
Pantheon	2018-10-05	2	1	1	3	0.5
Hailey	2018-10-06	1	1	1	2	0.5
Deadly Curse: Insane Nightmare	2018-10-10	2	1	1	3	0.5
HEAVEN AND HELL - the last war	2018-12-07	1	1	1	2	0.5
Dega Madness	2018-10-12	1	1	1	2	0.5
VR Cricket	2018-12-28	2	1	1	3	0.5
Teck Boxing 3D	2018-10-17	1	1	1	2	0.5
Dive Inside	2018-12-05	2	1	1	3	0.5
Our Worst Fears	2018-10-18	2	1	1	3	0.5
The Hour Has Come	2018-12-25	3	1	1	4	0.5
Deconstruction Lab	2018-11-02	2	1	1	3	0.5
机能女孩-Energy Girl	2018-10-31	1	1	1	2	0.5
Super Darts VR	2018-11-14	4	1	1	5	0.5
Daedalic Complex	2018-11-08	2	1	1	3	0.5
DragonScales 5: The Frozen Tomb	2018-11-20	2	1	1	3	0.5
Actual Volleyball	2018-11-28	5	1	1	6	0.5
Paintball Chibis	2018-12-27	2	1	1	3	0.5
Knights Rubbish	2018-12-07	3	1	1	4	0.5
Mahlone One	2018-01-24	39	80	81	120	0.4976
Trivia Vault: Fashion Trivia	2018-05-24	5	34	35	40	0.49479999999999996
MU Legend	2018-08-07	6531	1829	1872	8403	0.4947
Total Battle	2018-12-18	44	33	34	78	0.49460000000000004
Trivia Vault: Toy Trivia	2018-05-25	7	31	32	39	0.4943
My Little Riding Champion	2018-11-29	12	30	31	43	0.49420000000000003
Cosmos Invictus	2018-06-27	51	29	30	81	0.494
Survival Games	2018-04-11	31	25	26	57	0.4932
Pizza Connection 3	2018-03-22	1695	479	495	2190	0.4928
Bolt Riley, A Reggae Adventure - Chapter 1	2018-02-08	7	23	24	31	0.4927
Pro Fishing Simulator	2018-11-29	28	22	23	51	0.4924
Inca Marbles	2018-06-08	5	22	23	28	0.4924
King of Queendoms	2018-11-02	14	22	23	37	0.4924
The Evil Party	2018-01-08	4	21	22	26	0.49210000000000004
Waifu School	2018-09-21	10	21	22	32	0.49210000000000004
J.A.W.S	2018-03-08	38	71	74	112	0.49200000000000005
Dr. Pills	2018-04-17	4	20	21	25	0.4918
The Putinland: Divide & Conquer	2018-07-03	3	19	20	23	0.4914
Professor Watts Memory Match: Cats	2018-09-19	4	18	19	23	0.49100000000000005
Mars or Die!	2018-07-13	18	34	36	54	0.4897
Space of Darkness	2018-07-10	98	50	53	151	0.489
Reveal	2018-07-17	4	14	15	19	0.489
Sudoku Original	2018-06-29	6	14	15	21	0.489
Extreme Drifters	2018-07-25	3	14	15	18	0.489
忍者村大战RC2	2018-01-03	115	141	149	264	0.48869999999999997
En Tactico	2018-04-10	2	13	14	16	0.4883
Sunny Smiles	2018-04-25	10	12	13	23	0.4875
Scary Maze	2018-06-06	4	12	13	17	0.4875
Qu-tros	2018-11-26	3	12	13	16	0.4875
Pylow	2018-07-31	25	27	29	54	0.48740000000000006
Useless Box	2018-10-01	8	11	12	20	0.4866
Who Must Die	2018-11-13	5	11	12	17	0.4866
Blind Boris	2018-02-26	2	11	12	14	0.4866
Arkasha	2018-02-22	3	11	12	15	0.4866
Viking Days	2018-08-08	3	11	12	15	0.4866
Build buildings	2018-08-10	3	11	12	15	0.4866
Defiance 2050	2018-07-10	2343	1111	1183	3526	0.4858
My Golf	2018-04-27	4	23	25	29	0.48560000000000003
Ice Caves of Europa	2018-07-10	4	10	11	15	0.48560000000000003
HEVN	2018-09-24	8	10	11	19	0.48560000000000003
Devil in the Details	2018-10-12	14	10	11	25	0.48560000000000003
Venal Soul (Chapter One)	2018-05-13	2	10	11	13	0.48560000000000003
The Epic Bang Theory	2018-05-17	2	10	11	13	0.48560000000000003
Survive in Angaria TWO	2018-08-21	4	10	11	15	0.48560000000000003
Dinosaur Safari VR	2018-10-15	20	10	11	31	0.48560000000000003
Trinity VR	2018-11-20	5	10	11	16	0.48560000000000003
21+	2018-08-17	6	146	157	163	0.4851
Paradox Soul	2018-02-09	12	35	38	50	0.4851
J15 Fighter Jet VR (歼15舰载机)	2018-06-22	5	22	24	29	0.4851
Fog of War	2018-06-18	206	380	408	614	0.48460000000000003
M4 Tank Brigade	2018-03-26	6	9	10	16	0.4844
Midnightland	2018-01-19	1	9	10	11	0.4844
A Story of Distress	2018-04-02	6	9	10	16	0.4844
Viral Cry	2018-03-07	3	9	10	13	0.4844
搜索·迷城掠影/The phantom of the city	2018-12-05	2	9	10	12	0.4844
The Mystery of Devils House	2018-05-11	2	9	10	12	0.4844
BattleX	2018-09-14	22	9	10	32	0.4844
Smash Halloween Pumpkins: The Challenge	2018-09-14	2	9	10	12	0.4844
Crucible Falls: Together Forever	2018-04-21	30	20	22	52	0.4839
WAyE	2018-07-20	5	20	22	27	0.4839
BREATHE	2018-03-08	85	172	186	271	0.48380000000000006
Monster Clicker : Idle Halloween Strategy	2018-11-20	82	30	33	115	0.483
Cruz Brothers	2018-03-19	3	8	9	12	0.4829
MEGAMiX	2018-10-05	12	8	9	21	0.4829
Elementium	2018-02-02	4	8	9	13	0.4829
Bounty Hunter: Space Detective	2018-03-31	2	8	9	11	0.4829
Ancient Rush 2	2018-05-04	3	8	9	12	0.4829
Survive the West	2018-06-22	4	8	9	13	0.4829
Puzzles and Board Games Mega Collection	2018-07-25	13	8	9	22	0.4829
Snakest	2018-12-07	3	8	9	12	0.4829
Bargain Hunter	2018-11-15	8	8	9	17	0.4829
Bizango Blast	2018-12-10	8	8	9	17	0.4829
CARDCORE	2018-11-26	13	18	20	33	0.48240000000000005
Mist of the Dark	2018-08-19	57	61	67	124	0.48200000000000004
Hunt Down The Freeman	2018-02-24	151	1509	1634	1785	0.4819
Beat Boxers	2018-10-23	20	38	42	62	0.4817
KURSK	2018-11-07	110	195	213	323	0.4816
Pinball 2018	2018-05-18	4	27	30	34	0.4814
Trivia Vault: Literature Trivia	2018-06-01	5	27	30	35	0.4814
Splotches	2018-12-03	8	7	8	16	0.4811
Moto VR	2018-02-24	4	7	8	12	0.4811
Void Cube Runner	2018-04-19	3	7	8	11	0.4811
World Apart	2018-01-19	4	7	8	12	0.4811
Death Game+	2018-04-19	5	7	8	13	0.4811
Circles of hell	2018-04-14	3	7	8	11	0.4811
Oligopoly	2018-10-05	13	7	8	21	0.4811
Allison's Diary: Rebirth	2018-12-07	3	7	8	11	0.4811
Tentlan	2018-07-10	262	57	63	325	0.48090000000000005
Charlotte	2018-04-09	15	26	29	44	0.4808
Reboant - Endless Dawn	2018-04-14	6	16	18	24	0.4807
VR Slots	2018-08-30	10	15	17	27	0.4797
MeatPossible: Chapter 1.5	2018-09-19	3	15	17	20	0.4797
#WarGames	2018-03-14	36	42	47	83	0.4792
Escape the Omnochronom!	2018-11-05	3	6	7	10	0.4789
PRESim	2018-02-17	3	6	7	10	0.4789
SchoolJump	2018-05-18	2	6	7	9	0.4789
X-Fire VR	2018-02-17	3	6	7	10	0.4789
Mystic Space	2018-02-06	4	6	7	11	0.4789
King of Mazes	2018-03-15	5	6	7	12	0.4789
Piano Cat	2018-03-16	2	6	7	9	0.4789
Sleepwalker	2018-04-13	2	6	7	9	0.4789
Reliefs The time of the Lemures	2018-09-07	3	6	7	10	0.4789
DayD: Through time	2018-07-17	5	6	7	12	0.4789
The Magician's Burden	2018-08-16	12	6	7	19	0.4789
The Christmas Gifts	2018-10-05	2	6	7	9	0.4789
Achtung die Kugel!	2018-10-11	5	6	7	12	0.4789
Bravado	2018-11-02	3	6	7	10	0.4789
TooHot!	2018-12-15	2	6	7	9	0.4789
Evie	2018-02-15	8	59	66	74	0.47850000000000004
Escape Room VR: Stories	2018-03-06	9	14	16	25	0.47850000000000004
Strip Breaker : Hentai Girls	2018-09-30	8	14	16	24	0.47850000000000004
Real Drift	2018-08-31	5	49	55	60	0.4783
Dungeons&Vampires	2018-10-16	11	22	25	36	0.478
Origin Space	2018-09-27	8	13	15	23	0.4772
Team Up	2018-08-21	12	13	15	27	0.4772
Air Combat XF	2018-12-18	3	13	15	18	0.4772
ATLAS	2018-12-22	58939	19701	21691	80630	0.4769
ARK Park	2018-03-22	79	175	196	275	0.4765
Agony	2018-05-29	2845	1252	1390	4235	0.47630000000000006
Bitcoin Or Bomb?	2018-02-22	3	20	23	26	0.47630000000000006
Hentai Words	2018-06-19	176	20	23	199	0.47630000000000006
The Humans Collection	2018-06-05	2	5	6	8	0.4761
Initiation	2018-01-08	3	5	6	9	0.4761
Sky Ball	2018-01-05	3	5	6	9	0.4761
Puzzle for Kids	2018-02-06	4	5	6	10	0.4761
Geometry Runner Online	2018-03-07	3	5	6	9	0.4761
Magikiras	2018-03-08	15	5	6	21	0.4761
TRIGGERED	2018-04-27	3	5	6	9	0.4761
Infinite Survival	2018-04-23	4	5	6	10	0.4761
Ancient Journey	2018-06-08	3	5	6	9	0.4761
Save President From Rebels	2018-09-03	2	5	6	8	0.4761
The Call	2018-08-08	2	5	6	8	0.4761
Leisure Town	2018-09-12	2	5	6	8	0.4761
東方苦粗芸物語 Touhou KSG Story	2018-12-28	3	5	6	9	0.4761
Trivia Vault: Music Trivia	2018-06-23	2	12	14	16	0.4758
Professor Watts Memory Match: Expressions	2018-09-12	2	12	14	16	0.4758
Crying is not Enough	2018-06-19	34	84	95	129	0.4757
Strange Night ll	2018-02-05	9	27	31	40	0.4756
Bitcoin Farm	2018-01-19	24	57	65	89	0.47490000000000004
Golden Dungeons	2018-03-03	9	49	56	65	0.47490000000000004
Montecrypto: The Bitcoin Enigma	2018-02-20	2521	128	145	2666	0.4746
Individual Investor Tycoon	2018-02-22	21	18	21	42	0.4742
The Mark of Robot	2018-09-22	18	18	21	39	0.4742
Infinity Escape	2018-01-24	2	11	13	15	0.47409999999999997
Gold Digger Maze	2018-07-24	3	11	13	16	0.47409999999999997
Professor Watts Memory Match: Cute Animals	2018-08-07	2	11	13	15	0.47409999999999997
Bike Rush	2018-01-15	12	32	37	49	0.4739
Pro Basketball Manager 2019	2018-11-21	24	32	37	61	0.4739
Intrepid	2018-12-22	50	46	53	103	0.47350000000000003
Revelation Online	2018-08-07	591	363	411	1002	0.4732
Cortex	2018-11-02	6	17	20	26	0.473
rOt 2	2018-09-14	5	17	20	25	0.473
Mind the Vikings	2018-01-05	16	37	43	59	0.47250000000000003
Don't Bleed	2018-01-20	13	10	12	25	0.4722
Nanoui	2018-03-21	5	10	12	17	0.4722
Professor Watts Word Search: Pirates Life	2018-06-28	2	10	12	14	0.4722
Warbot	2018-03-26	4	4	5	9	0.4722
Zazmo Arcade Pack	2018-08-03	2	4	5	7	0.4722
Harsh	2018-01-25	4	4	5	9	0.4722
Naturallandscape - GuilinLandscape (自然景观系列-桂林山水)	2018-02-15	2	4	5	7	0.4722
SUPER ROBO MOUSE	2018-03-02	2	4	5	7	0.4722
Marginal act	2018-03-27	1	4	5	6	0.4722
M.I.N.D.	2018-05-24	2	4	5	7	0.4722
Игра забытых Богов. Проснись / Game of the forgotten Gods. Wake up	2018-04-17	1	4	5	6	0.4722
Up And Up	2018-06-20	4	4	5	9	0.4722
PASSAGE	2018-11-14	2	4	5	7	0.4722
Let's Split Up (A Visual Novel)	2018-06-30	1	4	5	6	0.4722
Draft Day Sports: College Football 2018	2018-07-06	18	4	5	23	0.4722
Jumper Magic	2018-07-03	1	4	5	6	0.4722
Pilgrimage	2018-07-20	2	4	5	7	0.4722
YOU - The Untold Stories	2018-10-24	2	4	5	7	0.4722
Sharknado VR	2018-11-07	2	4	5	7	0.4722
Jay Walker	2018-09-19	2	4	5	7	0.4722
The Martian Job	2018-10-05	14	4	5	19	0.4722
バインドを解除する(unbind)	2018-11-28	4	4	5	9	0.4722
BloodyMary	2018-09-29	4	29	34	38	0.4717
They That Feast	2018-12-29	4	16	19	23	0.4717
Red points	2018-11-16	2	16	19	21	0.4717
The Parallax Effect	2018-01-01	61	112	129	190	0.4715
Neon Sun	2018-02-14	4	22	26	30	0.4712
Super Street: The Game	2018-09-12	68	159	183	251	0.47100000000000003
Action Alien : Prelude	2018-02-27	3	15	18	21	0.4703
INVISIBLE	2018-01-26	5	9	11	16	0.47000000000000003
The Haunting of Billy	2018-02-26	8	20	24	32	0.469
Beach Restaurant	2018-01-09	5	38	45	50	0.46890000000000004
P.A.S.	2018-08-08	225	380	439	664	0.46880000000000005
Gachi Gang	2018-05-27	2	14	17	19	0.4687
Land of Puzzles: Elven Princess	2018-09-28	2	14	17	19	0.4687
Make It Rain: Love of Money	2018-05-25	148	105	123	271	0.4682
Panic Room 2: Hide and Seek	2018-07-09	23	31	37	60	0.4682
Artifact Classic	2018-11-28	60646	11563	13240	73886	0.4678
Name The Song Quiz	2018-02-09	10	19	23	33	0.46770000000000006
NARK THE DRAGON	2018-01-02	4	30	36	40	0.46740000000000004
Forgotten Places: Lost Circus	2018-03-22	10	30	36	46	0.46740000000000004
Wild West VR	2018-06-15	8	8	10	18	0.4673
HOT GIRLS VR	2018-10-27	7	8	10	17	0.4673
RockShot	2018-06-04	176	169	198	374	0.4672
Car Crash Couch Party	2018-02-01	10	13	16	26	0.4669
High Speed Trains	2018-03-27	5	13	16	21	0.4669
Day of Destruction	2018-01-17	3	3	4	7	0.4668
Elixir of Immortality II: The League of Immortality	2018-05-18	14	3	4	18	0.4668
Chessia	2018-09-20	3	3	4	7	0.4668
Squash Kings VR	2018-03-13	2	3	4	6	0.4668
I Hate Heroes: Rocket Man	2018-06-30	2	3	4	6	0.4668
Pit Blocks 3D	2018-09-27	2	3	4	6	0.4668
Don't Look Back	2018-03-20	2	3	4	6	0.4668
Box Maze Extreme	2018-07-05	3	3	4	7	0.4668
Precision Sniping: Competitive	2018-03-27	3	3	4	7	0.4668
Doomsday on Demand 2	2018-06-26	6	3	4	10	0.4668
Doomsday on Demand	2018-06-26	8	3	4	12	0.4668
Nova Wing III	2018-05-15	2	3	4	6	0.4668
Towards a perilous journey	2018-07-24	53	3	4	57	0.4668
幻想郷ローリングフォース	2018-08-09	4	3	4	8	0.4668
NightmareBullet	2018-07-19	1	3	4	5	0.4668
Pingball Ultra	2018-08-07	3	3	4	7	0.4668
Super Commander XL	2018-10-09	3	3	4	7	0.4668
Hunter's Trial	2018-12-12	7	3	4	11	0.4668
3 Days in the Abyss	2018-11-27	2	3	4	6	0.4668
Spaceguy: Red Space	2018-12-06	3	3	4	7	0.4668
Voyage Senki VR	2018-04-16	13	18	22	35	0.46630000000000005
Best Life Simulator	2018-11-24	5	18	22	27	0.46630000000000005
Degrees	2018-05-19	4	23	28	32	0.46590000000000004
Shadow Council: The Puppeteers	2018-06-21	7	23	28	35	0.46590000000000004
!LABrpgUP!	2018-06-13	5	23	28	33	0.46590000000000004
Sunset Rangers	2018-03-01	32	130	154	186	0.46549999999999997
Breach of Contract Reloaded	2018-03-14	54	101	120	174	0.46549999999999997
Zomby Soldier	2018-01-22	3	17	21	24	0.4648
Roulette Simulator	2018-01-19	4	17	21	25	0.4648
Ice Cream Factory	2018-02-24	3	12	15	18	0.4648
VR Jogger	2018-08-17	5	12	15	20	0.4648
Close the Window!	2018-01-02	4	32	39	43	0.4643
StackFortress	2018-03-05	5	7	9	14	0.46409999999999996
Nuclear 2050	2018-04-11	2	7	9	11	0.46409999999999996
Diary of Defender	2018-07-12	4	7	9	13	0.46409999999999996
Capsella The Lights of Lucern	2018-06-23	3	7	9	12	0.46409999999999996
Cryptochain	2018-06-22	2	7	9	11	0.46409999999999996
MiniCar Race	2018-07-13	4	7	9	13	0.46409999999999996
Love at Elevation	2018-11-08	33	7	9	42	0.46409999999999996
ZoneDriver	2018-03-29	8	26	32	40	0.46340000000000003
Internet Simulator	2018-03-15	4	26	32	36	0.46340000000000003
Zombie Clicker Defense	2018-02-02	60	21	26	86	0.46340000000000003
The Commission: Organized Crime Grand Strategy	2018-08-23	24	21	26	50	0.46340000000000003
Cyborg Invasion Shooter 2: Battle Of Earth	2018-02-28	4	16	20	24	0.4632
Lost Cities	2018-05-19	8	11	14	22	0.4625
Grandpa	2018-09-29	7	86	104	111	0.46240000000000003
RECOG The First Wave	2018-06-15	6	6	8	14	0.46020000000000005
Call each NEW YEAR	2018-06-22	2	6	8	10	0.46020000000000005
Robots 2 Unknown World	2018-07-13	2	6	8	10	0.46020000000000005
Terror	2018-10-02	2	6	8	10	0.46020000000000005
Checkmate!	2018-09-07	3	6	8	11	0.46020000000000005
SCP: Derelict - SciFi First Person Shooter	2018-12-03	2	6	8	10	0.46020000000000005
Dragon Awaken	2018-10-03	43	23	29	72	0.4598
Vatnik Simulator - A Russian Patriot Game	2018-06-21	2	10	13	15	0.4598
CROSS X CARROT	2018-10-31	4	10	13	17	0.4598
Car Crash Online	2018-07-28	5	10	13	18	0.4598
SCP-087: Recovered document	2018-01-01	4	41	51	55	0.4595
Late at night	2018-09-27	15	50	62	77	0.4593
Virtual Villagers Origins 2	2018-10-26	71	116	142	213	0.45909999999999995
Corrupted	2018-09-27	9	18	23	32	0.45880000000000004
PIXEL DRIFT	2018-02-04	6	35	44	50	0.4583
Super Puzzle Galaxy	2018-07-05	11	2	3	14	0.4583
Greece Defense TD	2018-03-09	4	2	3	7	0.4583
The Sunset 2096	2018-06-04	3	2	3	6	0.4583
influence	2018-01-22	3	2	3	6	0.4583
Battle Ion	2018-03-09	1	2	3	4	0.4583
Musical Reflex	2018-04-16	2	2	3	5	0.4583
Orcz Evolve	2018-05-03	2	2	3	5	0.4583
King Battle	2018-01-30	2	2	3	5	0.4583
Gump	2018-01-27	1	2	3	4	0.4583
Raptainment	2018-04-18	2	2	3	5	0.4583
MechTroid	2018-02-03	1	2	3	4	0.4583
Space Chip	2018-05-17	1	2	3	4	0.4583
Venture Arctic	2018-05-01	3	2	3	6	0.4583
So Long Grandma	2018-03-16	2	2	3	5	0.4583
Ignis Avis Venatio	2018-03-12	3	2	3	6	0.4583
Yacht Simulator VR	2018-03-19	1	2	3	4	0.4583
Ratergy	2018-03-30	4	2	3	7	0.4583
Nano Nebula	2018-11-02	2	2	3	5	0.4583
Not So Middle Ages	2018-04-27	2	2	3	5	0.4583
Fernz Gate	2018-08-30	5	2	3	8	0.4583
Trivia King	2018-06-22	4	2	3	7	0.4583
Another world: Truck driver	2018-07-30	2	2	3	5	0.4583
One Piu Day	2018-09-26	1	2	3	4	0.4583
Deadly Curse	2018-09-07	2	2	3	5	0.4583
Help Me Escape! The Puzzle Maker's Office	2018-09-10	3	2	3	6	0.4583
Type Fighter	2018-09-17	2	2	3	5	0.4583
Croquet Pro 2	2018-11-16	4	2	3	7	0.4583
Waifu Hunter - Episode 1 : The Runaway Samurai	2018-10-25	4	2	3	7	0.4583
Mahjong Secrets	2018-11-19	5	2	3	8	0.4583
Spacefarers!	2018-10-15	1	2	3	4	0.4583
Beyond	2018-10-31	2	2	3	5	0.4583
败家仔 Last Wish	2018-10-31	5	2	3	8	0.4583
Mars: Chaos Menace	2018-11-16	2	2	3	5	0.4583
Yet Another Snake Game	2018-11-01	1	2	3	4	0.4583
Tiger Tank 59 Ⅰ A-Gun	2018-10-25	136	2	3	139	0.4583
The Silver Crusade: Aoorha Axeman	2018-11-04	3	2	3	6	0.4583
Halloween Puzzles	2018-11-06	2	2	3	5	0.4583
Hidden Object: Home Makeover	2018-11-29	4	2	3	7	0.4583
Evolo.Mine	2018-11-22	1	2	3	4	0.4583
ToyShot VR	2018-12-21	3	2	3	6	0.4583
傲皇忆剑诀	2018-12-30	4	2	3	7	0.4583
Mountain Troll	2018-01-22	3	56	70	73	0.45740000000000003
Silence in Space - Season One	2018-09-04	956	13	17	973	0.457
Z: Escape	2018-05-29	136	9	12	148	0.45670000000000005
Bitcoin Trader	2018-05-03	6	37	47	53	0.4561
Deconstructor	2018-06-01	5	28	36	41	0.45530000000000004
A night with Natalie	2018-11-14	5	20	26	31	0.45520000000000005
TRUTH OF FALCHION	2018-07-26	2	5	7	9	0.45520000000000005
The Princess Adventure	2018-11-08	2	5	7	9	0.45520000000000005
Torn Tales: Rebound Edition	2018-09-06	3	5	7	10	0.45520000000000005
Cro Magnon	2018-07-31	5	5	7	12	0.45520000000000005
Inevitable VR	2018-08-19	16	5	7	23	0.45520000000000005
DOKA 2 GUTS OUT NINJA	2018-12-27	2	5	7	9	0.45520000000000005
Commands & Colors: Ancients	2018-09-12	49	36	46	95	0.4551
Ashley: The Story Of Survival	2018-04-13	9	16	21	30	0.455
Experiment Gone Rogue	2018-12-20	5	12	16	21	0.4545
RedSun RTS	2018-10-30	4	12	16	20	0.4545
Fantasy Defense	2018-03-29	8	12	16	24	0.4545
Envoy of Nezphere	2018-07-17	191	12	16	207	0.4545
Professor Watts Word Search: Yummy Foods	2018-07-02	2	12	16	18	0.4545
Political puzzle	2018-08-07	4	35	45	49	0.45409999999999995
Who's in the Box?	2018-04-13	4	23	30	34	0.45380000000000004
Battle Royale: Survivors	2018-06-29	107	257	320	427	0.4535
Lingotopia	2018-08-16	7	19	25	32	0.4535
Dawn of the Breakers	2018-11-22	123	42	54	177	0.4533
School Grounds	2018-12-14	42	34	44	86	0.45310000000000006
The Prison Game	2018-02-14	10	8	11	21	0.45310000000000006
Space Shaft	2018-03-10	3	8	11	14	0.45310000000000006
Battle Of Keys	2018-03-21	2	8	11	13	0.45310000000000006
Flapping Over It	2018-05-17	9	8	11	20	0.45310000000000006
Counter Fight 3	2018-12-20	4	8	11	15	0.45310000000000006
Maia	2018-11-23	101	463	578	679	0.4516
STE : Save The Earth	2018-04-02	45	11	15	60	0.4516
Dark Rose Valkyrie	2018-04-10	41	67	86	127	0.4515
Hot Mars 69	2018-03-12	3	36	47	50	0.4512
Wall Street Junior	2018-09-13	24	25	33	57	0.4512
Infinite World	2018-06-12	6	25	33	39	0.4512
25 Cadre of Death	2018-10-22	5	25	33	38	0.4512
Cereal Soup	2018-06-03	153	319	402	555	0.4504
Nightmare Simulator	2018-03-12	2	14	19	21	0.4504
Shoottera	2018-03-01	18	24	32	50	0.4497
Archibald	2018-03-08	26	45	59	85	0.44930000000000003
West of Red	2018-03-07	5	41	54	59	0.4489
aMAZE ABC	2018-09-04	3	41	54	57	0.4489
ArchaeologyX	2018-11-26	3	7	10	13	0.4487
Volkstein	2018-03-23	2	7	10	12	0.4487
Fall Down	2018-04-30	6	7	10	16	0.4487
PearsAndGrayWitch	2018-01-01	5	7	10	15	0.4487
Stary	2018-12-24	3	7	10	13	0.4487
Shop Tycoon The Boss	2018-07-31	5	4	6	11	0.4486
Descending	2018-11-15	2	4	6	8	0.4486
Agents of Aggro City Online	2018-01-05	289	4	6	295	0.4486
The Tavern of Magic	2018-09-07	5	4	6	11	0.4486
Love or Loved	2018-02-08	3	4	6	9	0.4486
My Safe House	2018-04-21	6	4	6	12	0.4486
Made to Order	2018-06-19	5	4	6	11	0.4486
Beyond the Mind	2018-07-05	3	4	6	9	0.4486
Dark Tales: Edgar Allan Poe's The Tell-Tale Heart Collector's Edition	2018-08-01	3	4	6	9	0.4486
The Desert's Rose	2018-09-26	2	4	6	8	0.4486
Supreme City	2018-12-12	3	4	6	9	0.4486
Skylands	2018-04-23	8	10	14	22	0.4483
Target speed	2018-01-16	9	10	14	23	0.4483
Life Game	2018-11-23	5	10	14	19	0.4483
Deadly Station	2018-05-25	4	13	18	22	0.44780000000000003
Fury Strike	2018-08-17	55	13	18	73	0.44780000000000003
Castle of Venia	2018-08-22	3	13	18	21	0.44780000000000003
Valor Time	2018-11-14	69	75	98	167	0.4476
The Life of One Dog	2018-10-03	3	52	69	72	0.44630000000000003
The Last Tower	2018-03-29	5	25	34	39	0.446
Gift of Parthax	2018-09-12	11	34	46	57	0.445
Amigo Fishing	2018-04-12	10	15	21	31	0.4448
The Secrets of The Forest	2018-04-07	3	12	17	20	0.4448
Simple Man	2018-03-12	3	9	13	16	0.44450000000000006
Finding summer	2018-12-28	3	9	13	16	0.44450000000000006
Hinterhalt	2018-02-28	5	24	33	38	0.44430000000000003
Gopnik Simulator	2018-05-15	8	36	49	57	0.4435
New Gundam Breaker	2018-09-24	421	951	1224	1645	0.4434
First Impact: Rise of a Hero	2018-06-08	19	6	9	28	0.4434
Award. Room of fear	2018-03-02	2	6	9	11	0.4434
HELI	2018-02-05	4	6	9	13	0.4434
Legend Knight	2018-04-18	3	6	9	12	0.4434
Bloody Faerie	2018-09-28	3	6	9	12	0.4434
Dark Visit	2018-06-28	3	6	9	12	0.4434
FortOfTheNight	2018-07-12	3	6	9	12	0.4434
Mosaics Galore. Challenging journey	2018-11-26	4	6	9	13	0.4434
Monster Minis Extreme Off-Road	2018-08-11	4	1	2	6	0.44310000000000005
Ancient Code VR	2018-02-01	2	1	2	4	0.44310000000000005
Enshrouded World: Home Truths	2018-02-26	2	1	2	4	0.44310000000000005
Ancient Tower	2018-11-28	2	1	2	4	0.44310000000000005
Rookie Math Pro	2018-06-03	3	1	2	5	0.44310000000000005
Big Blue - Memory	2018-03-08	2	1	2	4	0.44310000000000005
The Adventures of Kusoge	2018-02-08	2	1	2	4	0.44310000000000005
Kai Yuen's Overlapped Universe	2018-10-31	1	1	2	3	0.44310000000000005
One Man Army VR	2018-03-07	1	1	2	3	0.44310000000000005
Tennis Kings VR	2018-04-23	6	1	2	8	0.44310000000000005
Ball Driver	2018-03-30	2	1	2	4	0.44310000000000005
BurningBridges VR	2018-04-26	1	1	2	3	0.44310000000000005
Space Flowers	2018-04-06	1	1	2	3	0.44310000000000005
Havoc in heaven	2018-04-18	1	1	2	3	0.44310000000000005
Twilight Phenomena: The Incredible Show Collector's Edition	2018-04-09	3	1	2	5	0.44310000000000005
A Penny For Some Motivation	2018-04-11	2	1	2	4	0.44310000000000005
Heavy Blade	2018-05-28	3	1	2	5	0.44310000000000005
Spirits of Metropolis	2018-05-09	2	1	2	4	0.44310000000000005
Super Hero VR	2018-04-16	3	1	2	5	0.44310000000000005
Darkest Mana : Master of the Table	2018-05-31	3	1	2	5	0.44310000000000005
Number Hunt	2018-12-21	3	1	2	5	0.44310000000000005
Warlock: Tower Defence	2018-06-08	2	1	2	4	0.44310000000000005
Muerte's Arena	2018-10-22	2	1	2	4	0.44310000000000005
PLANET RESERVE	2018-06-22	1	1	2	3	0.44310000000000005
Jailbreak Lockdown	2018-12-21	2	1	2	4	0.44310000000000005
Brick Breaker Premium 3	2018-06-22	2	1	2	4	0.44310000000000005
Harpoon Cat	2018-07-12	3	1	2	5	0.44310000000000005
Slave Master: The Game	2018-11-18	2	1	2	4	0.44310000000000005
Forgotten World	2018-07-18	3	1	2	5	0.44310000000000005
Atlantic Edge	2018-09-07	2	1	2	4	0.44310000000000005
The Grand Museum VR	2018-07-20	1	1	2	3	0.44310000000000005
Retroids	2018-08-06	1	1	2	3	0.44310000000000005
Sandhill Architectures	2018-08-17	2	1	2	4	0.44310000000000005
Tale of Palmi	2018-08-12	2	1	2	4	0.44310000000000005
DrillMania	2018-08-14	2	1	2	4	0.44310000000000005
Skateboarding pro	2018-08-08	2	1	2	4	0.44310000000000005
Combiner the Card Game	2018-08-10	2	1	2	4	0.44310000000000005
CRACKPOT DESPOT: TRUMP WARFARE	2018-08-27	2	1	2	4	0.44310000000000005
Darken VR	2018-08-13	1	1	2	3	0.44310000000000005
Survivor in Summer	2018-08-31	1	1	2	3	0.44310000000000005
Conjure Strike	2018-09-28	5	1	2	7	0.44310000000000005
CrazyDriving	2018-09-06	1	1	2	3	0.44310000000000005
The Hot Dog would Explode	2018-09-27	2	1	2	4	0.44310000000000005
Shrines Of Sacred Essenсe	2018-10-24	2	1	2	4	0.44310000000000005
OIL PATCH SIMULATIONS	2018-10-23	2	1	2	4	0.44310000000000005
Space Bugs	2018-10-12	1	1	2	3	0.44310000000000005
Super Keepy Ups	2018-12-14	2	1	2	4	0.44310000000000005
ANSIBLE	2018-11-08	2	1	2	4	0.44310000000000005
Spray Dynamite X Radioactive Insects	2018-12-06	1	1	2	3	0.44310000000000005
Tiger Soldier Ⅰ	2018-12-20	1	1	2	3	0.44310000000000005
Lucky Skiing	2018-11-27	2	1	2	4	0.44310000000000005
Stone In Galaxy	2018-12-05	3	1	2	5	0.44310000000000005
SHELL_BREAK	2018-12-17	1	1	2	3	0.44310000000000005
Sudoku3D	2018-12-23	373	1	2	375	0.44310000000000005
Space Struck Run	2018-12-19	1	1	2	3	0.44310000000000005
Johnny Rocket	2018-11-12	4	20	28	32	0.4425
Fear Effect Sedna	2018-03-06	45	76	102	147	0.44229999999999997
Warrecs	2018-07-31	14	14	20	34	0.44200000000000006
The Momo Game	2018-10-16	14	56	76	90	0.4416
Space Colonizers Idle Clicker	2018-06-01	53	11	16	69	0.4414
Hamster Daily	2018-07-03	3	8	12	15	0.44
Hentai PuZZles	2018-04-26	2	8	12	14	0.44
Othello 2018	2018-06-21	3	8	12	15	0.44
Puzzle Monarch: Nile River	2018-09-24	3	8	12	15	0.44
老虎游戏-casino	2018-11-20	27	16	23	50	0.43979999999999997
Unborne	2018-02-20	3	3	5	8	0.43950000000000006
INFERNO: Deathfield	2018-01-25	2	3	5	7	0.43950000000000006
Holy Towers	2018-05-28	6	3	5	11	0.43950000000000006
In League	2018-09-05	6	3	5	11	0.43950000000000006
The Departure	2018-01-29	3	3	5	8	0.43950000000000006
Way Out	2018-02-09	153	3	5	158	0.43950000000000006
LOVE Obsession VR	2018-05-06	3	3	5	8	0.43950000000000006
Hit The Hive	2018-08-23	1	3	5	6	0.43950000000000006
VOICEACTRESSⅡ	2018-09-25	7	3	5	12	0.43950000000000006
Roller	2018-05-18	3	3	5	8	0.43950000000000006
Dirt Bike Insanity	2018-06-15	2	3	5	7	0.43950000000000006
Glow Ball - Not A Billiard Puzzle Game	2018-05-18	2	3	5	7	0.43950000000000006
Unexpected Journey	2018-07-01	3	3	5	8	0.43950000000000006
Dance With Memes	2018-06-12	2	3	5	7	0.43950000000000006
Devochka Quest	2018-06-21	1	3	5	6	0.43950000000000006
碧落传说	2018-11-24	3	3	5	8	0.43950000000000006
Mission Of Hero	2018-03-09	2	13	19	21	0.439
AIDEN	2018-02-09	3	18	26	29	0.438
Land of Puzzles: Battles	2018-09-08	5	18	26	31	0.438
Escape From Cozy Island	2018-05-07	4	10	15	19	0.4375
Battle Of Worldviews	2018-07-27	4	10	15	19	0.4375
MMA Simulator	2018-09-25	6	10	15	21	0.4375
Swamp Jump	2018-08-21	3	10	15	18	0.4375
Legend of Assassin: Jungle	2018-09-10	4	10	15	19	0.4375
Starship Corporation	2018-05-03	281	225	303	584	0.43729999999999997
The Entity	2018-07-02	4	15	22	26	0.43710000000000004
Paintball War	2018-06-01	215	496	662	877	0.4369
Zula Türkiye	2018-01-11	3041	6302	8249	11290	0.4368
Pit of Evil	2018-10-26	5	5	8	13	0.4368
冰封之门	2018-02-12	2	5	8	10	0.4368
Stickman Fighting	2018-03-06	3	5	8	11	0.4368
Honor Cry: Aftermath	2018-06-06	2	5	8	10	0.4368
Volcano Eruption	2018-11-07	6	5	8	14	0.4368
Wetwork	2018-07-27	3	5	8	11	0.4368
City Defense	2018-12-31	2	5	8	10	0.4368
The Official GamingTaylor Game, Great Job!	2018-07-06	7	47	66	73	0.4361
KryptCrawler	2018-06-05	4	12	18	22	0.43560000000000004
Girl Mod | GIRLS VR (create + pose in VR)	2018-10-19	4	12	18	22	0.43560000000000004
Death Trader: Cold War	2018-10-19	10	30	43	53	0.4353
ULTIMATE ARENA: SHOWDOWN	2018-02-23	11	7	11	22	0.4347
BRIGHTEST	2018-01-30	3	7	11	14	0.4347
Geek Fighter	2018-03-25	2	7	11	13	0.4347
ELF	2018-04-13	3	7	11	14	0.4347
Evolo.Evolution	2018-09-04	3	7	11	14	0.4347
Life is Feudal: MMO	2018-01-12	5331	2810	3731	9062	0.43460000000000004
Genius Calculator	2018-03-23	2	14	21	23	0.434
Dead by Death	2018-07-18	3	9	14	17	0.43310000000000004
Polyventure	2018-01-28	27	16	24	51	0.43270000000000003
Ecchi 2: compile 2D chan	2018-11-12	4	23	34	38	0.4319
A night with Natalie VR	2018-11-07	6	11	17	23	0.43170000000000003
Winner Winner Chicken Dinner!	2018-01-22	4	18	27	31	0.4316
Cryptocurrency Clicker	2018-04-06	60	42	61	121	0.43060000000000004
Safe House 	2018-05-22	12	13	20	32	0.43060000000000004
Land of Puzzles: Knights	2018-08-26	6	13	20	26	0.43060000000000004
Chronicles of Vinland	2018-05-24	28	59	85	113	0.4299
Psychiatrist Simulator	2018-02-13	9	39	57	66	0.4299
Board Battlefield	2018-08-10	8	24	36	44	0.429
Knife Hit Dash	2018-04-07	24	31	46	70	0.4288
Icons: Legacy Edition	2018-07-12	925	413	574	1499	0.42869999999999997
Island Tribe 5	2018-01-15	7	6	10	17	0.4283
Stage Fright	2018-02-01	3	6	10	13	0.4283
Neon Void Runner	2018-04-23	2	6	10	12	0.4283
Beerd leaver	2018-06-23	2	6	10	12	0.4283
Life's Playground	2018-06-12	2	6	10	12	0.4283
Island Build Masters	2018-02-07	9	4	7	16	0.4282
Feed Eve	2018-03-05	2	4	7	9	0.4282
Global Soccer: A Management Game 2018	2018-04-06	10	4	7	17	0.4282
Der Milchbauer	2018-08-21	8	4	7	15	0.4282
Professor Madhouse	2018-06-04	2	4	7	9	0.4282
Adventures of Mike	2018-05-24	3	4	7	10	0.4282
Heroes Of The Offworld Arena	2018-06-04	1	4	7	8	0.4282
Urbance Clans Card Battle!	2018-10-03	3	4	7	10	0.4282
Captain The Runner	2018-08-10	2	4	7	9	0.4282
梦本无忧	2018-09-19	3	4	7	10	0.4282
Citadale - The Ancestral Strain	2018-10-24	3	4	7	10	0.4282
LOR - League of Runners	2018-04-06	1610	8	13	1623	0.4279
Among the Dead	2018-05-30	2	8	13	15	0.4279
Madness of the Architect	2018-02-02	3	8	13	16	0.4279
Cubic Color	2018-03-30	2	8	13	15	0.4279
Outline	2018-03-23	4	8	13	17	0.4279
Skat Stammtisch	2018-05-01	9	8	13	22	0.4279
Let's Play with Nanai!	2018-11-01	4	8	13	17	0.4279
Brainf*ck	2018-09-27	4	8	13	17	0.4279
Phoenix Dynasty 2	2018-06-08	389	165	234	623	0.4278
Deadly Tropics	2018-04-23	3	10	16	19	0.4274
Synthetic Love	2018-10-15	12	10	16	28	0.4274
70 Seconds Survival	2018-08-08	3	10	16	19	0.4274
The Castle Disaster 2	2018-07-13	11	10	16	27	0.4274
Clone Adventures	2018-08-27	3	10	16	19	0.4274
Battle royale simulator	2018-08-24	3	10	16	19	0.4274
Nostradamus - The Four Horsemen of the Apocalypse	2018-02-12	8	12	19	27	0.4269
Hungry Games: Survive in a world of predatory fish	2018-04-11	6	12	19	25	0.4269
ESport Manager	2018-06-18	131	70	102	233	0.4267
City Patrol: Police	2018-11-29	5	14	22	27	0.4264
Lost	2018-07-09	4	14	22	26	0.4264
Bunny - The Horror Game	2018-08-28	3	14	22	25	0.4264
Puzzle of Santa Girl VR	2018-01-24	2	2	4	6	0.4261
Ladybird Reflect	2018-04-18	2	2	4	6	0.4261
美食梦工厂：研发美食开心制作糖果模拟经营养成	2018-10-16	3	2	4	7	0.4261
Night Drive VR	2018-03-02	2	2	4	6	0.4261
Brutalism	2018-03-26	2	2	4	6	0.4261
Sword Mans	2018-03-30	4	2	4	8	0.4261
烹饪吧！地狱土豆？！	2018-08-20	8	2	4	12	0.4261
Strive	2018-06-14	35	2	4	39	0.4261
The Boy Who Typed Wolf	2018-08-07	4	2	4	8	0.4261
Brain 43℃	2018-06-14	1	2	4	5	0.4261
Colonumbers	2018-06-19	1	2	4	5	0.4261
Tiger Tank 59 Ⅰ	2018-07-23	1	2	4	5	0.4261
Potion island	2018-09-26	2	2	4	6	0.4261
Blokin	2018-11-12	2	2	4	6	0.4261
The Colony	2018-12-27	2	2	4	6	0.4261
Small Sister	2018-08-15	6	40	60	66	0.42490000000000006
No Way Out	2018-10-04	4601	42	63	4664	0.42460000000000003
Soulblight	2018-03-15	33	51	76	109	0.4244
Cowboy Escape	2018-02-26	7	24	37	44	0.4242
Bloody sand	2018-07-04	6	13	21	27	0.4227
Dread of Laughter	2018-11-01	4	13	21	25	0.4227
On Board 4 PC	2018-04-23	42	11	18	60	0.4227
Puzzle Monarch: Vampires	2018-08-10	3	11	18	21	0.4227
Slime CCG	2018-07-13	217	36	55	272	0.42240000000000005
SAS VS Zombies	2018-03-23	2	9	15	17	0.42240000000000005
Me And Dungeons	2018-07-06	4	9	15	19	0.42240000000000005
Imperialism: Fate of India	2018-08-10	6	9	15	21	0.42240000000000005
Beast Quest	2018-03-13	6	21	33	39	0.42210000000000003
Knights Hunt	2018-03-20	14	40	61	75	0.4219
Sign Here: _________	2018-05-03	4	7	12	16	0.4218
Gotcha Racing 2nd	2018-07-18	9	7	12	21	0.4218
Moonfall Ultimate	2018-09-04	6	7	12	18	0.4218
Professor Watts Memory Match: Yummy Cupcakes	2018-08-13	2	7	12	14	0.4218
The End	2018-07-24	5	29	45	50	0.4214
Jumpdrive	2018-01-18	28	65	98	126	0.42060000000000003
Hard Helmets	2018-07-17	5	5	9	14	0.4204
Mafia Gambling	2018-03-11	3	5	9	12	0.4204
War of Criminals	2018-03-16	7	5	9	16	0.4204
Farm Quest	2018-04-03	4	5	9	13	0.4204
FlickSync - Mad Hatter VR	2018-03-30	7	5	9	16	0.4204
TheShooterGame	2018-05-03	2	5	9	11	0.4204
Recursive Dragon	2018-06-21	2	5	9	11	0.4204
Biodigital	2018-09-24	7	5	9	16	0.4204
Fairy Tower Defense	2018-09-11	3	5	9	12	0.4204
7-minute HOP	2018-11-09	2	5	9	11	0.4204
Nights at the Clown Maze	2018-11-17	2	5	9	11	0.4204
DEAD DOZEN	2018-06-19	81	238	348	429	0.41990000000000005
Dark Ghost RPG	2018-04-17	2	16	26	28	0.4193
A Walk in the Woods	2018-05-01	32	214	315	347	0.419
Rockfest	2018-02-13	35	12	20	55	0.4186
Land of Puzzles: Castles	2018-08-15	3	12	20	23	0.4186
The Front of Greed	2018-08-16	92	10	17	109	0.4179
Gym Simulator	2018-11-17	165	170	254	419	0.41700000000000004
Avenging Angel	2018-06-15	39	21	34	73	0.41700000000000004
Strid	2018-10-26	15	8	14	29	0.4167
Adventures of Hendri	2018-03-07	2	8	14	16	0.4167
Heroes Arena	2018-07-27	4	8	14	18	0.4167
The Warrior Of Treasures 2: Skull Hunter	2018-09-17	2	8	14	16	0.4167
King of Crowns Chess Online	2018-03-27	1262	3	6	1268	0.4167
Bad Government	2018-02-16	4	3	6	10	0.4167
Batch 17	2018-01-27	7	3	6	13	0.4167
Looney Rally	2018-02-17	3	3	6	9	0.4167
SmartBoy	2018-02-20	2	3	6	8	0.4167
The Unknown City (Horror Begins Now.....Episode 1)	2018-07-06	4	3	6	10	0.4167
Adventure in Kana Village	2018-05-27	2	3	6	8	0.4167
Yoga Lesson VR	2018-08-01	4	3	6	10	0.4167
GoFetch	2018-08-09	3	3	6	9	0.4167
BBlocks	2018-12-01	2	3	6	8	0.4167
Aspect	2018-12-04	2	3	6	8	0.4167
Draft Day Sports: Pro Basketball 2019	2018-11-13	18	3	6	24	0.4167
Darts and Friends	2018-04-10	8	17	28	36	0.4164
Arena of Cube	2018-07-26	22	17	28	50	0.4164
Boons Farm	2018-08-16	3	17	28	31	0.4164
Idle Kingdom Builder	2018-11-05	70	40	63	133	0.41590000000000005
Purgatory II	2018-02-28	27211	15	25	27236	0.41590000000000005
Potatoe	2018-02-13	3	15	25	28	0.41590000000000005
Craft and Dungeon	2018-04-03	48	15	25	73	0.41590000000000005
Dungeons of the dead	2018-04-12	7	24	39	46	0.41500000000000004
The Frontier Outskirts VR	2018-05-14	5	6	11	16	0.41450000000000004
Galaxy Race	2018-03-01	5	6	11	16	0.41450000000000004
Mortal Royale	2018-12-17	213	99	153	366	0.4131
I saw IT	2018-03-11	2	16	27	29	0.413
Oil Baron	2018-09-20	5	16	27	32	0.413
Clicker: Mining Simulator	2018-01-18	17	65	102	119	0.4129
THE ARCHER: Dead Hunt	2018-02-07	2	9	16	18	0.41250000000000003
SMASH IT	2018-06-20	2	9	16	18	0.41250000000000003
Ambition	2018-09-06	6	9	16	22	0.41250000000000003
Run'N'Get	2018-11-12	2	9	16	18	0.41250000000000003
ZombieThon	2018-05-19	33	14	24	57	0.4121
City Escaper	2018-04-20	4	14	24	28	0.4121
Again?	2018-08-08	2	21	35	37	0.41200000000000003
Abandoned	2018-12-29	8	30	49	57	0.4119
Rapture Rejects	2018-11-29	962	702	1049	2011	0.4114
Sure Footing	2018-03-30	36	12	21	57	0.4108
Full-On Paintball	2018-03-13	5	12	21	26	0.4108
AI Dummy	2018-12-31	2	24	40	42	0.4106
Norilsk	2018-04-27	2	4	8	10	0.4103
Wrestlers Without Boundaries	2018-05-30	2	4	8	10	0.4103
AmazeD 3D	2018-07-14	2	4	8	10	0.4103
Monopolist: Technological Revolution	2018-07-27	2	4	8	10	0.4103
Strike Cars	2018-09-06	2	4	8	10	0.4103
Wrath of the Goliaths: Dinosaurs	2018-09-14	3	7	13	16	0.41000000000000003
Fesnia	2018-07-02	3	7	13	16	0.41000000000000003
Siberian Dawn	2018-09-20	5	7	13	18	0.41000000000000003
Mad Hunting Simulator VR	2018-12-30	3	7	13	16	0.41000000000000003
The Works of Mercy	2018-09-26	75	84	133	208	0.4094
烈焰战纪	2018-10-01	85	15	26	111	0.4094
Motorbike Garage Mechanic Simulator	2018-03-14	18	20	34	52	0.4092
X-MiGuFighters: Stripper Anya	2018-03-01	5	10	18	23	0.409
Demolition Engineer	2018-05-11	3	10	18	21	0.409
Girlfriend Cards	2018-09-20	4	10	18	22	0.409
My Riding Stables: Your Horse breeding	2018-11-16	6	10	18	24	0.409
Veritex	2018-03-15	121	55	89	210	0.4083
Sphaera	2018-06-26	3	18	31	34	0.4082
Order No. 227: Not one step back!	2018-07-03	13	28	47	60	0.40770000000000006
Tennis World Tour	2018-06-12	295	263	408	703	0.4072
Export Simulator	2018-07-06	14	16	28	42	0.40700000000000003
Lords of Kingdoms	2018-06-16	197	24	41	238	0.40630000000000005
Ghost Platoon	2018-05-24	11	8	15	26	0.40630000000000005
Crashbots	2018-10-09	4	8	15	19	0.40630000000000005
Welcome To The Dreamscape	2018-06-28	3	8	15	18	0.40630000000000005
Sacrament	2018-03-09	153	11	20	173	0.406
❂ Hexaluga ❂ Weapon and Shield ☯ 	2018-05-14	5	11	20	25	0.406
Puzzle Monarch: Super Natural	2018-08-21	4	11	20	24	0.406
Emberdoom VR	2018-07-29	1	0	1	2	0.4058
ESCAPE FROM VOYNA: Dead Forest	2018-12-20	1	0	1	2	0.4058
Mountaineer	2018-07-11	1	0	1	2	0.4058
Hamlet	2018-10-26	1	0	1	2	0.4058
Lost Connection	2018-11-06	1	0	1	2	0.4058
Martha Madison: Forces	2018-02-08	1	0	1	2	0.4058
Martha Madison: Simple Machines Volume 1	2018-02-08	2	0	1	3	0.4058
FARIA: Spiritbird	2018-03-13	3	0	1	4	0.4058
Eggcellent VR	2018-12-26	2	0	1	3	0.4058
star of lemutia	2018-01-05	1	0	1	2	0.4058
Kunoichi Rush	2018-02-02	1	0	1	2	0.4058
Asteroid Girl	2018-02-05	2	0	1	3	0.4058
Thrushbriar Hall	2018-10-26	2	0	1	3	0.4058
Daydream	2018-12-26	1	0	1	2	0.4058
Gambit Heart	2018-06-15	2	0	1	3	0.4058
FormFish	2018-01-14	1	0	1	2	0.4058
The Short Story of a Drifting Labyrinth	2018-02-26	1	0	1	2	0.4058
Zero Gravity Pool	2018-01-19	1	0	1	2	0.4058
Cute War：Zero 萌系战争：零	2018-02-22	1	0	1	2	0.4058
StretchingVr	2018-04-27	1	0	1	2	0.4058
For Food Sake! VR	2018-03-01	2	0	1	3	0.4058
WWⅡ英雄列伝 泥の中の虎　オットー・カリウス	2018-02-09	2	0	1	3	0.4058
光明大陆	2018-03-23	72	0	1	73	0.4058
100 Seconds	2018-03-12	2	0	1	3	0.4058
Lair of the Titans	2018-03-17	2	0	1	3	0.4058
Mad Zombie	2018-02-24	1	0	1	2	0.4058
Virtual Ninja VR	2018-07-17	5	0	1	6	0.4058
Retro Rocket Robot	2018-04-19	1	0	1	2	0.4058
Uncanny	2018-07-31	1	0	1	2	0.4058
Torimodosu	2018-03-22	1	0	1	2	0.4058
Skyscraper Climb VR	2018-03-19	1	0	1	2	0.4058
Ben 10 VR	2018-03-30	1	0	1	2	0.4058
Cyber Escape	2018-03-30	1	0	1	2	0.4058
Planet Assault	2018-03-23	1	0	1	2	0.4058
Questlike	2018-03-29	1	0	1	2	0.4058
Night of the Shrub Part 1	2018-04-03	1	0	1	2	0.4058
Production Sound	2018-03-20	1	0	1	2	0.4058
Draoi	2018-09-27	3	0	1	4	0.4058
Alien Invasion 3d	2018-03-22	1	0	1	2	0.4058
Gummy Goo Clean Up	2018-04-20	2	0	1	3	0.4058
Battle of cubes	2018-03-28	1	0	1	2	0.4058
INFINITY CHALLENGE	2018-06-05	1	0	1	2	0.4058
Rounders (Arena)	2018-09-27	1	0	1	2	0.4058
GL1TCH	2018-03-28	2	0	1	3	0.4058
METAL	2018-03-30	1	0	1	2	0.4058
Mervin and the Wicked Station	2018-04-07	2	0	1	3	0.4058
Hovercraft Drive	2018-04-06	1	0	1	2	0.4058
Slamdunk VR	2018-04-23	2	0	1	3	0.4058
Dungeon Adventure	2018-06-20	2	0	1	3	0.4058
Beginner'sGame	2018-05-06	2	0	1	3	0.4058
Escape Code - Coding Adventure	2018-05-03	1	0	1	2	0.4058
BOXiGON!	2018-10-01	1	0	1	2	0.4058
Jungle Juggle	2018-05-28	1	0	1	2	0.4058
Block Smashers	2018-05-10	3	0	1	4	0.4058
LifeGameSimulator	2018-06-01	1	0	1	2	0.4058
Aurum Kings	2018-07-24	1	0	1	2	0.4058
Journey of the Fox	2018-08-17	1	0	1	2	0.4058
Free the Animation	2018-06-08	1	0	1	2	0.4058
Journey To Valhalla	2018-09-10	1	0	1	2	0.4058
Paper Shakespeare: Stick Julius Caesar (with a dagger)	2018-09-19	1	0	1	2	0.4058
Survival	2018-12-04	1	0	1	2	0.4058
Double Head Shark Attack	2018-10-19	2	0	1	3	0.4058
Bomb-Bomb	2018-05-17	1	0	1	2	0.4058
The General Retreats	2018-05-30	1	0	1	2	0.4058
Science:The world is in your hands	2018-06-23	1	0	1	2	0.4058
Sea of Lies: Tide of Treachery Collector's Edition	2018-06-15	2	0	1	3	0.4058
Survival Diary	2018-07-20	1	0	1	2	0.4058
Heart'n Block	2018-08-24	2	0	1	3	0.4058
Brainstorm	2018-09-14	4	0	1	5	0.4058
Asteroid RKD	2018-12-18	1	0	1	2	0.4058
Night of the Shrub Part 2	2018-07-18	1	0	1	2	0.4058
Magical girl's labyrinth	2018-08-11	1	0	1	2	0.4058
Summer: Jigsaw Puzzles	2018-07-17	2	0	1	3	0.4058
Open Space 2D	2018-07-06	1	0	1	2	0.4058
MYSTERY HOUSE : SECRET STEALTH	2018-07-19	2	0	1	3	0.4058
Save Them	2018-08-08	1	0	1	2	0.4058
ulxrd	2018-08-02	1	0	1	2	0.4058
Merlin Soccer	2018-08-03	1	0	1	2	0.4058
The Asteroid Belt's Trial	2018-08-30	1	0	1	2	0.4058
GALAXY TOP WING	2018-09-01	1	0	1	2	0.4058
Dystopia	2018-08-17	3	0	1	4	0.4058
From Darkness	2018-12-21	1	0	1	2	0.4058
Safe	2018-11-02	2	0	1	3	0.4058
O2Jam x DancingParty	2018-09-02	1	0	1	2	0.4058
Lifespan 5seconds	2018-09-06	2	0	1	3	0.4058
The Bloobles and the Quest for Chocolate	2018-09-07	2	0	1	3	0.4058
Extreme Painting Puzzle	2018-10-12	2	0	1	3	0.4058
Cubanoids	2018-10-22	2	0	1	3	0.4058
Red Beard Labyrinth	2018-10-25	2	0	1	3	0.4058
Rand-O-mazE	2018-10-25	2	0	1	3	0.4058
Charlie's Conscious	2018-10-22	1	0	1	2	0.4058
无敌荒野\Unbeatable Wilderness	2018-11-05	1	0	1	2	0.4058
BATTLE X Arcade	2018-10-25	7	0	1	8	0.4058
梦缚	2018-11-06	2	0	1	3	0.4058
Toy Road Constructor	2018-11-23	2	0	1	3	0.4058
Cubic Factory	2018-11-23	3	0	1	4	0.4058
MagicJam	2018-12-21	1	0	1	2	0.4058
The Last Sphinx ARG	2018-11-12	2	0	1	3	0.4058
Mutland	2018-12-21	1	0	1	2	0.4058
JumpoPitec	2018-12-03	1	0	1	2	0.4058
Whale Island	2018-12-07	1	0	1	2	0.4058
Koboomballs	2018-12-01	1	0	1	2	0.4058
Powerless	2018-12-18	2	0	1	3	0.4058
Esc: From Planet	2018-12-20	1	0	1	2	0.4058
Desktop Soccer	2018-12-28	3	0	1	4	0.4058
cell	2018-02-20	3	5	10	13	0.4057
Turtle Lu	2018-03-22	2	5	10	12	0.4057
Secret of Harrow Manor	2018-04-24	3	5	10	13	0.4057
Criminal Pursuit Force	2018-10-08	3	5	10	13	0.4057
American Patriots: The Swamp Fox	2018-10-31	3	5	10	13	0.4057
Space Simulator	2018-02-26	43	56	92	135	0.4053
Crows - 乌鸦	2018-10-26	7	20	35	42	0.4042
Viking's drakkars	2018-03-30	7	38	64	71	0.40409999999999996
Fruit for the Village	2018-05-22	2	1	3	5	0.40399999999999997
SlipDrive	2018-08-17	1	1	3	4	0.40399999999999997
Primal Lands	2018-09-11	2	1	3	5	0.40399999999999997
Comit the Astrodian 3	2018-01-02	1	1	3	4	0.40399999999999997
World Circuit Boxing	2018-01-06	3	1	3	6	0.40399999999999997
Hover X Souls: Git Gud Edition	2018-04-30	4	1	3	7	0.40399999999999997
Traffic Cop	2018-05-28	2	1	3	5	0.40399999999999997
Battle for Mountain Throne	2018-09-04	2	1	3	5	0.40399999999999997
Math RTS	2018-01-09	2	1	3	5	0.40399999999999997
FreeFlight	2018-04-02	2	1	3	5	0.40399999999999997
7 Soccer: a sci-fi soccer tale	2018-02-14	2	1	3	5	0.40399999999999997
斗地主VR	2018-03-10	2	1	3	5	0.40399999999999997
The Next Day After Friday	2018-03-29	1	1	3	4	0.40399999999999997
Touch the devil VR(おさわり魔王VR)	2018-03-26	2	1	3	5	0.40399999999999997
Type	2018-04-04	2	1	3	5	0.40399999999999997
Mr Rabbit's Memory	2018-05-29	2	1	3	5	0.40399999999999997
Rapid	2018-05-13	2	1	3	5	0.40399999999999997
Paper Shakespeare: Loves Labor(s) Lost	2018-07-05	1	1	3	4	0.40399999999999997
Footy Ball Tournament 2018	2018-06-14	2	1	3	5	0.40399999999999997
Red Rose Rising	2018-06-05	2	1	3	5	0.40399999999999997
Mazes and Mages	2018-06-15	1	1	3	4	0.40399999999999997
SPECKLE: Chill Puzzle Game	2018-06-13	2	1	3	5	0.40399999999999997
UniteStar	2018-07-02	1	1	3	4	0.40399999999999997
Noble Armada: Lost Worlds	2018-09-13	4	1	3	7	0.40399999999999997
RGBCELLS	2018-07-26	2	1	3	5	0.40399999999999997
On Board Remastered	2018-10-04	1	1	3	4	0.40399999999999997
Meteor	2018-09-08	2	1	3	5	0.40399999999999997
Tempo Wizard	2018-08-20	3	1	3	6	0.40399999999999997
The Secret of Puffin Cove	2018-12-10	3	1	3	6	0.40399999999999997
A Top-Down Job: Blood Gain	2018-09-25	2	1	3	5	0.40399999999999997
Terror for Two	2018-10-10	2	1	3	5	0.40399999999999997
Mini Golf Buddies	2018-12-18	3	1	3	6	0.40399999999999997
Lost On The Island	2018-12-07	1	1	3	4	0.40399999999999997
PixNautiCraft	2018-11-17	3	1	3	6	0.40399999999999997
PomboTroll	2018-12-07	3	1	3	6	0.40399999999999997
Gems Kingdom	2018-11-12	2	1	3	5	0.40399999999999997
Girls and Tests	2018-11-23	2	1	3	5	0.40399999999999997
DATAFLOW	2018-12-10	1	1	3	4	0.40399999999999997
JOBU-KI	2018-12-19	1	1	3	4	0.40399999999999997
Inaccessible world	2018-02-15	4	23	40	44	0.4037
Prodigy Tactics	2018-09-28	19	75	123	142	0.40340000000000004
Ninja jump	2018-02-28	6	12	22	28	0.40340000000000004
World of Feudal	2018-06-16	10	15	27	37	0.4032
Don't Pray To Satan	2018-04-20	6	9	17	23	0.4032
Mogic	2018-04-03	5	9	17	22	0.4032
The Monk and the Warrior. The Heart of the King.	2018-03-02	6	18	32	38	0.4029
Professor Watts Memory Match: Puppies	2018-09-18	2	6	12	14	0.402
Bitcoin	2018-11-13	43	53	89	132	0.4017
STALINGRAD ABATIS	2018-09-21	3	10	19	22	0.4006
Typical Nightmare	2018-08-21	9	39	67	76	0.40030000000000004
Mimic Hunter	2018-01-23	2	2	5	7	0.40030000000000004
3571 The Game	2018-01-02	4	2	5	9	0.40030000000000004
Monstrous	2018-05-16	8	2	5	13	0.40030000000000004
Legend of Long Night	2018-04-17	6	2	5	11	0.40030000000000004
One Night On The Road	2018-01-23	3	2	5	8	0.40030000000000004
Super Goribei	2018-02-14	1	2	5	6	0.40030000000000004
Bomb Labyrinth	2018-04-29	2	2	5	7	0.40030000000000004
Kara's Darkness Chapter 1	2018-06-05	2	2	5	7	0.40030000000000004
Space Armor 2	2018-05-24	3	2	5	8	0.40030000000000004
Balloon Strike	2018-05-18	2	2	5	7	0.40030000000000004
荒野寻踪	2018-06-01	3	2	5	8	0.40030000000000004
Shooter Game	2018-09-14	4	2	5	9	0.40030000000000004
Starfield Wars	2018-07-05	2	2	5	7	0.40030000000000004
Dangerous Skies 80's edition	2018-07-23	2	2	5	7	0.40030000000000004
Cyclones Playground	2018-08-30	1	2	5	6	0.40030000000000004
Steampunk Graveyard	2018-10-26	2	2	5	7	0.40030000000000004
Edge	2018-11-03	2	2	5	7	0.40030000000000004
Zero spring episode 2	2018-11-29	1	2	5	6	0.40030000000000004
Galactic Battles	2018-01-31	6	40	69	75	0.3993
Restaurant Manager	2018-04-24	2	7	14	16	0.39909999999999995
The Hero Project: Open Season	2018-04-05	36	7	14	50	0.39909999999999995
Dark Matter	2018-05-04	4	7	14	18	0.39909999999999995
王者战车	2018-12-24	11	7	14	25	0.39909999999999995
PlayUSA	2018-03-20	5	14	26	31	0.399
S.T.R.E.T.C.H.	2018-05-18	3	11	21	24	0.3983
Puzzle Monarch: Mummy	2018-09-15	2	11	21	23	0.3983
GM Forge - Virtual Tabletop	2018-05-31	35	30	53	88	0.39799999999999996
Click&Fight	2018-02-20	8	15	28	36	0.3972
Endless Crusade	2018-05-04	3	3	7	10	0.3972
Jerry and the mystery loot box	2018-02-01	1	3	7	8	0.3972
Apocalypse Rider	2018-08-23	2	3	7	9	0.3972
OboStar	2018-05-01	2	3	7	9	0.3972
Jade's Dungeon Descent	2018-07-06	2	3	7	9	0.3972
Wolf: The Evolution Story	2018-08-22	9	3	7	16	0.3972
CUBE 332	2018-09-28	1	3	7	8	0.3972
Zombie Soldier	2018-10-25	2	3	7	9	0.3972
Death Collector	2018-12-06	14	3	7	21	0.3972
Aquarium Sandbox	2018-12-14	3	3	7	10	0.3972
Club Lighting	2018-12-07	3	3	7	10	0.3972
ZDF History 360° – Tempelhof	2018-12-08	6	3	7	13	0.3972
Seek Love	2018-11-21	25	8	16	41	0.39659999999999995
NBA 2K19	2018-09-11	29202	8937	13937	43139	0.396
A Handful of Keflings	2018-01-25	6	4	9	15	0.3946
Mind Trap	2018-06-18	3	4	9	12	0.3946
Acucalypse	2018-04-26	3	4	9	12	0.3946
Shadow: Treachery cannot be tolerated	2018-03-05	2	4	9	11	0.3946
Bloody and cruel story of toys	2018-03-07	2	4	9	11	0.3946
The President	2018-05-07	7	4	9	16	0.3946
Battleground Shooting Training	2018-06-22	13	4	9	22	0.3946
Draft Day Sports: Pro Golf	2018-07-24	8	4	9	17	0.3946
Zombie	2018-07-25	2	4	9	11	0.3946
悪梦er-mo	2018-08-22	9	4	9	18	0.3946
秋叶|Autumn leaves	2018-09-29	2	13	25	27	0.3945
MegaRace 3	2018-01-10	2	9	18	20	0.3945
Christmas Santa Troubles	2018-04-25	3	9	18	21	0.3945
Forest Harvester Simulator	2018-03-19	3	9	18	21	0.3945
Chess Puzzles	2018-06-20	6	9	18	24	0.3945
Hungry Shadows	2018-08-12	3	9	18	21	0.3945
EreaDrone 2018	2018-07-17	13	17	32	45	0.39409999999999995
Kinaman vs Gray Elephant	2018-05-10	9	14	27	36	0.3929
Night Fly	2018-01-24	3	18	34	37	0.39270000000000005
Aquarium Simulator	2018-06-21	6	18	34	40	0.39270000000000005
♛ GAME TUBE ♛	2018-05-15	2	10	20	22	0.3926
Build Bridges	2018-03-11	3	5	11	14	0.3924
Mermaid Land	2018-03-16	3	5	11	14	0.3924
Doodle God: Genesis Secrets	2018-05-10	5	5	11	16	0.3924
Deep Dark Labyrinth	2018-06-21	3	5	11	14	0.3924
Leviathan	2018-07-02	1	5	11	12	0.3924
Ritter	2018-08-12	3	5	11	14	0.3924
The War of the Worlds: Andromeda	2018-10-12	2	5	11	13	0.3924
Heavy Dreams	2018-09-01	251	64	113	364	0.3907
Frontline Heroes VR	2018-06-29	3	6	13	16	0.39049999999999996
Until None Remain VR	2018-01-18	22	6	13	35	0.39049999999999996
In The Long Run The Game	2018-07-02	3	6	13	16	0.39049999999999996
景行 | Encourage	2018-12-20	2	6	13	15	0.39049999999999996
Gloom	2018-10-31	37	59	105	142	0.3899
In memory of TITAN	2018-06-02	5	12	24	29	0.3895
Cube XL	2018-03-12	7	7	15	22	0.3889
Apocalypse: The Game	2018-10-18	3	7	15	18	0.3889
Club Dance Party VR	2018-06-07	4	7	15	19	0.3889
Airplane Sky Voyage	2018-06-01	3	7	15	18	0.3889
Treasures of the Ancients: Egypt	2018-06-06	9	55	99	108	0.3884
Planetes	2018-08-28	6	8	17	23	0.3875
Imperatum	2018-07-16	5	8	17	22	0.3875
Shining Hotel: Lost in Nowhere	2018-06-05	3	8	17	20	0.3875
Roarr! Jurassic Edition	2018-11-07	12	61	110	122	0.3871
Annual	2018-07-05	11	14	28	39	0.3871
Great Hunt: North America	2018-03-12	8	14	28	36	0.3871
Balloon	2018-02-07	2	9	19	21	0.3862
Kings	2018-11-02	5	9	19	24	0.3862
Puzzle Monarch: Zombie	2018-08-23	3	9	19	22	0.3862
Civil Warfare: Another Bullet In The War	2018-01-20	21	45	83	104	0.3859
Story: Heaven & Hell	2018-09-06	5	30	57	62	0.3851
Girlfriend Experience VR	2018-09-25	8	10	21	29	0.3851
Puzzle Monarch: Egypt	2018-09-20	6	10	21	27	0.3851
Death Space	2018-11-06	1	10	21	22	0.3851
Frog Demon	2018-12-11	4	11	23	27	0.384
Bless Online	2018-10-23	34392	3755	6271	40663	0.3824
DarkLast	2018-02-15	3	13	27	30	0.3822
Color Party	2018-07-25	13	13	27	40	0.3822
The Last One	2018-01-22	50	46	87	137	0.3811
Frank the Miner	2018-03-02	3	21	42	45	0.381
Cave Brawlers	2018-01-15	2	4	10	12	0.3805
Flurius	2018-04-24	2	4	10	12	0.3805
Under The War	2018-06-20	12	4	10	22	0.3805
Full Metal Renegade	2018-08-06	9	4	10	19	0.3805
GIRLS VR	2018-09-29	3	4	10	13	0.3805
Station 21 - Space Station Simulator	2018-02-16	4	5	12	16	0.3804
Battle For Korsun	2018-10-27	5	5	12	17	0.3804
Grim Town: Battle Tales 	2018-03-21	3	5	12	15	0.3804
Meme Machine	2018-06-22	5	5	12	17	0.3804
Aiso	2018-01-05	2	3	8	10	0.3803
Kamikazo VR	2018-01-12	2	3	8	10	0.3803
All Stars Racing Cup	2018-02-01	5	3	8	13	0.3803
Block'hood VR	2018-04-19	4	3	8	12	0.3803
Freedom March: Rebel Leader	2018-04-28	1	3	8	9	0.3803
Great Mountain Experience	2018-06-01	2	3	8	10	0.3803
Gaze At Maze	2018-07-13	2	3	8	10	0.3803
Gallows Choice	2018-08-31	3	3	8	11	0.3803
Skywriter	2018-08-24	3	3	8	11	0.3803
Ensign-1	2018-04-23	3	6	14	17	0.38
❂ Hexaluga ❂ Dungeons and Hunting ☠	2018-05-22	2	6	14	16	0.38
Good Morning	2018-03-12	4	7	16	20	0.37950000000000006
Redline Ultimate Racing	2018-02-14	6	7	16	22	0.37950000000000006
Super Kids Racing	2018-03-01	4	7	16	20	0.37950000000000006
ASSASSINATION BOX	2018-01-22	1597	46	88	1685	0.3791
Halloween Girl	2018-11-26	10	30	59	69	0.3791
Country Park	2018-07-23	4	24	48	52	0.3791
OutBreak Zombie	2018-02-07	3	2	6	9	0.379
Road Legends	2018-03-21	2	2	6	8	0.379
Seasonal Soccer	2018-03-20	1	2	6	7	0.379
Blind Mind	2018-04-19	2	2	6	8	0.379
Iron Ground	2018-06-21	4	2	6	10	0.379
CSI VR Crime Scene Investigation	2018-09-05	4	2	6	10	0.379
King of my Castle VR	2018-08-24	2	2	6	8	0.379
A.D.K.	2018-11-23	2	2	6	8	0.379
Quantum Retribution	2018-11-09	3	2	6	9	0.379
Turn the mirror, please.	2018-12-01	2	2	6	8	0.379
Achievement Collector: Cat	2018-09-06	5	18	37	42	0.3787
gRally	2018-05-21	125	31	61	186	0.3786
★ Fallalypse ★ Death or Cress ♝	2018-02-06	2	9	20	22	0.3785
Square Head Zombies	2018-03-23	5	32	63	68	0.37810000000000005
Past Cure	2018-02-23	25	19	39	64	0.37810000000000005
Intelligence Trader	2018-08-03	9	19	39	48	0.37810000000000005
Parkour Simulator	2018-03-22	4	10	22	26	0.3779
Loot Box Simulator 20!8	2018-01-30	3	28	56	59	0.3771
Wormhole City	2018-12-31	382	12	26	408	0.3769
MineDrill Redux	2018-11-25	2	1	4	6	0.3749
Cube Defender 2000	2018-10-18	1	1	4	5	0.3749
TAD: That Alien Dude	2018-06-15	2	1	4	6	0.3749
Salsa Virtual	2018-11-09	2	1	4	6	0.3749
Beer Pong VR	2018-03-03	2	1	4	6	0.3749
Starboy	2018-04-27	1	1	4	5	0.3749
SOLAR BATTALION	2018-05-04	2	1	4	6	0.3749
Margot's Word Brain	2018-04-05	2	1	4	6	0.3749
Codename Ghost Hunt	2018-09-02	2	1	4	6	0.3749
ARENA 8	2018-05-16	1	1	4	5	0.3749
Balance of Soccer	2018-12-12	2	1	4	6	0.3749
Dark Days of Horror	2018-06-04	1	1	4	5	0.3749
Magic Flight Academy	2018-06-13	7	1	4	11	0.3749
Absolute VR Experiences	2018-09-05	2	1	4	6	0.3749
Crescent Hollow	2018-07-10	4	1	4	8	0.3749
The Life's Lane	2018-07-16	2	1	4	6	0.3749
Unbroken Warrior	2018-06-22	1	1	4	5	0.3749
Project 59	2018-07-19	2	1	4	6	0.3749
The Occluder	2018-11-16	2	1	4	6	0.3749
Garrison Gauntlet	2018-08-17	2	1	4	6	0.3749
街头英雄 Street Heroes	2018-09-10	3	1	4	7	0.3749
Bikini Heaven	2018-09-29	3	1	4	7	0.3749
Color Guardian	2018-10-05	2	1	4	6	0.3749
Chronon	2018-10-02	2	1	4	6	0.3749
Wonderland Trails	2018-12-19	2	1	4	6	0.3749
Xenochamber	2018-11-16	1	1	4	5	0.3749
The Quiet Man	2018-11-01	127	203	372	499	0.3747
BlackShot Revolution	2018-08-22	97	113	212	309	0.3744
Cube - The Jumper	2018-05-15	8	60	116	124	0.3744
Black_Faith.	2018-07-04	99	142	265	364	0.3736
Welcome Back Daddy	2018-05-10	10	30	61	71	0.37329999999999997
DAISENRYAKU PERFECT 4.0	2018-10-02	30	32	65	95	0.37270000000000003
Rail World	2018-11-29	68	34	69	137	0.37210000000000004
Wrath of Anna	2018-04-03	1149	79	153	1302	0.3714
Duder	2018-03-13	3	9	21	24	0.3711
Chronicles of Mystery - The Legend of the Sacred Treasure	2018-07-13	5	12	27	32	0.371
Infernales: Circles of Hell	2018-03-16	2	8	19	21	0.371
Professor Watts Word Search: Space Voyage	2018-06-25	3	8	19	22	0.371
Shards of Eradine	2018-03-12	11	7	17	28	0.37070000000000003
REVENGER: Age of Morons	2018-03-26	1	6	15	16	0.37020000000000003
Monsters Attack	2018-03-18	3	6	15	18	0.37020000000000003
Ghoststory	2018-06-21	5	6	15	20	0.37020000000000003
HUNTING SIMULATOR VR	2018-12-15	4	6	15	19	0.37020000000000003
The Prison Experiment	2018-06-01	12	32	66	78	0.37
Stunt Hill	2018-03-25	4	18	39	43	0.37
Wildlife Park Gold Reloaded	2018-02-02	10	5	13	23	0.3694
Mystical	2018-02-08	4	5	13	17	0.3694
Behind The Beyond	2018-12-15	2	5	13	15	0.3694
Survive: The king killer	2018-02-20	2	5	13	15	0.3694
Granny's Grantastic Granventure	2018-07-30	2	5	13	15	0.3694
Creatio Ex Nihilo: Aition	2018-02-05	2	4	11	13	0.3679
Christmas Tale - Visual Novel	2018-01-02	3	4	11	14	0.3679
SecretLaboratory	2018-03-27	2	4	11	13	0.3679
ZombieHunterZ	2018-05-25	1	4	11	12	0.3679
Daytona Racing	2018-08-08	3	4	11	14	0.3679
Shoemaker	2018-10-15	3	4	11	14	0.3679
Double Stretch	2018-08-20	2	4	11	13	0.3679
Farm Business	2018-11-23	3	4	11	14	0.3679
Underworld Ascendant	2018-11-15	622	353	661	1283	0.36700000000000005
DEATH FIELD: The Battle Royale of Disaster	2018-05-03	137	60	121	258	0.3667
I'm Lost	2018-03-07	4	19	42	46	0.36590000000000006
"Object ""Cleaning"""	2018-02-01	15	18	40	55	0.36590000000000006
THE LAST HUNT	2018-02-22	11	3	9	20	0.3655
DDS (D.I.Y Drone Simulator) Demo	2018-03-19	3	3	9	12	0.3655
Hard Work	2018-07-20	4	3	9	13	0.3655
Business Tycoon Billionaire	2018-07-05	8	3	9	17	0.3655
Falling Blocks	2018-07-13	2	3	9	11	0.3655
A.D.M(Angels,Demons And Men)	2018-08-15	2	3	9	11	0.3655
Football Director 2019	2018-12-14	4	3	9	13	0.3655
Exiled to the Void	2018-12-20	5	3	9	14	0.3655
Telekinetic	2018-12-17	2	3	9	11	0.3655
Fantastic Beasts and Where to Find Them	2018-01-23	8	9	22	30	0.3642
Mahjong Classic	2018-03-12	4	7	18	22	0.3625
江湖侠客行	2018-05-05	11	7	18	29	0.3625
Tinkr Garage	2018-10-09	11	17	39	50	0.3617
Longboard Stunts and Tricks	2018-04-29	3	6	16	19	0.36119999999999997
Knight Fighter	2018-04-24	2	6	16	18	0.36119999999999997
John:Condemned	2018-10-31	2	6	16	18	0.36119999999999997
Orn the tiny forest sprite	2018-12-24	4	2	7	11	0.3611
Dumb Stone	2018-11-05	5	2	7	12	0.3611
JungleShoot	2018-05-17	2	2	7	9	0.3611
Adult Toy Store	2018-12-12	6	2	7	13	0.3611
Black Home 2	2018-04-26	3	2	7	10	0.3611
Ashes of the Ark	2018-06-27	2	2	7	9	0.3611
Fort	2018-08-09	2	2	7	9	0.3611
The Seven Chambers	2018-12-04	3	2	7	10	0.3611
Yuzi Lims: anime runner	2018-01-22	5	27	60	65	0.35960000000000003
Haters, kill them all!	2018-02-22	3	11	27	30	0.3594
Planum	2018-04-18	2	11	27	29	0.3594
Nazi Elimination	2018-01-17	2	5	14	16	0.3593
Dusk Of Confinement	2018-02-23	3	5	14	17	0.3593
Lost Artifacts: Soulstone	2018-12-22	8	5	14	22	0.3593
TublerVR	2018-10-29	1	0	2	3	0.3592
まぜっこタワー	2018-02-15	3	0	2	5	0.3592
War on Drugs VR	2018-08-13	2	0	2	4	0.3592
Chineze	2018-04-13	2	0	2	4	0.3592
Trireme Commander	2018-01-03	1	0	2	3	0.3592
Alien Revival	2018-07-21	2	0	2	4	0.3592
Little fight	2018-02-21	2	0	2	4	0.3592
Jambo	2018-01-24	1	0	2	3	0.3592
Twilight on Yulestead	2018-04-13	1	0	2	3	0.3592
Casino Poker	2018-02-23	2	0	2	4	0.3592
Jesters Poker	2018-03-05	2	0	2	4	0.3592
Castle Secrets: Between Day and Night	2018-03-07	11	0	2	13	0.3592
Nightmare Pop!	2018-04-05	2	0	2	4	0.3592
DESOLATE: Clone Catastrophe	2018-03-29	1	0	2	3	0.3592
Hykee - Episode 1: Underwater	2018-04-13	1	0	2	3	0.3592
Hokan: Monster Slayer	2018-07-26	1	0	2	3	0.3592
Sail Ships	2018-06-04	1	0	2	3	0.3592
Good Girl	2018-09-22	3	0	2	5	0.3592
Coach Bus Simulator Parking	2018-07-13	2	0	2	4	0.3592
Destruction Paper	2018-10-03	1	0	2	3	0.3592
Mars Troopers	2018-07-21	1	0	2	3	0.3592
Dinosaur Hunter VR	2018-08-30	1	0	2	3	0.3592
CaveDare	2018-10-29	1	0	2	3	0.3592
Lamp Man Down	2018-09-19	1	0	2	3	0.3592
Siege - Battle of Ashington	2018-10-01	1	0	2	3	0.3592
King Of Gods: Angel The Awakening Of A Demon	2018-10-31	1	0	2	3	0.3592
Spotter	2018-10-04	1	0	2	3	0.3592
Zoological Era	2018-10-17	1	0	2	3	0.3592
Zero spring episode 1 Japanese version	2018-10-24	1	0	2	3	0.3592
A Business Power	2018-12-03	1	0	2	3	0.3592
You are Never Alone	2018-11-27	2	0	2	4	0.3592
X Archetype	2018-12-04	1	0	2	3	0.3592
Otiiz's adventure - Sushi Champ	2018-12-18	2	0	2	4	0.3592
Witch The Bloodlines	2018-09-03	4	17	40	44	0.3577
Seas dogs	2018-05-23	70	104	214	284	0.3575
Zima uhodi!	2018-04-18	5	15	36	41	0.3568
Rampage Ragdoll	2018-01-10	2	4	12	14	0.3565
ORION	2018-03-30	1	4	12	13	0.3565
Longest Monday: Unveiling	2018-05-31	2	4	12	14	0.3565
AVATAR: Consolidate	2018-06-29	2	4	12	14	0.3565
The Colony	2018-11-28	5	4	12	17	0.3565
Tropical Escape	2018-02-15	7	8	21	28	0.3564
Hiking Simulator 2018	2018-12-31	5	8	21	26	0.3564
Nevsky Run	2018-10-09	3	8	21	24	0.3564
King and Assassins	2018-08-08	38	24	55	93	0.3563
Vogue, the Explorer	2018-07-14	2	7	19	21	0.35479999999999995
WAR_WAR_WAR: Smiles vs Ghosts	2018-08-27	3	7	19	22	0.35479999999999995
Precision Archery: Competitive	2018-02-07	3	11	28	31	0.35380000000000006
DYNASTY WARRIORS 9	2018-02-13	3586	3230	6173	9759	0.35350000000000004
Doodle God: Alchemy Jam	2018-01-26	6	23	54	60	0.3529
Flynn and Freckles	2018-09-07	3	3	10	13	0.35240000000000005
Downtown	2018-04-23	4	3	10	14	0.35240000000000005
Police Air Transporter	2018-07-05	3	3	10	13	0.35240000000000005
Driftpunk Racer	2018-08-30	3	3	10	13	0.35240000000000005
ICE AGENT	2018-10-09	3	3	10	13	0.35240000000000005
Clash of Magic VR	2018-03-20	3	1	5	8	0.3522
Alien Food Frenzy	2018-02-14	1	1	5	6	0.3522
My Beastly Lovers	2018-02-11	3	1	5	8	0.3522
Shadow of Something	2018-01-31	2	1	5	7	0.3522
Unknown Pain: Hardcore	2018-04-18	1	1	5	6	0.3522
Kaleido Chaos	2018-08-28	1	1	5	6	0.3522
Garage Master 2018	2018-07-11	3	1	5	8	0.3522
Exodus	2018-08-20	3	1	5	8	0.3522
Mimic	2018-08-25	4	1	5	9	0.3522
The Masked Mage	2018-10-13	3	1	5	8	0.3522
Rampage Online	2018-11-14	2	1	5	7	0.3522
My zero trip	2018-05-24	6	14	35	41	0.3517
Raceland	2018-01-06	9	68	148	157	0.3515
God Vs Zombies	2018-05-11	4	19	46	50	0.3511
Police Enforcement VR : 1-K-27	2018-06-08	13	89	192	205	0.3503
Hostage: Rescue Mission	2018-02-08	3	5	15	18	0.35000000000000003
BrainPower	2018-04-02	4	5	15	19	0.35000000000000003
Castle Rencounter	2018-11-09	3	5	15	18	0.35000000000000003
Spellrune: Realm of Portals	2018-09-21	27	12	31	58	0.3498
Curling World Cup	2018-05-08	4	8	22	26	0.3497
Prey: Typhon Hunter	2018-12-11	134	235	490	624	0.3483
Lightform	2018-02-20	4	7	20	24	0.34750000000000003
Delivery man simulator	2018-04-25	4	7	20	24	0.34750000000000003
Robot Chase	2018-08-01	3	14	36	39	0.34740000000000004
Castaway VR	2018-10-11	6	13	34	40	0.34630000000000005
Magic Tower 3D	2018-03-08	16	4	13	29	0.3462
李教授的知识问答	2018-07-27	2	4	13	15	0.3462
YEARN Tyrant's Conquest	2018-04-06	3	2	8	11	0.3458
Lunch Truck Tycoon 2	2018-02-20	6	2	8	14	0.3458
Proletarian Budget Survival	2018-02-10	7	2	8	15	0.3458
Obscurity	2018-05-04	2	2	8	10	0.3458
Beyond Minimalism	2018-06-18	2	2	8	10	0.3458
Colonization of the Moon	2018-11-14	4	2	8	12	0.3458
The Karters	2018-06-07	86	20	50	136	0.34509999999999996
Kamikaze Cube 2	2018-08-01	5	12	32	37	0.34500000000000003
Robot Fighting	2018-02-17	5	6	18	23	0.34490000000000004
🐰RabbiruN🐰	2018-03-27	3	6	18	21	0.34490000000000004
Hacker.exe	2018-09-15	12	6	18	30	0.34490000000000004
Zombow	2018-03-28	4	15	39	43	0.3443
Robots Attack On Vapeland	2018-04-04	4	5	16	20	0.34140000000000004
Circle Up	2018-06-19	3	7	21	24	0.3407
Helicopter Flight Simulator	2018-05-10	2	3	11	13	0.3407
Magic Chess	2018-06-20	3	3	11	14	0.3407
The Searcher Wild West Adventure	2018-07-12	6	3	11	17	0.3407
Total 15	2018-08-10	4	3	11	15	0.3407
Dawn of China: Rise of Qin	2018-09-28	5	9	26	31	0.3397
Extinction	2018-04-10	82	95	217	299	0.3392
150,000 B.C.	2018-05-30	39	123	279	318	0.3379
Psi Cards	2018-03-19	5	19	50	55	0.3379
Sniper Squad Mission	2018-04-29	3	6	19	22	0.3375
School Idol	2018-07-06	5	8	24	29	0.3373
Bitcoin VS Brain	2018-03-16	4	10	29	33	0.3367
Simple Sailing	2018-05-11	3	4	14	17	0.3367
HecatoncheirStory	2018-08-20	2	4	14	16	0.3367
Pixel Royale	2018-11-06	9	4	14	23	0.3367
RollingBall	2018-03-07	3	9	27	30	0.3343
Crypto Girl The Visual Novel	2018-03-21	2	7	22	24	0.3343
Xmas Zombie Rampage 2	2018-01-01	2	1	6	8	0.33380000000000004
Teeny Heist	2018-02-11	1	1	6	7	0.33380000000000004
Roanoke	2018-02-12	2	1	6	8	0.33380000000000004
Gingerbread Story	2018-03-22	4	1	6	10	0.33380000000000004
Moto Racing 3D	2018-04-03	4	1	6	10	0.33380000000000004
GameMaster: MAGUS	2018-05-25	6	1	6	12	0.33380000000000004
Zombie Rampage	2018-05-30	2	1	6	8	0.33380000000000004
Street Karate	2018-06-20	2	1	6	8	0.33380000000000004
Slabs	2018-06-21	2	1	6	8	0.33380000000000004
Epic Game Theory	2018-10-03	2	1	6	8	0.33380000000000004
Forest Plague	2018-10-05	2	1	6	8	0.33380000000000004
Corrupt The Priest	2018-12-14	2	1	6	8	0.33380000000000004
X-Town 3D game	2018-04-15	2	5	17	19	0.33340000000000003
Bounty Hunter: Ocean Diver	2018-04-10	2	5	17	19	0.33340000000000003
CryptoFarm	2018-09-14	5	5	17	22	0.33340000000000003
Steel Arena: Robot War	2018-03-19	2	2	9	11	0.33240000000000003
Zombie Lane Survival	2018-02-20	3	2	9	12	0.33240000000000003
Zack Y	2018-12-07	1	2	9	10	0.33240000000000003
Girls & sweets	2018-12-24	2	2	9	11	0.33240000000000003
Jurassic Safari Hunt	2018-05-25	3	6	20	23	0.3306
Hero Village Simulator	2018-02-22	21	3	12	33	0.33020000000000005
Abnormal world: season one	2018-04-19	2	3	12	14	0.33020000000000005
Dino Dawn	2018-05-11	3	11	33	36	0.3295
Roller Coaster Egypt VR	2018-03-21	4	0	3	7	0.32939999999999997
Nuke Babysitter Simulator | Kim Edition	2018-02-11	2	0	3	5	0.32939999999999997
Overlook: Local multiplayer game - up to 16 players	2018-06-27	3	0	3	6	0.32939999999999997
To the City of the Clouds	2018-01-18	3	0	3	6	0.32939999999999997
Forgotten Sound 1: Revelation	2018-01-18	2	0	3	5	0.32939999999999997
Forgotten Sound 2: Destiny	2018-01-18	1	0	3	4	0.32939999999999997
TANK SOULS	2018-09-12	2	0	3	5	0.32939999999999997
Future City Coaster	2018-03-29	2	0	3	5	0.32939999999999997
Virtual Pirate VR	2018-07-17	8	0	3	11	0.32939999999999997
World of Virtual Reality VR	2018-07-07	1	0	3	4	0.32939999999999997
VTree Beach Volleyball	2018-05-19	2	0	3	5	0.32939999999999997
The One We Found	2018-10-31	2	0	3	5	0.32939999999999997
Flaming Pixels	2018-06-15	2	0	3	5	0.32939999999999997
DDS(D.I.Y Drone Simulator)	2018-07-02	2	0	3	5	0.32939999999999997
Pilot Rudder VR	2018-08-07	1	0	3	4	0.32939999999999997
Nightmare Simulator	2018-09-03	2	0	3	5	0.32939999999999997
Saturnine	2018-10-08	1	0	3	4	0.32939999999999997
Food Bomber	2018-08-30	2	0	3	5	0.32939999999999997
the escape	2018-10-10	2	0	3	5	0.32939999999999997
Gravity Spin	2018-10-11	1	0	3	4	0.32939999999999997
Control Freak	2018-11-06	5	0	3	8	0.32939999999999997
Evoke	2018-11-19	2	0	3	5	0.32939999999999997
Exile to Death	2018-06-01	11	7	23	34	0.3282
Escape	2018-01-28	3	7	23	26	0.3282
2DGameManias Taken	2018-05-04	3	7	23	26	0.3282
Voxel Baller	2018-03-22	3	4	15	18	0.32799999999999996
Sci-fi Chess	2018-04-11	2	4	15	17	0.32799999999999996
LVN Fake News	2018-08-21	3	4	15	18	0.32799999999999996
Puzzle Monarch: Forests	2018-09-13	2	4	15	17	0.32799999999999996
Amazon Rush	2018-03-06	3	8	26	29	0.3261
Not my day	2018-11-21	3	5	18	21	0.326
Airport Simulator 2019	2018-05-31	82	38	101	183	0.3246
Kama Bullet Heritage 2	2018-04-19	4	20	57	61	0.3245
Goldmine	2018-03-28	53	111	273	326	0.32420000000000004
Aeve:Zero Gravity	2018-02-02	11	32	88	99	0.32170000000000004
Five Keys to Exit	2018-02-15	3	8	27	30	0.3209
Drift Legends	2018-03-15	6	3	13	19	0.3207
Supermarket VR	2018-04-24	3	3	13	16	0.3207
Road Patrol Truck	2018-06-18	3	3	13	16	0.3207
Romantic Journey	2018-11-10	2	3	13	15	0.3207
OniBushi VR	2018-04-13	2	2	10	12	0.3207
Mountain Racing	2018-05-15	2	2	10	12	0.3207
Strike Force Remastered	2018-11-20	6	2	10	16	0.3207
ArcBall 3: Infinity	2018-06-28	2	2	10	12	0.3207
UnBorn	2018-07-04	1	2	10	11	0.3207
♞ The Tactics of War ♞	2018-09-24	3	2	10	13	0.3207
ArcBall	2018-03-29	13	14	43	56	0.32049999999999995
Paradise City VR	2018-12-15	9	5	19	28	0.319
Metropolis	2018-03-29	5	1	7	12	0.3185
MAR WAR: The Evil Awakens	2018-02-01	2	1	7	9	0.3185
The Woods	2018-06-01	6	1	7	13	0.3185
Coastiality	2018-05-14	2	1	7	9	0.3185
Piano Play 3D	2018-04-26	2	1	7	9	0.3185
The RisenDead : VR	2018-07-26	6	1	7	13	0.3185
Bad Bots Rise	2018-07-06	1	1	7	8	0.3185
Curse in our heads	2018-07-09	2	1	7	9	0.3185
Wizard Street	2018-06-12	2	1	7	9	0.3185
Gilded Rails	2018-11-01	30	1	7	37	0.3185
Hanse - The Hanseatic League	2018-04-30	170	28	80	250	0.3179
Hentball	2018-09-24	3	7	25	28	0.3169
Aerial Guardian	2018-07-24	20	20	60	80	0.3166
Knights of Hearts	2018-02-13	3	8	28	31	0.3159
Wild West Online	2018-05-10	818	271	670	1488	0.315
Hello Pollution!	2018-08-07	20	17	53	73	0.3141
Colony On Mars	2018-01-04	2	10	34	36	0.314
Slayer Of Traitors	2018-05-13	2	10	34	36	0.314
Idle Heist	2018-06-08	222	88	233	455	0.3139
RollingBall: Unlimited World	2018-04-10	6	11	37	43	0.3131
Project Skylab	2018-08-16	13	11	37	50	0.3131
❂ Hexaluga ❂ Witch Hunter's Travelling Castle ♉	2018-03-12	2	5	20	22	0.3125
Truth: Disorder II	2018-05-02	2	4	17	19	0.3125
Magic League	2018-04-30	3	3	14	17	0.312
21	2018-09-28	2	3	14	16	0.312
Wonfourn	2018-06-15	3	2	11	14	0.3103
TheWraithTrials	2018-04-03	2	2	11	13	0.3103
Super Punchman	2018-05-09	2	2	11	13	0.3103
Pro Gamer Tycoon	2018-07-05	3	2	11	14	0.3103
Glass Painting: Winter Art	2018-12-14	3	2	11	14	0.3103
Caramba	2018-08-15	3	19	60	63	0.3099
Police Patrol	2018-04-23	3	11	38	41	0.3093
9 Balls	2018-04-20	4	13	44	48	0.30820000000000003
Jammerball	2018-03-05	1	0	4	5	0.308
BOX IT	2018-06-04	2	0	4	6	0.308
Uncanny Islands	2018-03-02	1	0	4	5	0.308
Scary new year	2018-01-25	2	0	4	6	0.308
War of Spells	2018-03-29	2	0	4	6	0.308
Sky Hawk	2018-03-28	2	0	4	6	0.308
Zombie World	2018-06-01	3	0	4	7	0.308
Naturallandscape - Grand Canyon (自然景观系列-美国大峡谷)	2018-04-12	2	0	4	6	0.308
Distant castle	2018-05-11	2	0	4	6	0.308
VikingJourney	2018-05-31	3	0	4	7	0.308
Talos VR	2018-06-08	2	0	4	6	0.308
Tomb Reader: TrapLand	2018-06-28	3	0	4	7	0.308
Bitcoin Mining Tycoon	2018-07-05	4	0	4	8	0.308
World of War : Battlegrounds	2018-07-05	7	0	4	11	0.308
In The Dark	2018-10-09	2	0	4	6	0.308
The Blood Eclipse	2018-10-20	3	0	4	7	0.308
Snowballed: Crazy Downhill	2018-12-28	2	0	4	6	0.308
Haldor	2018-04-21	2	7	27	29	0.30670000000000003
Sacred Saga Online	2018-10-04	42	8	30	72	0.3066
Foxus	2018-02-27	10	9	33	43	0.3064
Imperialism: The Dark Continent	2018-05-18	12	9	33	45	0.3064
Vietcong	2018-05-25	4	9	33	37	0.3064
Drill Arena	2018-02-25	6	4	18	24	0.3056
Pottery Crafts: Hand-Made Simulator	2018-03-15	3	4	18	21	0.3056
RapStar Tycoon	2018-06-21	2	4	18	20	0.3056
Tombo Breaker VR	2018-02-27	2	1	8	10	0.3056
5Rings	2018-05-03	2	1	8	10	0.3056
Fear Half Factor	2018-03-02	2	1	8	10	0.3056
Piano Bar	2018-08-28	1	1	8	9	0.3056
Lost Cosmonauts ARG	2018-10-01	2	1	8	10	0.3056
Impossible Tower Defense 2D	2018-12-24	2	1	8	10	0.3056
Christmas Carol	2018-11-19	4	3	15	19	0.3041
Unveloped	2018-01-23	2	2	12	14	0.3009
AlienSurvival	2018-03-10	2	2	12	14	0.3009
TheGunRunner	2018-03-16	3	4	19	22	0.2992
Tetripank	2018-04-09	2	4	19	21	0.2992
Dungeon Kitty	2018-08-31	4	11	41	45	0.2988
World Of Walking Cities	2018-05-14	4	3	16	20	0.2967
SOS	2018-01-23	2606	1923	4956	7562	0.295
Stellar Warrior	2018-02-01	1	1	9	10	0.2943
Healer Simulator	2018-03-29	3	1	9	12	0.2943
Funny Yo	2018-04-25	2	1	9	11	0.2943
雕像的预言（ The prophecy of statues）	2018-09-30	3	1	9	12	0.2943
Zuma Legend VR	2018-11-28	2	1	9	11	0.2943
Sapper boom!	2018-06-07	6	14	52	58	0.2933
Jurassic City Walk	2018-04-25	2	4	20	22	0.2932
Electroquest: Resistance is Futile	2018-04-29	2	4	20	22	0.2932
Fadeholm	2018-05-15	3	0	5	8	0.2916
RTS Commander: Smash the Rebels	2018-12-29	2	0	5	7	0.2916
Dexterity	2018-01-24	1	0	5	6	0.2916
Mystery Village: Shards of the past	2018-03-16	2	0	5	7	0.2916
Dust n Wheels	2018-06-22	1	0	5	6	0.2916
Clicker Planet	2018-04-10	2	0	5	7	0.2916
Muay Thai Fighting	2018-06-29	2	0	5	7	0.2916
Dark Nebula VR	2018-10-10	1	0	5	6	0.2916
Ladies	2018-10-26	2	0	5	7	0.2916
Colo Grid Zation	2018-12-21	1	0	5	6	0.2916
Battle Arena: Euro Wars	2018-10-19	1	0	5	6	0.2916
Mars Taken	2018-03-23	4	3	17	21	0.29
Coinon	2018-06-19	2	3	17	19	0.29
Little Adventurer III	2018-02-01	45	11	44	89	0.2893
Chronicles of Mystery - Secret of the Lost Kingdom	2018-07-13	6	7	31	37	0.289
School of Horror	2018-06-21	5	14	54	59	0.28809999999999997
OldFactory	2018-03-26	2	4	21	23	0.28750000000000003
Dead Forest	2018-08-04	3	6	28	31	0.2874
Tech Executive Tycoon	2018-12-22	27	10	42	69	0.2854
Piano Simulator	2018-05-30	2	2	14	16	0.2848
Vegas Party	2018-01-08	4	1	10	14	0.2845
Abduction Prologue: The Story Of Jonathan Blake	2018-04-11	2	1	10	12	0.2845
Girl Rugby Dash	2018-10-19	2	1	10	12	0.2845
Skydiving Simulator VR	2018-02-06	3	0	6	9	0.2783
WingMen	2018-01-10	7	0	6	13	0.2783
Music Producer	2018-05-31	2	0	6	8	0.2783
PRATAGON	2018-10-19	3	0	6	9	0.2783
AA Touch Gun!	2018-12-05	3	0	6	9	0.2783
REVOLT 1917	2018-04-11	2	3	19	21	0.2779
Blockshock	2018-02-06	4	2	15	19	0.2778
Girl with a big SWORD	2018-10-04	3	7	34	37	0.2776
From The Sky	2018-08-02	5	8	38	43	0.2762
Trains of the Orient	2018-09-28	19	5	27	46	0.2762
Judged: A Court Simulator	2018-11-15	6	1	11	17	0.2758
My First Music Workshop	2018-07-28	2	1	11	13	0.2758
Became The Hunted	2018-10-02	2	1	11	13	0.2758
Hentai - Color by Number	2018-12-27	3	1	11	14	0.2758
Landlord Simulator	2018-12-31	4	2	16	20	0.27140000000000003
Labyrinths of Atlantis	2018-03-27	4	10	47	51	0.271
AridFortress	2018-06-06	1	1	12	13	0.2681
Stage 3: Azaria	2018-03-16	2	0	7	9	0.26739999999999997
AfternoonEmpire	2018-02-15	5	0	7	12	0.26739999999999997
Pong like	2018-04-16	2	0	7	9	0.26739999999999997
Fury Fighter VR	2018-05-25	2	0	7	9	0.26739999999999997
GHOUL	2018-06-05	8	3	21	29	0.26730000000000004
光明大陆	2018-03-23	71	8	41	112	0.267
DesertShootout	2018-02-28	1	2	17	18	0.2655
Confederate Express	2018-04-10	6	7	38	44	0.2643
Mesozoica	2018-01-02	261	124	438	699	0.2622
Formula X	2018-05-05	2	1	13	15	0.2611
Last Alive	2018-06-18	2	1	13	15	0.2611
Glow Chess	2018-08-07	2	1	13	15	0.2611
Adventure of a Digger	2018-06-16	5	2	18	23	0.26
Fading Visage	2018-05-29	3	4	27	30	0.2597
The Amazonian Dread	2018-09-21	1	0	8	9	0.2581
War Hunter	2018-04-24	5	6	36	41	0.258
The first thrust of God	2018-01-03	3	5	32	35	0.2572
The Mummy Pharaoh	2018-10-09	2	2	19	21	0.2549
Debris	2018-07-09	2	1	14	16	0.2547
Poker Tower Defense	2018-12-19	3	1	14	17	0.2547
DeerHunterX	2018-04-21	3	9	50	53	0.25379999999999997
Achievement Collector: Space	2018-10-09	2	3	24	26	0.25370000000000004
ESCAPE FROM VOYNA: Tactical FPS survival	2018-05-10	2	0	9	11	0.25
Angry King	2018-11-05	2	0	9	11	0.25
Emergency Robot Simulator	2018-06-11	2	1	15	17	0.249
City Bus Simulator 2018	2018-04-18	5	6	40	45	0.2464
Tower Defense Sudden Attack	2018-03-26	2	2	21	23	0.24559999999999998
ArcBall 2	2018-04-24	15	4	31	46	0.2454
Sensual VR	2018-01-22	3	0	10	13	0.2429
Ascent Spirit	2018-03-01	2	0	10	12	0.2429
Medieval Real Estate	2018-01-08	2	3	27	29	0.24230000000000002
Fantasyland	2018-04-21	4	5	37	41	0.24180000000000001
The Culling 2	2018-07-10	249	27	133	382	0.24050000000000002
Ancient Warlords: Aequilibrium	2018-07-02	2	0	11	13	0.2366
Sacrifice Dungeon	2018-02-02	4	4	34	38	0.23629999999999998
Art of Murder - Deadly Secrets	2018-07-13	4	7	49	53	0.23600000000000002
ZombieHunt	2018-02-20	2	2	24	26	0.2338
Hyper Train Corporation	2018-06-18	10	2	24	34	0.2338
Digital Siege	2018-07-20	5	3	30	35	0.2324
No safety	2018-05-08	3	0	12	15	0.231
Digital Dungeon	2018-05-25	2	0	12	14	0.231
Frozen Soul	2018-07-27	8	5	43	51	0.2268
强军	2018-06-29	435	87	412	847	0.2245
Tank rush	2018-06-05	6	10	71	77	0.22340000000000002
University Tycoon: 2019	2018-07-31	2	0	14	16	0.2213
Art of Murder - The Secret Files	2018-07-13	6	10	75	81	0.2177
Identity	2018-12-01	694	370	1699	2393	0.2111
Space Launch Engineer	2018-02-27	5	1	25	30	0.2096
Lucky Night: Poker Games	2018-08-08	5	0	17	22	0.2095
天风之光 ~ Touhou Fan of Destiny	2018-10-12	5	2	34	39	0.2054
Slime Rancher	2017-08-01	7214	103475	2216	9430	0.9643
Hollow Knight	2017-02-24	20324	276013	7969	28293	0.9612
A Hat in Time	2017-10-05	7312	45576	928	8240	0.9612
Doki Doki Literature Club	2017-10-06	7402	179934	6426	13828	0.9535
Ravenfield	2017-05-18	3939	56363	1731	5670	0.9529000000000001
Finding Paradise	2017-12-14	994	14671	316	1310	0.9523999999999999
Cuphead	2017-09-29	19026	129540	4654	23680	0.9520000000000001
Gorogoa	2017-12-14	813	13595	335	1148	0.9490000000000001
Divinity: Original Sin 2	2017-09-14	93701	154187	6371	100072	0.9478
東方天空璋 ～ Hidden Star in Four Seasons.	2017-11-17	649	4386	64	713	0.9469
West of Loathing	2017-08-10	2835	8145	192	3027	0.9455
NEKOPARA Vol. 3	2017-05-25	2571	11276	334	2905	0.9431
planetarian HD	2017-05-08	120	2091	22	142	0.9407
Opus Magnum	2017-12-07	901	5001	131	1032	0.9381999999999999
CarX Drift Racing Online	2017-11-17	5369	57607	2742	8111	0.938
What Remains of Edith Finch	2017-04-25	564	30701	1415	1979	0.9359000000000001
Hidden Folks	2017-02-15	763	8223	285	1048	0.9359000000000001
Superflight	2017-11-09	613	9976	368	981	0.9357
Resident Evil 7 Biohazard	2017-01-26	20449	66794	3529	23978	0.9342
Rivals of Aether	2017-03-28	2922	26507	1250	4172	0.9340999999999999
Rusted Warfare - RTS	2017-07-14	273	3447	93	366	0.9333
Little Nightmares	2017-04-27	78169	83411	4631	82800	0.9329000000000001
DEEP SPACE WAIFU	2017-05-31	268	8272	336	604	0.9308
Rakuen	2017-05-10	235	5186	186	421	0.9303
Monolith	2017-06-07	133	1610	31	164	0.9293000000000001
Raging Loop	2017-08-23	446	3690	123	569	0.9287000000000001
Cinderella Phenomenon	2017-04-05	354	3628	120	474	0.9287000000000001
Orbt XL	2017-04-21	509	3135	101	610	0.9276000000000001
Kindergarten	2017-06-15	561	5918	243	804	0.9273
Alien Swarm: Reactive Drop	2017-04-20	9335	18024	940	10275	0.9272
SteamWorld Dig 2	2017-09-22	3736	5445	237	3973	0.9243000000000001
Stick Fight: The Game	2017-09-28	5147	100704	6709	11856	0.9242
Pavlov VR	2017-02-27	3221	33628	2080	5301	0.9229
Darkwood	2017-08-17	1315	14371	806	2121	0.9223
Majotori	2017-03-28	32	1470	39	71	0.9218000000000001
King Exit	2017-10-20	557	6363	310	867	0.9215000000000001
Dungeons 3	2017-10-13	3289	16272	951	4240	0.9212
Cat Quest	2017-08-08	1651	6625	331	1982	0.9209
Battle Chef Brigade	2017-11-20	535	2098	74	609	0.9198000000000001
Angels with Scaly Wings	2017-01-31	76	1500	44	120	0.9198000000000001
Empires of the Undergrowth	2017-12-01	2509	7714	409	2918	0.9197
Little Busters! English Edition	2017-11-01	179	685	9	188	0.9191
Freddy Fazbear's Pizzeria Simulator	2017-12-04	6492	21582	1379	7871	0.9185
Total War: WARHAMMER II	2017-09-28	84920	110986	8422	93342	0.9167000000000001
The Legend of Heroes: Trails of Cold Steel	2017-08-02	1628	4479	230	1858	0.9158
Heat Signature	2017-09-21	3877	6193	344	4221	0.9156000000000001
Draw Puzzle	2017-08-04	312	792	17	329	0.9152
Crawl	2017-04-11	319	6054	338	657	0.9151
Cattails	2017-12-01	442	2165	90	532	0.9151
OLDTV	2017-07-15	353	5045	275	628	0.9144
Meltys Quest	2017-10-24	463	1892	76	539	0.9144
Misao: Definitive Edition	2017-10-25	40	1534	56	96	0.9143000000000001
Sudoku Universe	2017-12-18	232	2158	93	325	0.9138
Life is Strange: Before the Storm	2017-08-31	16209	33489	2451	18660	0.9134000000000001
Night in the Woods	2017-02-21	1305	14195	945	2250	0.9134000000000001
Linelight	2017-01-31	53	865	23	76	0.9127
Sonic Mania	2017-08-29	11937	20819	1475	13412	0.9125
Planescape: Torment: Enhanced Edition	2017-04-11	955	3540	185	1140	0.9124
SENRAN KAGURA ESTIVAL VERSUS	2017-03-17	1088	4665	264	1352	0.9119
The Darkside Detective	2017-07-27	252	3433	182	434	0.9115000000000001
Spooky's Jump Scare Mansion: HD Renovation	2017-03-01	173	1963	87	260	0.9115000000000001
Learn to Fly 3	2017-05-12	1506	7144	453	1959	0.9105
Half-Life 2: DownFall	2017-04-17	56	2613	131	187	0.9105
Zup! 7	2017-12-12	483	1905	86	569	0.9104000000000001
Soda Dungeon	2017-02-07	5690	5413	327	6017	0.9103
BlazBlue Centralfiction	2017-04-26	4773	8217	542	5315	0.9096
The Jackbox Party Pack 4	2017-10-19	3902	2586	134	4036	0.9091
Kingdoms and Castles	2017-07-20	4856	22407	1713	6569	0.9084000000000001
Zero Escape: The Nonary Games	2017-03-24	960	4116	246	1206	0.908
Pictopix	2017-01-05	773	988	35	808	0.908
Cogmind	2017-10-17	168	1299	54	222	0.9076000000000001
Unturned	2017-07-07	112703	465824	43226	155929	0.9070999999999999
Tametsi	2017-10-18	203	769	24	227	0.9068
SCP: Secret Laboratory	2017-12-29	11323	144235	13145	24468	0.9051
Nightshade	2017-04-12	220	625	18	238	0.9046
Zombie Estate 2	2017-01-13	163	547	14	177	0.9044
Pinkman	2017-01-16	101	526	13	114	0.9043000000000001
The Evil Within 2	2017-10-13	9918	22648	1865	11783	0.9037000000000001
Space Pirate Trainer	2017-10-12	229	2598	153	382	0.9034000000000001
Bayonetta	2017-04-11	4194	21997	1816	6010	0.9033
Emily is Away Too	2017-05-26	844	5019	342	1186	0.9033
Short Stories Collection of Class Tangerine	2017-09-14	63	827	31	94	0.9032
Ancient Warfare 3	2017-12-21	180	1919	106	286	0.9024
X-Plane 11	2017-03-30	4210	14418	1159	5369	0.9023000000000001
I Expect You To Die	2017-04-25	228	2177	126	354	0.902
Symphonic Rain	2017-06-15	69	621	20	89	0.9018
Rain World	2017-03-28	4808	13221	1070	5878	0.9013
Charlie Murder	2017-05-12	130	1507	79	209	0.9012000000000001
WILL: A Wonderful World	2017-06-06	1126	4826	340	1466	0.9011
Thimbleweed Park	2017-03-30	2733	3338	219	2952	0.9009999999999999
Zup! 6	2017-09-19	791	2070	121	912	0.9009
Coming Out on Top	2017-10-13	394	1233	61	455	0.9005
Danganronpa V3: Killing Harmony Demo Ver.	2017-08-25	1112	1554	84	1196	0.9004000000000001
Confess My Love	2017-05-28	130	4113	288	418	0.8998
Okami HD	2017-12-12	2136	6856	524	2660	0.8996
A Sky Full of Stars	2017-12-15	73	719	28	101	0.8994
Open Sorcery	2017-02-22	359	316	5	364	0.8993000000000001
Dominions 5	2017-11-27	1085	1839	109	1194	0.8986000000000001
Four Last Things	2017-02-23	37	873	39	76	0.8985
Consummate:Missing World	2017-07-22	748	959	45	793	0.8984000000000001
The Long Dark	2017-08-01	14433	88169	8581	23014	0.8983
Bai Qu: Hundreds of Melodies	2017-07-28	22	635	24	46	0.8979
Tales of Berseria	2017-01-26	8085	14941	1291	9376	0.8978
DEEP SPACE WAIFU: FLAT JUSTICE	2017-12-07	241	2081	131	372	0.8974
Bleed 2	2017-02-08	160	751	32	192	0.8974
Subsurface Circular	2017-08-17	193	1628	96	289	0.8972
NEKO-NIN exHeart	2017-04-21	89	922	44	133	0.8971
Ken Follett's The Pillars of the Earth	2017-08-15	476	5344	412	888	0.8968
Zup! 5	2017-06-13	221	2434	162	383	0.8966
Hellblade: Senua's Sacrifice	2017-08-08	5653	50161	4848	10501	0.8965000000000001
Higurashi When They Cry Hou - Ch.5 Meakashi	2017-04-28	49	488	16	65	0.8964
The End Is Nigh	2017-07-12	1641	2504	169	1810	0.8962000000000001
Under Leaves	2017-04-27	20	561	21	41	0.8956999999999999
Blackberry Honey	2017-10-24	23	464	15	38	0.8956000000000001
Peace, Death!	2017-03-24	196	1839	117	313	0.8952
Zup! Zero	2017-04-06	301	2345	160	461	0.8948
TY the Tasmanian Tiger 2	2017-12-13	180	608	25	205	0.8945000000000001
Outlast 2	2017-04-25	5966	38594	3768	9734	0.8944
The Legend of Heroes: Trails in the Sky the 3rd	2017-05-03	886	1408	85	971	0.8940000000000001
Material Girl	2017-06-20	3167	8428	724	3891	0.8939
Forts	2017-04-19	7280	13717	1249	8529	0.8935
HIVESWAP: ACT 1	2017-09-14	4842	3550	270	5112	0.8935
Entropy : Zero	2017-10-10	411	6562	550	961	0.8934000000000001
D'LIRIUM	2017-08-25	80	850	43	123	0.8934000000000001
Umineko When They Cry - Answer Arcs	2017-11-17	81	781	38	119	0.8934000000000001
We Were Here	2017-02-03	1469	20298	1918	3387	0.8933
Paradigm	2017-04-05	188	1360	83	271	0.893
Crimson Imprint plus -Nonexistent Christmas-	2017-12-01	185	1854	124	309	0.8928
Wonderful Everyday Down the Rabbit-Hole	2017-08-31	137	1140	66	203	0.8926999999999999
Car Mechanic Simulator 2018	2017-07-28	8474	41364	4178	12652	0.8921
Nekojishi	2017-11-12	451	3718	292	743	0.892
Sniper Elite 4	2017-02-14	17366	42685	4344	21710	0.8916
The Sexy Brutale	2017-04-11	348	3074	238	586	0.8908
Sky Force Reloaded	2017-11-29	330	1788	124	454	0.8904000000000001
Prey	2017-05-05	24594	38535	4000	28594	0.8896
Fantasynth One	2017-04-20	15	438	17	32	0.8894
Endless ATC	2017-07-19	29	309	9	38	0.8885
The Dishwasher: Vampire Smile	2017-05-12	100	1025	63	163	0.8882
Elise the Devil	2017-11-02	727	2078	156	883	0.888
SeaBed	2017-12-20	29	382	14	43	0.8879000000000001
Soulslayer	2017-07-13	90	523	24	114	0.8878
20XX	2017-08-16	712	3777	320	1032	0.8874
D&D Lords of Waterdeep	2017-09-01	394	1253	84	478	0.8871
Burger Shop	2017-12-01	19	178	2	21	0.8867
Chroma Lab	2017-08-22	28	310	10	38	0.8863
Yomawari: Midnight Shadows	2017-10-24	49	626	33	82	0.8862000000000001
3030 Deathwar Redux - A Space Odyssey	2017-09-13	138	1011	65	203	0.8859
Hidden & Dangerous 2: Courage Under Fire	2017-12-20	76	607	32	108	0.8856
Batman: The Enemy Within - The Telltale Series	2017-08-08	2029	6418	602	2631	0.8854000000000001
Dream Daddy: A Dad Dating Simulator	2017-07-20	14471	5032	459	14930	0.8852
Burger Shop 2	2017-12-01	49	241	6	55	0.8852
The Escapists 2	2017-08-21	11202	23552	2500	13702	0.8851000000000001
Colony Survival	2017-06-16	1488	6048	570	2058	0.8845999999999999
Google Spotlight Stories: Pearl	2017-10-19	17	344	13	30	0.8845999999999999
Love Ribbon	2017-01-27	162	1653	125	287	0.8845000000000001
MudRunner	2017-10-30	8667	25042	2699	11366	0.8842
Full Throttle Remastered	2017-04-18	422	2209	180	602	0.8837999999999999
Bridge Constructor Portal	2017-12-20	1745	4238	387	2132	0.8835
Heart's Medicine - Hospital Heat	2017-05-23	146	322	12	158	0.8834000000000001
Barrage Musical ～A Fantasy of Tempest～	2017-10-07	98	320	12	110	0.8831
Shigatari	2017-08-25	84	214	5	89	0.8831
Fate/EXTELLA	2017-07-25	2946	3682	333	3279	0.8828
Killer Instinct	2017-09-27	701	3488	313	1014	0.8826999999999999
Oik 2	2017-03-28	496	1164	84	580	0.8821
Your Smile Beyond Twilight	2017-06-24	21	531	29	50	0.8815000000000001
Crimson Gray	2017-07-14	157	350	15	172	0.8813
Fight'N Rage	2017-09-19	220	2270	196	416	0.8805
SiNKR	2017-10-12	39	410	20	59	0.8805
X-Morph: Defense	2017-08-30	918	2771	248	1166	0.8804000000000001
Brigand: Oaxaca	2017-07-12	22	302	12	34	0.8801000000000001
Another Adventure	2017-03-10	392	3941	375	767	0.8799
Mini Ghost	2017-04-28	97	365	17	114	0.8795000000000001
Half-Life: C.A.G.E.D.	2017-09-21	275	2687	243	518	0.8793000000000001
Pyre	2017-07-25	4013	7406	767	4780	0.8792
Fausts Alptraum	2017-04-08	59	927	66	125	0.8792
KARAKARA2	2017-11-10	79	569	34	113	0.8791
Ultimate Marvel vs. Capcom 3	2017-03-07	2487	4162	406	2893	0.8786
Lines X Free	2017-10-31	121	1384	111	232	0.8786
Graze Counter	2017-07-29	40	253	9	49	0.8786
Ukrainian ball in search of gas	2017-12-08	16	685	45	61	0.8781
Sky Rogue	2017-08-24	107	931	68	175	0.8779000000000001
Superdimension Neptune VS Sega Hard Girls	2017-06-12	597	842	60	657	0.8776
She Remembered Caterpillars	2017-01-17	206	439	24	230	0.8776
Engare	2017-10-23	48	378	19	67	0.8776
1982	2017-06-28	88	707	48	136	0.8771
qop 2	2017-12-12	1272	386	20	1292	0.8769
Golf It!	2017-02-17	2877	19220	2220	5097	0.8768000000000001
Hoshizora no Memoria -Wish upon a Shooting Star-	2017-12-19	12	202	6	18	0.8768000000000001
Project Rhombus	2017-12-08	127	1278	104	231	0.8765999999999999
Milkmaid of the Milky Way	2017-01-04	22	430	24	46	0.8763
Turok 2: Seeds of Evil	2017-03-16	894	1888	168	1062	0.8762000000000001
SIMULACRA	2017-10-26	333	3313	324	657	0.8761
RUINER	2017-09-26	918	9417	1039	1957	0.8759
Darkarta: A Broken Heart's Quest Collector's Edition	2017-03-08	600	811	59	659	0.8759
I Can't Believe It's Not Gambling GOTY Edition	2017-12-11	350	1398	118	468	0.8756
Splasher	2017-02-07	217	891	67	284	0.8756
Solar Settlers	2017-07-21	30	265	11	41	0.8755
Immortal Redneck	2017-04-25	590	2684	257	847	0.8753000000000001
b	2017-06-26	44	3440	343	387	0.8751000000000001
Find You	2017-09-04	134	363	19	153	0.8751000000000001
The Caribbean Sail	2017-09-19	21	398	22	43	0.875
Hakuoki: Kyoto Winds	2017-08-24	183	1307	110	293	0.8748
Kingsway	2017-07-18	446	1310	111	557	0.8745
CS2D	2017-11-15	1418	7806	863	2281	0.8743000000000001
Bad Dream: Coma	2017-03-09	114	1711	154	268	0.8742000000000001
Mutant Football League	2017-10-31	93	676	48	141	0.8740000000000001
Arcade Moonlander	2017-10-25	247	939	74	321	0.8738
Jumps	2017-03-31	2642	269	12	2654	0.8736
Demonheart	2017-03-24	109	587	40	149	0.8734999999999999
LOVE 2: kuso	2017-11-07	18	189	6	24	0.8734000000000001
Halo Wars: Definitive Edition	2017-04-20	3192	6208	679	3871	0.8733
Spark the Electric Jester	2017-04-10	64	903	71	135	0.8733
Agatha Knife	2017-04-27	20	409	24	44	0.8731
Operation Warcade VR	2017-08-04	15	279	13	28	0.8731
Zwei: The Ilvard Insurrection	2017-10-31	92	527	35	127	0.8727
SPACEPLAN	2017-05-04	760	2171	209	969	0.8725
Golden Krone Hotel	2017-10-26	50	264	12	62	0.8725
RED	2017-01-14	13	288	14	27	0.8724
仙剑奇侠传四(Chinese Paladin：Sword and Fairy 4)	2017-09-05	1265	4380	467	1732	0.8723000000000001
Low Magic Age	2017-01-11	675	2525	250	925	0.8722
Mothlight	2017-08-25	29	358	20	49	0.8722
Stay! Stay! Democratic People's Republic of Korea!	2017-05-11	78	522	35	113	0.872
PAKO 2	2017-11-16	20	309	16	36	0.8718000000000001
The Painscreek Killings	2017-09-27	161	2970	305	466	0.8713
Ys SEVEN	2017-08-30	283	660	49	332	0.8712000000000001
Yorkshire Gubbins	2017-10-17	11	153	4	15	0.8712000000000001
RiME	2017-05-26	634	4319	467	1101	0.871
Fallout Shelter	2017-03-29	42656	50913	6607	49263	0.8709
Zup! 3	2017-01-12	712	4727	518	1230	0.8708
Show It 2 Me	2017-12-14	4	122	2	6	0.8708
Rez Infinite	2017-08-09	208	935	79	287	0.8695999999999999
911 Operator	2017-02-24	1955	13337	1630	3585	0.8694
Darkestville Castle	2017-09-21	29	440	29	58	0.8694
Diamo XL	2017-10-13	724	450	30	754	0.8693000000000001
Sky Knights	2017-07-27	54	375	23	77	0.8693000000000001
Metal as Phuk	2017-07-13	8	237	11	19	0.8691
Cosmic Express	2017-03-16	56	362	22	78	0.8689
Shovel Knight: Specter of Torment	2017-04-05	57	383	24	81	0.8688
Minecraft: Story Mode - Season Two	2017-07-11	1228	1362	127	1355	0.8687
Fidel Dungeon Rescue	2017-08-01	135	359	22	157	0.8684000000000001
LineWay	2017-06-21	164	422	28	192	0.8682
Dead Horizon	2017-08-11	10	313	18	28	0.868
Dreadhalls	2017-03-09	21	300	17	38	0.8676
Neko Navy	2017-06-14	19	128	3	22	0.8674
Super Blood Hockey	2017-08-17	68	833	71	139	0.8672
Press X to Not Die	2017-10-06	113	3177	348	461	0.867
Transparent Black	2017-08-24	7	229	11	18	0.867
The Invisible Hours	2017-10-10	18	433	30	48	0.8667
DeathComing	2017-11-06	1034	2866	311	1345	0.8666
theHunter: Call of the Wild™	2017-02-16	23612	114439	16001	39613	0.8664000000000001
The Adventures of Fei Duanmu 端木斐异闻录	2017-03-10	159	1570	156	315	0.8662000000000001
Kitten adventures in city park	2017-09-08	30	480	35	65	0.8661
Linked	2017-02-21	2063	367	24	2087	0.8659
Dark Elf	2017-08-03	1263	4465	517	1780	0.8656999999999999
Zup! 4	2017-02-20	484	2489	268	752	0.8656999999999999
Juniper's Knot	2017-08-29	6	247	13	19	0.8656999999999999
Middle-earth™: Shadow of War™	2017-10-10	68183	75521	10505	78688	0.8654999999999999
Ultimate General: Civil War	2017-07-14	1678	6171	740	2418	0.8654999999999999
Panty Party	2017-01-24	61	904	81	142	0.8653000000000001
Super Fancy Pants Adventure	2017-09-20	178	1382	136	314	0.8652
Attentat 1942	2017-10-31	17	331	21	38	0.865
Disgaea 2 PC	2017-01-30	918	1264	123	1041	0.8647
Sphinx and the Cursed Mummy	2017-11-10	76	450	33	109	0.8645
Bendy and the Ink Machine	2017-04-27	3457	19462	2575	6032	0.8643000000000001
Cube Racer	2017-10-30	3283	1029	97	3380	0.8640000000000001
UBERMOSH Vol.5	2017-05-25	8	294	18	26	0.8639
Grisaia Phantom Trigger Vol.2	2017-04-28	36	132	4	40	0.8636
McOsu	2017-03-20	423	4915	590	1013	0.8634000000000001
LEGO® City Undercover	2017-04-04	833	6052	742	1575	0.8633
64.0	2017-03-16	306	1302	130	436	0.8633
Loot Box Quest	2017-12-13	65	383	27	92	0.8632
Sakura no Mori † Dreamers	2017-12-28	87	746	66	153	0.863
qop	2017-07-13	560	860	79	639	0.8629000000000001
Tiny Town VR	2017-08-02	58	616	52	110	0.8626
Battle Brothers	2017-03-24	8060	16835	2258	10318	0.8621
Wave	2017-04-12	482	538	44	526	0.8620000000000001
Grisaia Phantom Trigger Vol.3	2017-07-28	71	128	4	75	0.8619
Vanquish	2017-05-25	2418	5427	670	3088	0.8618000000000001
Griptape Backbone	2017-05-05	14	480	38	52	0.8617
Sweetest Monster	2017-02-06	43	461	36	79	0.8616
Max's Big Bust - A Captain Nekorai Tale	2017-02-06	29	114	3	32	0.8615
The Mammoth: A Cave Painting	2017-11-22	25	775	71	96	0.8614
Silver	2017-06-02	116	605	52	168	0.8612000000000001
Voodoo Vince: Remastered	2017-04-18	83	430	33	116	0.8612000000000001
Ellipsis	2017-01-25	66	218	12	78	0.8608
FORM	2017-06-01	28	872	84	112	0.8599
Alice Mystery Garden	2017-12-20	9	193	10	19	0.8598
Out of the Park Baseball 18	2017-03-24	1586	619	55	1641	0.8595
Hob	2017-09-26	1179	4098	508	1687	0.8590000000000001
1bitHeart	2017-08-28	64	657	60	124	0.8588
Airtone	2017-06-08	30	198	11	41	0.8579000000000001
Cat or Bread?	2017-05-08	3169	519	45	3214	0.8578
Juanito Arcade Mayhem	2017-08-03	25	308	22	47	0.8578
The House of Da Vinci	2017-11-24	484	4175	526	1010	0.8577
Art Of Gravity	2017-06-13	211	561	50	261	0.8576
NEKO-NIN exHeart +PLUS Nachi	2017-11-02	19	238	15	34	0.8575
Skeleton Boomerang	2017-08-01	19	130	5	24	0.8575
Cook, Serve, Delicious! 2!!	2017-09-13	1532	2448	291	1823	0.8573999999999999
Rush Rover	2017-11-30	68	207	12	80	0.8573999999999999
Another Lost Phone: Laura's Story	2017-09-21	32	686	65	97	0.8571
Grisaia Phantom Trigger Vol.1	2017-04-28	99	295	21	120	0.8570000000000001
Learn Japanese To Survive! Katakana War	2017-01-31	103	415	34	137	0.8568000000000001
Taima Miko Yuugi	2017-10-21	224	598	55	279	0.8567
Bulletstorm: Full Clip Edition	2017-04-07	1598	5940	783	2381	0.8565
Pinstripe	2017-04-25	694	2057	242	936	0.8563
Conductor	2017-05-02	15	272	19	34	0.856
Punch Planet	2017-11-08	46	160	8	54	0.8558
Bomber Crew	2017-10-19	9898	10677	1484	11382	0.8556999999999999
RollerCoaster Tycoon Classic	2017-09-28	1136	1621	186	1322	0.8555
Scanner Sombre	2017-04-26	194	2841	353	547	0.8552
Sounds of Her Love	2017-03-09	29	637	61	90	0.8552
Planet RIX-13	2017-05-12	48	88	2	50	0.8549
MagiCat	2017-08-22	108	490	44	152	0.8545999999999999
Change	2017-12-28	15	350	28	43	0.8545999999999999
Tricolour Lovestory	2017-09-21	2733	22385	3285	6018	0.8545
Desert Golfing	2017-12-19	20	74	1	21	0.8545
Oik	2017-02-14	648	1437	164	812	0.8544
Darkness and Flame: Missing Memories	2017-10-24	19	87	2	21	0.8543000000000001
Brickochet	2017-09-04	8	87	2	10	0.8543000000000001
Poi	2017-02-01	146	629	61	207	0.8541
Assassin's Creed Origins	2017-10-27	41551	76085	11787	53338	0.8540000000000001
The Witches' Tea Party	2017-08-28	12	99	3	15	0.8540000000000001
Maggie's Apartment	2017-08-01	47	99	3	50	0.8540000000000001
Corona Blossom Vol.3 Journey to the Stars	2017-01-26	76	122	5	81	0.8537
Fire Pro Wrestling World	2017-12-18	1712	2510	313	2025	0.8534999999999999
Grey Hack	2017-12-15	77	955	103	180	0.8532
Dishonored®: Death of the Outsider™ 	2017-09-15	6086	8896	1253	7339	0.8531000000000001
Ladykiller in a Bind	2017-01-09	34	289	22	56	0.8531000000000001
Dawn	2017-03-31	33	701	71	104	0.8529000000000001
In Your Face TD	2017-03-22	9	142	7	16	0.8528
Little Triangle	2017-01-21	129	486	45	174	0.8525
Beyond the Sunset 斜阳下的彼岸	2017-10-05	24	152	8	32	0.8525
NARUTO SHIPPUDEN: Ultimate Ninja STORM 2	2017-08-25	189	2495	315	504	0.8523999999999999
The Journey Down: Chapter Three	2017-09-21	79	400	35	114	0.8522
Please Knock on My Door	2017-09-07	18	211	14	32	0.8522
Hop Step Sing! Kimamani☆Summer vacation (HQ Edition)	2017-08-18	8	95	3	11	0.8517
Putty Pals	2017-02-16	12	94	3	15	0.8511
Battle Chasers: Nightwar	2017-10-03	5375	5825	812	6187	0.851
Pinball FX3	2017-09-26	835	3822	515	1350	0.8506
Morphblade	2017-03-03	153	483	46	199	0.8505
Otaku's Fantasy	2017-10-12	370	2672	348	718	0.8503000000000001
Passpartout: The Starving Artist	2017-06-06	481	5164	723	1204	0.8495
Rising Storm 2: Vietnam	2017-05-30	24518	45107	7150	31668	0.8494
Rumu	2017-12-12	49	460	44	93	0.8493
第九日-The 9th Day-	2017-02-16	67	292	24	91	0.8491
Pinball Deluxe: Reloaded	2017-10-06	15	134	7	22	0.8490000000000001
Hell Girls	2017-01-13	1688	3464	471	2159	0.8488
Thaumistry: In Charm's Way	2017-10-08	10	52	0	10	0.8487
愛神餐館2	2017-12-30	19	52	0	19	0.8487
A Normal Lost Phone	2017-01-26	91	1986	255	346	0.8484
Green Elephant 2D	2017-04-20	1696	315	27	1723	0.8484
Dong-Jin Rice-hime	2017-04-29	85	430	41	126	0.8482
Pepper's Puzzles	2017-08-08	20	122	6	26	0.8482
Flood of Light	2017-06-15	26	235	18	44	0.8479000000000001
Lines Infinite	2017-11-24	21	428	41	62	0.8478
Succubus Rem	2017-12-20	373	846	96	469	0.8473999999999999
Macbat 64	2017-03-17	19	311	27	46	0.8473999999999999
Danganronpa Another Episode: Ultra Despair Girls	2017-06-27	487	3961	554	1041	0.8473
Stonekeep	2017-03-24	12	98	4	16	0.8466
Canvas The Gallery	2017-02-16	117	274	23	140	0.8465
The Cat Games	2017-03-24	107	835	96	203	0.8462000000000001
Figment	2017-09-22	4232	2768	379	4611	0.846
Eternal Hour: Golden Hour	2017-11-27	42	738	83	125	0.846
Get To The Orange Door	2017-10-27	218	2275	305	523	0.8459000000000001
NieR:Automata™	2017-03-17	23908	98868	16580	40488	0.8456999999999999
Race for the Galaxy	2017-06-27	63	321	29	92	0.8456999999999999
The Last Birdling	2017-08-31	21	62	1	22	0.8456999999999999
Time Up	2017-10-10	7	85	3	10	0.8453
Archaica: The Path of Light	2017-09-08	72	218	17	89	0.8451000000000001
Slash It 2	2017-01-24	1059	1066	130	1189	0.845
Perceptions of the Dead	2017-10-31	30	293	26	56	0.8448000000000001
Zork: Grand Inquisitor	2017-04-18	9	73	2	11	0.8448000000000001
Lance A Lot: Enhanced Edition	2017-09-28	18	73	2	20	0.8448000000000001
Stories Untold	2017-02-27	374	3937	565	939	0.8447
Long Live Santa!	2017-12-19	400	2640	365	765	0.8445999999999999
Loading Screen Simulator	2017-07-14	1079	7297	1104	2183	0.8443
Battle Bruise	2017-05-04	879	395	39	918	0.8443
These nights in Cairo	2017-10-17	194	233	19	213	0.8443
Injustice™ 2	2017-11-14	1873	14614	2308	4181	0.8442000000000001
F1 2017	2017-08-24	8111	5138	758	8869	0.8442000000000001
Eiyu*Senki - The World Conquest	2017-11-11	152	628	70	222	0.8441
The Frostrune	2017-02-02	58	315	29	87	0.8441
LEGO® MARVEL Super Heroes 2	2017-11-14	1047	6131	919	1966	0.8440000000000001
Realm Grinder	2017-06-15	6265	5337	792	7057	0.8439
THE LAST BLADE 2	2017-11-17	34	240	20	54	0.8438
Run Zeus Run	2017-10-11	114	1170	147	261	0.8437000000000001
Age of Fear 3: The Legend	2017-09-01	21	161	11	32	0.8436
The Mooseman	2017-02-17	137	908	110	247	0.8432
Soma Spirits: Rebalance	2017-04-14	33	46	0	33	0.8431000000000001
Snail Trek - Chapter 1: Intershellar	2017-11-30	4	131	8	12	0.8425
Persian Nights: Sands of Wonders	2017-06-29	40	219	18	58	0.8423999999999999
Strikey Sisters	2017-06-01	44	659	76	120	0.8422000000000001
Lupinball	2017-08-17	15	58	1	16	0.8422000000000001
The Mind of Marlo	2017-10-19	5	184	14	19	0.8421
Fishing Planet	2017-08-28	6709	36708	6183	12892	0.8415
Home Sweet Home	2017-09-27	323	2795	401	724	0.8415
Flightless Classic	2017-10-27	30	329	32	62	0.8415
Crashday Redline Edition	2017-08-10	264	1297	170	434	0.8412999999999999
Atomic 79	2017-01-13	56	90	4	60	0.8412999999999999
Late Shift	2017-04-18	395	7003	1088	1483	0.8412000000000001
Caveblazers	2017-05-24	723	3321	486	1209	0.8412000000000001
Desert Bus VR	2017-11-27	235	1407	187	422	0.8411
AngerForce: Reloaded	2017-09-15	91	334	33	124	0.8408
Old Man's Journey	2017-05-18	180	2861	415	595	0.8407
50 years	2017-05-26	391	563	64	455	0.8407
Death Squared	2017-03-14	66	454	49	115	0.8407
Mr Shifty	2017-04-13	349	1380	184	533	0.8406
Shadow Bug	2017-07-22	8	99	5	13	0.8406
Golden Hornet	2017-12-22	136	154	11	147	0.8403
.hack//G.U. Last Recode	2017-11-03	1989	2730	396	2385	0.8402
The Zwuggels - Beach Holidays	2017-07-20	11	78	3	14	0.8401000000000001
Campfire Cooking	2017-10-18	8	43	0	8	0.84
Niche - a genetics survival game	2017-09-21	1046	3951	595	1641	0.8399
Tannenberg	2017-11-16	1177	7578	1200	2377	0.8397
PickCrafter	2017-12-14	1820	4935	763	2583	0.8390000000000001
The Monster Inside	2017-08-01	91	1424	194	285	0.8390000000000001
Koi Musubi	2017-01-30	36	250	23	59	0.8390000000000001
The Disney Afternoon Collection	2017-04-18	174	692	84	258	0.8389
OVIVO	2017-05-12	161	394	42	203	0.8389
Cats Make You Smarter!	2017-10-19	13	168	13	26	0.8388
Cleansuit	2017-11-01	4	42	0	4	0.8388
Irony Of Nightmare	2017-12-12	14	551	64	78	0.8387000000000001
Saku Saku: Love Blooms with the Cherry Blossoms	2017-10-02	227	241	22	249	0.8386
No Heroes Here	2017-10-03	66	390	42	108	0.838
Cold Waters	2017-06-05	865	3359	509	1374	0.8378
Slowdrive	2017-04-28	7	75	3	10	0.8377
Bullet Party	2017-07-31	5	75	3	8	0.8377
The Eden of Grisaia	2017-04-28	69	85	4	73	0.8376000000000001
CropDuster Supreme	2017-02-24	923	165	13	936	0.8373999999999999
Last Day of June	2017-08-31	362	3417	521	883	0.8373
AER Memories of Old	2017-10-25	483	5265	833	1316	0.8370000000000001
God Of Thunder	2017-11-14	5	74	3	8	0.8368000000000001
Umineko: Golden Fantasia	2017-12-09	187	332	35	222	0.8362999999999999
WAGAMAMA HIGH SPEC	2017-07-27	52	310	32	84	0.8362999999999999
Syrian Warfare	2017-02-21	491	3633	563	1054	0.8361000000000001
Carrier Deck	2017-06-15	336	771	99	435	0.8359000000000001
PEG	2017-10-09	8	153	12	20	0.8356
Endless Fables 2: Frozen Path	2017-11-16	69	169	14	83	0.8354
Redeemer	2017-08-01	802	2317	347	1149	0.8353
Tally Ho	2017-12-14	37	82	4	41	0.8353
Swordlord	2017-01-24	3	39	0	3	0.8353
Power Hover	2017-01-10	948	276	28	976	0.835
SAS: Zombie Assault 4	2017-10-16	1530	6404	1047	2577	0.8349
Battle Snails	2017-12-05	111	283	29	140	0.8349
NEKO-NIN exHeart +PLUS Saiha	2017-11-17	15	176	15	30	0.8349
Warcube	2017-01-27	121	290	30	151	0.8348000000000001
Danganronpa V3: Killing Harmony	2017-09-26	4691	13943	2388	7079	0.8347
Nex Machina	2017-06-20	326	1706	249	575	0.8346
The Letter	2017-07-24	209	1108	153	362	0.8345
Thy Sword	2017-11-14	8	61	2	10	0.8344
Evening Surprise	2017-09-15	26	573	71	97	0.8342
The Quarter Game	2017-12-08	6	71	3	9	0.8342
Field of Glory II	2017-10-12	309	646	82	391	0.8341
Strategic Command WWII: War in Europe	2017-06-06	233	288	30	263	0.8341
After Death	2017-10-05	7	99	6	13	0.8341
I wanna be The Cat	2017-12-14	72	150	12	84	0.8340000000000001
Oik 3	2017-11-09	1527	675	87	1614	0.8334999999999999
Super Bunny Man	2017-08-31	684	3495	554	1238	0.8334
Cosmic Star Heroine	2017-04-11	224	720	94	318	0.8334
Use Your Words	2017-04-03	487	648	83	570	0.8334
HIBIKAKEYIRONOKISEKI / 裂色的奇迹	2017-12-15	65	300	32	97	0.8334
Path Out	2017-11-02	22	157	13	35	0.8334
Lost Lands: The Wanderer	2017-05-03	20	70	3	23	0.8333
XING: The Land Beyond	2017-09-21	39	263	27	66	0.8331000000000001
MHRD	2017-01-05	52	334	37	89	0.8329000000000001
Nancy Drew: Sea of Darkness	2017-02-02	44	123	9	53	0.8327
The Inner World: The Last Wind Monk	2017-10-20	73	290	31	104	0.8325
Hyper Knights	2017-05-19	314	655	85	399	0.8323999999999999
Forever Home	2017-11-01	18	155	13	31	0.8323999999999999
Battlerite	2017-11-08	45145	49635	9139	54284	0.8319
Warlock's Tower	2017-01-31	9	48	1	10	0.8319
The LEGO® NINJAGO® Movie Video Game	2017-09-22	5434	4918	814	6248	0.8315000000000001
ChronoClock	2017-02-28	42	121	9	51	0.8315000000000001
Tormentor❌Punisher	2017-06-02	1012	491	61	1073	0.8312999999999999
Japanese Women - Animated Jigsaws	2017-04-10	80	137	11	91	0.8312999999999999
Containment Initiative	2017-04-14	19	435	53	72	0.8307
AccuRC 2	2017-07-12	56	381	45	101	0.8307
Tacoma	2017-08-02	386	3515	572	958	0.8306
Shark Dating Simulator XL+	2017-08-14	85	789	108	193	0.8306
Dujanah	2017-09-19	10	204	20	30	0.8303
Serial Cleaner	2017-07-14	13958	2487	394	14352	0.8301999999999999
Marvel's Guardians of the Galaxy: The Telltale Series	2017-04-18	906	1568	237	1143	0.8301000000000001
Unhack 2	2017-01-12	50	76	4	54	0.8301000000000001
Dark Strokes: The Legend of the Snow Kingdom Collector’s Edition	2017-12-21	15	102	7	22	0.8299
SOULS	2017-08-14	5	118	9	14	0.8295
Beyond Eden	2017-10-07	29	157	14	43	0.8293
Atelier Sophie: The Alchemist of the Mysterious Book	2017-02-07	618	1585	242	860	0.8292
Fox Hime	2017-11-03	673	3273	537	1210	0.8291
Brawlhalla	2017-10-17	34816	266991	52203	87019	0.8290000000000001
Twickles	2017-09-28	10	109	8	18	0.8290000000000001
Lydia	2017-06-02	33	486	62	95	0.8289
Mashinky	2017-10-06	1622	2124	336	1958	0.8288
Shiver	2017-10-25	13	292	33	46	0.8287000000000001
The Heiress	2017-08-11	720	1377	208	928	0.8286
Shadows of Adam	2017-02-23	60	200	20	80	0.8285
Qbik	2017-11-17	393	100	7	400	0.8284
Code 7: A Story-Driven Hacking Adventure	2017-08-11	18	100	7	25	0.8284
Zork Anthology	2017-04-18	19	65	3	22	0.8284
Conquest of the New World	2017-07-22	25	65	3	28	0.8284
Da Capo 3 R	2017-01-20	31	74	4	35	0.8283
#monstercakes	2017-05-05	1107	697	96	1203	0.8281999999999999
Einlanzer	2017-03-02	23	116	9	32	0.8281999999999999
Midas Gold Plus	2017-02-01	2398	1475	226	2624	0.828
The Walking Vegetables	2017-09-27	30	162	15	45	0.828
Tower Fortress	2017-11-20	10	91	6	16	0.8279000000000001
Fantasya Final Definitiva REMAKE	2017-09-15	401	99	7	408	0.8277
THE VIDEOKID	2017-01-31	6	82	5	11	0.8276000000000001
The Norwood Suite	2017-10-02	295	894	129	424	0.8275
Death's Hangover	2017-01-20	185	408	51	236	0.8275
2MD VR Football Classic	2017-09-26	12	138	12	24	0.8273
Reformers	2017-11-23	5	33	0	5	0.8270000000000001
Alien Splatter Redux	2017-07-28	7	122	10	17	0.8269
Hand of Fate 2	2017-11-07	2873	4534	780	3653	0.8265000000000001
A Robot Named Fight	2017-09-07	100	680	95	195	0.8265000000000001
Excellent Expectations	2017-12-22	64	789	113	177	0.8264
Mysteries of Fence	2017-07-28	52	258	29	81	0.8264
Hand Simulator	2017-07-18	2755	29736	5635	8390	0.8261000000000001
de Blob 2	2017-06-22	10	113	9	19	0.8261000000000001
Codename CURE	2017-10-31	1308	13637	2509	3817	0.826
Ultrawings	2017-07-20	37	350	43	80	0.826
Antihero	2017-07-10	333	664	93	426	0.8259000000000001
Company of Heroes: Blitzkrieg Mod	2017-11-30	354	1623	257	611	0.8258
Necrosphere	2017-09-01	35	128	11	46	0.8258
Icycle: On Thin Ice	2017-10-25	12	80	5	17	0.8258
Mega Man Legacy Collection 2	2017-08-10	184	944	140	324	0.8256
Yu-Gi-Oh! Duel Links	2017-11-17	21520	33134	6332	27852	0.8255
Ticket	2017-03-10	201	43	1	202	0.8255
Toy Clash	2017-08-25	5	43	1	6	0.8255
Cyberia	2017-05-17	5	32	0	5	0.8255
Snail Trek - Chapter 2: A Snail Of Two Worlds	2017-12-12	3	32	0	3	0.8255
Ne no Kami - The Two Princess Knights of Kyoto Part 2	2017-09-07	12	112	9	21	0.8254000000000001
Imperium Galactica	2017-01-19	52	96	7	59	0.8253
Trackless	2017-09-12	10	62	3	13	0.8253
Wonder Boy: The Dragon's Trap	2017-06-08	236	1882	305	541	0.8249
WAVESHAPER	2017-05-03	76	333	41	117	0.8248000000000001
Cinderella Escape 2 Revenge	2017-10-06	102	320	39	141	0.8248000000000001
LEGIE	2017-12-19	7	79	5	12	0.8248000000000001
The Secret Order 6: Bloodline	2017-08-31	44	156	15	59	0.8247
Space Pilgrim Academy: Year 1	2017-10-06	118	103	8	126	0.8245
Company of Heroes: Eastern Front	2017-06-01	226	1189	184	410	0.8244
Tenta Shooter	2017-12-09	19	133	12	31	0.8242
GRIDD: Retroenhanced	2017-05-16	14	61	3	17	0.8242
One Strike	2017-11-03	6	61	3	9	0.8242
Silicon Zeroes	2017-09-18	97	211	23	120	0.8240999999999999
Army Gals	2017-04-17	130	204	22	152	0.8240000000000001
Grass Cutter	2017-03-24	1775	270	32	1807	0.8235
Super Hydorah	2017-09-20	31	168	17	48	0.8235
Star Wars: Droid Repair Bay	2017-12-06	52	392	51	103	0.8234
Organ Quarter	2017-10-19	11	250	29	40	0.8234
Vampire: The Masquerade - Redemption	2017-04-18	68	594	84	152	0.8233
High Hell	2017-10-23	65	1130	176	241	0.8231
Molemen Must Die!	2017-03-21	45	51	2	47	0.8231
Legend of Hand	2017-09-27	19	77	5	24	0.8229000000000001
East 73: Magenta Fairytale	2017-12-30	9	116	10	19	0.8228
Spartaga	2017-08-28	7	41	1	8	0.8227
ARK: Survival Evolved	2017-08-29	248405	516013	106833	355238	0.8226000000000001
Base Defense	2017-11-20	38	274	33	71	0.8226000000000001
The Red Stare	2017-07-31	68	357	46	114	0.8225
SoulSet	2017-02-07	19	123	11	30	0.8225
Army Men RTS	2017-12-20	86	702	103	189	0.8224
Alvora Tactics	2017-06-01	16	108	9	25	0.8224
Zombidle: REMONSTERED	2017-05-30	2382	1392	224	2606	0.8223
We Slay Monsters	2017-06-22	38	68	4	42	0.8223
Virtual Rides 3	2017-03-16	121	600	86	207	0.8222
I.F.O	2017-08-11	14	30	0	14	0.8222
Super Lumi Live	2017-09-05	5	30	0	5	0.8222
Connected Hearts - Visual novel	2017-08-12	29	259	31	60	0.8219
Omegaland	2017-07-12	82	84	6	88	0.8219
The Curse Of Yendor	2017-02-17	12	67	4	16	0.8212
Lost Eden	2017-02-13	4	67	4	8	0.8212
Spears 'n' Spades	2017-08-07	8	40	1	9	0.8212
Gunlock	2017-12-07	7	40	1	8	0.8212
Tokyo Xanadu eX+	2017-12-08	302	1260	203	505	0.821
Fenimore Fillmore: The Westerner	2017-03-11	9	75	5	14	0.821
Rex: Another Island	2017-10-18	8	106	9	17	0.8209000000000001
Scream Collector	2017-10-26	566	586	85	651	0.8207
Stunt Kite Masters VR	2017-06-01	4	58	3	7	0.8207
Magic Wand	2017-06-25	6	58	3	9	0.8207
Mages of Mystralia	2017-05-18	281	1109	177	458	0.8204000000000001
Yeah Jam Fury: U, Me, Everybody!	2017-12-15	8	29	0	8	0.8204000000000001
Let Them Come	2017-10-03	118	968	152	270	0.8203
Blossom Tales: The Sleeping King	2017-03-28	45	453	63	108	0.8203
UniBall	2017-02-24	93	155	16	109	0.8201
Modern Tales: Age of Invention	2017-10-19	50	202	23	73	0.8200000000000001
GIBZ	2017-04-07	113	885	138	251	0.8198000000000001
Cartesian	2017-02-18	8	39	1	9	0.8197
Brain Machine	2017-09-18	6	39	1	7	0.8197
Soul Searching	2017-02-15	21	240	29	50	0.8195
Herald: An Interactive Period Drama	2017-02-22	13	126	12	25	0.8195
Asyula 方舟之链	2017-08-09	72	214	25	97	0.8194
Zarya-1: Mystery on the Moon	2017-05-30	8	89	7	15	0.8193000000000001
Unexplored	2017-02-22	129	589	87	216	0.8190999999999999
Delicious - Emily's Hopes and Fears	2017-01-02	18	65	4	22	0.8190000000000001
Dr. Cares - Pet Rescue 911	2017-09-21	14	65	4	18	0.8190000000000001
Battlestar Galactica Deadlock	2017-08-31	2143	2254	393	2536	0.8188
Nancy Drew: The Silent Spy	2017-04-03	32	96	8	40	0.8188
Queen's Quest 2: Stories of Forgotten Past	2017-02-09	43	199	23	66	0.8186
Goalie Challenge VR	2017-02-04	20	103	9	29	0.8185
Vaporum	2017-09-28	142	717	110	252	0.8184
PUSH	2017-10-18	14	533	78	92	0.8184
Tale of Fallen Dragons	2017-02-06	90	421	59	149	0.8183
Battle Dome	2017-06-08	96	415	58	154	0.8183
Rock of Ages 2	2017-08-28	2273	2542	450	2723	0.8181999999999999
Yet Another Zombie Defense HD	2017-08-25	2573	2120	370	2943	0.818
JYDGE	2017-10-04	139	623	94	233	0.818
Fart Simulator 2018	2017-12-05	6	95	8	14	0.818
SQUIDS FROM SPACE	2017-06-16	39	204	24	63	0.8178000000000001
The Journeyman Project 1: Pegasus Prime	2017-02-20	13	47	2	15	0.8178000000000001
Tokyo Dark	2017-09-07	223	1039	169	392	0.8176000000000001
ENDLESS™ Space 2	2017-05-18	53435	16959	3368	56803	0.8174
Super Skelemania	2017-11-17	12	79	6	18	0.8170999999999999
Fairy Fencer F Advent Dark Force	2017-02-14	971	1929	337	1308	0.8170000000000001
Dragonia	2017-05-29	1118	4845	908	2026	0.8169
Tiny Echo	2017-08-31	25	526	78	103	0.8169
Invisigun Reloaded	2017-02-08	257	439	63	320	0.8169
Fibrillation HD	2017-04-12	14	265	34	48	0.8169
Darknet	2017-06-08	23	101	9	32	0.8169
Heart of the House	2017-10-26	31	55	3	34	0.8169
Armed with Wings: Rearmed	2017-06-01	524	409	58	582	0.8168000000000001
TTV2	2017-09-11	127	156	17	144	0.8167
Weed Shop 2	2017-03-31	422	739	116	538	0.8166
Prison Boss VR	2017-08-29	22	214	26	48	0.8165000000000001
Faerie Solitaire Remastered	2017-12-22	69	437	63	132	0.8164
Getting Over It with Bennett Foddy	2017-12-06	5054	48108	9968	15022	0.8163
Microtransaction Simulator	2017-09-14	189	698	109	298	0.8163
Fantasia of the Wind - 风之幻想曲	2017-10-26	98	342	47	145	0.8162
仙剑奇侠传五 前传（Chinese Paladin：Sword and Fairy 5 Prequel）	2017-09-30	596	1874	329	925	0.8161
The Legacy: Forgotten Gates	2017-08-04	17	78	6	23	0.8161
克莉丝的炎之信仰 Cryste: the Faith of Fire Vol.1	2017-05-17	35	262	34	69	0.8158
Shooty Fruity	2017-12-19	20	174	20	40	0.8158
Ball 3D: Soccer Online	2017-03-31	6162	7420	1439	7601	0.8157
MINDNIGHT	2017-08-04	422	2506	453	875	0.8156
Splody	2017-03-21	27	85	7	34	0.8156
Floor Plan: Hands-On Edition	2017-09-14	8	85	7	15	0.8156
Witchinour	2017-06-12	7	54	3	10	0.8156
Super Man Or Monster	2017-10-31	71	106	10	81	0.8151
Wrestling Revolution 3D	2017-07-20	68	338	47	115	0.8150000000000001
TO THE TOP	2017-05-18	58	650	102	160	0.8148000000000001
Rocking Pilot	2017-05-15	189	45	2	191	0.8148000000000001
Portal Knights	2017-05-18	6545	17007	3457	10002	0.8144
Choice of Rebels: Uprising	2017-11-09	121	112	11	132	0.8144
Faeria	2017-03-08	3675	5766	1115	4790	0.8143000000000001
The Drone Racing League Simulator	2017-11-01	421	2743	505	926	0.8143000000000001
The Coma: Recut	2017-09-22	411	1438	250	661	0.8143000000000001
Danmaku Unlimited 3	2017-03-09	25	165	19	44	0.8143000000000001
XGun-Weapon Evolution	2017-05-16	16	105	10	26	0.8143000000000001
Project Nimbus: Complete Edition	2017-09-26	99	1264	217	316	0.8142
Miles & Kilo	2017-11-30	7	61	4	11	0.8142
MXGP3 - The Official Motocross Videogame	2017-05-30	504	805	131	635	0.8140999999999999
VR Battleship YAMATO	2017-08-18	18	76	6	24	0.8140000000000001
Voxel Turf	2017-09-14	263	454	68	331	0.8136
Octopus Bar	2017-09-22	32	111	11	43	0.8136
de Blob	2017-04-27	37	226	29	66	0.8135
Skylar & Plux: Adventure On Clover Island	2017-05-19	51	362	52	103	0.8134
Lily of the Valley	2017-05-05	9	68	5	14	0.8134
Shark Simulator	2017-11-22	111	396	58	169	0.8133
Gaia's Melody: Echoed Melodies	2017-10-20	12	44	2	14	0.8133
Scarlett Mysteries: Cursed Child	2017-06-08	40	207	26	66	0.8131999999999999
Serious Sam VR: The First Encounter	2017-03-30	75	525	81	156	0.8131
Mega Overload	2017-04-18	96	35	1	97	0.813
Dark Parables: Ballad of Rapunzel Collector's Edition	2017-05-01	9	35	1	10	0.813
Tricone Lab	2017-07-27	5	75	6	11	0.8129000000000001
Warhammer 40,000: Sanctus Reach	2017-01-19	735	1097	188	923	0.8127
TEKKEN 7	2017-06-01	18966	66244	14211	33177	0.8126000000000001
Puzzle Puppers	2017-01-20	14	89	8	22	0.8125
Gang Beasts	2017-12-12	3062	38960	8271	11333	0.8122
Imperium Galactica II	2017-01-19	160	409	61	221	0.8122
South Park The Fractured But Whole	2017-10-17	21609	17363	3602	25211	0.8118000000000001
Cublast HD	2017-04-28	62	43	2	64	0.8117000000000001
STATUS: INSANE	2017-11-14	6	43	2	8	0.8117000000000001
Furious Angels	2017-02-27	16	333	48	64	0.8116
Day of Infamy	2017-03-23	9210	18120	3785	12995	0.8111
Sudden Strike Gold	2017-05-22	109	303	43	152	0.8111
Entanglement	2017-10-17	11	34	1	12	0.8111
Will Glow the Wisp	2017-09-15	314	851	144	458	0.8108
Save the Ninja Clan	2017-01-20	4941	94	9	4950	0.8107
Fabulous - Angela's High School Reunion	2017-06-22	18	73	6	24	0.8107
Carcassonne: The Official Board Game	2017-11-29	1050	1643	299	1349	0.8106
Dal Segno	2017-06-30	33	114	12	45	0.8106
Crowtel Renovations	2017-01-06	17	58	4	21	0.8104000000000001
CHAOS CODE -NEW SIGN OF CATASTROPHE-	2017-03-16	106	195	25	131	0.8103
Rumpus	2017-04-12	5	24	0	5	0.8103
Frog Hop	2017-02-23	13	24	0	13	0.8103
Avatar Of The Wolf	2017-06-22	34	24	0	34	0.8103
Senalux	2017-10-16	5	24	0	5	0.8103
カニマン VS メカモンキー	2017-10-27	4	24	0	4	0.8103
Stationeers	2017-12-12	1485	4437	874	2359	0.8101
Reflex Arena	2017-03-08	240	1304	233	473	0.8101
Belko VR: An Escape Room Experiment	2017-03-03	41	560	90	131	0.8101
Solaroids	2017-05-26	13	42	2	15	0.81
Boinks	2017-11-27	6	42	2	8	0.81
Cooking Witch	2017-05-18	1201	200	26	1227	0.8098000000000001
Plasma Puncher	2017-05-11	91	65	5	96	0.8098000000000001
First Strike: Classic	2017-05-31	159	1144	203	362	0.8094
Asura: Vengeance Edition	2017-04-14	456	577	94	550	0.8092
Play With Gilbert - Remake	2017-11-15	11	112	12	23	0.809
BlobCat	2017-08-31	26	57	4	30	0.809
VALKYRIE DRIVE -BHIKKHUNI-	2017-06-20	524	955	167	691	0.8088
Strike Vector EX	2017-07-19	132	644	107	239	0.8088
aMAZE 2	2017-04-21	5735	654	109	5844	0.8087000000000001
Serious Sam VR: The Last Hope	2017-09-20	362	1122	200	562	0.8086
Eye in the Sky	2017-12-05	8	85	8	16	0.8085
Splat the Blob	2017-10-06	7	85	8	15	0.8085
A Rose in the Twilight	2017-04-11	51	390	60	111	0.8084
Blink	2017-03-10	39	71	6	45	0.8084
Alien Shooter TD	2017-01-13	1032	657	110	1142	0.8083
WayOut 2: Hex	2017-02-10	1863	306	45	1908	0.8081999999999999
Alpacapaca Dash	2017-01-24	1606	167	21	1627	0.8081999999999999
Swarm Queen	2017-12-19	24	167	21	45	0.8081999999999999
Once on a windswept night	2017-02-06	18	136	16	34	0.8079000000000001
Princess Evangile W Happiness - Steam Edition	2017-07-28	66	56	4	70	0.8076000000000001
Mutiny!!	2017-10-20	324	219	30	354	0.8075
Yissa Deep Realms	2017-11-23	22	70	6	28	0.8072
Dimensional Rift	2017-02-09	7	32	1	8	0.8072
GORB	2017-04-07	5	32	1	6	0.8072
Sidewords	2017-09-07	33	32	1	34	0.8072
DUNGEONS OF CHAOS	2017-09-15	66	141	17	83	0.8070999999999999
Fruity Smoothie	2017-12-21	80	183	24	104	0.807
In The Shadows	2017-10-20	8	48	3	11	0.8069
Hide and Shriek	2017-10-19	1028	3870	776	1804	0.8068000000000001
Psebay	2017-07-12	1014	103	11	1025	0.8068000000000001
Lost Technology	2017-08-09	92	427	68	160	0.8066
M.A.X.: Mechanized Assault & Exploration	2017-04-07	34	128	15	49	0.8066
Blackout Z: Slaughterhouse Edition	2017-10-20	168	1408	262	430	0.8064
7 days with Death	2017-10-14	10	55	4	14	0.8062
TrainerVR	2017-12-27	7	55	4	11	0.8062
Hyperun	2017-09-08	26	76	7	33	0.8061
Super Cloudbuilt 	2017-07-25	57	244	35	92	0.8059000000000001
Expeditions: Viking	2017-04-27	2901	2979	592	3493	0.8057
Hard Time	2017-08-16	11	198	27	38	0.8057
Towards The Pantheon: Escaping Eternity	2017-10-25	18	108	12	30	0.8056000000000001
旧手表-Old Watch	2017-12-20	89	554	93	182	0.8055
THE 2048	2017-07-13	10	82	8	18	0.8054000000000001
DYSTORIA	2017-02-21	11	47	3	14	0.8053
Dies irae ~Amantes amentes~	2017-06-02	283	432	70	353	0.8051
UBERMOSH:WRAITH	2017-01-29	7	197	27	34	0.8051
Causality	2017-02-02	5	31	1	6	0.8051
Crisis in the Kremlin	2017-03-20	3095	1072	197	3292	0.8047
Aliens Go Home Run	2017-01-27	53	68	6	59	0.8047
Reigns: Her Majesty	2017-12-07	292	918	166	458	0.8046
Bomb Squad Academy	2017-03-28	52	377	60	112	0.8046
Antagonist	2017-03-17	6	61	5	11	0.8046
Reflex	2017-11-23	1528	625	108	1636	0.8043000000000001
Everything	2017-04-21	629	2816	566	1195	0.8038
Sentience: The Android's Tale	2017-06-02	814	106	12	826	0.8038
Card Quest	2017-11-07	27	261	39	66	0.8036
Induction	2017-02-07	14	118	14	28	0.8036
The Dragons' Twilight	2017-07-24	7	46	3	10	0.8036
Ticket to Earth	2017-06-28	10	93	10	20	0.8034
Gorescript	2017-06-15	20	60	5	25	0.8031999999999999
Power Solitaire VR	2017-06-08	45	30	1	46	0.8029999999999999
Fist's Elimination Tower	2017-08-28	66	38	2	68	0.8029000000000001
Wacky Wings VR Edition	2017-01-16	3	21	0	3	0.8028000000000001
Space Rogue Classic	2017-03-28	3	21	0	3	0.8028000000000001
Les Quatre Alices	2017-08-28	3	21	0	3	0.8028000000000001
Defenders of Ekron	2017-08-15	11	21	0	11	0.8028000000000001
EatWell	2017-07-27	3	21	0	3	0.8028000000000001
Lily's Day Off	2017-01-06	17	164	22	39	0.8027
Interplanetary: Enhanced Edition	2017-08-02	370	641	113	483	0.8025
Serious Sam 3 VR: BFE	2017-11-09	52	438	73	125	0.8025
BRAIN / OUT	2017-02-24	2032	12563	2757	4789	0.8024
Computer Tycoon	2017-10-12	390	725	130	520	0.8024
CrossCells	2017-05-26	113	570	99	212	0.8024
Your Bunny Wrote	2017-12-04	9	152	20	29	0.8024
Park Bound	2017-11-30	30	92	10	40	0.8024
Beat Cop	2017-03-30	754	3754	778	1532	0.8023
Styx: Shards of Darkness	2017-03-14	1241	3796	789	2030	0.802
StarCrawlers	2017-05-23	465	703	126	591	0.802
Bouncing Duck Simulator	2017-09-08	34	110	13	47	0.8019
Mystika 3 : Awakening of the dragons	2017-06-23	17	59	5	22	0.8018000000000001
MegaGlest	2017-04-01	8	52	4	12	0.8017000000000001
Hop Step Sing! kiss×kiss×kiss (HQ Edition)	2017-06-30	5	52	4	9	0.8017000000000001
My Coloring Book: Transport	2017-11-21	6	52	4	10	0.8017000000000001
Duck Season	2017-09-14	83	1089	206	289	0.8015000000000001
Sundered: Eldritch Edition	2017-07-28	708	3631	756	1464	0.8014
Counter Fight: Samurai Edition	2017-06-07	10	72	7	17	0.8014
Totemori	2017-02-10	30	266	41	71	0.8012
Road Redemption	2017-10-04	806	8894	1943	2749	0.8011
THE KING OF FIGHTERS XIV STEAM EDITION	2017-06-15	1197	3128	647	1844	0.8011
BIGFOOT	2017-01-31	1525	12964	2880	4405	0.8009000000000001
Inertia	2017-12-01	18	523	91	109	0.8009000000000001
Witch of Ice Kingdom II	2017-01-06	109	78	8	117	0.8009000000000001
Cow Milking Simulator	2017-10-31	98	37	2	100	0.8009000000000001
Defend the Cake	2017-12-01	7	37	2	9	0.8009000000000001
Idle Bouncer	2017-09-27	420	302	48	468	0.8007
CRYPTARK	2017-06-20	108	817	151	259	0.8006000000000001
Spelunker Party!	2017-10-19	20	58	5	25	0.8004000000000001
LEAVES - The Return	2017-03-14	95	248	38	133	0.8003
🔴 Circles	2017-02-17	7	114	14	21	0.8002
Balloon Popping Pigs	2017-01-30	36	44	3	39	0.8002
MSI Electric City: Core Assault	2017-09-08	10	71	7	17	0.8001
Indygo	2017-10-24	8	51	4	12	0.8001
Kona	2017-03-17	349	2460	505	854	0.8
Oh...Sir! The Hollywood Roast	2017-05-31	1868	295	47	1915	0.8
Runic Rampage	2017-05-17	11	171	24	35	0.8
Lit the Torch	2017-08-03	2	20	0	2	0.8
JU	2017-10-19	3	20	0	3	0.8
Prey with Gun	2017-11-24	80	165	23	103	0.7997
Cyberhunt	2017-05-19	5810	1219	237	6047	0.7996
ICY: Frostbite Edition	2017-08-11	247	314	51	298	0.7993000000000001
Nevrosa: Prelude	2017-02-23	13	181	26	39	0.7993000000000001
NIGHTSTAR: STARFIGHTER	2017-03-08	6	57	5	11	0.7989
Squarism	2017-11-21	19	57	5	24	0.7989
Dolphin Up	2017-05-04	11	28	1	12	0.7983
Radium 2	2017-03-02	18	28	1	19	0.7983
Knight Terrors	2017-10-31	4	28	1	5	0.7983
Cosmic Trip	2017-05-24	66	437	76	142	0.7981
Pinball Wicked	2017-10-12	10	157	22	32	0.7981
Wild Guns Reloaded	2017-07-11	30	300	49	79	0.7979
SOK	2017-12-22	6	105	13	19	0.7973
World of Warships	2017-11-15	411338	96149	23099	434437	0.7972
Unforgiving - A Northern Hymn	2017-11-27	90	1114	219	309	0.7972
Twisted Arrow	2017-03-28	13	81	9	22	0.7970999999999999
CapRiders: Euro Soccer	2017-04-07	17	19	0	17	0.7970999999999999
GUNGUNGUN	2017-04-14	13	19	0	13	0.7970999999999999
Zap Zone	2017-02-10	5	19	0	5	0.7970999999999999
Chainless	2017-03-24	3	19	0	3	0.7970999999999999
Rangi	2017-08-03	4	19	0	4	0.7970999999999999
CubeWorks	2017-10-31	3	19	0	3	0.7970999999999999
Revhead	2017-03-10	74	447	79	153	0.7968000000000001
Ricochet Kills: Noir	2017-03-04	11	49	4	15	0.7968000000000001
Flagsplosion	2017-06-28	4	49	4	8	0.7968000000000001
Red Obsidian Remnant	2017-09-05	290	693	130	420	0.7967000000000001
Freedom Locomotion VR	2017-03-13	24	182	27	51	0.7967000000000001
Semispheres	2017-02-14	25	62	6	31	0.7967000000000001
Christmas Stories: A Christmas Carol Collector's Edition	2017-12-01	21	42	3	24	0.7965000000000001
The Infectious Madness of Doctor Dekker	2017-05-19	165	416	73	238	0.7964
State of Anarchy Complete: Master of Mayhem	2017-03-31	4012	450	80	4092	0.7963
Tomboys Need Love Too!	2017-05-12	51	154	22	73	0.7961
YANKAI'S PEAK.	2017-07-13	5	55	5	10	0.7958
Midnight at the Celestial Palace: Chapter I	2017-02-24	6	27	1	7	0.7958
sphereFACE	2017-05-19	58	27	1	59	0.7958
A Snake's Tale	2017-07-06	4	27	1	5	0.7958
Next	2017-11-11	7	212	33	40	0.7957
True or False 2	2017-01-27	42	126	17	59	0.7957
Ignition	2017-02-06	10	164	24	34	0.7955
4D Toys	2017-06-02	14	164	24	38	0.7955
Isotiles	2017-06-16	6	153	22	28	0.7954000000000001
Nefarious	2017-01-23	123	338	58	181	0.7952
Yonder: The Cloud Catcher Chronicles	2017-07-18	1305	2412	514	1819	0.795
RuneSage	2017-09-28	6	48	4	10	0.795
Monsters' Den: Godfall	2017-07-07	487	406	72	559	0.7948999999999999
MidBoss	2017-05-25	97	226	36	133	0.7948000000000001
Mary Le Chef - Cooking Passion	2017-06-23	18	85	10	28	0.7948000000000001
MMM: Murder Most Misfortunate	2017-05-01	579	79	9	588	0.7947
A Long Road Home	2017-01-31	686	34	2	688	0.7946
Cursed Treasure 2	2017-07-21	122	341	59	181	0.7945000000000001
Bucket Detective	2017-02-16	10	215	34	44	0.7945000000000001
I Am Overburdened	2017-11-02	25	130	18	43	0.7945000000000001
Morgan lives in a Rocket House in VR	2017-11-03	10	41	3	13	0.7945000000000001
Interkosmos	2017-04-25	183	316	54	237	0.7944
Riptale	2017-04-27	24	96	12	36	0.7942
Pixel Puzzles Junior	2017-02-17	1046	135	19	1065	0.7941
Oik Memory	2017-12-29	54	167	25	79	0.7939
Viral EX	2017-07-10	9	18	0	9	0.7939
ICEBOX: Speedgunner	2017-10-18	4	18	0	4	0.7939
Cursery: The Crooked Man and the Crooked Cat Collector's Edition	2017-04-12	4	18	0	4	0.7939
Burst Fighter	2017-09-16	5	18	0	5	0.7939
Dark Parables: Queen of Sands Collector's Edition	2017-07-28	6	18	0	6	0.7939
Kyklos Code	2017-12-15	7	18	0	7	0.7939
Dungeon's Barrage	2017-12-21	3	18	0	3	0.7939
CPU Invaders	2017-02-17	2489	593	112	2601	0.7938
Drop Hunt	2017-02-23	3107	284	48	3155	0.7936
Blasters of the Universe	2017-08-31	24	203	32	56	0.7936
Magical Squash	2017-11-10	3	72	8	11	0.7935
Balthazar's Dream	2017-05-30	48	101	13	61	0.7934000000000001
Entangle	2017-02-17	10	47	4	14	0.7931999999999999
3..2..1..Grenades!	2017-06-21	5	26	1	6	0.7931999999999999
Far from Noise	2017-11-14	11	139	20	31	0.793
EMERGENCY 20	2017-10-31	765	1212	249	1014	0.7928000000000001
Animal Lover	2017-02-14	230	128	18	248	0.7928000000000001
Kart Racing Pro	2017-07-14	93	287	49	142	0.7927
Train Frontier Classic	2017-12-15	33	165	25	58	0.7926000000000001
Fidget Spinner Editor	2017-10-09	5	83	10	15	0.7925
Viktor, a Steampunk Adventure	2017-03-17	10	53	5	15	0.7925
Ballway	2017-07-20	3	53	5	8	0.7925
Life of a Mobster	2017-03-17	31	33	2	33	0.7923
Invisibox	2017-10-18	940	59	6	946	0.7922
ReThink | Evolved	2017-09-15	6	59	6	12	0.7922
Astoria: The Holders of Power Saga	2017-08-02	12	71	8	20	0.7920999999999999
Project CARS 2	2017-09-21	6775	14317	3398	10173	0.792
Detention	2017-01-12	2335	11104	2613	4948	0.7919
Slime-san	2017-04-07	128	240	40	168	0.7917000000000001
Age of Rivals	2017-03-14	32	189	30	62	0.7914
Ghostory	2017-10-23	14	46	4	18	0.7914
Rocket Wars	2017-06-15	621	46	4	625	0.7914
Aaero	2017-04-11	289	710	140	429	0.7913
Wo Yao Da	2017-09-15	203	214	35	238	0.7912
Aporia: Beyond The Valley	2017-07-19	96	557	107	203	0.7909999999999999
Little Kite	2017-09-14	3104	115	16	3120	0.7909999999999999
Lines	2017-06-08	52	93	12	64	0.7909999999999999
Beekyr Reloaded	2017-11-14	11	76	9	20	0.7909999999999999
Wunderdoktor	2017-10-11	8	76	9	17	0.7909999999999999
Trianga's Project: Battle Splash 2.0	2017-12-19	6	70	8	14	0.7908
Trianguluv	2017-03-15	1557	52	5	1562	0.7908
TAURONOS	2017-08-04	5	52	5	10	0.7908
Hostil	2017-12-01	7	203	33	40	0.7907
Blocks	2017-07-06	111	167	26	137	0.7905
Shoot Shoot Mega Pack	2017-04-28	4	17	0	4	0.7905
Zombie Killin'	2017-01-31	121	17	0	121	0.7905
Cadenza: Music, Betrayal and Death Collector's Edition	2017-05-03	4	17	0	4	0.7905
Christmas Puzzle	2017-11-07	10	17	0	10	0.7905
Monarch of Greed - Act 1	2017-11-29	28	17	0	28	0.7905
School of Talent: SUZU-ROUTE	2017-02-23	103	98	13	116	0.7904000000000001
Otome Romance Jigsaws - Midnight Cinderella & Destined to Love	2017-02-27	6	25	1	7	0.7904000000000001
HAUNTED: Halloween '86 (The Curse Of Possum Hollow)	2017-03-28	4	25	1	5	0.7904000000000001
BOROS	2017-04-06	24	25	1	25	0.7904000000000001
Eventide Night	2017-05-04	5265	25	1	5266	0.7904000000000001
Companion	2017-03-31	4	81	10	14	0.7901
Nioh: Complete Edition	2017-11-07	10649	25316	6193	16842	0.79
Nancy Drew: The Secret of Shadow Ranch	2017-01-09	30	103	14	44	0.7898999999999999
Adventures of the Worm	2017-08-18	5	32	2	7	0.7898999999999999
Achievement Clicker	2017-11-17	52	2018	442	494	0.7898000000000001
Don't Make Love	2017-10-26	153	356	65	218	0.7896
An Alien with a Magnet	2017-03-29	623	45	4	627	0.7895000000000001
Shuyan Saga	2017-08-08	25	421	79	104	0.7894
Missile Cards	2017-04-07	11	51	5	16	0.7891
Ghosts of Miami	2017-08-22	11	51	5	16	0.7891
Trenches of War	2017-07-06	13	57	6	19	0.789
Gal*Gun VR	2017-08-09	65	389	73	138	0.7881
Gene Shift Auto	2017-05-23	214143	1803	397	214540	0.788
Island Dash	2017-08-30	43	416	79	122	0.7879
Fugl	2017-09-14	18	434	83	101	0.7877
Hello Neighbor	2017-12-08	1414	9327	2248	3662	0.7875
Zombie Solitaire 2 Chapter 2	2017-10-09	16	44	4	20	0.7875
Clarent Saga: Tactics	2017-09-25	6	44	4	10	0.7875
Block King	2017-02-10	7	24	1	8	0.7875
Scribble Ships	2017-03-29	18	24	1	19	0.7875
Hopalong: The Badlands	2017-11-22	4	24	1	5	0.7875
Tell a Demon	2017-07-21	4	24	1	5	0.7875
Headmaster	2017-08-30	6	31	2	8	0.7874
A House of Many Doors	2017-02-03	90	326	60	150	0.7872
The Talos Principle VR	2017-10-17	96	612	123	219	0.7870999999999999
Frequent Flyer	2017-01-20	518	73	9	527	0.7870999999999999
Circuit Dude	2017-08-03	5	16	0	5	0.7869
Debris Infinity	2017-12-08	4	16	0	4	0.7869
Sigi - A Fart for Melusina	2017-12-22	7	100	14	21	0.7868
Super Sports Surgery	2017-06-22	12	191	32	44	0.7866
Rosenkreuzstilette Freudenstachel	2017-10-17	19	105	15	34	0.7865000000000001
Shift Happens	2017-02-22	3905	2182	494	4399	0.7861
VoiceActress	2017-11-29	86	190	32	118	0.7859999999999999
Alicia Quatermain: Secrets Of The Lost Treasures	2017-09-01	14	115	17	31	0.7859999999999999
STLD Redux: Episode 02	2017-05-19	4	37	3	7	0.7859999999999999
Dick Wilde	2017-03-29	9	37	3	12	0.7859999999999999
Life on Mars Remake	2017-08-11	5	37	3	8	0.7859999999999999
Shadowhand	2017-12-07	231	606	123	354	0.7858
Romance of the Three Kingdoms IX with Power Up Kit	2017-10-18	229	313	58	287	0.7858
FURIDASHI: Drift Cyber Sport	2017-11-02	114	995	213	327	0.7855
Lamm	2017-02-09	15	49	5	20	0.7855
God of Light: Remastered	2017-11-08	6	43	4	10	0.7855
Nature Treks VR	2017-05-04	20	236	42	62	0.7848999999999999
Geo	2017-01-31	112	139	22	134	0.7848
Haque	2017-11-23	15	134	21	36	0.7848
Red's Kingdom	2017-01-19	17	30	2	19	0.7848
Henry The Hamster Handler VR	2017-01-16	154	30	2	156	0.7848
Super Perspective	2017-09-15	7	30	2	9	0.7848
Rule with an Iron Fish	2017-08-24	10	30	2	12	0.7848
Wolfenstein II: The New Colossus	2017-10-27	16141	28932	7353	23494	0.7847
Serious Sam VR: The Second Encounter	2017-04-04	23	173	29	52	0.7844
Boot Hill Bounties	2017-12-15	5	23	1	6	0.7844
Pixel Puzzles Mosaics	2017-06-09	1612	71	9	1621	0.7843000000000001
Sakura Gamer	2017-10-05	56	336	64	120	0.784
Constructor Classic 1997	2017-04-28	24	54	6	30	0.784
Farmington Tales	2017-07-18	17	92	13	30	0.7837999999999999
SYMMETRY alpha	2017-02-13	14	36	3	17	0.7837000000000001
UNTITLED	2017-06-02	6	36	3	9	0.7837000000000001
Atelier Firis: The Alchemist and the Mysterious Journey	2017-03-07	393	513	104	497	0.7836
Breaking Good	2017-08-05	7	97	14	21	0.7835
System Goose Overload	2017-08-04	6	65	8	14	0.7835
Ski Sniper	2017-05-18	106	205	36	142	0.7834000000000001
Attack of the Bugs	2017-11-29	5	42	4	9	0.7834000000000001
Grave Chase	2017-09-20	8	42	4	12	0.7834000000000001
Bearslayer	2017-01-13	14	15	0	14	0.783
Crashimals	2017-09-07	2	15	0	2	0.783
Drone Fighters	2017-04-21	28	15	0	28	0.783
Travel Riddles: Trip To Greece	2017-06-23	9	15	0	9	0.783
Clad in Iron: Gulf of Mexico 1864	2017-09-05	3	15	0	3	0.783
Dark Parables: Goldilocks and the Fallen Star Collector's Edition	2017-09-19	9	15	0	9	0.783
Happy Neighbors	2017-11-08	4	15	0	4	0.783
Astrohazard Solutions Ltd.	2017-12-11	3	15	0	3	0.783
Heart of the Emberstone: Coliseum	2017-12-18	496	59	7	503	0.7828
Starblast	2017-11-08	87	627	131	218	0.7827
Leisure Suit Larry 7 - Love for Sail	2017-12-22	31	151	25	56	0.7826000000000001
Friday the 13th: The Game	2017-05-26	16096	57319	15021	31117	0.7823000000000001
BERSERK and the Band of the Hawk	2017-02-21	1271	2211	515	1786	0.7823000000000001
Downward Spiral: Prologue	2017-03-31	13	106	16	29	0.7822
Gloom	2017-04-13	24	468	95	119	0.7820999999999999
Cluckles' Adventure	2017-04-10	11	29	2	13	0.7820999999999999
Creatures Such as We	2017-05-12	5	29	2	7	0.7820999999999999
Nox Dei	2017-12-01	6	29	2	8	0.7820999999999999
SAMURAI WARRIORS: Spirit of Sanada	2017-05-23	127	485	99	226	0.7819
DiRT 4	2017-06-08	4396	12430	3144	7540	0.7818
Yono and the Celestial Elephants	2017-10-12	87	202	36	123	0.7817000000000001
Card City Nights 2	2017-09-01	62	145	24	86	0.7817000000000001
Starlight of Aeons	2017-12-09	687	280	53	740	0.7816
Tom Clancy's Ghost Recon® Wildlands	2017-03-07	45704	59610	15713	61417	0.7815000000000001
Deceit	2017-03-03	16923	68554	18129	35052	0.7814
Minos Strategos	2017-01-27	20	35	3	23	0.7813
The Myth Seekers: The Legacy of Vulcan	2017-08-10	85	154	26	111	0.7812000000000001
Echo Grotto	2017-09-20	5	58	7	12	0.7812000000000001
The Filmmaker - A Text Adventure	2017-03-08	16	22	1	17	0.7811
Cubrick	2017-04-12	10	22	1	11	0.7811
Sojourner	2017-07-17	8	22	1	9	0.7811
Sudden Strike 2 Gold	2017-05-22	58	205	37	95	0.7807
The Gallery - Episode 2: Heart of the Emberstone	2017-10-18	67	327	64	131	0.7806000000000001
Tragedy of Prince Rupert	2017-07-26	39	52	6	45	0.7803
A Clockwork Ley-Line: The Borderline of Dusk	2017-12-19	16	46	5	21	0.7796
Cubic	2017-10-09	13	262	50	63	0.7795000000000001
Gary Grigsby's War in the West	2017-08-03	48	123	20	68	0.7795000000000001
Cookies vs. Claus	2017-12-03	49	212	39	88	0.7794
古剑奇谭(GuJian)	2017-09-08	1782	3742	917	2699	0.7793000000000001
A Duel Hand Disaster: Trackher	2017-08-29	6	28	2	8	0.7792
aMAZE	2017-03-14	2143	581	124	2267	0.7791
Carpe Diem: Reboot	2017-09-30	7	108	17	24	0.7791
Jake's Love Story	2017-10-06	6	108	17	23	0.7791
Neptunian Donut	2017-10-12	24	108	17	41	0.7791
RUMP! - It's a Jump and Rump!	2017-05-12	23	40	4	27	0.779
Sword Art Online: Hollow Realization Deluxe Edition	2017-10-27	3254	5737	1438	4692	0.7789
Nidhogg 2	2017-08-15	327	883	197	524	0.7787999999999999
Nadia Was Here	2017-05-26	7	34	3	10	0.7787999999999999
Pivot Pilot	2017-01-07	154	34	3	157	0.7787999999999999
Lines X	2017-10-31	33	663	144	177	0.7787000000000001
Sumer	2017-02-15	5	14	0	5	0.7787000000000001
VR Aquarium -雅-	2017-01-11	3	14	0	3	0.7787000000000001
Turn	2017-03-10	7	14	0	7	0.7787000000000001
Over My Dead Body (For You)	2017-09-11	4	14	0	4	0.7787000000000001
Freefall	2017-06-01	3	14	0	3	0.7787000000000001
Slam Fighter II	2017-11-18	2	14	0	2	0.7787000000000001
Onironauta	2017-10-09	2	14	0	2	0.7787000000000001
White Day: A Labyrinth Named School	2017-08-22	299	1905	452	751	0.7785
Night Trap - 25th Anniversary Edition	2017-08-15	42	141	24	66	0.7785
Hop Step Sing! Kisekiteki Shining! (HQ Edition)	2017-06-30	6	51	6	12	0.7785
Payroll	2017-04-03	13	51	6	19	0.7785
The Legend of Dark Witch Episode 2 -The Price of Desire-	2017-01-20	25	51	6	31	0.7785
Bit Heroes	2017-12-13	977	2204	528	1505	0.7784000000000001
This Strange Realm Of Mine	2017-07-19	117	412	85	202	0.7782
Star Wars: Imperial Assault - Legends of the Alliance	2017-12-04	98	131	22	120	0.778
Bedfellows FRENZY	2017-02-23	15	87	13	28	0.7778
Iron Crypticle	2017-07-12	69	87	13	82	0.7778
PacaPlus	2017-03-30	7	56	7	14	0.7777
Train Bandit	2017-10-12	6	56	7	13	0.7777
Ramify	2017-04-21	555	21	1	556	0.7777
Spycraft: The Great Game	2017-04-18	6	21	1	7	0.7777
AuroraBound Deluxe	2017-11-01	5	21	1	6	0.7777
Maniac Mansion	2017-12-18	25	121	20	45	0.7776000000000001
Hover	2017-05-31	428	1635	387	815	0.7774
Run!ZombieFood!	2017-07-31	691	907	205	896	0.7774
Strain Tactics	2017-05-04	28	172	31	59	0.7772
Tacopocalypse	2017-03-14	13	61	8	21	0.7772
The Falconers: Moonlight	2017-04-18	6	61	8	14	0.7772
Oriental Empires	2017-09-14	896	2269	550	1446	0.777
Little Red Lie	2017-07-07	13	106	17	30	0.777
Wander No More	2017-02-18	16	139	24	40	0.7768
Digby Extreme	2017-10-17	14	39	4	18	0.7767000000000001
Mindsight	2017-10-26	7	50	6	13	0.7765000000000001
Eventide 3: Legacy of Legends	2017-09-28	36	198	37	73	0.7764
Upside Down	2017-02-14	3296	511	110	3406	0.7763
I Am The Hero	2017-01-16	87	444	94	181	0.7763
KByte	2017-02-24	3	27	2	5	0.7762000000000001
Command: Chains of War	2017-05-18	46	27	2	48	0.7762000000000001
Tooth and Tail	2017-09-12	1975	3083	765	2740	0.7761
Sweet fantasy	2017-04-04	271	379	79	350	0.7758
Tank Warfare: Tunisia 1943	2017-05-01	46	280	56	102	0.7755
Mercury Fallen	2017-10-16	122	165	30	152	0.7755
Fidget Spinner	2017-09-06	18	549	120	138	0.7754000000000001
Mad Age & This Guy	2017-10-24	10	90	14	24	0.7754000000000001
LandTraveller	2017-06-09	12	44	5	17	0.7754000000000001
Skipper	2017-10-18	4	44	5	9	0.7754000000000001
Phantom Jump	2017-12-08	9	44	5	14	0.7754000000000001
YAPP: Yet Another Puzzle Platformer	2017-12-01	8	44	5	13	0.7754000000000001
Orange Season	2017-04-21	30	249	49	79	0.7752
CAYNE	2017-01-24	589	1253	296	885	0.7751000000000001
Romance of the Three Kingdoms X with Power Up Kit	2017-12-06	322	377	79	401	0.7751000000000001
SolarGun	2017-07-28	2376	169	31	2407	0.7751000000000001
A Girls Fabric Face	2017-03-10	8	160	29	37	0.7751000000000001
Conduct DELUXE!	2017-12-05	23	137	24	47	0.7751000000000001
Gas Guzzlers: Combat Carnage	2017-03-10	16	80	12	28	0.7751000000000001
Square n Fair	2017-01-30	1214	75	11	1225	0.7751000000000001
Our End of the World	2017-11-03	720	3452	871	1591	0.7745000000000001
Blortasia	2017-01-05	8	49	6	14	0.7745000000000001
Kreedz Climbing	2017-06-15	379	772	176	555	0.7744
Guns'n'Stories: Preface VR	2017-10-26	35	230	45	80	0.7744
Armored Kitten	2017-09-30	133	303	62	195	0.7743000000000001
Jet Buster	2017-10-24	119	38	4	123	0.7743000000000001
Rescue Team 7	2017-08-16	20	38	4	24	0.7743000000000001
Riaaf The Spider	2017-07-13	7	136	24	31	0.7742
Neofeud	2017-09-19	7	181	34	41	0.7741
Duck Life: Space	2017-05-05	23	89	14	37	0.7741
Kult of Ktulu: Olympic	2017-02-09	4	13	0	4	0.7741
Neo Angle	2017-10-20	2	13	0	2	0.7741
Temple Raid	2017-10-26	2	13	0	2	0.7741
Zombie Bloxx	2017-11-22	5	13	0	5	0.7741
Stand by you	2017-12-09	4	13	0	4	0.7741
void LINK	2017-12-28	6	20	1	7	0.774
Splinter Zone	2017-06-01	3	20	1	4	0.774
Future Unfolding	2017-03-15	28	79	12	40	0.7737999999999999
Chimpology	2017-06-21	2216	79	12	2228	0.7737999999999999
Creativerse	2017-05-08	10929	24108	6545	17474	0.7737
Fashioning Little Miss Lonesome	2017-09-08	109	259	52	161	0.7737
Manifest 99	2017-09-12	8	59	8	16	0.7737
DED	2017-03-04	40	517	114	154	0.7735
Speedway Challenge League	2017-07-07	11	32	3	14	0.7734000000000001
AchBall	2017-11-17	4	32	3	7	0.7734000000000001
You Must be 18 or Older to Enter	2017-10-31	31	228	45	76	0.7733
Red Haze	2017-02-13	24	144	26	50	0.7732
Hold My Beer	2017-08-02	7	43	5	12	0.7732
Arcana Heart 3 LOVEMAX SIXSTARS!!!!!! XTEND	2017-12-13	319	232	46	365	0.7731
Chocolate	2017-08-17	11	26	2	13	0.773
Dracula: Vampires vs. Zombies	2017-08-08	8	26	2	10	0.773
Fur Up	2017-08-31	6	26	2	8	0.773
EVERSPACE™	2017-05-25	1448	8033	2126	3574	0.7726000000000001
THE AWKWARD STEVE DUOLOGY	2017-07-17	9	48	6	15	0.7725
Loco Dojo	2017-07-27	50	48	6	56	0.7725
American Patriots: Boston Tea Party	2017-09-19	4	73	11	15	0.7722
8-bit Adventure Anthology: Volume I	2017-10-31	7	53	7	14	0.7721
Bullet Sorrow VR	2017-04-18	43	230	46	89	0.772
Tasty Planet	2017-11-02	17	178	34	51	0.772
VRSailing by BeTomorrow	2017-01-12	12	58	8	20	0.772
Fire Arrow Plus	2017-02-01	3	37	4	7	0.7718
U.F.O - Unfortunately Fortunate Organisms	2017-06-02	611	37	4	615	0.7718
Emily Wants to Play Too	2017-12-13	23	322	68	91	0.7716
Caladrius Blaze	2017-01-12	37	276	57	94	0.7716
Weapon Shop Fantasy	2017-03-28	1607	1280	311	1918	0.7714
Command Ops 2 Core Game	2017-02-15	34	267	55	89	0.7714
Capitalism 2	2017-08-01	140	346	74	214	0.7713
Luna	2017-10-17	15	96	16	31	0.7711
Dead Effect 2 VR	2017-10-03	92	945	225	317	0.7709999999999999
Icarus Starship Command Simulator	2017-05-27	16	42	5	21	0.7709
Rainbow Step	2017-09-28	4	42	5	9	0.7709
Crazy Ball Adventures	2017-07-20	6	150	28	34	0.7708
Flix and Chill	2017-02-27	3364	189	37	3401	0.7706000000000001
Humanity Must Perish	2017-09-25	14	176	34	48	0.7706000000000001
Diorama Worlds	2017-06-14	4	31	3	7	0.7706000000000001
Inescapable VR: Underground	2017-08-03	4	31	3	7	0.7706000000000001
Steam Tactics	2017-09-13	8	47	6	14	0.7704000000000001
The Deal	2017-02-17	381	57	8	389	0.7701000000000001
The Dream Collector	2017-12-18	7	57	8	15	0.7701000000000001
Patchman vs. Red Circles	2017-10-19	3	19	1	4	0.77
Super Stone Legacy	2017-05-26	17	19	1	18	0.77
Sliding Blocks	2017-09-11	4	19	1	5	0.77
Observer	2017-08-15	953	4532	1194	2147	0.7698999999999999
Blackwood Crossing	2017-04-05	34	330	71	105	0.7698
Laser Lasso BALL	2017-02-14	84	25	2	86	0.7697
Silver Grapple	2017-08-26	9	25	2	11	0.7697
Writers	2017-11-20	6	25	2	8	0.7697
Black Desert SA (Retired)	2017-11-15	8981	10605	2888	11869	0.7696
White Noise 2	2017-04-07	163	2258	577	740	0.7694
Leaving Lyndow	2017-02-08	106	826	197	303	0.7693000000000001
Darwin's Demons	2017-02-13	17	36	4	21	0.7692
Hearthlands	2017-04-28	382	324	70	452	0.7690000000000001
Apple Jack 1&2	2017-05-03	3	12	0	3	0.7690000000000001
Labyrinths of the World: Shattered Soul Collector's Edition	2017-01-27	5	12	0	5	0.7690000000000001
Eskimo Bob: Starring Alfonzo	2017-07-21	3	12	0	3	0.7690000000000001
The Wardrobe	2017-02-15	66	356	78	144	0.7687999999999999
Marble Land	2017-12-07	8	66	10	18	0.7687999999999999
Overgrowth	2017-10-16	606	5874	1577	2183	0.7687
Cobalt WASD	2017-12-01	139	156	30	169	0.7686000000000001
Spinning Around	2017-11-24	4	41	5	9	0.7685
Serious Sam's Bogus Detour	2017-06-20	149	354	78	227	0.7681
DvDrum, Ultimate Drum Simulator!	2017-02-09	13	89	15	28	0.7681
Blink the Bulb	2017-01-03	5	75	12	17	0.768
Pixel Gladiator	2017-09-08	555	313	68	623	0.7678
Racket Fury: Table Tennis VR	2017-11-09	14	235	49	63	0.7676999999999999
Evil Glitch	2017-05-31	3645	30	3	3648	0.7676000000000001
Dungeons of Hell	2017-10-19	4	30	3	7	0.7676000000000001
Battle High 2 A+	2017-12-15	6	30	3	9	0.7676000000000001
FEMINAZI: The Triggering	2017-02-20	1882	983	241	2123	0.7675000000000001
Bars and Balance	2017-11-10	5	65	10	15	0.7671
Easy Red	2017-12-01	94	773	187	281	0.7666
SightLineVR	2017-10-31	5	35	4	9	0.7665000000000001
Dragon Bros	2017-05-31	5	24	2	7	0.7662000000000001
TAROTICA VOO DOO	2017-12-30	4	24	2	6	0.7662000000000001
BANANO BROS.	2017-11-01	4	24	2	6	0.7662000000000001
Scar of the Doll 人形の傷跡	2017-04-21	4	40	5	9	0.7661
Adventure Craft	2017-07-06	137	140	27	164	0.766
Ghost Blade HD	2017-03-08	10	45	6	16	0.766
House of Velez - part 1	2017-10-25	5	45	6	11	0.766
Snow White Solitaire. Charmed Kingdom	2017-12-28	10	45	6	16	0.766
Odysseus Kosmos and his Robot Quest: Adventure Game	2017-12-01	320	127	24	344	0.7659
Moribund	2017-03-16	26	18	1	27	0.7658
Dwingle B.O.T	2017-06-19	4	18	1	5	0.7658
Adelantado Trilogy. Book Three	2017-12-07	11	18	1	12	0.7658
Madcap Castle	2017-12-12	5	18	1	6	0.7658
SAELIG	2017-07-01	100	489	114	214	0.7656999999999999
Mahjong	2017-02-20	67	264	57	124	0.7656999999999999
The Shadows of Pygmalion	2017-02-25	21	87	15	36	0.7655
Snake Pass	2017-03-28	3406	2230	586	3992	0.7652
Madu Maths	2017-09-01	20	122	23	43	0.7652
Lawnmower Game	2017-07-20	63	374	85	148	0.7651000000000001
Tethered	2017-02-27	36	168	34	70	0.7647
Shikhondo(食魂徒) - Soul Eater	2017-10-09	21	168	34	55	0.7647
War Robots VR: The Skirmish	2017-08-10	39	604	145	184	0.7646
Ashes Cricket	2017-12-15	155	353	80	235	0.7646
Left-Hand Path	2017-11-10	17	104	19	36	0.7646
The Tenth Line	2017-03-17	47	104	19	66	0.7646
Piggy Poggy Pog	2017-11-28	18	481	113	131	0.7645000000000001
Crashnauts	2017-07-24	7	29	3	10	0.7645000000000001
The Final Specimen: Arrival	2017-03-03	9	29	3	12	0.7645000000000001
LEGO® Worlds	2017-03-07	4911	11377	3209	8120	0.7644
BOOR	2017-02-14	323	176	36	359	0.7644
Elminage ORIGINAL	2017-11-29	16	54	8	24	0.7644
Richie's Plank Experience	2017-12-19	154	468	110	264	0.7641
Like Clay	2017-03-14	18	86	15	33	0.7641
BLUE REFLECTION	2017-09-26	168	938	235	403	0.7640000000000001
aMAZE ZER0	2017-07-28	7	196	41	48	0.7640000000000001
Vector 36	2017-01-25	31	204	43	74	0.7639
WORLD OF FINAL FANTASY	2017-11-21	1295	2249	597	1892	0.7637999999999999
Neighborhorde	2017-06-06	21	34	4	25	0.7637
Shit Storm	2017-12-27	5	34	4	9	0.7637
Star Story: The Horizon Escape	2017-09-05	46	150	30	76	0.7636000000000001
WaveLand	2017-04-19	34	63	10	44	0.7636000000000001
xoEl Empire	2017-06-05	9	11	0	9	0.7634000000000001
Chaos Drift	2017-03-03	5	11	0	5	0.7634000000000001
SOYF: S#!T ON YOUR FRIENDS	2017-07-07	5	11	0	5	0.7634000000000001
Magician's Gambit	2017-09-01	3	11	0	3	0.7634000000000001
Fatty Rabbit Hole	2017-08-21	2	11	0	2	0.7634000000000001
LOGistICAL: Italy	2017-08-22	14	11	0	14	0.7634000000000001
Polygoneer	2017-08-24	1018	1191	305	1323	0.7633
Toukiden 2	2017-03-21	1938	1069	272	2210	0.7632
LoveKami -Useless Goddess-	2017-05-29	89	306	69	158	0.763
Insanity VR: Last Score	2017-08-15	14	145	29	43	0.7629000000000001
Wrath Of The Fire God	2017-12-19	5	23	2	7	0.7625000000000001
FETCH	2017-01-24	4	23	2	6	0.7625000000000001
SmuggleCraft	2017-05-24	18	23	2	20	0.7625000000000001
exercise book epic	2017-07-05	3	23	2	5	0.7625000000000001
UniOne	2017-07-13	6	23	2	8	0.7625000000000001
The Hunt - Rebuilt	2017-09-12	4	23	2	6	0.7625000000000001
Airmen	2017-07-25	62	261	58	120	0.7621
Space Pirates and Zombies 2	2017-11-07	2283	2145	575	2858	0.7619
In the Raven Shadow - Ve stinu havrana	2017-07-12	13	71	12	25	0.7618
Light Apprentice	2017-11-10	52	48	7	59	0.7618
The Witch's Isle	2017-09-14	15	48	7	22	0.7618
Knockout Checkers Chamber	2017-12-18	9	48	7	16	0.7618
Demise of Nations	2017-08-08	138	380	89	227	0.7615999999999999
Formicide	2017-06-12	98	260	58	156	0.7615999999999999
Dungeon Defenders II	2017-06-20	18785	15846	4593	23378	0.7614000000000001
LEAVES - The Journey	2017-03-07	199	429	102	301	0.7614000000000001
Knife Club VR	2017-10-09	7	43	6	13	0.7613
DWVR	2017-09-26	5	17	1	6	0.7613
Weather Lord: Royal Holidays Collector's Edition	2017-01-26	26	17	1	27	0.7613
Dark Parables: Jack and the Sky Kingdom Collector's Edition	2017-01-13	7	17	1	8	0.7613
Haunted Halls: Green Hills Sanitarium Collector's Edition	2017-07-12	5	17	1	6	0.7613
JunkerBot	2017-11-14	6	17	1	7	0.7613
Sentinels	2017-02-18	7	28	3	10	0.7612000000000001
Star Rage VR	2017-09-29	8	28	3	11	0.7612000000000001
Saloon Showdown VR	2017-10-10	4	28	3	7	0.7612000000000001
Battle Girls	2017-07-06	77	75	13	90	0.7611
Endless Winter	2017-06-02	11	38	5	16	0.7609
Hex-Up	2017-12-29	4	38	5	9	0.7609
</reality>	2017-04-18	10	33	4	14	0.7608
Personal Disco VR	2017-04-06	5	33	4	9	0.7608
战术狂想1(Chimera of Tactics 1)	2017-09-27	4	33	4	8	0.7608
TERA	2017-01-31	5068	5990	1695	6763	0.7605
GIGA WRECKER	2017-02-06	180	478	116	296	0.7602
Dungeon Escape VR	2017-04-08	12	146	30	42	0.7602
Crossout	2017-07-27	12170	41763	12455	24625	0.7601000000000001
Don't cut your hand	2017-05-31	23	170	36	59	0.7599
Great eSports Manager	2017-08-16	89	100	19	108	0.7598
Red Comrades 3: Return of Alaska. Reloaded	2017-11-07	96	268	61	157	0.7597
Western 1849 Reloaded	2017-02-10	57	141	29	86	0.7593000000000001
Kimmy	2017-04-18	4	56	9	13	0.7591
Arelite Core	2017-02-08	7	22	2	9	0.7586
Wojdan - وجدان	2017-01-25	3	22	2	5	0.7586
Happy Penguin VR	2017-03-30	4	22	2	6	0.7586
Chambara	2017-12-12	4	22	2	6	0.7586
Heart of Crown PC	2017-12-13	324	428	104	428	0.7585
Aurora Trail	2017-12-28	911	82	15	926	0.7585
Ecchi Sketch: Draw Cute Girls Every Day!	2017-03-18	467	69	12	479	0.7585
Frisky Business	2017-03-24	1856	180	39	1895	0.7584000000000001
Metal Waltz	2017-05-03	607	1198	318	925	0.7582
Monster Slayers	2017-03-23	285	910	237	522	0.7582
Alwa's Awakening	2017-02-02	65	523	130	195	0.7582
Arma: Cold War Assault Mac/Linux	2017-03-14	145	107	21	166	0.7582
How to Fool a Liar King	2017-10-20	15	37	5	20	0.7582
Eternity Warriors™ VR	2017-09-18	49	257	59	108	0.7579000000000001
BATTLESLOTHS 2025: The Great Pizza Wars	2017-06-06	24	73	13	37	0.7579000000000001
Conarium	2017-06-06	165	1513	409	574	0.7576999999999999
Boogeyman 2	2017-02-07	28	268	62	90	0.7576999999999999
Puzzle Poker	2017-12-18	95	32	4	99	0.7576999999999999
Merper VR	2017-11-02	8	32	4	12	0.7576999999999999
Seinarukana -The Spirit of Eternity Sword 2-	2017-01-27	24	27	3	27	0.7576999999999999
The Little Ball That Could	2017-09-12	4	27	3	7	0.7576999999999999
Tales of Winds: Tomb of the Sol Empire	2017-12-15	166	131	27	193	0.7576
DESYNC	2017-02-28	71	384	93	164	0.7574
Virtual SlotCars	2017-06-09	14	46	7	21	0.7572
The Mummy Demastered	2017-10-24	47	457	113	160	0.7571
Deserving Life	2017-10-13	78	102	20	98	0.7571
Revolve	2017-02-14	17	10	0	17	0.7571
The Great Wobo Escape	2017-09-29	2	10	0	2	0.7571
Conquest: Frontier Wars	2017-01-17	3	10	0	3	0.7571
Train Harder	2017-04-21	2	10	0	2	0.7571
The Mimic	2017-11-17	3	10	0	3	0.7571
EXIT 2 - Directions	2017-09-02	3	10	0	3	0.7571
Fantasy Mosaics 18: Explore New Colors	2017-07-24	6	10	0	6	0.7571
Luna	2017-08-16	3	10	0	3	0.7571
Iggy's Zombie A-Pug-Alypse	2017-09-22	7	10	0	7	0.7571
Plexarium	2017-09-14	14	10	0	14	0.7571
Glo	2017-10-23	3	10	0	3	0.7571
Root Letter	2017-07-07	48	405	99	147	0.757
RAYGUN COMMANDO VR	2017-01-24	11	81	15	26	0.757
Clash Force	2017-10-25	5	110	22	27	0.7569
Try Hard Parking	2017-01-04	11	68	12	23	0.7568000000000001
Youtubers Life	2017-02-02	7553	11577	3425	10978	0.7567
Shio	2017-05-05	430	1186	318	748	0.7567
ECHO	2017-09-19	245	1162	311	556	0.7567
One Dog Story	2017-04-28	367	397	97	464	0.7567
Omega Strike	2017-10-04	23	266	62	85	0.7567
Train Sim World® 2020	2017-03-16	1933	5411	1565	3498	0.7565000000000001
Roofbot	2017-02-17	4	16	1	5	0.7564000000000001
Echo Lake	2017-01-27	5	16	1	6	0.7564000000000001
Adelantado Trilogy. Book Two	2017-12-01	8	16	1	9	0.7564000000000001
Everything Must Fall	2017-05-25	3	16	1	4	0.7564000000000001
Doodle Jamboree	2017-09-26	4	16	1	5	0.7564000000000001
Aerofly FS 2 Flight Simulator	2017-11-20	109	1534	419	528	0.7563
Chroma Blast	2017-07-07	56	208	47	103	0.7562000000000001
SturmFront - The Mutant War: Übel Edition	2017-08-11	24	41	6	30	0.7562000000000001
Return to Zork	2017-04-18	11	41	6	17	0.7562000000000001
Fearful Symmetry & The Cursed Prince	2017-12-12	6	41	6	12	0.7562000000000001
Prehistorik 2	2017-11-28	7	41	6	13	0.7562000000000001
Sorry, James	2017-11-10	191	616	158	349	0.7559
illie	2017-11-06	9	101	20	29	0.7559
Yi and the Thousand Moons	2017-11-24	2	145	31	33	0.7556999999999999
Viaerium	2017-10-24	3	109	22	25	0.7556999999999999
88 Heroes	2017-03-24	16	63	11	27	0.7556
侠客风云传前传(Tale of Wuxia:The Pre-Sequel)	2017-08-15	510	1897	527	1037	0.7555
Disassembly 3D	2017-12-01	38	226	52	90	0.7555
Onirim - Solitaire Card Game	2017-07-26	33	168	37	70	0.7553000000000001
Black Jewel	2017-12-01	4	84	16	20	0.7553000000000001
Libra of the Vampire Princess	2017-06-20	53	36	5	58	0.7553000000000001
Google Spotlight Stories: Special Delivery	2017-12-14	21	36	5	26	0.7553000000000001
Sumoman	2017-03-28	28	429	107	135	0.7551000000000001
Just Cause™ 3: Multiplayer Mod	2017-07-20	602	1966	549	1151	0.755
Halcyon 6: Lightspeed Edition	2017-08-10	420	601	155	575	0.7549
Dark Angels: Masquerade of Shadows	2017-02-02	26	179	40	66	0.7548
MX Nitro: Unleashed	2017-02-14	35	96	19	54	0.7547
Jettomero	2017-09-15	7	96	19	26	0.7547
Super Dungeon Boy	2017-11-29	16	171	38	54	0.7545999999999999
Dimension Drive	2017-12-07	134	71	13	147	0.7545999999999999
Battle Summoners	2017-05-23	8	31	4	12	0.7545999999999999
OK Bob	2017-03-31	6	21	2	8	0.7544
The Hero Unmasked!	2017-07-27	35	21	2	37	0.7544
Boss 101	2017-11-02	28	58	10	38	0.7543000000000001
Leashed Soul	2017-07-31	106	26	3	109	0.7541
Wars Across The World	2017-05-04	22	143	31	53	0.7539
Detective Butler: Maiden Voyage Murder	2017-05-26	31	193	44	75	0.7538
Airport Madness 3D: Volume 2	2017-11-28	38	139	30	68	0.7538
Impossiball	2017-08-08	203	49	8	211	0.7537
Animals Memory	2017-12-20	5	49	8	13	0.7537
Lionheart: Legacy of the Crusader	2017-03-15	18	87	17	35	0.7536
Sponchies	2017-09-27	3557	40	6	3563	0.7536
Air Missions: HIND	2017-06-14	39	446	113	152	0.7535
Ancient Rus	2017-04-27	27	127	27	54	0.7535
Red Death	2017-03-23	2921	91	18	2939	0.7535
Galaxy Admirals	2017-01-17	752	181	41	793	0.7534000000000001
Post Human W.A.R	2017-12-14	66	95	19	85	0.7534000000000001
Reflection of Mine	2017-02-24	177	173	39	216	0.7531
Stars in Shadow	2017-01-19	470	572	149	619	0.7529000000000001
ClickRaid	2017-10-21	564	233	55	619	0.7529000000000001
Ninja Stealth 3	2017-12-06	924	281	68	992	0.7528
Outcast - Second Contact	2017-11-14	247	599	157	404	0.7526
Jump Gunners	2017-11-14	5	35	5	10	0.7524
Parallyzed	2017-04-19	272	44	7	279	0.7523000000000001
The Wolf's Bite	2017-08-28	10	44	7	17	0.7523000000000001
Text Wormhole	2017-11-02	6	44	7	13	0.7523000000000001
Behold the Kickmen	2017-07-20	104	373	94	198	0.7518000000000001
Cybermotion	2017-07-28	22	61	11	33	0.7518000000000001
The Secret Order 5: The Buried Kingdom	2017-04-06	40	152	34	74	0.7515000000000001
ProjectM : Dream	2017-09-05	12	65	12	24	0.7514000000000001
Head Goal: Soccer Online	2017-08-18	3261	559	147	3408	0.7513
Sudden Strike 4	2017-08-11	2476	5397	1612	4088	0.7512000000000001
Flairtender	2017-11-17	7	30	4	11	0.7512000000000001
Rescue Team 4	2017-09-27	12	30	4	16	0.7512000000000001
Corroded	2017-04-26	683	73	14	697	0.751
Dark Blood Chronicles	2017-11-23	4	15	1	5	0.751
Dawn of a Soul	2017-10-02	3	15	1	4	0.751
Imperil	2017-11-01	4	15	1	5	0.751
BAPTISM	2017-11-30	1	15	1	2	0.751
Manipulated	2017-03-28	8	39	6	14	0.7509
TankBlitz	2017-04-21	35	39	6	41	0.7509
Super Samurai Rampage	2017-08-01	7	39	6	13	0.7509
Microgons	2017-03-27	414	52	9	423	0.7506999999999999
Botlike - a robot's rampage	2017-09-14	14	52	9	23	0.7506999999999999
Raw Data	2017-10-05	414	1885	541	955	0.7505
Black The Fall	2017-07-11	302	1228	344	646	0.7505
ReThink	2017-03-09	100	207	49	149	0.7505
Anarchy Online	2017-02-22	23	181	42	65	0.7505
Clad in Iron: Philippines 1898	2017-11-14	3	25	3	6	0.7503000000000001
Die drei ??? - Geheimnis der Schattenhelden	2017-12-13	13	25	3	16	0.7503000000000001
绝境幸存者 Escape Zombie Land	2017-12-20	8	25	3	11	0.7503000000000001
古剑奇谭二(GuJian2)	2017-09-08	563	1920	553	1116	0.7501000000000001
Stardrift Nomads	2017-04-07	20	9	0	20	0.75
Wanderer of Teandria	2017-09-27	40	9	0	40	0.75
World In Danger	2017-02-09	212	9	0	212	0.75
Hyper Void	2017-10-09	2	9	0	2	0.75
Ascender	2017-03-17	108	9	0	108	0.75
Silver Island	2017-03-29	2	9	0	2	0.75
Anomie	2017-08-22	4	9	0	4	0.75
Red Bull Doodle Art - Global VR Gallery	2017-07-01	6	9	0	6	0.75
Project MALLOW	2017-07-18	3	9	0	3	0.75
Fantasy Mosaics 15: Ancient Land	2017-07-03	7	9	0	7	0.75
Exatron Quest 	2017-07-20	3	9	0	3	0.75
Otherworld: Shades of Fall Collector's Edition	2017-09-21	3	9	0	3	0.75
GOLDRUSHERS	2017-09-09	2	9	0	2	0.75
De Mambo	2017-10-17	3	9	0	3	0.75
AWS Argentina Wingshooting Simulator	2017-11-08	2	9	0	2	0.75
LOGistICAL: USA - New York	2017-10-25	10	9	0	10	0.75
FISK	2017-12-22	3	9	0	3	0.75
Born Tubi Wild	2017-12-11	1	9	0	1	0.75
Snowflake's Chance	2017-03-16	12	20	2	14	0.7499
A Butterfly in the District of Dreams	2017-05-12	9	20	2	11	0.7499
Big Hit VR Baseball	2017-05-02	5	20	2	7	0.7499
Bit Bullet	2017-11-06	3	20	2	5	0.7499
MegaRace 2	2017-11-10	2	20	2	4	0.7499
I Can See the Future	2017-10-12	7	60	11	18	0.7498
Nudist Beach Survival Simulator	2017-09-28	4	43	7	11	0.7498
One Eyed Kutkh	2017-03-30	524	104	22	546	0.7497
Deadly Hunter VR	2017-06-20	23	213	51	74	0.7495999999999999
Chasing Styx	2017-03-31	11	64	12	23	0.7495999999999999
Block Survival: Legend of the Lost Islands	2017-07-14	14	64	12	26	0.7495999999999999
Regalia: Of Men and Monarchs	2017-05-18	294	409	106	400	0.7493000000000001
Gunman Taco Truck	2017-01-28	19	183	43	62	0.7492000000000001
Brave Furries	2017-03-14	807	76	15	822	0.7492000000000001
BUCK: Saturday Morning Cartoon Apocalypse	2017-03-18	8	47	8	16	0.7490000000000001
WRC 7	2017-09-15	1034	4082	1225	2259	0.7488
LOGistICAL	2017-02-15	67	175	41	108	0.7488
Just In Time Incorporated	2017-07-27	21	175	41	62	0.7488
Drunk or Dead	2017-01-10	5	51	9	14	0.7484999999999999
Bouncy Bob	2017-10-24	7	51	9	16	0.7484999999999999
Nine Parchments	2017-12-05	594	2912	866	1460	0.7481
BAJA: Edge of Control HD	2017-09-14	30	279	70	100	0.7481
MONITOR: The Game	2017-09-15	25	55	10	35	0.7481
Taiko Risshiden	2017-04-18	20	38	6	26	0.748
Vidar	2017-06-15	15	29	4	19	0.7478
Gray Skies, Dark Waters	2017-06-09	4	29	4	8	0.7478
Refract	2017-07-07	7	29	4	11	0.7478
Google Spotlight Stories: Son of Jaguar	2017-10-30	11	79	16	27	0.7477
EvilMorph	2017-02-03	604	71	14	618	0.7476
Mysterium	2017-01-12	470	593	161	631	0.7475
鸿源战纪 - Tales of Hongyuan	2017-09-01	303	369	96	399	0.7474
Sparc	2017-11-16	119	341	88	207	0.7474
Vampires!	2017-10-06	17	140	32	49	0.7474
Rosenkreuzstilette	2017-02-03	29	281	71	100	0.7473000000000001
Happy Drummer VR	2017-01-25	8	42	7	15	0.7471
Mouse Playhouse	2017-03-31	9	42	7	16	0.7471
Flix and Chill 2: Millennials	2017-07-18	68	42	7	75	0.7471
Doodle Devil	2017-05-25	977	117	26	1003	0.7469
My Coloring Book: Food and Beverage	2017-12-21	8	90	19	27	0.7465999999999999
The Ranger: Lost Tribe	2017-08-01	608	283	72	680	0.7465
Peregrin	2017-08-08	13	237	59	72	0.7465
King of the Couch: Zoovival	2017-11-21	97	212	52	149	0.7465
ATOMEGA	2017-09-19	180	1082	309	489	0.7464000000000001
Relik	2017-10-18	42	139	32	74	0.7464000000000001
Alphabear: Hardcover Edition	2017-08-23	120	86	18	138	0.7464000000000001
Swarm Universe	2017-03-30	16	24	3	19	0.7463
Awaken	2017-01-26	9	24	3	12	0.7463
Magic Lantern	2017-01-30	255	24	3	258	0.7463
Voxel Shot VR	2017-05-19	4	24	3	7	0.7463
HEIANKYO ALIEN / 平安京エイリアン	2017-10-13	13	24	3	16	0.7463
VR Dungeon Knight	2017-04-24	67	1041	297	364	0.7462000000000001
Pixel Sand	2017-04-20	9	50	9	18	0.7462000000000001
Shooty Squad	2017-08-17	11	50	9	20	0.7462000000000001
Feral Fury	2017-04-02	1026	105	23	1049	0.7461
A Timely Intervention	2017-03-24	980	33	5	985	0.7461
Pale Spectrum - Part Two of the Book of Gray Magic	2017-09-28	21	33	5	26	0.7461
Kautic - The Bald Wizard	2017-03-03	507	33	5	512	0.7461
Metropolis: Lux Obscura	2017-10-11	53	338	88	141	0.746
Lucid Trips	2017-01-12	18	66	13	31	0.7458
Gigantic	2017-07-19	8303	5694	1764	10067	0.7454999999999999
The Ultimatest Battle	2017-09-12	313	405	108	421	0.7453000000000001
Weebish Mines	2017-04-21	3	14	1	4	0.7453000000000001
Knightfall	2017-09-04	5	14	1	6	0.7453000000000001
Intrusion Protocol	2017-07-20	6	14	1	7	0.7453000000000001
On Earth As It Is In Heaven - A Kinetic Novel	2017-11-28	3	14	1	4	0.7453000000000001
Symploké: La Leyenda de Gustavo Bueno (Capítulo 2)	2017-12-22	1401	14	1	1402	0.7453000000000001
DevWill	2017-10-12	3	14	1	4	0.7453000000000001
Christmas Puzzle 2	2017-12-01	5	14	1	6	0.7453000000000001
Criminal Girls: Invite Only	2017-01-11	228	432	116	344	0.7452
PSYCHO-PASS: Mandatory Happiness	2017-04-24	55	123	28	83	0.7452
Epic Little War Game	2017-05-31	14	37	6	20	0.7451000000000001
Rescue Quest Gold	2017-06-05	12	37	6	18	0.7451000000000001
Gnomes Garden New Home	2017-12-14	11	37	6	17	0.7451000000000001
Oure	2017-11-15	9	37	6	15	0.7451000000000001
Boom Box Blue!	2017-12-11	3	37	6	9	0.7451000000000001
Operator Overload	2017-09-28	10	19	2	12	0.7451000000000001
Crimson Trigger	2017-01-30	6	19	2	8	0.7451000000000001
Color Jumper	2017-11-01	30	19	2	32	0.7451000000000001
SMASHING THE BATTLE VR	2017-06-16	7	19	2	9	0.7451000000000001
Ancient Amuletor VR	2017-12-20	15	19	2	17	0.7451000000000001
ARRAYNIUM	2017-10-12	2	19	2	4	0.7451000000000001
Operation Sheep Defense	2017-08-02	5	19	2	7	0.7451000000000001
Not Dying Today	2017-01-13	43	188	46	89	0.7448
Bombernauts	2017-12-29	117	141	33	150	0.7448
Fictorum	2017-08-09	453	818	232	685	0.7447
Nancy Drew: The Final Scene	2017-04-18	25	81	17	42	0.7447
Lode Runner Legacy	2017-07-13	25	115	26	51	0.7445999999999999
Fumiko!	2017-02-13	288	77	16	304	0.7444
Lost Dimension	2017-10-30	82	155	37	119	0.7443000000000001
The Chronicles of Dragon Wing - Reborn	2017-08-15	161	173	42	203	0.7442000000000001
Dreamstones	2017-11-09	22	73	15	37	0.7442000000000001
Transport Defender	2017-09-11	1125	313	82	1207	0.7441
All You Can Eat	2017-07-13	13	275	71	84	0.7441
Gods of the Fallen Land	2017-07-31	70	92	20	90	0.7440000000000001
Bare Metal	2017-12-01	31	69	14	45	0.7440000000000001
Tiles	2017-03-20	5	45	8	13	0.7440000000000001
Aesthetic Melody	2017-04-18	104	49	9	113	0.7438
Seven: Enhanced Edition	2017-12-01	443	1203	352	795	0.7437
BULLET SOUL	2017-04-07	27	53	10	37	0.7437
Oafmatch	2017-05-19	91	53	10	101	0.7437
Blind Men	2017-07-25	8	53	10	18	0.7437
Civil War: Battle of Petersburg	2017-02-09	2441	147	35	2476	0.7436
Star Trek: Bridge Crew	2017-05-30	883	2250	681	1564	0.7434999999999999
Just Ignore Them	2017-04-28	495	464	127	622	0.7434000000000001
Ultimate Epic Battle Simulator	2017-06-01	10326	8767	2789	13115	0.7432
Party Panic	2017-08-07	388	2278	691	1079	0.7432
Let`s not stay friends	2017-11-29	70	221	56	126	0.7431
Breaking Fast	2017-06-08	75	32	5	80	0.7428
Bionic Battle Mutants	2017-10-24	7	32	5	12	0.7428
Ben The Exorcist	2017-07-07	7	32	5	12	0.7428
Hex	2017-11-06	3	32	5	8	0.7428
SpellForce 3 Reforced	2017-12-07	8932	5168	1623	10555	0.7427
MotoGP™17	2017-06-15	429	405	110	539	0.7427
Nancy Drew: Treasure in the Royal Tower	2017-05-22	26	117	27	53	0.7426
Embers of Magic	2017-04-06	23	72	15	38	0.7425
Mob Rule Classic	2017-03-31	236	160	39	275	0.7423000000000001
Fields XY	2017-04-07	1616	36	6	1622	0.742
Kokoda VR	2017-10-31	80	36	6	86	0.742
Uncharted Waters	2017-04-18	18	23	3	21	0.742
SUPERHYPERCUBE	2017-11-07	5	23	3	8	0.742
A Tale of Two Kingdoms	2017-10-31	9	23	3	12	0.742
Equivoque	2017-06-27	2	23	3	5	0.742
Dark Romance: Vampire in Love Collector's Edition	2017-10-11	6	23	3	9	0.742
Mare Nostrvm	2017-11-02	13	23	3	16	0.742
When It Hits the Fan	2017-09-19	3	8	0	3	0.7419
Outskirts	2017-09-20	4	8	0	4	0.7419
Theatre of Doom	2017-04-19	50	8	0	50	0.7419
Mayan Prophecies: Ship of Spirits Collector's Edition	2017-01-06	3	8	0	3	0.7419
Paranormal Pursuit: The Gifted One Collector's Edition	2017-01-10	4	8	0	4	0.7419
Idioctopus	2017-02-10	3	8	0	3	0.7419
Island Tribe 4	2017-12-01	7	8	0	7	0.7419
Shadow Wolf Mysteries: Curse of the Full Moon Collector's Edition	2017-04-28	3	8	0	3	0.7419
Tilted Mind	2017-06-09	2	8	0	2	0.7419
Maestro: Music of Death Collector's Edition	2017-06-07	4	8	0	4	0.7419
Super Flipside	2017-07-18	4	8	0	4	0.7419
Fantasy Mosaics 17: New Palette	2017-07-17	7	8	0	7	0.7419
Diving Trunks	2017-06-21	2	8	0	2	0.7419
Blind Witch -Peek Window-	2017-08-08	4	8	0	4	0.7419
Dungeon Manager ZV: Resurrection	2017-08-16	19	8	0	19	0.7419
Jobous the alien R	2017-09-02	2	8	0	2	0.7419
Hex: Origins	2017-09-23	4	8	0	4	0.7419
Dungeoneer	2017-12-12	1	8	0	1	0.7419
La Aventura De Axel	2017-10-20	3	8	0	3	0.7419
Cadenza: The Kiss of Death Collector's Edition	2017-12-15	4	8	0	4	0.7419
Drifting Lands	2017-06-05	156	205	52	208	0.7417
The Fidelio Incident	2017-05-23	33	643	183	216	0.7415999999999999
forma.8	2017-02-23	33	40	7	40	0.7415999999999999
SYNCH	2017-04-11	5	40	7	12	0.7415999999999999
Plank not included	2017-02-28	13	40	7	20	0.7415999999999999
Trigonometry	2017-11-24	3	40	7	10	0.7415999999999999
Lamp Head	2017-06-01	1981	331	89	2070	0.7414000000000001
Throne of Lies®: Medieval Politics	2017-09-29	1381	2090	639	2020	0.7413
Black Desert	2017-05-24	60395	50015	16677	77072	0.7411
Escape: VR	2017-04-12	1273	130	31	1304	0.741
MadOut2 BigCityOnline	2017-02-22	432	3305	1033	1465	0.7408
Grab the Bottle	2017-05-22	777	86	19	796	0.7406999999999999
Golf for Workgroups	2017-04-07	24	71	15	39	0.7406999999999999
Chromadrome 2	2017-05-04	3	27	4	7	0.7403000000000001
Embers of Mirrim	2017-05-23	8	27	4	12	0.7403000000000001
The Eagle's Heir	2017-03-30	52	27	4	56	0.7403000000000001
VR Slugger	2017-06-08	4	27	4	8	0.7403000000000001
Disparity	2017-10-05	4	27	4	8	0.7403000000000001
Wild Romance: Mofu Mofu Edition	2017-11-20	40	147	36	76	0.7402
HEADLINER	2017-10-03	44	643	185	229	0.74
Alone With You	2017-02-09	19	63	13	32	0.74
Magi	2017-01-17	5	18	2	7	0.74
Northern Tale 4	2017-11-16	12	18	2	14	0.74
Nighthaw-X3000	2017-04-14	13	18	2	15	0.74
Canvas Quest	2017-07-16	3	18	2	5	0.74
Cutthroat Gunboat	2017-08-11	7	18	2	9	0.74
BackSlash	2017-08-31	7	18	2	9	0.74
Choice of the Cat	2017-09-28	21	18	2	23	0.74
Lost Grimoires 2: Shard of Mystery	2017-03-09	53	136	33	86	0.7398
RunningDead	2017-03-03	98	78	17	115	0.7398
Mainlining	2017-01-26	53	250	66	119	0.7397
The First Tree	2017-09-14	601	3870	1228	1829	0.7393000000000001
A Bloody Night	2017-06-23	71	74	16	87	0.7393000000000001
Puzzle Chambers	2017-12-01	11	74	16	27	0.7393000000000001
Tiny Troopers 2: Special Ops	2017-05-31	7	55	11	18	0.7393000000000001
Rush to Adventure	2017-09-11	4	31	5	9	0.7393000000000001
A Small Robot Story	2017-12-20	2	31	5	7	0.7393000000000001
Skyworld	2017-10-17	55	198	51	106	0.7392000000000001
Rogue Trooper Redux	2017-10-17	69	249	66	135	0.7391
Surfasaurus	2017-03-16	928	13	1	929	0.7389
The Overdreamer	2017-07-17	35	13	1	36	0.7389
CompliKATed	2017-10-04	3	13	1	4	0.7389
ESCAPE Room: Reality	2017-06-21	4	13	1	5	0.7389
Vintage Hero	2017-08-04	2	13	1	3	0.7389
Awakening: The Goblin Kingdom Collector's Edition	2017-09-07	5	13	1	6	0.7389
Mari and the Black Tower	2017-10-03	3	13	1	4	0.7389
Pimiko Plus	2017-12-14	3	13	1	4	0.7389
Christmas Puzzle 3	2017-12-15	8	13	1	9	0.7389
XXZ: XXL	2017-09-30	37	156	39	76	0.7388
Keep Defending	2017-06-19	5	47	9	14	0.7388
JetmanGo	2017-09-29	13	142	35	48	0.7387
Bakery	2017-11-22	61	92	21	82	0.7387
Bottom of the 9th	2017-10-11	102	43	8	110	0.7387
Fix Me Fix You	2017-03-08	938	39	7	945	0.7387
Chaos Town	2017-05-29	4840	39	7	4847	0.7387
Team Four Star RPG	2017-11-08	77	66	14	91	0.7384000000000001
LogicBots	2017-02-08	56	138	34	90	0.7382
Cart Racer	2017-06-05	778	651	190	968	0.738
OVERTURN	2017-10-17	13	62	13	26	0.738
HYPERNOVA: Escape from Hadea	2017-09-06	55	62	13	68	0.738
Ballistic Overkill	2017-03-28	1091	5373	1740	2831	0.7377
Yooka-Laylee	2017-04-11	6508	3625	1160	7668	0.7375
Galactic Gallery	2017-12-05	7	22	3	10	0.7375
The Superlatives: Aetherfall	2017-10-19	41	22	3	44	0.7375
The Surge	2017-05-15	5978	6655	2173	8151	0.7373999999999999
The Initial	2017-07-18	264	1455	448	712	0.7373000000000001
Once Upon an All Hallow's Eve	2017-01-19	9	123	30	39	0.7372
Echoes of the Fey Episode 0: The Immolation	2017-02-07	54	54	11	65	0.7371
Space Live - Advent of the Net Idols	2017-09-29	9	50	10	19	0.7366
Tangrams Deluxe	2017-08-09	8	50	10	18	0.7366
Harvest Moon: Light of Hope	2017-11-14	556	818	245	801	0.7365
Disc Jam	2017-03-07	1374	1197	367	1741	0.7364
VectorWave	2017-11-17	33	26	4	37	0.7363
Son of Scoregasm	2017-11-29	73	26	4	77	0.7363
Chronicles of cyberpunk	2017-12-07	3	26	4	7	0.7363
Romance of the Three Kingdoms V with Power Up Kit	2017-04-18	53	61	13	66	0.7359
Zzzz-Zzzz-Zzzz	2017-06-05	1609	180	47	1656	0.7358
Dragon Climax	2017-12-18	985	38	7	992	0.7356999999999999
Last Hours Of Jack	2017-05-04	26	30	5	31	0.7356999999999999
Restoration	2017-08-18	10	30	5	15	0.7356999999999999
Burgle Bros	2017-11-29	11	30	5	16	0.7356999999999999
Alien Insanity	2017-03-17	5	34	6	11	0.7356
Riders of Asgard	2017-03-31	20	17	2	22	0.7345
DragoDino	2017-06-20	5	17	2	7	0.7345
Travel Riddles: Trip To India	2017-03-11	9	17	2	11	0.7345
GoBlock's Impossible Medley	2017-04-15	377	17	2	379	0.7345
Der einzig wahre Auserwählte	2017-08-02	6	17	2	8	0.7345
Travel Riddles: Trip To France	2017-07-16	7	17	2	9	0.7345
拼词游戏 2017	2017-11-30	2	17	2	4	0.7345
Warspear Online	2017-11-02	704	1702	538	1242	0.7343000000000001
Guns of Icarus Alliance	2017-03-31	2142	1044	322	2464	0.7342000000000001
Achievement Lurker: Dad Jokes	2017-12-26	16	110	27	43	0.7342000000000001
Comedy Night	2017-08-24	1122	6093	2027	3149	0.7337
Cybercube	2017-10-10	46	154	40	86	0.7337
GET EVEN	2017-06-20	473	1189	371	844	0.7334999999999999
Animation Throwdown: The Quest for Cards	2017-05-05	1380	2578	835	2215	0.7333
Six Days of Snow	2017-12-29	34	259	72	106	0.7333
Marshmallow Melee	2017-10-06	16	67	15	31	0.7332
Life of a Wizard	2017-03-17	28	56	12	40	0.7331000000000001
Symploké: La Leyenda de Gustavo Bueno 	2017-09-30	10	56	12	22	0.7331000000000001
Live	2017-10-12	2	41	8	10	0.733
Lost Grimoires 3: The Forgotten Well	2017-12-14	20	126	32	52	0.7328
River City Ransom: Underground	2017-02-28	1659	1775	568	2227	0.7327
Songbringer	2017-09-01	99	196	53	152	0.7327
A-Train PC Classic	2017-06-09	311	88	21	332	0.7327
Nevrosa: Escape	2017-12-22	10	88	21	31	0.7327
Dimension Hunter VR	2017-09-25	13	81	19	32	0.7327
Baezult 2	2017-02-06	4	21	3	7	0.7327
No Stick Shooter	2017-05-17	67	21	3	70	0.7327
PowBall Renaissance	2017-08-01	4	21	3	7	0.7327
Bad School Boy	2017-12-14	10	21	3	13	0.7327
Home Wars	2017-06-13	244	648	196	440	0.7326
Paladin	2017-03-21	2	7	0	2	0.7326
Rotation Phonology: Break	2017-01-13	8	7	0	8	0.7326
Journey: Benjamin's Adventures	2017-02-22	2	7	0	2	0.7326
War of Castle VR	2017-03-14	8	7	0	8	0.7326
JETBROS	2017-07-14	5	7	0	5	0.7326
Gnomelings: Migration	2017-06-12	3	7	0	3	0.7326
People Eater	2017-07-25	5	7	0	5	0.7326
Microcosm	2017-06-02	3	7	0	3	0.7326
Slime-san: Blackbird's Kraken	2017-07-20	4	7	0	4	0.7326
Geneticognito	2017-07-20	2	7	0	2	0.7326
Medieval Mystery Match	2017-08-01	5	7	0	5	0.7326
Quantum Wizard	2017-10-03	6	7	0	6	0.7326
Ether Awakening	2017-07-03	4	7	0	4	0.7326
Dragon Drop	2017-11-09	4	7	0	4	0.7326
An Occasional Dream	2017-09-06	5	7	0	5	0.7326
Galaxy Annihilation	2017-07-28	3	7	0	3	0.7326
Infinity Fall	2017-08-30	2	7	0	2	0.7326
Charpi	2017-08-31	2	7	0	2	0.7326
FROG X BIRD	2017-11-21	3	7	0	3	0.7326
Champions of Aerial	2017-11-21	4	7	0	4	0.7326
Number World Adventure	2017-09-22	2	7	0	2	0.7326
Reginald Does His Thang	2017-12-06	3	7	0	3	0.7326
Bit Storm VR: First Loop	2017-10-18	2	7	0	2	0.7326
Command: Shifting Sands	2017-10-24	12	7	0	12	0.7326
Funball Games VR	2017-10-31	2	7	0	2	0.7326
Tooki	2017-12-16	2	7	0	2	0.7326
Offensive Dimensions	2017-11-24	1	7	0	1	0.7326
League of Light: Silent Mountain Collector's Edition	2017-12-06	3	7	0	3	0.7326
NARUTO: Ultimate Ninja STORM	2017-08-25	550	3840	1268	1818	0.7325
Shardbound	2017-04-06	751	924	286	1037	0.7325
Rat Simulator	2017-07-27	27	146	38	65	0.7325
救う(SHE SAVE)	2017-07-14	17	37	7	24	0.7325
Pinewood Island	2017-10-10	5	37	7	12	0.7325
GravNewton	2017-07-26	532	293	83	615	0.7323999999999999
inVokeR	2017-07-20	126	52	11	137	0.7323999999999999
Entwined: Strings of Deception	2017-06-22	9	33	6	15	0.7321
Swim Out	2017-09-14	4	33	6	10	0.7321
Ben 10	2017-11-15	20	231	64	84	0.7320000000000001
Final Bravely	2017-01-05	910	25	4	914	0.7320000000000001
Kygo 'Carry Me' VR Experience	2017-02-02	5	25	4	9	0.7320000000000001
Myrne: The Quest	2017-06-01	22	25	4	26	0.7320000000000001
Where Are My Friends?	2017-10-10	3	25	4	7	0.7320000000000001
Alpha Locus VR	2017-11-27	14	25	4	18	0.7320000000000001
AFFECTED: The Manor - The Complete Edition	2017-10-03	36	132	34	70	0.7319
Pinball Evolution: The Summoning	2017-04-29	4	29	5	9	0.7319
Glider Island	2017-04-28	9	29	5	14	0.7319
Lazer Cops	2017-06-15	37	12	1	38	0.7319
Watchlist	2017-07-06	3	12	1	4	0.7319
Ophidian	2017-09-15	3	12	1	4	0.7319
Maybot Run	2017-10-19	3	12	1	4	0.7319
Left&Right	2017-10-19	2	12	1	3	0.7319
Eador. Imperium	2017-01-27	238	908	282	520	0.7318000000000001
Blue Effect VR	2017-02-09	13	108	27	40	0.7316
Pixel Worlds	2017-06-09	1404	4087	1362	2766	0.7313
Nihilist Simulator	2017-12-11	2997	66	15	3012	0.7313
ELEX	2017-10-17	22969	13242	4555	27524	0.7312000000000001
Lucky Night: Texas Hold'em VR	2017-07-26	28	138	36	64	0.7312000000000001
ANIMALITY	2017-02-02	1314	583	177	1491	0.7309
Shadows 2: Perfidia	2017-03-24	4821	197	54	4875	0.7309
Locomancer	2017-03-01	136	55	12	148	0.7308
Ropes And Dragons VR	2017-04-21	910	44	9	919	0.7308
Swords and Sandals 2 Redux	2017-06-29	52	340	99	151	0.7306
Nancy Drew: Message in a Haunted Mansion	2017-05-01	32	114	29	61	0.7306
Ruin of the Reckless	2017-04-26	65	62	14	79	0.7304
The Initiate	2017-08-01	27	157	42	69	0.7303000000000001
SpiritSphere	2017-01-23	29	40	8	37	0.73
ARENA GODS	2017-10-16	8	93	23	31	0.7298
Dresden Files Cooperative Card Game	2017-10-30	27	86	21	48	0.7295
Greedy Guns	2017-09-01	14	65	15	29	0.7293000000000001
Dead Drop	2017-04-21	536	65	15	551	0.7293000000000001
Battlezone	2017-05-11	61	287	83	144	0.7292000000000001
SOLITUNE	2017-04-25	853	96	24	877	0.7292000000000001
Gelu	2017-07-11	25	96	24	49	0.7292000000000001
Hollowed	2017-11-02	29	116	30	59	0.7290000000000001
Reach Me	2017-12-07	4	47	10	14	0.7290000000000001
Steam: Rails to Riches	2017-03-25	37	82	20	57	0.7286
Super Amazeballs	2017-05-16	4	32	6	10	0.7286
WESTSLINGERS	2017-08-21	14	32	6	20	0.7286
Legendary Mahjong	2017-10-25	10	32	6	16	0.7286
Mind OVR Matter	2017-05-22	5	16	2	7	0.7286
Northern Tale 2	2017-12-01	12	16	2	14	0.7286
HIKIBYOU2	2017-01-30	108	16	2	110	0.7286
Link Twin	2017-04-13	3	16	2	5	0.7286
The Royal Cosmonautical Society	2017-08-10	3	16	2	5	0.7286
Secrets of Magic 2: Witches and Wizards	2017-10-27	5	16	2	7	0.7286
Plox Neon	2017-12-19	5	16	2	7	0.7286
Rocket Blasters	2017-12-06	2	16	2	4	0.7286
The Elder Scrolls: Legends	2017-05-31	8873	7653	2641	11514	0.7284
Stitched HD	2017-10-30	10	75	18	28	0.7284
Save Their Souls	2017-04-11	708	54	12	720	0.7284
ONRAID	2017-04-18	1037	1362	442	1479	0.7283
NEONomicon	2017-06-01	567	92	23	590	0.7283
Dynasty Feud	2017-05-23	22	68	16	38	0.7283
World to the West	2017-05-05	263	282	82	345	0.7282
Iron Armada	2017-12-30	62	122	32	94	0.7282
Rival Rampage	2017-11-07	380	43	9	389	0.728
2Dark	2017-03-10	110	451	137	247	0.7279000000000001
Civil War: Gettysburg	2017-08-25	9	28	5	14	0.7279000000000001
Strangers of the Power	2017-08-17	4	28	5	9	0.7279000000000001
Face It - A game to fight inner demons	2017-06-09	2594	924	295	2889	0.7276
Tears of a Dragon	2017-07-07	1490	20	3	1493	0.7276
Batter Up! VR	2017-07-17	5	20	3	8	0.7276
Chromatic	2017-07-17	15	20	3	18	0.7276
2V Hoverbike	2017-07-07	4	20	3	7	0.7276
Band of Outlaws	2017-08-22	2	20	3	5	0.7276
Sneaky Bears	2017-10-17	6	20	3	9	0.7276
Prehistorik	2017-11-17	4	20	3	7	0.7276
Mass Exodus Redux	2017-05-04	26	218	62	88	0.7275
Loops of Zen	2017-08-10	22	24	4	26	0.7275
Foxfolk	2017-08-08	3	24	4	7	0.7275
Draw Souls	2017-09-08	6	24	4	10	0.7275
Elevator... to the Moon!	2017-11-29	7	24	4	11	0.7275
Chronicle of Innsmouth	2017-05-05	44	147	40	84	0.7270000000000001
Battle of Red Cliffs VR	2017-11-02	5	39	8	13	0.7270000000000001
Steel Division: Normandy 44	2017-05-23	4678	4413	1512	6190	0.7269
Aztez	2017-08-01	31	134	36	67	0.7269
DreadEye VR	2017-11-28	15	111	29	44	0.7268000000000001
SpaceShot	2017-09-20	23	172	48	71	0.7263
My Coloring Book: Animals	2017-10-11	7	67	16	23	0.7263
The Pirate: Plague of the Dead	2017-10-13	398	410	125	523	0.7262000000000001
Eddy Violet	2017-09-16	23	53	12	35	0.726
Theseus	2017-10-26	4	53	12	16	0.726
PARKAN: THE IMPERIAL CHRONICLES	2017-01-23	7	35	7	14	0.7259000000000001
Ball 2D: Soccer Online	2017-09-08	4560	287	85	4645	0.7258
Evolution VR	2017-02-04	27	97	25	52	0.7258
Putrefaction 2: Void Walker	2017-05-29	7963	262	77	8040	0.7256999999999999
Chicken Farm 2K17	2017-12-05	235	234	68	303	0.7256
UNO	2017-01-03	5639	32586	11767	17406	0.7253000000000001
2 Ninjas 1 Cup	2017-02-03	1003	199	57	1060	0.7252
Distant Space 2	2017-11-02	40	113	30	70	0.7252
Uurnog Uurnlimited	2017-11-16	17	80	20	37	0.7252
Dear Esther: Landmark Edition	2017-02-14	2097	3980	1373	3470	0.7251000000000001
Aven Colony	2017-07-25	1738	1712	573	2311	0.7249
ZANGEKI WARP	2017-02-15	7	31	6	13	0.7248
Phantasma VR	2017-06-12	5	31	6	11	0.7248
Lethal Laser	2017-08-16	7	31	6	13	0.7248
Weable	2017-08-22	2416	214	62	2478	0.7247
Naev	2017-07-17	62	132	36	98	0.7247
Machine Made: Rebirth	2017-10-10	2395	106	28	2423	0.7245999999999999
Spacecats with Lasers : The Outerspace	2017-05-24	5	11	1	6	0.7242000000000001
SkyKeepers	2017-03-31	3	11	1	4	0.7242000000000001
TRESPASS - Episode 2	2017-02-17	5	11	1	6	0.7242000000000001
Dr. Doyle & The Mystery of the Cloche Hat	2017-04-27	3	11	1	4	0.7242000000000001
Gearend	2017-11-17	4	11	1	5	0.7242000000000001
Diesel Power	2017-03-03	4	11	1	5	0.7242000000000001
Super Pixel Smash	2017-01-25	7	11	1	8	0.7242000000000001
Just VR Slingshot Target Practice	2017-02-25	2	11	1	3	0.7242000000000001
Moonatees	2017-03-29	3	11	1	4	0.7242000000000001
Golden Panic	2017-06-21	6	11	1	7	0.7242000000000001
Bonny's Adventure	2017-04-26	2524	11	1	2525	0.7242000000000001
Dark and Bright	2017-11-29	2	11	1	3	0.7242000000000001
RPS Runner	2017-07-05	4	11	1	5	0.7242000000000001
THE HOUCHI PLAY -THE 放置プレイ-	2017-07-31	7	11	1	8	0.7242000000000001
Space Waver	2017-09-07	3	11	1	4	0.7242000000000001
Secrets of Arcadia	2017-10-03	3	11	1	4	0.7242000000000001
BlockGame	2017-09-12	3	11	1	4	0.7242000000000001
Sweaty Palms	2017-11-06	7	11	1	8	0.7242000000000001
岚零之风 - Wind Horizon	2017-09-04	5	11	1	6	0.7242000000000001
Boot Hill Blaster	2017-11-09	1	11	1	2	0.7242000000000001
BROKE PROTOCOL: Online City RPG	2017-08-26	147854	2174	740	148594	0.7238
Mercury: Cascade into Madness	2017-08-10	499	38	8	507	0.7238
Chester One	2017-02-20	432	27	5	437	0.7238
Tales of the Tiny Planet	2017-08-03	14	27	5	19	0.7238
Elemental Combat	2017-11-17	5	27	5	10	0.7238
Tank Destroyer	2017-03-09	943	246	73	1016	0.7234
Tiny Tales: Heart of the Forest	2017-07-20	39	153	43	82	0.7234
Forest Legends: The Call of Love Collector's Edition	2017-12-20	8	62	15	23	0.723
Star Control I & II	2017-10-19	31	95	25	56	0.7228
Monumental Failure	2017-01-17	8	23	4	12	0.7228
VRemin	2017-02-06	629	23	4	633	0.7228
Tailwind	2017-07-28	5	23	4	9	0.7228
Burn It Down	2017-08-03	6	55	13	19	0.7225
Robot Heroes	2017-08-26	12	55	13	25	0.7225
Chess Ultra	2017-06-21	179	1299	436	615	0.7223999999999999
Wooden Battles	2017-12-22	45	323	99	144	0.7223999999999999
Space Fuss	2017-02-28	1235	75	19	1254	0.7222
Think To Die 3	2017-03-27	17	65	16	33	0.7222
Child of the Wind	2017-06-16	10	15	2	12	0.7222
Header Goal VR: Being Axel Rix	2017-08-16	3	15	2	5	0.7222
Ricky Raccoon	2017-05-23	5	15	2	7	0.7222
ERSATZ	2017-09-13	3	15	2	5	0.7222
Atomic Adam: Episode 1	2017-12-30	3	15	2	5	0.7222
222 Hearts	2017-10-20	4	48	11	15	0.7221
Home Run Solitaire	2017-10-18	6	19	3	9	0.7221
Runt of the Litter	2017-02-23	73	41	9	82	0.7220000000000001
Collision Course	2017-01-07	20	201	59	79	0.7219
Narcosis	2017-03-28	67	855	282	349	0.7217
Pixel Shopkeeper	2017-07-21	117	123	34	151	0.7217
Sticker Craft	2017-01-19	501	78	20	521	0.7217
Monsters and Medicine	2017-09-20	4	6	0	4	0.7217
Marty Thinks 4th Dimensionally	2017-09-27	16	6	0	16	0.7217
Ulama: Arena of the Gods	2017-03-29	2	6	0	2	0.7217
World Destroyers	2017-03-14	2	6	0	2	0.7217
GunHero	2017-04-18	32	6	0	32	0.7217
Paul Pixel - The Awakening	2017-01-09	2	6	0	2	0.7217
Dead Reckoning: Silvermoon Isle Collector's Edition	2017-02-03	4	6	0	4	0.7217
Off The Record: The Art of Deception Collector's Edition	2017-03-10	3	6	0	3	0.7217
Sketch! Run!	2017-03-31	2	6	0	2	0.7217
Crowd Smashers	2017-05-04	6	6	0	6	0.7217
Cosmic Kites	2017-09-07	2	6	0	2	0.7217
Bridge to Another World: Burnt Dreams Collector's Edition	2017-04-10	6	6	0	6	0.7217
Final Cut: Encore Collector's Edition	2017-04-14	3	6	0	3	0.7217
Raybeem	2017-10-02	2	6	0	2	0.7217
Break The Food Chain	2017-07-17	3	6	0	3	0.7217
Costumenaut	2017-09-22	2	6	0	2	0.7217
Glitchbuster	2017-11-21	3	6	0	3	0.7217
Shn!p	2017-07-14	2	6	0	2	0.7217
Jetball	2017-12-06	11	6	0	11	0.7217
Photon Rush	2017-07-06	4	6	0	4	0.7217
Kartofank VR	2017-10-12	3	6	0	3	0.7217
Destiny of a Wizard	2017-07-31	3	6	0	3	0.7217
Math Combat Challenge	2017-11-03	3	6	0	3	0.7217
Where the Money Is	2017-08-30	2	6	0	2	0.7217
ASSASSINATION STATION	2017-09-29	2	6	0	2	0.7217
Half Past Disaster	2017-10-13	3	6	0	3	0.7217
Phantom Warfare	2017-08-28	4	6	0	4	0.7217
Don't Explode	2017-10-15	2	6	0	2	0.7217
Going Astray	2017-10-10	2	6	0	2	0.7217
Another Rocket Game	2017-10-25	4	6	0	4	0.7217
Azada® : In Libro Collector's Edition	2017-11-08	3	6	0	3	0.7217
Tico	2017-11-21	4	6	0	4	0.7217
Metal Quest	2017-12-06	2	6	0	2	0.7217
Man of Honor	2017-12-07	2	6	0	2	0.7217
Souland	2017-12-30	3	6	0	3	0.7217
Rick and Morty: Virtual Rick-ality	2017-04-20	935	1456	494	1429	0.7215
Ambre - a heartbreaking kinetic novel	2017-06-09	35	460	146	181	0.7214
Heliborne Collection	2017-10-12	1349	2720	947	2296	0.7212999999999999
Pipes!	2017-12-21	1443	129	36	1479	0.7212999999999999
SUPERHOT VR	2017-05-25	839	6461	2311	3150	0.7212000000000001
Frosty Nights	2017-12-08	124	160	46	170	0.7211
Flow:The Sliding	2017-07-16	32	221	66	98	0.7209000000000001
Neon Seoul: Outrun	2017-12-20	11	30	6	17	0.7209000000000001
MAKE IT as an Artist	2017-03-09	5	84	22	27	0.7208
Pixel Traffic: Circle Rush	2017-08-30	15	100	27	42	0.7206999999999999
Copoka	2017-02-15	16	190	56	72	0.7205
The Trap 2: Mindlock (beta)	2017-06-06	20	202	60	80	0.7204
EMERGENCY 3	2017-12-19	44	103	28	72	0.7204
Robocraft	2017-08-24	26725	86120	32351	59076	0.7202
Tomato Jones 2	2017-05-12	962	64	16	978	0.7201000000000001
Constructor	2017-05-26	333	508	164	497	0.7199
Sin Castle	2017-06-19	116	77	20	136	0.7199
Find this!	2017-09-01	13	115	32	45	0.7195999999999999
FootRock 2	2017-06-16	847	47	11	858	0.7194
Spring Bonus	2017-04-11	16	47	11	27	0.7194
Accel World VS. Sword Art Online Deluxe Edition	2017-09-12	426	781	260	686	0.7193
Bottle: Pilgrim Redux	2017-11-10	18	158	46	64	0.7192000000000001
Leisure Suit Larry - Magna Cum Laude Uncut and Uncensored	2017-12-18	93	378	120	213	0.7191
Operation Babel: New Tokyo Legacy	2017-05-16	78	70	18	96	0.7190000000000001
The Superfluous	2017-05-19	129	40	9	138	0.7189
Kith - Tales from the Fractured Plateaus	2017-04-07	10	40	9	19	0.7189
Graceful Explosion Machine	2017-08-08	13	33	7	20	0.7187
StepX	2017-09-26	45	73	19	64	0.7184999999999999
SWARMRIDER OMEGA	2017-09-19	5	73	19	24	0.7184999999999999
The Land of Pain	2017-09-13	58	405	130	188	0.7182
夏花的轨迹——A summer promise to forever	2017-09-16	918	232	71	989	0.7182
Alien Arena: Warriors Of Mars	2017-11-03	147	117	33	180	0.7182
The Fishing Club 3D	2017-03-23	256	367	117	373	0.7181000000000001
中国象棋	2017-10-20	604	166	49	653	0.7181000000000001
Just Fishing	2017-12-16	437	696	232	669	0.718
Ocean Rift	2017-09-13	14	95	26	40	0.718
Nick	2017-12-01	12	63	16	28	0.7179000000000001
Fragmental	2017-12-20	6	22	4	10	0.7178
Going Nowhere: The Dream	2017-11-22	3	22	4	7	0.7178
Xploquest	2017-12-06	4	22	4	8	0.7178
Killing Time	2017-09-21	289	900	305	594	0.7177
Katy and Bob Way Back Home	2017-10-17	1505	79	21	1526	0.7177
Battle Chess	2017-04-20	10	53	13	23	0.7176
Just A Dream	2017-11-01	18	53	13	31	0.7176
Vertical Strike Endless Challenge	2017-04-28	21	144	42	63	0.7173999999999999
Breakneck	2017-12-08	12	104	29	41	0.7173999999999999
TITAN SLAYER	2017-04-28	19	66	17	36	0.7173999999999999
96 Mill	2017-01-26	3	36	8	11	0.7170000000000001
Child Of Ault	2017-01-25	55	36	8	63	0.7170000000000001
Welcome to Moreytown	2017-05-05	48	36	8	56	0.7170000000000001
Battle for Orion 2	2017-03-23	17	56	14	31	0.7169
Chambered	2017-07-19	8	29	6	14	0.7169
Microsoft Allegiance	2017-09-29	105	122	35	140	0.7167
Arena Hero	2017-01-14	21	46	11	32	0.7166
TOTOBALL	2017-09-11	5	46	11	16	0.7166
Starpoint Gemini Warlords	2017-05-23	1260	2470	882	2142	0.7162999999999999
Romance of the Three Kingdoms II	2017-01-24	34	18	3	37	0.7162999999999999
４人打ちアクション麻雀 / ACTION MAHJONG	2017-02-24	8	18	3	11	0.7162999999999999
Crush	2017-06-09	4	18	3	7	0.7162999999999999
Sphere Frustration	2017-07-14	25	18	3	28	0.7162999999999999
Arrowpoint	2017-12-11	3	18	3	6	0.7162999999999999
Redneck Rampage	2017-01-04	10	112	32	42	0.7156999999999999
Audio Factory	2017-11-06	9	49	12	21	0.7156999999999999
Galactic Fighters	2017-03-15	51	10	1	52	0.7155
Disney's The Jungle Book	2017-12-18	3	10	1	4	0.7155
IsoBoom	2017-08-14	3	10	1	4	0.7155
Boxed In	2017-12-22	3	10	1	4	0.7155
MuX	2017-12-18	3	10	1	4	0.7155
HELI-COMMANDO 2017	2017-10-07	2	10	1	3	0.7155
Tough Story: Big Hell	2017-09-25	2	10	1	3	0.7155
Drone Racer: Canyons	2017-08-29	4	10	1	5	0.7155
Vibrant	2017-10-24	3	10	1	4	0.7155
The Scrungeon Depths	2017-11-09	5	10	1	6	0.7155
LOGistICAL: Switzerland	2017-11-09	9	10	1	10	0.7155
Bronze Age	2017-09-25	108	216	67	175	0.7152
Doctor Kvorak's Obliteration Game	2017-07-26	4	14	2	6	0.7152
An Octonaut Odyssey	2017-03-03	3	14	2	5	0.7152
Solitaire VR	2017-04-20	3	14	2	5	0.7152
Kindled Cavern	2017-01-13	3	14	2	5	0.7152
Oblivion Tesseract VR	2017-04-20	3	14	2	5	0.7152
Ironclads 2: Boshin War	2017-04-19	3	14	2	5	0.7152
Flux8	2017-08-07	10	14	2	12	0.7152
陨星危机	2017-12-08	3	14	2	5	0.7152
AstronjumpBaby	2017-08-29	2	14	2	4	0.7152
Titus the Fox	2017-09-29	2	14	2	4	0.7152
Echoed World	2017-12-04	72	423	139	211	0.7151000000000001
Rocketbirds 2 Evolution	2017-01-26	153	277	88	241	0.7151000000000001
Flinthook	2017-04-18	459	600	202	661	0.715
Leisure Suit Larry 6 - Shape Up Or Slip Out	2017-12-18	9	52	13	22	0.715
Queen of Seas	2017-02-02	928	93	26	954	0.7149
Gravity Lab	2017-05-18	8	32	7	15	0.7149
One Night You're Crazy	2017-09-21	3	32	7	10	0.7149
Artifact Quest 2	2017-11-03	13	32	7	20	0.7149
Nirvana Pilot Yume	2017-12-14	6	96	27	33	0.7148000000000001
Forgotten Chambers	2017-04-21	5	25	5	10	0.7148000000000001
Within a Rose	2017-10-20	5	25	5	10	0.7148000000000001
Technotron Defense	2017-12-22	6	25	5	11	0.7148000000000001
Need For Drink	2017-11-03	68	749	256	324	0.7147
Samurai Riot Definitive Edition	2017-09-13	12	55	14	26	0.7144
Grobda Remix	2017-11-16	798	567	191	989	0.7143
Malzbie's Pinball Collection	2017-10-27	15	114	33	48	0.7143
Tetropunk	2017-12-13	2396	120	35	2431	0.7142000000000001
Wolfenstein II: The New Colossus German Edition	2017-10-26	2782	1111	389	3171	0.7140000000000001
Has-Been Heroes	2017-03-27	154	278	89	243	0.7140000000000001
VRChat	2017-02-01	46814	139358	54314	101128	0.7139
MEMETYPER	2017-09-27	5	58	15	20	0.7139
Time Recoil	2017-08-10	14	83	23	37	0.7137000000000001
Pixel Painter	2017-06-19	14105	739	254	14359	0.7136
Eldritch Hunter	2017-01-28	63	35	8	71	0.7134999999999999
Reverie	2017-10-04	5	35	8	13	0.7134999999999999
TumbleSeed	2017-05-02	51	161	49	100	0.7134
Adventures of Bertram Fiddle: Episode 2: A Bleaker Predicklement	2017-08-24	29	134	40	69	0.7131000000000001
Nights of Azure 2: Bride of the New Moon	2017-10-24	151	250	80	231	0.7127
A Hole New World	2017-05-19	35	70	19	54	0.7126
Schacht	2017-02-27	172	28	6	178	0.7126
Cliffstone Manor	2017-10-17	4	28	6	10	0.7126
Hexters	2017-12-16	7	21	4	11	0.7125
LyraVR	2017-03-22	5	21	4	9	0.7125
9th Dawn Classic	2017-09-07	5	21	4	9	0.7125
Gangs of Space	2017-08-10	383	312	102	485	0.7123
Conclave	2017-01-20	36	54	14	50	0.7119
Achievement Lurker: Respectable Accomplishment	2017-11-01	13	85	24	37	0.7118000000000001
King Kaiju	2017-01-31	14	118	35	49	0.7117
Ananias Roguelike	2017-02-10	10	41	10	20	0.7114
Nimble Fish	2017-09-12	11	60	16	27	0.7112
The Trail: Frontier Challenge	2017-08-15	119	219	70	189	0.711
Caligo	2017-09-22	39	692	241	280	0.7109000000000001
Hex Commander: Fantasy Heroes	2017-12-22	170	196	62	232	0.7109000000000001
NEXT JUMP: Shmup Tactics	2017-04-28	26	63	17	43	0.7109000000000001
Sky Jump	2017-09-23	26	193	61	87	0.7108
Don't Tax Me, Bro!	2017-06-05	490	44	11	501	0.7107
The Search	2017-04-14	452	854	302	754	0.7101999999999999
STAR WARS™: Shadows of the Empire	2017-02-08	98	441	150	248	0.7101999999999999
About Elise	2017-09-26	31	102	30	61	0.7101999999999999
Close Me	2017-08-09	31	81	23	54	0.7101999999999999
KROSMAGA	2017-04-12	794	716	251	1045	0.7101000000000001
Bitku	2017-02-09	22	47	12	34	0.7101000000000001
Nocturnal Hunt	2017-12-01	8	47	12	20	0.7101000000000001
Delila's Gift	2017-05-22	6	17	3	9	0.71
Slingshot Puzzle	2017-07-01	7	17	3	10	0.71
LOGistICAL: British Isles	2017-08-08	16	17	3	19	0.71
MOBIUS FINAL FANTASY	2017-02-06	9443	3175	1185	10628	0.7099
Odyssey - The Invention of Science	2017-04-19	32	209	67	99	0.7099
Yesterday	2017-08-24	4	24	5	9	0.7099
Magic Potion Destroyer	2017-09-26	22	24	5	27	0.7099
Highlands, Deep Waters	2017-09-28	16	24	5	21	0.7099
Fariwalk: The Prelude	2017-11-24	5	24	5	10	0.7099
Block'hood	2017-05-11	640	919	327	967	0.7098000000000001
VR SHOOT AROUND - Realistic basketball simulator -	2017-07-13	6	34	8	14	0.7098000000000001
BLOKDODGE	2017-09-20	10	34	8	18	0.7098000000000001
A Trip to Yugoslavia: Director's Cut	2017-02-22	852	217	70	922	0.7095
Bokida - Heartfelt Reunion	2017-05-17	38	113	34	72	0.7090000000000001
Legends of Iskaria	2017-07-06	8	37	9	17	0.7088
DOG GONE GOLFING	2017-08-25	726	37	9	735	0.7088
Darkarta: A Broken Heart's Quest Standard Edition	2017-08-28	13	62	17	30	0.7087000000000001
Leisure Suit Larry 1 - In the Land of the Lounge Lizards	2017-12-18	63	159	50	113	0.7086
Cuit	2017-04-24	52	98	29	81	0.7086
Mission Ammunition	2017-10-27	9	71	20	29	0.7084
Melody	2017-10-05	2	5	0	2	0.7084
Crystal Control II	2017-07-12	371	5	0	371	0.7084
Clutter Infinity: Joe's Ultimate Quest	2017-08-10	10	5	0	10	0.7084
Ze VR	2017-03-28	1	5	0	1	0.7084
Light It	2017-03-30	3	5	0	3	0.7084
Toymaker	2017-03-24	2	5	0	2	0.7084
Love Story: Letters from the Past	2017-03-29	3	5	0	3	0.7084
Hidden Expedition: The Pearl of Discord Collector's Edition	2017-04-08	4	5	0	4	0.7084
League of Light: Wicked Harvest Collector's Edition	2017-04-24	4	5	0	4	0.7084
Journey of Johann	2017-05-19	2	5	0	2	0.7084
Defenders of the Realm VR	2017-05-23	2	5	0	2	0.7084
RoboTraps	2017-06-20	1	5	0	1	0.7084
A Quick Death	2017-07-11	2	5	0	2	0.7084
Arena	2017-08-01	10	5	0	10	0.7084
Cognizant Protocol	2017-07-22	2	5	0	2	0.7084
OtterBash	2017-07-13	4	5	0	4	0.7084
Whispered Secrets: Into the Beyond Collector's Edition	2017-07-17	3	5	0	3	0.7084
Monsteria	2017-08-08	2	5	0	2	0.7084
Surface: Game of Gods Collector's Edition	2017-09-11	3	5	0	3	0.7084
Tic Tac Toe Lounge	2017-10-04	2	5	0	2	0.7084
TERRAGEARTH	2017-10-02	2	5	0	2	0.7084
Duped	2017-09-30	2	5	0	2	0.7084
Mark After Dark	2017-12-15	3	5	0	3	0.7084
Konrad the Rocket	2017-10-16	2	5	0	2	0.7084
Hidden Expedition: The Fountain of Youth Collector's Edition	2017-10-09	5	5	0	5	0.7084
Dogma	2017-11-03	2	5	0	2	0.7084
Clutter VI: Leigh's Story	2017-10-19	5	5	0	5	0.7084
Yanone: Letter Splatter	2017-11-23	2	5	0	2	0.7084
Chevo Lurker: Exodus	2017-10-12	9	77	22	31	0.7083
Toy Plane Heroes	2017-06-08	7	40	10	17	0.7081000000000001
Saga of the Void: Admirals	2017-08-02	6	27	6	12	0.7081000000000001
Sommad	2017-08-07	4	27	6	10	0.7081000000000001
Glorious Noon	2017-11-15	10	27	6	16	0.7081000000000001
Yōdanji	2017-12-07	9	27	6	15	0.7081000000000001
UltraGoodness	2017-06-02	1062	161	51	1113	0.7078
Queen's Quest 3: The End of Dawn	2017-04-27	33	112	34	67	0.7077
Escape Lizards	2017-04-10	5	13	2	7	0.7075
High Noon Revolver	2017-01-25	7	13	2	9	0.7075
Children of the Galaxy	2017-03-14	6	13	2	8	0.7075
VRQB	2017-09-08	2	13	2	4	0.7075
Wacky Spores: The Chase	2017-02-10	9	13	2	11	0.7075
Powernaut VANGARDT	2017-03-29	549	13	2	551	0.7075
Crystal Reign	2017-11-08	3	13	2	5	0.7075
Zombie Town	2017-07-28	3	13	2	5	0.7075
Robots: create AI	2017-09-11	10	13	2	12	0.7075
VR Hurl	2017-09-12	4	13	2	6	0.7075
Labyrinthian	2017-09-14	2	13	2	4	0.7075
Broadway: 1849	2017-11-22	18	13	2	20	0.7075
ATOMINE	2017-05-04	36	236	78	114	0.7071
Choppa	2017-02-23	2274	97	29	2303	0.7071
Dream Golf VR	2017-11-03	18	97	29	47	0.7071
Carrier	2017-08-31	28	30	7	35	0.7068000000000001
Reckpunk	2017-01-12	6	20	4	10	0.7068000000000001
Fat Mask	2017-05-15	12	20	4	16	0.7068000000000001
Viking Saga: Epic Adventure	2017-12-07	21	20	4	25	0.7068000000000001
Castles II: Siege & Conquest	2017-08-18	7	20	4	11	0.7068000000000001
Minimalism	2017-02-08	5657	1244	457	6114	0.7067
Nancy Drew: Labyrinth of Lies	2017-02-13	30	52	14	44	0.7067
Hidden & Dangerous: Action Pack	2017-12-20	14	82	24	38	0.7066
Endless Combat	2017-11-12	134	55	15	149	0.7065
Grimoire Chronicles	2017-04-20	744	58	16	760	0.7064
Firewood	2017-08-01	23	108	33	56	0.7061000000000001
Distrust	2017-08-23	472	1592	593	1065	0.706
TheFirstClass VR / 第一课 VR	2017-12-15	14	33	8	22	0.7059000000000001
Artillerists	2017-01-02	79	102	31	110	0.7058
XOXO Droplets	2017-08-31	46	198	65	111	0.7057
Didgery	2017-03-10	5	9	1	6	0.7057
Schlocks	2017-04-18	4	9	1	5	0.7057
AEGIS 2186	2017-05-14	4	9	1	5	0.7057
Geoid	2017-06-17	6	9	1	7	0.7057
Potentia	2017-07-04	4	9	1	5	0.7057
Fantasy Mosaics 16: Six Colors in Wonderland	2017-07-10	7	9	1	8	0.7057
Brave Path	2017-07-26	4	9	1	5	0.7057
Battle Chess II: Chinese Chess	2017-07-31	2	9	1	3	0.7057
玄龙棋 MysteryChess	2017-10-12	2	9	1	3	0.7057
RUNRUNRUN	2017-10-06	3	9	1	4	0.7057
Cyberia 2: Resurrection	2017-10-24	4	9	1	5	0.7057
LightTrack	2017-10-20	2	9	1	3	0.7057
Brainy Joy	2017-11-27	2	9	1	3	0.7057
Unforgiving Happiness	2017-11-15	2	9	1	3	0.7057
Idle Evolution	2017-04-03	206	136	43	249	0.7054
Gold Rush: The Game	2017-10-13	6625	9160	3599	10224	0.7053
Willy-Nilly Knight	2017-11-10	85	214	71	156	0.7051999999999999
Moonfall	2017-04-12	15	36	9	24	0.7051999999999999
Supermagical	2017-08-11	5	36	9	14	0.7051999999999999
STRAFE: Gold Edition	2017-05-09	1126	1684	632	1758	0.7051000000000001
Jay Fighter: Remastered	2017-12-01	19	172	56	75	0.7048000000000001
Legends of Talia: Arcadia	2017-10-27	12	158	51	63	0.7048000000000001
Polygon Hero	2017-07-07	6	39	10	16	0.7048000000000001
Brute	2017-05-17	34	23	5	39	0.7048000000000001
Tiny Wheels	2017-01-06	11	23	5	16	0.7048000000000001
Resurgence	2017-09-29	20	23	5	25	0.7048000000000001
Major League Gladiators	2017-12-18	15	23	5	20	0.7048000000000001
Emmerholt: Prologue	2017-02-14	13	75	22	35	0.7045
Delicious - Emily's Miracle of Life	2017-08-03	69	75	22	91	0.7045
Dysfunctional Systems: Orientation	2017-07-24	18	42	11	29	0.7044
The Path of Greatest Resistance	2017-02-18	8	42	11	19	0.7044
AudioBeats	2017-01-06	7	42	11	18	0.7044
Trapped With the Dolls VR	2017-04-24	6	42	11	17	0.7044
Lux Alliance	2017-06-08	21	48	13	34	0.7041
Temple Escape	2017-09-26	11	48	13	24	0.7041
Crowman & Wolfboy	2017-06-02	756	60	17	773	0.7040000000000001
Through the Mirror	2017-01-07	1230	51	14	1244	0.7040000000000001
Dream Hills: Captured Magic	2017-11-07	20	51	14	34	0.7040000000000001
Paranormal Activity: The Lost Soul	2017-08-15	57	518	185	242	0.7039
Games&Girls	2017-04-18	1395	201	67	1462	0.7036
My Vet Practice	2017-02-28	9	26	6	15	0.7034
Tanks vs Aliens	2017-05-25	1762	26	6	1768	0.7034
Mini Hockey Champ!	2017-11-02	11	26	6	17	0.7034
The Love Boat	2017-12-01	16	26	6	22	0.7034
Grappledrome	2017-02-13	12	16	3	15	0.7033
Caliper	2017-02-01	2836	16	3	2839	0.7033
MEGALOMANIAC	2017-04-26	9	16	3	12	0.7033
MarksmanVR	2017-09-19	3	16	3	6	0.7033
El Ministerio del Tiempo VR: El tiempo en tus manos	2017-09-29	4	16	3	7	0.7033
Zero Days VR	2017-12-14	4	16	3	7	0.7033
Wells	2017-01-30	988	77	23	1011	0.7027
Absolver	2017-08-29	18921	9865	3937	22858	0.7026000000000001
Terroir	2017-09-20	55	278	96	151	0.7025
Void Rangers	2017-05-11	10	29	7	17	0.7025
Evertree Inn	2017-01-20	32	29	7	39	0.7025
Zork Nemesis: The Forbidden Lands	2017-04-18	8	29	7	15	0.7025
Geostorm	2017-10-30	6	29	7	13	0.7025
Solstice Chronicles: MIA	2017-07-26	101	221	75	176	0.7022
welcome to heaven	2017-06-22	74	381	135	209	0.7020000000000001
Omega Quintet	2017-12-15	152	122	39	191	0.7020000000000001
Chocolate makes you happy	2017-11-22	7	122	39	46	0.7020000000000001
The Crow's Eye	2017-03-20	23	130	42	65	0.7016
Game Tengoku CruisinMix Special	2017-11-30	27	59	17	44	0.7016
The Wild Eternal	2017-04-13	20	99	31	51	0.7012999999999999
Tender Loving Care	2017-03-30	12	99	31	43	0.7012999999999999
Throttle Powah VR	2017-05-30	11	38	10	21	0.7012999999999999
Senko no Ronde 2	2017-09-07	81	41	11	92	0.7012
Leisure Suit Larry 3 - Passionate Patti in Pursuit of the Pulsating Pectorals	2017-12-18	28	41	11	39	0.7012
Bunny Hop League	2017-04-27	423	520	189	612	0.7011000000000001
Helltown	2017-09-27	4	44	12	16	0.7011000000000001
Adventures Of Pipi	2017-11-10	5	176	59	64	0.7009000000000001
Pacer	2017-05-31	122	558	204	326	0.7008
Lil Tanks	2017-04-04	11	19	4	15	0.7008
GoalkeepVr	2017-01-06	8	19	4	12	0.7008
LIT	2017-02-21	14	19	4	18	0.7008
A Foretold Affair	2017-03-10	61	19	4	65	0.7008
Infinite Minigolf	2017-07-25	18	93	29	47	0.7007
Total Miner	2017-12-23	104	448	162	266	0.7004
City Climber	2017-02-24	92	261	91	183	0.7001999999999999
Lazaretto	2017-05-19	5	70	21	26	0.7001999999999999
Deep GachiGASM	2017-11-13	5	98	31	36	0.6997
WARRIORS ALL-STARS	2017-08-30	369	482	176	545	0.6996
Bannerman	2017-08-31	22	109	35	57	0.6995
Zombie Solitaire 2 Chapter 1	2017-06-30	163	61	18	181	0.6994
Gotta Go	2017-08-11	8	22	5	13	0.6994
The Astonishing Game	2017-02-06	11	22	5	16	0.6994
PATHOS	2017-12-05	8	22	5	13	0.6994
Timension	2017-11-03	4	22	5	9	0.6994
room13	2017-01-13	157	58	17	174	0.6990999999999999
Bitdude	2017-05-16	6	12	2	8	0.6990999999999999
CyberDrifter	2017-05-09	3	12	2	5	0.6990999999999999
Dead Days	2017-03-31	39	12	2	41	0.6990999999999999
The Cursed Revolver	2017-04-26	4	12	2	6	0.6990999999999999
Uphill Skiing	2017-07-01	5	12	2	7	0.6990999999999999
Goalie VR	2017-10-05	4	12	2	6	0.6990999999999999
RetroGunX VR	2017-09-05	2	12	2	4	0.6990999999999999
Drosoph Hotel	2017-10-23	3	12	2	5	0.6990999999999999
The Flesh God	2017-11-02	4	12	2	6	0.6990999999999999
Light of Mine	2017-10-30	3	12	2	5	0.6990999999999999
HoPiKo	2017-01-06	1001	147	49	1050	0.6990000000000001
Looterkings	2017-08-11	130	322	115	245	0.6989
Company of Heroes: Modern Combat	2017-11-30	17	198	68	85	0.6989
Miner Meltdown	2017-08-02	94	103	33	127	0.6988
Tarim: Guardians	2017-10-27	1819	55	16	1835	0.6988
One Piece: Unlimited World Red - Deluxe Edition	2017-08-25	81	277	98	179	0.6986
Last Dream: World Unknown	2017-06-01	57	52	15	72	0.6986
Redneck Rampage Rides Again	2017-06-05	4	25	6	10	0.6985
Trapper Knight, Sharpshooter Princess	2017-04-10	5	25	6	11	0.6985
The Lost Gardens	2017-10-31	6	25	6	12	0.6985
Fluffy Friends	2017-09-19	8	49	14	22	0.6983
Druid	2017-01-17	690	173	59	749	0.6981
Unknown Pharaoh	2017-01-06	6	28	7	13	0.698
Mono	2017-03-24	5	28	7	12	0.698
Coffee Run	2017-10-30	13	83	26	39	0.6979000000000001
VR: The Puzzle Room	2017-01-05	11	40	11	22	0.6978
Sangokushi Eiketsuden	2017-08-30	16	40	11	27	0.6978
In Game Adventure: Legend of Monsters	2017-06-29	11	94	30	41	0.6977
Doug and Lily	2017-03-01	3246	37	10	3256	0.6977
Incredible Dracula II: The Last Call Collector's Edition	2017-01-26	57	31	8	65	0.6977
Shining Plume 2	2017-02-24	778	34	9	787	0.6976000000000001
Cyborg Tower Defense	2017-04-14	9	34	9	18	0.6976000000000001
RHEM I SE: The Mysterious Land	2017-07-28	8	34	9	17	0.6976000000000001
Time Lock VR 1 	2017-08-09	27	435	160	187	0.6973
Twins of the Pasture	2017-07-20	200	224	79	279	0.6965000000000001
The Low Road	2017-07-26	19	150	51	70	0.6964
Gauntlet of IRE	2017-12-15	66	131	44	110	0.6962
The Legend of Bean	2017-12-21	7	68	21	28	0.6959000000000001
Spark	2017-11-10	5	15	3	8	0.6959000000000001
Hell Dimension VR	2017-09-08	9	15	3	12	0.6959000000000001
Inflatality	2017-10-26	7	15	3	10	0.6959000000000001
Sokoban Land DX	2017-07-27	4	15	3	7	0.6959000000000001
BELPAESE: Homecoming	2017-10-16	3	15	3	6	0.6959000000000001
TRATEL64	2017-11-22	14	101	33	47	0.6958
Thing-in-Itself	2017-01-05	6	79	25	31	0.6957
Neighboring Islands	2017-05-01	3436	79	25	3461	0.6957
Metamorfose S	2017-07-04	2050	109	36	2086	0.6956
ШП (ShP)	2017-10-31	13	141	48	61	0.6953
DYE	2017-02-23	206	62	19	225	0.6950000000000001
BAFL - Brakes Are For Losers	2017-10-18	6	45	13	19	0.6950000000000001
Space Fist	2017-02-22	14	45	13	27	0.6950000000000001
Army Men	2017-12-20	15	73	23	38	0.6947
Running Through Russia	2017-05-21	157	1010	394	551	0.6946
Shogo: Mobile Armor Division	2017-04-14	11	119	40	51	0.6945
Beastmancer	2017-10-05	21	59	18	39	0.6945
Mind Maze	2017-06-24	7	59	18	25	0.6945
Metagalactic Blitz	2017-11-16	8	18	4	12	0.6944
Adventuring gentleman	2017-04-10	181	18	4	185	0.6944
Northern Tale 3	2017-12-01	10	18	4	14	0.6944
SuperCluster: Void	2017-05-15	6	18	4	10	0.6944
Xenia	2017-09-01	5	18	4	9	0.6944
Speebot	2017-10-13	5	18	4	9	0.6944
Hate Free Heroes RPG 3.0	2017-07-08	1474	8	1	1475	0.6944
Wizard King	2017-02-09	3	8	1	4	0.6944
Orbital Injection	2017-02-02	4	8	1	5	0.6944
The St Christopher's School Lockdown	2017-10-18	7	8	1	8	0.6944
Winning Post	2017-07-25	16	8	1	17	0.6944
Aliens In The Yard	2017-07-25	2	8	1	3	0.6944
Lupus in Fabula	2017-07-13	3	8	1	4	0.6944
Virtual Temple: Order of the Golden Dawn	2017-07-26	2	8	1	3	0.6944
Slide!!	2017-10-06	3	8	1	4	0.6944
Mayhem Above	2017-08-14	2	8	1	3	0.6944
Laika 2.0	2017-09-08	3	8	1	4	0.6944
Dark Tales: Edgar Allan Poe's The Fall of the House of Usher Collector's Edition	2017-07-19	4	8	1	5	0.6944
Sudokube	2017-11-15	4	8	1	5	0.6944
Death Rings of Jupiter	2017-12-02	2	8	1	3	0.6944
Slash/Dots.	2017-09-06	2	8	1	3	0.6944
LOGistICAL: USA - Oregon	2017-09-19	11	8	1	12	0.6944
OVO Smash!	2017-10-10	3	8	1	4	0.6944
Tactical AR	2017-11-08	5	8	1	6	0.6944
The Exorcist: Legion VR - Chapter 1: First Rites	2017-11-22	25	200	71	96	0.6940000000000001
Iron Tides	2017-07-24	22	56	17	39	0.6940000000000001
The Adventurer and His Backpack	2017-09-04	96	56	17	113	0.6940000000000001
Alexa's Wild Night	2017-12-13	8	36	10	18	0.6939000000000001
NOKBAK	2017-08-29	86	236	85	171	0.6938
Eternal Lore	2017-09-19	16	33	9	25	0.6936
Dungeon Marathon	2017-10-03	3	33	9	12	0.6936
Barbara-ian	2017-01-16	4	21	5	9	0.6936
Strategic Command Classic: WWI	2017-12-08	17	21	5	22	0.6936
Ezy	2017-08-07	3	21	5	8	0.6936
Devil in the Pines	2017-09-29	4	21	5	9	0.6936
Nakawak: Expanded Color Edition	2017-10-11	3	21	5	8	0.6936
Among the Innocent: A Stricken Tale	2017-02-14	37	53	16	53	0.6935
Element TD	2017-01-20	11	53	16	27	0.6935
Google Spotlight Stories: Sonaria	2017-11-17	7	30	8	15	0.6934
Castle Explorer	2017-03-31	11	27	7	18	0.6933
Skytropolis	2017-11-02	11	27	7	18	0.6933
DEATHPIT 3000	2017-12-01	8	27	7	15	0.6933
Numantia	2017-10-25	7	24	6	13	0.6933
Apocalypse Night	2017-10-31	117	24	6	123	0.6933
VITATIO	2017-07-28	4	24	6	10	0.6933
Z Runaway	2017-09-07	9	94	31	40	0.6931999999999999
Attack Of Insects	2017-09-15	18	64	20	38	0.6931
XXZ	2017-09-29	157	469	178	335	0.6929000000000001
Shephy	2017-08-04	42	115	39	81	0.6927
Megaton Rainfall	2017-11-17	457	1190	473	930	0.6925
Pinball Inside: A VR Arcade Game	2017-03-09	6	47	14	20	0.6924
The Last Conflict	2017-09-21	205	167	59	264	0.6923
Don't Knock Twice	2017-09-05	29	375	141	170	0.6922
aMAZE Double	2017-11-03	5	112	38	43	0.6922
Fidget Spinner In Space	2017-11-14	4	69	22	26	0.6920000000000001
WarpBall	2017-06-05	5	4	0	5	0.6920000000000001
Vektron Revenge	2017-03-06	3	4	0	3	0.6920000000000001
Fight Me Bro!	2017-01-21	2	4	0	2	0.6920000000000001
Convicted Galaxy	2017-02-09	5	4	0	5	0.6920000000000001
Dark Cases: The Blood Ruby Collector's Edition	2017-01-11	5	4	0	5	0.6920000000000001
Binary Trigger	2017-11-01	2	4	0	2	0.6920000000000001
Colourise	2017-04-21	2	4	0	2	0.6920000000000001
Fly Away	2017-03-21	3	4	0	3	0.6920000000000001
Spirits of Mystery: Song of the Phoenix Collector's Edition	2017-02-17	4	4	0	4	0.6920000000000001
elaine	2017-02-14	2	4	0	2	0.6920000000000001
Witch Hunters: Stolen Beauty Collector's Edition	2017-03-06	3	4	0	3	0.6920000000000001
Easy Magic	2017-03-27	2	4	0	2	0.6920000000000001
Web of Deceit: Black Widow Collector's Edition	2017-03-13	4	4	0	4	0.6920000000000001
Queen's Tales: The Beast and the Nightingale Collector's Edition	2017-03-15	5	4	0	5	0.6920000000000001
Punished Talents: Seven Muses Collector's Edition	2017-03-31	2	4	0	2	0.6920000000000001
Midnight Calling: Anabel Collector's Edition	2017-04-06	3	4	0	3	0.6920000000000001
Reflector: Bug Hunt	2017-08-22	10	4	0	10	0.6920000000000001
Royal Detective: Queen of Shadows Collector's Edition	2017-06-09	2	4	0	2	0.6920000000000001
Pixel Pursuit	2017-07-06	2	4	0	2	0.6920000000000001
Valhall 2000	2017-07-14	4	4	0	4	0.6920000000000001
Cube Creatures	2017-07-28	1	4	0	1	0.6920000000000001
Attack of the Gooobers	2017-10-13	5	4	0	5	0.6920000000000001
The Balloonist: Beyond the Clouds	2017-11-27	2	4	0	2	0.6920000000000001
Mayas' Virtual Brush	2017-09-22	2	4	0	2	0.6920000000000001
Disassembled	2017-08-31	2	4	0	2	0.6920000000000001
Geometry World	2017-09-20	4	4	0	4	0.6920000000000001
TurretMaster	2017-11-28	3	4	0	3	0.6920000000000001
Storms of Shambhala	2017-10-11	2	4	0	2	0.6920000000000001
Denki Gaka's Bombshell	2017-08-16	1	4	0	1	0.6920000000000001
Nebula Nuker	2017-12-21	2	4	0	2	0.6920000000000001
European Mystery: The Face of Envy Collector's Edition	2017-09-05	2	4	0	2	0.6920000000000001
Marblesared	2017-10-04	10	4	0	10	0.6920000000000001
王国出击	2017-10-26	4	4	0	4	0.6920000000000001
Beer, Babes and Dragons	2017-09-15	2	4	0	2	0.6920000000000001
All Cows In	2017-12-06	2	4	0	2	0.6920000000000001
Alien Mayhem	2017-12-20	4	4	0	4	0.6920000000000001
Endless Wave	2017-11-09	4	4	0	4	0.6920000000000001
Mad Gardener: Zombie Massacre	2017-12-14	3	4	0	3	0.6920000000000001
Solar Lander	2017-10-16	1	4	0	1	0.6920000000000001
Love all you have left	2017-10-31	4	4	0	4	0.6920000000000001
Lost Home	2017-12-01	3	4	0	3	0.6920000000000001
Timeless: The Lost Castle	2017-10-16	4	4	0	4	0.6920000000000001
Keyscaper	2017-10-30	4	4	0	4	0.6920000000000001
The Francy Droo & Friends Collection	2017-12-05	2	4	0	2	0.6920000000000001
One More Night: BiO Clinic	2017-11-06	2	4	0	2	0.6920000000000001
Find Pixel	2017-11-06	2	4	0	2	0.6920000000000001
Flow Handcrafted	2017-11-22	4	4	0	4	0.6920000000000001
Space Rocks	2017-11-28	3	4	0	3	0.6920000000000001
Defend Your Buttress	2017-12-12	1	4	0	1	0.6920000000000001
Talsaluq: Tower of Infinity	2017-12-15	1	4	0	1	0.6920000000000001
ThunderWheels	2017-11-02	6	44	13	19	0.6918000000000001
Trophy Fishing 2	2017-07-13	515	657	256	771	0.6914
Monster Monpiece	2017-03-14	159	268	99	258	0.6914
Miniature Garden	2017-03-30	18	55	17	35	0.6914
EscapeVR: Trapped Above the Clouds	2017-11-13	12	41	12	24	0.6912
Time in Time	2017-05-03	4602	74	24	4626	0.6911
STANDBY	2017-01-07	776	158	56	832	0.691
Sakura Agent	2017-01-27	374	402	153	527	0.6909000000000001
Memoranda	2017-01-25	24	111	38	62	0.6908
Run Of Mydan	2017-07-28	12	63	20	32	0.6908
NosTale	2017-09-18	2237	1974	808	3045	0.6903
Blaite	2017-01-02	1640	361	137	1777	0.6901999999999999
Windstorm: Start of a Great Friendship	2017-07-27	122	100	34	156	0.6900000000000001
Derpy Dinos	2017-11-02	13	49	15	28	0.6900000000000001
RETNE	2017-08-02	183	35	10	193	0.6900000000000001
Rogue Quest: The Vault of the Lost Tyrant	2017-10-25	4	35	10	14	0.6900000000000001
CAT Interstellar	2017-10-06	1367	746	295	1662	0.6899
AFTERGRINDER	2017-07-18	437	68	22	459	0.6898000000000001
Abatron	2017-03-10	11	11	2	13	0.6897
BrambleLash	2017-09-13	3	11	2	5	0.6897
Star Boss	2017-11-20	1923	11	2	1925	0.6897
Infektor	2017-03-06	17	11	2	19	0.6897
Prism Collider	2017-01-31	1223	11	2	1225	0.6897
Adjacency	2017-06-09	4	11	2	6	0.6897
Space Conquest	2017-07-17	9	11	2	11	0.6897
Divine Ascent	2017-04-11	27	11	2	29	0.6897
Gem Hunter	2017-04-28	2	11	2	4	0.6897
Runaway Train	2017-07-14	133	11	2	135	0.6897
Chicken Wars	2017-07-11	4	11	2	6	0.6897
Jam Studio VR	2017-09-25	3	11	2	5	0.6897
The Nothing	2017-08-30	3	11	2	5	0.6897
Battlefleet Engineer	2017-08-18	6	11	2	8	0.6897
Magibot	2017-12-18	4	11	2	6	0.6897
Tactera	2017-12-22	3	11	2	5	0.6897
Pizza Connection 2	2017-04-05	69	172	62	131	0.6896
The Barbarian and the Subterranean Caves	2017-02-10	1417	46	14	1431	0.6893000000000001
Afghanistan '11	2017-03-23	250	257	96	346	0.6890999999999999
Nice Way	2017-12-15	6	81	27	33	0.6890999999999999
Just Jump	2017-12-27	8	65	21	29	0.6890999999999999
Overkill VR	2017-03-10	27	194	71	98	0.6889000000000001
Sakura Magical Girls	2017-02-23	90	194	71	161	0.6889000000000001
Walkerman	2017-05-22	16	29	8	24	0.6888
Placement	2017-09-26	6	29	8	14	0.6888
Metin2	2017-05-08	8285	10307	4421	12706	0.6887000000000001
Pro Cycling Manager 2017	2017-06-15	3355	306	116	3471	0.6887000000000001
Cladun Returns: This Is Sengoku!	2017-06-06	55	54	17	72	0.6887000000000001
Pastry Lovers	2017-07-21	284	211	78	362	0.6884
Rainbow Snake	2017-10-07	5	130	46	51	0.6884
AFL Evolution	2017-07-21	74	78	26	100	0.6884
Bang Howdy!	2017-08-05	50	78	26	76	0.6884
Putrefaction 2: Rumble in the hometown	2017-10-11	10	78	26	36	0.6884
Rubber Ball VR	2017-03-09	8	26	7	15	0.6883
Cat Sorter VR	2017-08-29	4	26	7	11	0.6883
Pairs	2017-11-20	8	26	7	15	0.6883
Perception	2017-05-30	91	396	153	244	0.6881999999999999
Zen Garden	2017-04-04	192	91	31	223	0.6881
Building the Great Wall of China 2	2017-04-25	8	14	3	11	0.688
Onimod Land	2017-11-10	4	14	3	7	0.688
Stophat	2017-07-05	3	14	3	6	0.688
Hangry Bunnies From Mars	2017-08-23	3	14	3	6	0.688
Dark Descent: The Blue Rose	2017-07-20	7	14	3	10	0.688
Vulture	2017-09-09	4	14	3	7	0.688
Zeran's Folly	2017-10-06	11	51	16	27	0.6879000000000001
Village of Adventurers 2	2017-11-29	338	155	56	394	0.6878000000000001
Mystery Case Files: The Black Veil Collector's Edition	2017-03-23	8	23	6	14	0.6878000000000001
Ping	2017-07-04	136	23	6	142	0.6878000000000001
Cargo Breach	2017-10-13	4	23	6	10	0.6878000000000001
Puzzle Tactics	2017-12-01	3	23	6	9	0.6878000000000001
Samurai of Hyuga Book 3	2017-12-01	34	23	6	40	0.6878000000000001
Tequila Zombies 3	2017-03-29	2891	75	25	2916	0.6877
Zombie Riot	2017-05-25	20	59	19	39	0.6876000000000001
Cold Space	2017-12-08	138	101	35	173	0.6875
FlatFatCat	2017-08-15	3	20	5	8	0.6875
Blue-Collar Astronaut	2017-03-14	212	17	4	216	0.6875
The Professor Presents: Got Handles?	2017-04-13	30	17	4	34	0.6875
Rock 'N Roll	2017-08-28	3	17	4	7	0.6875
Nano Shift VR	2017-11-08	5	17	4	9	0.6875
Spartan	2017-10-02	3	17	4	7	0.6875
Galaxy of Pen & Paper	2017-07-27	191	279	106	297	0.6873
Rock God Tycoon	2017-02-13	212	212	79	291	0.6870999999999999
Legend of Fainn Dynasty ～Battles of Beautiful Warlords～	2017-10-20	54	93	32	86	0.6870999999999999
Slash It Ultimate	2017-07-14	2429	403	157	2586	0.687
Snow Moto Racing Freedom	2017-04-11	13	48	15	28	0.687
Golem Creation Kit	2017-07-14	22	48	15	37	0.687
Mutant Fighting Cup 2	2017-02-15	25	37	11	36	0.6869
Downward	2017-07-13	45	359	139	184	0.6868000000000001
Warbanners	2017-10-18	122	378	147	269	0.6866
BIOHAZARD 7 resident evil グロテスクVer.	2017-01-26	891	126	45	936	0.6866
Crash Force	2017-07-14	798	90	31	829	0.6864
Last Day of FEAR	2017-12-23	3	77	26	29	0.6864
PAKO - Car Chase Simulator	2017-01-10	173	118	42	215	0.6861
Seconds to Square	2017-08-23	14	45	14	28	0.6861
Tourists Kidnapped a Little Bear	2017-01-20	498	61	20	518	0.6859000000000001
I fell from Grace	2017-12-20	7	53	17	24	0.6859000000000001
Aeon	2017-05-22	29	173	64	93	0.6857
Yoba	2017-08-17	13	66	22	35	0.6853
LongStory	2017-12-07	19	71	24	43	0.6848000000000001
Unknightly	2017-12-01	10	157	58	68	0.6846
Sonya: The Great Adventure	2017-04-14	76	127	46	122	0.6846
Nephise	2017-03-14	776	325	127	903	0.6843000000000001
Baobabs Mausoleum Ep.1 Ovnifagos Don´t Eat Flamingos	2017-07-06	6	99	35	41	0.6843000000000001
In the Darkness of the Sea	2017-02-01	3	55	18	21	0.6840999999999999
RC-AirSim - RC Model Airplane Flight Simulator	2017-02-28	6	28	8	14	0.6840999999999999
Roads of Rome: New Generation	2017-12-05	14	28	8	22	0.6840999999999999
TrickStyle	2017-02-21	54	28	8	62	0.6840999999999999
VOID	2017-10-31	7	28	8	15	0.6840999999999999
JASEM: Just Another Shooter with Electronic Music	2017-10-19	914	119	43	957	0.6839000000000001
It's Quiz Time	2017-11-30	175	146	54	229	0.6834
Zhulik.exe	2017-12-27	4	60	20	24	0.6834
NBA Playgrounds	2017-05-09	688	959	398	1086	0.6831
Mountain Mind	2017-03-07	19	25	7	26	0.6831
Hereafter	2017-10-26	16	25	7	23	0.6831
Ayo: A Rain Tale	2017-11-09	5	25	7	12	0.6831
Winter Warland	2017-12-24	12	25	7	19	0.6831
WRONGED	2017-11-24	3	25	7	10	0.6831
Beats Fever	2017-01-10	10	52	17	27	0.6829999999999999
Dungeons & Treasure VR	2017-11-30	10	52	17	27	0.6829999999999999
After the Empire	2017-03-31	40	36	11	51	0.6829999999999999
interLOGIC	2017-02-07	1174	36	11	1185	0.6829999999999999
Rugby League Team Manager 2018	2017-10-13	46	36	11	57	0.6829999999999999
XAOC	2017-08-03	242	143	53	295	0.6828000000000001
Twin Saga	2017-09-01	833	591	241	1074	0.6826000000000001
Fjong	2017-09-11	8	70	24	32	0.6826000000000001
Torment: Tides of Numenera	2017-02-28	7430	2804	1208	8638	0.6825
Children of Zodiarcs	2017-07-18	429	355	141	570	0.6824
Flying Tigers: Shadows Over China	2017-05-29	176	625	256	432	0.6822
Flora	2017-12-27	49	145	54	103	0.6822
Original Journey	2017-08-16	67	135	50	117	0.6820999999999999
Avenger Bird	2017-01-05	1670	80	28	1698	0.6820999999999999
Call of War	2017-10-21	925	2948	1275	2200	0.682
CONTRACTED	2017-03-11	1333	22	6	1339	0.682
Antiquia Lost	2017-07-06	7	22	6	13	0.682
Asteroids Millennium	2017-08-07	5	22	6	11	0.682
Charlie the Duck	2017-09-22	3	22	6	9	0.682
Durak!	2017-09-14	10	49	16	26	0.6819
IL-2 Sturmovik: Cliffs of Dover Blitz	2017-12-14	457	974	408	865	0.6816
Fake Happy End	2017-01-23	4	7	1	5	0.6815000000000001
Ultimagus	2017-02-10	2	7	1	3	0.6815000000000001
Otherworld: Omens of Summer Collector's Edition	2017-02-06	3	7	1	4	0.6815000000000001
Azada: Elementa Collector's Edition	2017-03-03	4	7	1	5	0.6815000000000001
Jack Spriggan	2017-06-09	2	7	1	3	0.6815000000000001
Magnificent Ships: Volume 2	2017-05-18	2	7	1	3	0.6815000000000001
Journey to Alien Worlds	2017-04-28	2	7	1	3	0.6815000000000001
Beyond: Light Advent Collector's Edition	2017-05-05	3	7	1	4	0.6815000000000001
PuppetShow™: Souls of the Innocent Collector's Edition	2017-05-17	3	7	1	4	0.6815000000000001
Quantum Pilot	2017-10-20	2	7	1	3	0.6815000000000001
Eternal Maze	2017-09-11	3	7	1	4	0.6815000000000001
Dreamals: Dream Quest	2017-07-10	4	7	1	5	0.6815000000000001
Spaceship Trucker	2017-08-25	2	7	1	3	0.6815000000000001
GyroSphere Trials	2017-08-18	4	7	1	5	0.6815000000000001
Testbed Terror	2017-07-14	2	7	1	3	0.6815000000000001
Crusader Crash	2017-08-01	3	7	1	4	0.6815000000000001
Memories	2017-11-18	2	7	1	3	0.6815000000000001
Pixel Puzzle Picross	2017-08-28	6	7	1	7	0.6815000000000001
Fake World VR	2017-08-25	3	7	1	4	0.6815000000000001
Weapon and Armor: Mahjong	2017-09-19	4	7	1	5	0.6815000000000001
Black Friday: The Game	2017-10-16	3	7	1	4	0.6815000000000001
SweeperVR	2017-10-19	2	7	1	3	0.6815000000000001
Maddening Euphoria	2017-11-05	4	7	1	5	0.6815000000000001
OverKill	2017-10-23	3	7	1	4	0.6815000000000001
Lost In Maze	2017-12-26	4	7	1	5	0.6815000000000001
Orake Classic	2017-06-16	143	456	185	328	0.6812
Nova Blitz	2017-07-11	71	117	43	114	0.6812
Rabbit Story	2017-05-16	8	87	31	39	0.6809999999999999
A Room Beyond	2017-06-13	6	19	5	11	0.6809999999999999
Steampuff: Phinnegan's Factory	2017-08-29	4	19	5	9	0.6809999999999999
Bandit Kings of Ancient China	2017-02-22	55	19	5	60	0.6809999999999999
Zero-G	2017-01-13	180	19	5	185	0.6809999999999999
Zombie Buster VR	2017-04-08	12	19	5	17	0.6809999999999999
Huge Bang Bang	2017-10-03	25	19	5	30	0.6809999999999999
Captain Backwater	2017-09-12	3	19	5	8	0.6809999999999999
DUEL	2017-10-16	3	19	5	8	0.6809999999999999
Pixel Privateers	2017-02-21	1854	623	257	2111	0.6809000000000001
STAR OCEAN™ - THE LAST HOPE™ - 4K & Full HD Remaster	2017-11-28	1330	935	393	1723	0.6807
21 Days	2017-06-16	52	46	15	67	0.6807
Realms of Arkania: Star Trail	2017-08-10	70	124	46	116	0.6806
IrreVRsible	2017-02-17	8	30	9	17	0.6805
Speedball Arena	2017-10-26	7	30	9	16	0.6805
Under a Desert Sun	2017-02-19	3	30	9	12	0.6805
Lament	2017-03-31	5	30	9	14	0.6805
World of One	2017-06-08	28	69	24	52	0.6803
Girl Blonde	2017-10-18	3	69	24	27	0.6803
World Keepers: Last Resort	2017-02-02	32	89	32	64	0.6801
Katana X	2017-06-10	12	79	28	40	0.6801
The Shrouded Isle	2017-08-04	226	893	376	602	0.68
RunVR	2017-06-19	86	16	4	90	0.68
Spheroids	2017-02-13	100	16	4	104	0.68
Galactic Keep	2017-04-06	9	16	4	13	0.68
World Builder	2017-03-14	7	16	4	11	0.68
Choice	2017-11-15	5	16	4	9	0.68
Trespassers	2017-10-06	5	16	4	9	0.68
Runaway VR	2017-08-04	5	16	4	9	0.68
City of Ages: Picture Supportive Text MUD (server and client included)	2017-10-13	136	16	4	140	0.68
A Writer And His Daughter	2017-11-02	4	16	4	8	0.68
Thundering Skies	2017-12-02	2	16	4	6	0.68
Shadows Peak	2017-03-13	26	208	81	107	0.6799
Hoo-Boy	2017-09-29	17	116	43	60	0.6797
Reaching for Petals	2017-09-04	14	111	41	55	0.6796
Alchemist's Castle	2017-11-02	8	61	21	29	0.6794
Tank Battle: Normandy	2017-06-09	8	13	3	11	0.6793000000000001
Aeternum	2017-07-18	119	13	3	122	0.6793000000000001
ROTii	2017-03-10	9686	13	3	9689	0.6793000000000001
BRKÖUT	2017-09-29	3	13	3	6	0.6793000000000001
Outpost L5	2017-07-28	3	13	3	6	0.6793000000000001
VR Roller Coaster - Cave Depths	2017-11-21	6	13	3	9	0.6793000000000001
Ghost Pursuit VR	2017-09-01	14	10	2	16	0.6793000000000001
Owari	2017-06-16	12	10	2	14	0.6793000000000001
Jump, Step, Step	2017-03-29	3	10	2	5	0.6793000000000001
Skyling: Garden Defense	2017-02-14	6	10	2	8	0.6793000000000001
Galaxis Wars	2017-05-30	3	10	2	5	0.6793000000000001
Gus Track Adventures VR	2017-06-27	5	10	2	7	0.6793000000000001
ObserVRtarium	2017-06-08	5	10	2	7	0.6793000000000001
Screaming Eagles	2017-09-08	2	10	2	4	0.6793000000000001
Dead of Night	2017-07-13	2	10	2	4	0.6793000000000001
Baseball Mogul 2017	2017-08-08	18	10	2	20	0.6793000000000001
OM6N	2017-08-21	2	10	2	4	0.6793000000000001
Skript	2017-11-15	7	10	2	9	0.6793000000000001
Feed the Animals	2017-11-30	4	10	2	6	0.6793000000000001
TACTICAL	2017-12-08	3	10	2	5	0.6793000000000001
埋葬 DIG A BOO	2017-07-05	19	27	8	27	0.6790999999999999
Temple of Aluxes	2017-10-26	5	35	11	16	0.679
External Visions	2017-11-15	11	35	11	22	0.679
Academagia: The Making of Mages	2017-04-20	299	190	74	373	0.6787000000000001
Air Hockey	2017-12-01	9	40	13	22	0.6781
Royal Offense	2017-05-10	963	68	24	987	0.6779999999999999
ELMIA	2017-12-07	11	68	24	35	0.6779999999999999
Crab Dub	2017-01-19	1308	189	74	1382	0.6778000000000001
Rhythm Rush!	2017-04-24	1181	117	44	1225	0.6777
Too Many Weapons	2017-05-31	5	24	7	12	0.6776000000000001
Ultimate Spinner Simulator - Unstress Yourself	2017-10-27	3	24	7	10	0.6776000000000001
Goblins Keep Coming - Tower Defense	2017-11-20	5	24	7	12	0.6776000000000001
The Great Gatsby: Secret Treasure	2017-05-19	107	32	10	117	0.6775
Dragon Lords: 3D Strategy	2017-09-11	89	85	31	120	0.6773
Tales from Candlekeep: Tomb of Annihilation	2017-10-11	257	1354	588	845	0.677
Company of Heroes: Battle of Crete	2017-10-27	6	55	19	25	0.6769
AMPLITUDE: A Visual Novel	2017-09-05	21	37	12	33	0.6765000000000001
Bounty Train	2017-05-16	602	1039	449	1051	0.6763
Elisa: Seduce the Innkeeper	2017-09-25	37	128	49	86	0.6763
VITATIO 2	2017-04-12	2733	343	141	2874	0.6762
Masked Forces: Zombie Survival	2017-07-14	12	276	112	124	0.6762
Nelo	2017-11-20	17	94	35	52	0.6759000000000001
Star Fleet Armada: Rogue Adventures	2017-06-06	6	21	6	12	0.6759000000000001
Tank Battle: East Front	2017-03-31	7	21	6	13	0.6759000000000001
Delay	2017-06-13	11	21	6	17	0.6759000000000001
Time Tenshi Paradox: Episode 1	2017-12-20	10	21	6	16	0.6759000000000001
Vzerthos: Heir of Thunder	2017-01-19	147	72	26	173	0.6758
Art of Guile	2017-08-11	6	29	9	15	0.6758
The IOTA Project	2017-09-08	13	62	22	35	0.6756000000000001
White Pearl	2017-12-23	42	52	18	60	0.6755
Chocolate makes you happy 2	2017-12-18	4	84	31	35	0.6753
DRAGON QUEST HEROES™ II	2017-04-25	847	527	223	1070	0.6751
Galactic Junk League	2017-07-26	2089	1234	540	2629	0.675
STORM VR	2017-03-23	10	74	27	37	0.6748999999999999
All the Delicate Duplicates	2017-02-17	7	34	11	18	0.6748000000000001
Saucer-Like	2017-04-05	6	34	11	17	0.6748000000000001
Crossroad Mysteries: The Broken Deal	2017-09-01	33	69	25	58	0.6746
Romance of the Three Kingdoms VII with Power Up Kit	2017-07-25	50	69	25	75	0.6746
Uncharted Waters II	2017-10-18	55	69	25	80	0.6746
Zafehouse Diaries 2	2017-06-17	89	86	32	121	0.6745
The Inner Darkness	2017-02-24	304	64	23	327	0.6744
Box Maze	2017-03-03	5313	150	59	5372	0.6742
Where They Cremate The Roadkill	2017-09-29	5	54	19	24	0.6741
Amoreon NightClub	2017-09-07	13	49	17	30	0.6741
Skein	2017-11-13	18	18	5	23	0.674
Screamer 2	2017-09-15	3	18	5	8	0.674
Anahita	2017-12-26	4	18	5	9	0.674
Renters Revenge	2017-12-07	8	18	5	13	0.674
Armored Warfare	2017-11-17	767	2567	1154	1921	0.6739
Book Of Potentia 2	2017-07-22	31	76	28	59	0.6739
1979 Invasion Earth	2017-01-19	234	26	8	242	0.6739
ViveSpray 2	2017-12-27	6	26	8	14	0.6739
iubes:2	2017-12-13	19	26	8	27	0.6739
GUTS	2017-11-14	12	26	8	20	0.6739
Tokyo 42	2017-05-31	221	433	183	404	0.6736
Jump To Die!!	2017-02-10	58	66	24	82	0.6733
Valentino Rossi The Game Compact	2017-01-26	9	31	10	19	0.6729999999999999
Swords and Sandals Medieval	2017-09-14	8	31	10	18	0.6729999999999999
创世-修真录	2017-11-08	11	31	10	21	0.6729999999999999
Ghoulboy	2017-11-29	6	165	66	72	0.6727
Pressure Overdrive	2017-07-25	77	97	37	114	0.6727
Virtual Sports	2017-03-30	9	36	12	21	0.6725
Water Planet	2017-10-05	8	46	16	24	0.6724
Legendary Hunter VR	2017-08-24	4	41	14	18	0.6724
Home - A VR Spacewalk	2017-11-30	42	247	102	144	0.6720999999999999
Pixplode	2017-07-03	33	99	38	71	0.6720999999999999
Retired Application	2017-02-04	4	15	4	8	0.672
Randall	2017-06-06	9	15	4	13	0.672
Tengutana	2017-10-26	3	15	4	7	0.672
Grim Tales: The Wishes Collector's Edition	2017-12-04	8	15	4	12	0.672
VINDICTA	2017-06-20	10	63	23	33	0.6718999999999999
A Shooty Bit	2017-02-20	91	23	7	98	0.6718000000000001
>//:System.Hack	2017-05-12	6	23	7	13	0.6718000000000001
A Mortician's Tale	2017-10-18	57	839	369	426	0.6716
Cube Link	2017-10-23	20	70	26	46	0.6713
Warbands: Bushido	2017-09-15	129	800	352	481	0.6712
Nights of Azure	2017-02-07	210	436	187	397	0.6709999999999999
Therian Saga	2017-03-27	658	340	144	802	0.6709999999999999
Orcs Must Die! Unchained	2017-04-19	7768	4189	1933	9701	0.6709
imprint-X	2017-01-26	45	28	9	54	0.6709
Amelon	2017-12-27	4	28	9	13	0.6709
hack_me 2	2017-03-11	3012	544	236	3248	0.6708
Opaline	2017-05-05	361	43	15	376	0.6706000000000001
The Seasons	2017-08-25	4	43	15	19	0.6706000000000001
High clear VR	2017-06-28	8	43	15	23	0.6706000000000001
GALER: Plague of Heroes	2017-05-05	4	3	0	4	0.6706000000000001
Rally Racers	2017-12-21	4	3	0	4	0.6706000000000001
Rise High	2017-12-18	408	3	0	408	0.6706000000000001
Timeless: The Forgotten Town Collector's Edition	2017-01-16	3	3	0	3	0.6706000000000001
European Mystery: Scent of Desire Collector’s Edition	2017-01-30	3	3	0	3	0.6706000000000001
Xenobox VR	2017-07-01	4114	3	0	4114	0.6706000000000001
Clash of Vessels VR	2017-03-17	2	3	0	2	0.6706000000000001
Fatal Passion: Art Prison Collector's Edition	2017-02-27	5	3	0	5	0.6706000000000001
PSYCHO-PASS	2017-07-13	10	3	0	10	0.6706000000000001
Trail of Destruction	2017-05-26	3	3	0	3	0.6706000000000001
DOGO	2017-08-21	2	3	0	2	0.6706000000000001
Riddles of Fate: Into Oblivion Collector's Edition	2017-06-14	3	3	0	3	0.6706000000000001
Chromaestro	2017-06-15	2	3	0	2	0.6706000000000001
Dreamblaster	2017-07-06	2	3	0	2	0.6706000000000001
Save Dash	2017-10-13	2	3	0	2	0.6706000000000001
Teal	2017-12-15	6	3	0	6	0.6706000000000001
Bouncing Odyssey	2017-12-17	1	3	0	1	0.6706000000000001
TYRED	2017-11-20	5	3	0	5	0.6706000000000001
Jack & the Cat	2017-08-25	1	3	0	1	0.6706000000000001
Otto the Odd Ostrich	2017-09-19	3	3	0	3	0.6706000000000001
Omega Extinction	2017-12-16	8	3	0	8	0.6706000000000001
Access	2017-09-29	2	3	0	2	0.6706000000000001
Legendary Arcane	2017-11-01	1	3	0	1	0.6706000000000001
Maso Marble	2017-10-16	1	3	0	1	0.6706000000000001
Atomic Sky	2017-08-29	2	3	0	2	0.6706000000000001
Interplanetary Hunter	2017-08-03	1	3	0	1	0.6706000000000001
Code 9	2017-08-24	3	3	0	3	0.6706000000000001
Deathlands	2017-11-25	2	3	0	2	0.6706000000000001
Scuffle Scoundrels	2017-09-08	1	3	0	1	0.6706000000000001
Coffee Pixes	2017-11-07	2	3	0	2	0.6706000000000001
Royal Agents: Sweet Zombie	2017-09-14	1	3	0	1	0.6706000000000001
Starzine	2017-10-04	3	3	0	3	0.6706000000000001
By Any Means Necessary	2017-11-06	3	3	0	3	0.6706000000000001
Low Desert Punk	2017-09-28	4	3	0	4	0.6706000000000001
WHERE'S PHANTOM THIEF	2017-10-30	2	3	0	2	0.6706000000000001
Hopscotch	2017-10-05	2	3	0	2	0.6706000000000001
Owl's Midnight Journey	2017-10-05	3	3	0	3	0.6706000000000001
Dr. Fizzgigious Fantabulous Carbon Dating Simulacrum	2017-12-05	1	3	0	1	0.6706000000000001
Shattered	2017-10-13	1	3	0	1	0.6706000000000001
KEEPER-the hunter of insect	2017-09-29	1	3	0	1	0.6706000000000001
Romans From Mars	2017-11-09	1	3	0	1	0.6706000000000001
Morps	2017-11-21	2	3	0	2	0.6706000000000001
Ocean's Crabellum	2017-10-24	1	3	0	1	0.6706000000000001
Witch Hunters: Full Moon Ceremony Collector's Edition	2017-11-06	3	3	0	3	0.6706000000000001
Grandpa and the Zombies	2017-11-22	2	3	0	2	0.6706000000000001
EX0: Dark Moon	2017-12-08	1	3	0	1	0.6706000000000001
Cutthroat	2017-11-17	6	3	0	6	0.6706000000000001
Wurst Defender Coop Edition	2017-12-06	3	3	0	3	0.6706000000000001
Escape Camp Waddalooh	2017-11-22	1	3	0	1	0.6706000000000001
Starfighter Neon	2017-12-18	2	3	0	2	0.6706000000000001
D.F.R.: The Light	2017-11-30	2	3	0	2	0.6706000000000001
Bridge to Another World: The Others Collector's Edition	2017-11-17	4	3	0	4	0.6706000000000001
Intergalactic traveler: The Omega Sector	2017-11-26	1	3	0	1	0.6706000000000001
Sounds of Music	2017-12-07	1	3	0	1	0.6706000000000001
Vexius	2017-12-15	4	3	0	4	0.6706000000000001
Shadow Wolf Mysteries: Bane of the Family Collector's Edition	2017-12-13	4	3	0	4	0.6706000000000001
MIMIC	2017-12-28	2	3	0	2	0.6706000000000001
MightyIronBall	2017-12-28	2	3	0	2	0.6706000000000001
Rogue Port - Blue Nightmare	2017-03-31	2041	38	13	2054	0.6705
Apex	2017-10-19	9	33	11	20	0.6705
Deep Dark Fight	2017-12-28	7	112	44	51	0.6704000000000001
Princess Serena ~Raid of Demon Legion~	2017-09-22	60	100	39	99	0.6698999999999999
Land it Rocket	2017-02-24	3	12	3	6	0.6698000000000001
Hoggy 2	2017-05-10	10	12	3	13	0.6698000000000001
Ironclads 2: Caroline Islands War 1885	2017-07-20	3	12	3	6	0.6698000000000001
Simple RTS	2017-06-19	3	12	3	6	0.6698000000000001
Eat, Sleep, Bet, Repeat	2017-10-26	8	12	3	11	0.6698000000000001
ArchRobo - Robotic Annihilation	2017-09-01	135	12	3	138	0.6698000000000001
Extreme Real Reality HD Remix	2017-10-02	5	12	3	8	0.6698000000000001
CYCOM: Cybernet Combat	2017-10-30	13	12	3	16	0.6698000000000001
Sevgilim Olur musun ?	2017-09-25	74	540	236	310	0.6695000000000001
Cold Vengeance	2017-01-11	14	20	6	20	0.6694
Pyramaze The Game	2017-09-13	11	20	6	17	0.6694
BULLET SOUL INFINITE BURST	2017-07-31	21	45	16	37	0.6691
Gladiator School	2017-11-09	32	227	95	127	0.669
Moero Chronicle	2017-08-16	345	400	173	518	0.6688
TINY METAL	2017-12-21	109	184	76	185	0.6688
Introvert Quest	2017-03-15	1637	83	32	1669	0.6687000000000001
Brother Wings	2017-01-10	2351	83	32	2383	0.6687000000000001
Balloon Chair Death Match	2017-07-13	28	40	14	42	0.6687000000000001
Bonbon	2017-10-25	6	136	55	61	0.6685
100ft Robot Golf	2017-03-16	17	120	48	65	0.6685
My Pet Rock	2017-01-23	915	25	8	923	0.6685
Cash Crop	2017-08-03	12	25	8	20	0.6685
Deadly Dozen	2017-01-26	5	35	12	17	0.6684
Hive Jump	2017-01-18	126	253	107	233	0.6683
Code World	2017-09-11	4	30	10	14	0.6683
Dropzone	2017-02-15	1357	597	264	1621	0.6681
Ghost Files: The Face of Guilt	2017-05-18	48	183	76	124	0.6678000000000001
InfiniPicross	2017-03-06	1484	124	50	1534	0.6677
Missileman Origins	2017-02-22	1106	9	2	1108	0.6676000000000001
Hot Sugar Presents The Melody of Dust	2017-04-10	3	9	2	5	0.6676000000000001
Revenge Quest	2017-08-14	2	9	2	4	0.6676000000000001
Puzzle One	2017-07-13	5	9	2	7	0.6676000000000001
Escape 2042 - The Truth Defenders	2017-03-31	2	9	2	4	0.6676000000000001
The Cable Center - Virtual Archive	2017-04-06	7	9	2	9	0.6676000000000001
Virush	2017-06-08	3	9	2	5	0.6676000000000001
Casus Belli: Battle Of Annihilation	2017-08-02	2	9	2	4	0.6676000000000001
Malatzshia	2017-12-24	2	9	2	4	0.6676000000000001
Temporal Storm X: Hyperspace Dream	2017-09-07	3	9	2	5	0.6676000000000001
iHUGU	2017-10-10	2	9	2	4	0.6676000000000001
Turtle: Voidrunner	2017-10-27	3	9	2	5	0.6676000000000001
The Cryptkeepers of Hallowford	2017-12-22	17	9	2	19	0.6676000000000001
Natari at the Bubble Planet	2017-12-13	9	42	15	24	0.6670999999999999
Evil Genome	2017-08-08	206	354	154	360	0.6667000000000001
Spellspire	2017-05-23	18	68	26	44	0.6667000000000001
Light And Dance VR - Music, Action, Relaxation	2017-03-03	6	17	5	11	0.6666
The Tavern	2017-08-04	4	17	5	9	0.6666
Rise & Shine	2017-01-13	146	598	267	413	0.6664
IKEA VR Pancake Kitchen	2017-05-30	19	228	97	116	0.6662
Order of Ataxia: Initial Effects	2017-08-17	7	6	1	8	0.6662
Don't Drop the Bass	2017-03-17	4	6	1	5	0.6662
Love Chronicles: The Spell Collector's Edition	2017-01-25	2	6	1	3	0.6662
The Muybridge Mausoleum	2017-07-10	3	6	1	4	0.6662
Love Engine	2017-01-17	7	6	1	8	0.6662
Dark Realm: Queen of Flames Collector's Edition	2017-02-21	3	6	1	4	0.6662
Energia	2017-02-28	2	6	1	3	0.6662
Western Bank VR	2017-12-21	3	6	1	4	0.6662
Pix	2017-09-02	6	6	1	7	0.6662
Dark Parables: Requiem for the Forgotten Shadow Collector's Edition	2017-02-23	7	6	1	8	0.6662
Fading	2017-12-22	2	6	1	3	0.6662
Amaranthine Voyage: The Living Mountain Collector's Edition	2017-06-16	3	6	1	4	0.6662
Stick Nightmare	2017-07-16	2	6	1	3	0.6662
The war god : The artifact	2017-07-22	2	6	1	3	0.6662
Swap Blocks	2017-07-21	3	6	1	4	0.6662
Special Force VR	2017-08-10	4	6	1	5	0.6662
Radar Defense	2017-12-28	3	6	1	4	0.6662
Stones of Rome	2017-10-16	4	6	1	5	0.6662
Angry Gnome	2017-08-31	2	6	1	3	0.6662
End of Days	2017-09-28	3	6	1	4	0.6662
Dummy Life	2017-10-20	1	6	1	2	0.6662
AstroShift	2017-10-03	2	6	1	3	0.6662
Mirrors	2017-10-11	4	6	1	5	0.6662
The Survival Test VR: Defend To Death	2017-11-01	2	6	1	3	0.6662
Grey Zone	2017-10-15	2	6	1	3	0.6662
Hot Runback - VR Runner	2017-09-28	2	6	1	3	0.6662
VS Round 1	2017-12-19	3	6	1	4	0.6662
If Only...	2017-10-23	4	6	1	5	0.6662
Final Storm	2017-11-02	2	6	1	3	0.6662
Minimancer	2017-11-17	11	6	1	12	0.6662
Fantasy of Eden	2017-11-10	3	6	1	4	0.6662
Bunny Mania 2	2017-11-23	2	6	1	3	0.6662
Twinstack	2017-12-20	2	6	1	3	0.6662
RocketGirl	2017-12-16	3	6	1	4	0.6662
Shtriga: Summer Camp	2017-02-02	17	84	33	50	0.6661
Rugby League Live 4	2017-09-12	54	100	40	94	0.6659999999999999
Elisa: the Innkeeper	2017-03-28	14	100	40	54	0.6659999999999999
Civil War: 1861	2017-02-01	8	32	11	19	0.6659999999999999
SPACE-FRIGHT	2017-03-03	7	32	11	18	0.6659999999999999
Discovering Space 2	2017-03-10	15	63	24	39	0.6659
Grimoire : Heralds of the Winged Exemplar	2017-08-04	225	411	181	406	0.6658
Codex of Victory	2017-03-16	148	256	110	258	0.6657
HERO-E	2017-03-08	5	27	9	14	0.6657
Trigger Time	2017-05-15	7	22	7	14	0.6657
Questr	2017-10-27	8	22	7	15	0.6657
Depths of Limbo	2017-02-01	7	44	16	23	0.6656000000000001
DreamWorks Voltron VR Chronicles	2017-09-26	9	44	16	25	0.6656000000000001
Dogolrax	2017-02-24	9	205	87	96	0.6655
VRZ Torment	2017-05-18	25	165	69	94	0.6655
Eliosi's Hunt	2017-08-15	15	51	19	34	0.6652
Beyond Magic	2017-02-21	1233	39	14	1247	0.6648999999999999
Dragon Hunter	2017-12-21	8	39	14	22	0.6648999999999999
Polyball	2017-12-01	261	769	350	611	0.6646
Phoning Home	2017-02-07	212	662	300	512	0.6644
Now Man Flies	2017-11-23	11	46	17	28	0.6643000000000001
Police Quest - SWAT 2	2017-04-18	7	53	20	27	0.6642
Time Trap - Hidden Objects	2017-07-28	13	101	41	54	0.6638
Horse Paradise - My Dream Ranch	2017-12-15	10	29	10	20	0.6633
Crowe: The Drowned Armory	2017-05-30	3	14	4	7	0.6633
The Edgelands	2017-05-09	3	14	4	7	0.6633
Eruption	2017-08-04	4	14	4	8	0.6633
Puzzler	2017-10-12	3	14	4	7	0.6633
Santa's Workshop	2017-10-22	5	14	4	9	0.6633
Meme Dragons	2017-12-12	2	14	4	6	0.6633
Masked Forces 2: Mystic Demons	2017-09-14	5	48	18	23	0.6631999999999999
Hotel Anatolia	2017-03-20	2934	226	98	3032	0.6629
Westboro	2017-04-28	1920	191	82	2002	0.6628000000000001
How to shoot a criminal	2017-01-20	14	24	8	22	0.6627
The Wendigo	2017-03-02	6	24	8	14	0.6627
Bear Football	2017-07-31	6	80	32	38	0.6626000000000001
Evolvation	2017-02-06	172870	626	286	173156	0.6625
Grim Tales: The Legacy Collector's Edition	2017-04-19	9	19	6	15	0.6625
The Surprising Adventures of Munchausen	2017-09-26	5	19	6	11	0.6625
Happiness Drops!	2017-12-26	12	19	6	18	0.6625
Gunmetal Arcadia	2017-02-07	11	36	13	24	0.6624
Super Dungeon Master Ace	2017-10-15	16	36	13	29	0.6624
Over The Moonlight	2017-09-27	107	73	29	136	0.6622
Adventures On The Polluted Islands	2017-02-17	890	91	37	927	0.6620999999999999
Mover	2017-10-31	15	43	16	31	0.6620999999999999
Drums Hero	2017-03-23	8	59	23	31	0.6615000000000001
The Keep	2017-03-16	61	104	43	104	0.6614
Twist of Destiny	2017-04-13	8	31	11	19	0.6614
Nana in the Dark	2017-11-12	6	31	11	17	0.6614
Mortal Blitz	2017-07-20	8	52	20	28	0.6611
Loot Rascals	2017-03-07	94	139	59	153	0.6609999999999999
Oldage	2017-12-20	109	204	89	198	0.6607999999999999
aMAZE Dark Times	2017-08-17	6	141	60	66	0.6607
Spoids	2017-02-20	846	61	24	870	0.6607
IKAROS	2017-09-02	13	26	9	22	0.6603
Kitty Rescue	2017-11-01	136	26	9	145	0.6603
Grimoire: Manastorm	2017-10-26	830	693	322	1152	0.66
Attack Heroes	2017-04-27	84	160	69	153	0.66
ROMBY	2017-07-27	8	112	47	55	0.66
Zombie Ballz	2017-02-10	606	72	29	635	0.66
Tetraminos	2017-02-20	26	63	25	51	0.66
CTHON	2017-03-18	7	63	25	32	0.66
Roots of Insanity	2017-04-05	29	286	128	157	0.6597
When Our Journey Ends - A Visual Novel	2017-02-14	1174	33	12	1186	0.6596
Weaves of Fate	2017-08-03	5	56	22	27	0.6595000000000001
Beans: The Coffee Shop Simulator	2017-06-30	1416	105	44	1460	0.6594
spaceBOUND	2017-09-01	12	21	7	19	0.6593000000000001
Krieg	2017-09-22	13	21	7	20	0.6593000000000001
Karmasutra	2017-09-29	41	21	7	48	0.6593000000000001
Fairy Lands: Rinka and the Fairy Gems	2017-08-25	4	21	7	11	0.6593000000000001
meleng	2017-11-01	23	21	7	30	0.6593000000000001
Comets Wake	2017-12-23	12	21	7	19	0.6593000000000001
Creekside Creep Invasion	2017-10-11	3	11	3	6	0.6593000000000001
R.A.T.S.	2017-02-15	5	11	3	8	0.6593000000000001
Selatria: Advent of the Dakk'rian Empire	2017-02-03	7	11	3	10	0.6593000000000001
Dragon Wars	2017-05-26	4	11	3	7	0.6593000000000001
Phantasmat: The Endless Night Collector's Edition	2017-05-15	5	11	3	8	0.6593000000000001
Square x Square	2017-09-06	4	11	3	7	0.6593000000000001
Tiger Hunt	2017-06-23	2	11	3	5	0.6593000000000001
Animalia - The Quiz Game	2017-10-03	5	11	3	8	0.6593000000000001
Secondhand Lands	2017-12-02	37	76	31	68	0.6589
Genesia Legacy: Ultimate Domain	2017-05-09	41	49	19	60	0.6589
Brawl of Ages	2017-09-12	547	531	246	793	0.6587000000000001
The 111th Soul	2017-12-05	3	122	52	55	0.6587000000000001
Amber Tail Adventure	2017-04-05	6396	67	27	6423	0.6587000000000001
Call of Duty: WWII	2017-11-03	19406	23810	11961	31367	0.6586
Secret World Legends	2017-07-31	3731	5784	2856	6587	0.6584000000000001
Blobby Tennis	2017-05-12	6	35	13	19	0.6581999999999999
Giant Cop: Justice Above All	2017-05-30	11	28	10	21	0.6581999999999999
Trendpoker 3D: Texas Hold'em Poker	2017-12-11	24	60	24	48	0.658
Batman™: Arkham VR	2017-04-25	198	1290	619	817	0.6577
Caveman Warriors	2017-09-22	13	44	17	30	0.6574
Fear Of Nightmares: Madness Descent	2017-09-11	4	37	14	18	0.6569
Unalive	2017-01-05	2459	140	61	2520	0.6568
Out of Ammo: Death Drive	2017-08-17	27	64	26	53	0.6568
ProjectM : Daydream	2017-09-05	10	64	26	36	0.6568
Castle Clicker	2017-10-02	511	435	202	713	0.6567000000000001
Inner silence	2017-02-11	3236	99	42	3278	0.6567000000000001
Drawn™: Trail of Shadows Collector's Edition	2017-02-14	4	23	8	12	0.6567000000000001
Broccoli Bob	2017-03-22	1396	55	22	1418	0.6566
Leisure Suit Larry 2 - Looking For Love (In Several Wrong Places)	2017-12-18	30	55	22	52	0.6566
Lunarsea	2017-10-20	12	46	18	30	0.6565000000000001
Z. Year One	2017-02-22	11	30	11	22	0.6565000000000001
SHOW MUST GO ON	2017-06-01	5	30	11	16	0.6565000000000001
Magic Tower	2017-12-31	10	30	11	21	0.6565000000000001
Dragon Sinker	2017-12-20	8	30	11	19	0.6565000000000001
Football Manager Touch 2018	2017-11-09	1622	129	56	1678	0.6564
Brut@l	2017-02-09	56	88	37	93	0.6564
Seven boys 2	2017-09-15	10	66	27	37	0.6563
The Golf Club VR	2017-02-24	30	347	160	190	0.6562
Don't Feed	2017-10-10	7	39	15	22	0.6557
Blood Feed	2017-07-19	832	434	203	1035	0.6554000000000001
Mad Digger	2017-12-13	1550	141	62	1612	0.6553
Hold Your Own	2017-12-01	214	368	171	385	0.6552
TechWars: Global Conflict	2017-12-21	115	204	92	207	0.6551
Super VR Trainer	2017-03-13	8	18	6	14	0.6551
Super Rocket Shootout	2017-07-14	23	18	6	29	0.6551
Tank Battle: Pacific	2017-07-27	9	18	6	15	0.6551
Curse of the Old Gods	2017-12-04	3	18	6	9	0.6551
Mystic Melee	2017-09-19	170	32	12	182	0.655
Surf World Series	2017-08-30	10	32	12	22	0.655
Scarlett's Dungeon	2017-09-21	3	32	12	15	0.655
The Signal From Tölva	2017-04-10	162	695	332	494	0.6548
NVL	2017-12-24	298	262	120	418	0.6548
Soccer Manager 2018	2017-12-22	511	297	137	648	0.6547
Five Elements	2017-03-25	62	25	9	71	0.6546
KART CHASER : THE BOOST VR	2017-01-26	17	25	9	26	0.6546
Rogue'n Roll	2017-02-27	1395	25	9	1404	0.6546
Lost Items	2017-08-03	168	25	9	177	0.6546
unWorded	2017-10-10	4	25	9	13	0.6546
Beat The Game	2017-09-07	20	117	51	71	0.6545000000000001
PuppetsVR	2017-09-27	3	8	2	5	0.6542
Last Stitch Goodnight	2017-05-09	3	8	2	5	0.6542
Tribocalypse VR	2017-02-03	4	8	2	6	0.6542
Symphony of the Machine	2017-04-25	2	8	2	4	0.6542
Nemo_D.O	2017-09-15	2	8	2	4	0.6542
Mr. Donovan	2017-03-31	3	8	2	5	0.6542
Carlos III y la difusión de la antigüedad	2017-03-13	3	8	2	5	0.6542
Lunaform	2017-07-18	2	8	2	4	0.6542
Chess3D	2017-03-10	3	8	2	5	0.6542
Heart. Papers. Border.	2017-08-20	5	8	2	7	0.6542
One Hit KO	2017-04-05	3	8	2	5	0.6542
Center Of Gravity	2017-03-28	3	8	2	5	0.6542
Assassination ClassroomVR Balloon Challenge Time	2017-06-16	4	8	2	6	0.6542
Defend Your Kingdom	2017-06-27	4	8	2	6	0.6542
The Cerberus Project	2017-10-04	21	8	2	23	0.6542
Willful	2017-08-09	4	8	2	6	0.6542
LOGistICAL: USA - Florida	2017-08-30	10	8	2	12	0.6542
Labyrinths of the World: Forbidden Muse Collector's Edition	2017-09-29	4	8	2	6	0.6542
Witches' Legacy: The Dark Throne Collector's Edition	2017-09-15	5	8	2	7	0.6542
A Nova Califórnia	2017-11-19	4	8	2	6	0.6542
Room 42	2017-10-06	2	8	2	4	0.6542
Space Dragon	2017-12-06	2	8	2	4	0.6542
Soul Of Mask (SoM)	2017-11-24	1	8	2	3	0.6542
Turtle Quest	2017-11-06	3	8	2	5	0.6542
Orblitz	2017-11-23	2	8	2	4	0.6542
Totally Realistic Sledding VR	2017-12-01	4	8	2	6	0.6542
Bubble Struggle: Adventures	2017-12-07	3	8	2	5	0.6542
Hungry Flame	2017-03-08	2477	182	82	2559	0.6541
Project Explore	2017-08-11	87	165	74	161	0.6537999999999999
The Saint: Abyss of Despair	2017-02-02	18	65	27	45	0.6537999999999999
Domain Defense VR	2017-05-11	5	13	4	9	0.6537999999999999
Heroes of Dark Dungeon	2017-01-05	1303	13	4	1307	0.6537999999999999
Nightmare Grotto	2017-05-18	10	13	4	14	0.6537999999999999
The Dungeon Power	2017-07-21	3	13	4	7	0.6537999999999999
Guardian	2017-09-08	3	13	4	7	0.6537999999999999
COMBAT INSTINCT	2017-10-19	5	13	4	9	0.6537999999999999
Gear Path	2017-12-21	3	13	4	7	0.6537999999999999
Katharsis	2017-08-26	4	34	13	17	0.6537000000000001
Mahjong Magic Islands	2017-10-24	32	54	22	54	0.6536
Operation Abyss: New Tokyo Legacy	2017-03-27	129	112	49	178	0.6534000000000001
Evil Tag	2017-04-07	949	449	213	1162	0.653
Silver Tale	2017-08-11	20	56	23	43	0.653
Pixel Traffic: Risky Bridge	2017-09-06	14	45	18	32	0.653
BLOK DROP NEO	2017-10-18	3	45	18	21	0.653
Keep Rollin!	2017-11-21	5	27	10	15	0.6529
Around the World in 80 days	2017-11-30	18	118	52	70	0.6528
Rivais Em Batalha	2017-03-29	2009	36	14	2023	0.6526000000000001
EPONYMOUS	2017-10-31	3	36	14	17	0.6526000000000001
Morphite	2017-09-20	35	71	30	65	0.6525
All Alone: VR	2017-03-09	1011	58	24	1035	0.6525
Snake 3D Adventures	2017-08-01	24	20	7	31	0.6525
Reflection of a Fallen Feather	2017-03-31	7	20	7	14	0.6525
Oswald's Adventure	2017-08-21	7	20	7	14	0.6525
Guild Quest	2017-01-26	1713	1150	565	2278	0.6524
Dark Legion VR	2017-03-07	16	88	38	54	0.6523000000000001
Doodle God Blitz	2017-09-01	283	483	231	514	0.6520999999999999
AirMech® Command	2017-03-09	41	130	58	99	0.652
Gravity Quest	2017-06-23	3	60	25	28	0.652
Defense Clicker	2017-10-31	61	92	40	101	0.6518
Mustache Politics Shooter	2017-11-28	8	49	20	28	0.6517000000000001
qb	2017-08-07	14	38	15	29	0.6517000000000001
Danger Zone	2017-05-30	52	113	50	102	0.6516
Half-Rats: Parasomnia	2017-10-31	15	77	33	48	0.6515000000000001
Team Racing League	2017-08-11	48	64	27	75	0.6512000000000001
Tactical Genius	2017-01-20	72	158	72	144	0.6506000000000001
Davyria: Heroes of Eternity	2017-03-10	29	53	22	51	0.6506000000000001
OldMaidGirl	2017-07-20	9	53	22	31	0.6506000000000001
Romance of the Three Kingdoms VIII with Power Up Kit	2017-08-30	58	68	29	87	0.6505
Last Anime boy: Saving loli	2017-11-21	5	108	48	53	0.6503
Captain Kaon	2017-04-14	173	22	8	181	0.6503
Avoid The Monsters	2017-08-15	136	22	8	144	0.6503
The Botanist	2017-10-05	7	22	8	15	0.6503
Squareboy vs Bullies: Arena Edition	2017-12-07	4	22	8	12	0.6503
Shark Week: Operation Apex	2017-12-11	16	22	8	24	0.6503
March of Empires	2017-12-11	2061	880	434	2495	0.6502
Life of Lon	2017-06-01	13	31	12	25	0.6502
Let's Bowl VR	2017-08-07	4	31	12	16	0.6502
Spaceship Looter	2017-05-17	201	139	63	264	0.6501
Warfare Online	2017-05-08	314	680	333	647	0.65
Demon Peak	2017-07-07	44	141	64	108	0.65
EquiMagic - Galashow of Horses	2017-12-19	4	15	5	9	0.65
Super BoxMan Ultra	2017-11-13	6	15	5	11	0.65
Masked Shooters	2017-05-21	487	93	41	528	0.6497
Sniper Ghost Warrior 3	2017-04-24	4086	10814	5628	9714	0.6492
Way of Redemption	2017-11-07	17	33	13	30	0.6492
Stop Santa - Tower Defense	2017-12-04	5	33	13	18	0.6492
Formata	2017-12-07	112	533	260	372	0.6491
Heroes of Dire	2017-03-15	83	134	61	144	0.649
NAVYFIELD	2017-09-27	495	483	235	730	0.6489
Vindictive Drive	2017-05-15	3354	48	20	3374	0.6483
Disney's Aladdin	2017-12-18	8	35	14	22	0.6483
Life is Feudal: Forest Village	2017-05-26	1962	3649	1879	3841	0.6481
Tower!3D Pro	2017-03-08	123	585	288	411	0.648
Necromancer Accountant	2017-10-31	31	50	21	52	0.6479
Battlegun	2017-08-09	17	190	89	106	0.6478
Emberdoom	2017-09-27	4	5	1	5	0.6478
Starship Disco	2017-01-17	3	5	1	4	0.6478
Virtual Islands: Mini-Golf Challenge	2017-04-24	2	5	1	3	0.6478
Water Heroes: A Game for Change	2017-03-01	25	5	1	26	0.6478
Sable Maze: Sullivan River Collector's Edition	2017-01-20	3	5	1	4	0.6478
Birthseederia	2017-08-16	2	5	1	3	0.6478
The little vampir	2017-06-30	2	5	1	3	0.6478
归墟纪·寂夜 FINAL WORLD	2017-07-07	3	5	1	4	0.6478
Tomb Guard VR	2017-05-19	3	5	1	4	0.6478
Slice&Dice	2017-06-01	3	5	1	4	0.6478
LQVE: Lion Quest Versus Expanded	2017-12-14	2	5	1	3	0.6478
Simplefield	2017-07-31	2	5	1	3	0.6478
Layers	2017-11-13	2	5	1	3	0.6478
StopTime Drive	2017-07-18	2	5	1	3	0.6478
Malfunction	2017-07-27	3	5	1	4	0.6478
Pizza Hunt! How to hunt pizza (And Not Die Doing It)	2017-10-27	2	5	1	3	0.6478
Remnants of a Beautiful Day (2012)	2017-08-03	1	5	1	2	0.6478
Mogo Invasion	2017-07-25	2	5	1	3	0.6478
Mircron Wars XR	2017-08-04	1	5	1	2	0.6478
Cat vs. Corgis	2017-08-25	2	5	1	3	0.6478
Neckbeards: Basement Arena	2017-08-28	2	5	1	3	0.6478
Zenethics Lab : Outbreak	2017-09-04	2	5	1	3	0.6478
Dark Realm: Princess of Ice Collector's Edition	2017-09-27	4	5	1	5	0.6478
Flippt	2017-09-26	2	5	1	3	0.6478
Scavenger	2017-10-13	4	5	1	5	0.6478
TimeTravelers	2017-11-03	1	5	1	2	0.6478
How To Meat People	2017-11-17	2	5	1	3	0.6478
TrES-2b	2017-11-23	2	5	1	3	0.6478
Mystery Tales: The Twilight World Collector's Edition	2017-11-15	4	5	1	5	0.6478
Fields of Battle	2017-09-01	14	131	60	74	0.6476999999999999
Sonder. Episode ONE	2017-05-09	10	10	3	13	0.6476000000000001
YamaYama	2017-07-12	7	10	3	10	0.6476000000000001
Pigeon Fight	2017-10-09	7	10	3	10	0.6476000000000001
NOBUNAGA'S AMBITION: Bushou Fuunroku	2017-03-21	34	10	3	37	0.6476000000000001
Cubians VR	2017-02-17	3	10	3	6	0.6476000000000001
Sort 'Em	2017-03-01	3	10	3	6	0.6476000000000001
Trapped Summoner	2017-06-09	22	10	3	25	0.6476000000000001
WizzBall	2017-12-16	4	10	3	7	0.6476000000000001
Dash Dash Run!	2017-08-02	2	10	3	5	0.6476000000000001
Karradash - The Lost Dungeons	2017-09-01	5	10	3	8	0.6476000000000001
Grimrush	2017-11-30	5	10	3	8	0.6476000000000001
LOGistICAL: Chile	2017-09-29	10	10	3	13	0.6476000000000001
Moose Invasion	2017-11-12	2	10	3	5	0.6476000000000001
Orbitality	2017-12-30	2	10	3	5	0.6476000000000001
1010	2017-12-13	4	10	3	7	0.6476000000000001
LeftWay	2017-11-03	5	26	10	15	0.6473000000000001
The Last Tree	2017-05-31	775	26	10	785	0.6473000000000001
Final Core	2017-01-11	102	17	6	108	0.6473000000000001
Schatte ～The Witch and the Fake Shadow～	2017-11-08	4	17	6	10	0.6473000000000001
Getaway Island	2017-04-10	940	104	47	987	0.6470999999999999
9Dragons	2017-02-15	266	297	143	409	0.647
Train Mechanic Simulator 2017	2017-03-23	330	492	242	572	0.6469
FPV Drone Simulator	2017-09-09	29	255	122	151	0.6468
Hero	2017-02-03	2560	39	16	2576	0.6468
Beyond the Wall	2017-10-24	5	39	16	21	0.6468
Voidrunner	2017-05-31	10	56	24	34	0.6467
Chop and Drop VR	2017-08-21	12	41	17	29	0.6463
ARK: Survival Of The Fittest	2017-08-29	3929	7270	3818	7747	0.6462000000000001
Dragon Sin	2017-12-21	76	317	154	230	0.6459
Ninja Way	2017-11-02	22	93	42	64	0.6458
Ninja Stealth 2	2017-01-30	549	330	161	710	0.6455
Neptune: Arena FPS	2017-10-20	14	45	19	33	0.6453
Stash	2017-09-07	32094	439	217	32311	0.6452
Remnith	2017-08-30	18	19	7	25	0.6452
Jupiteration	2017-03-10	4	19	7	11	0.6452
Lathe Safety Simulator	2017-06-06	8	19	7	15	0.6452
dontbegrey	2017-08-15	4	19	7	11	0.6452
Chaos and the White Robot	2017-09-15	3	19	7	10	0.6452
Holy Potatoes! We’re in Space?!	2017-02-14	865	598	299	1164	0.6451000000000001
Soundscape VR	2017-05-16	11	70	31	42	0.6451000000000001
Lacuna Passage	2017-05-17	26	72	32	58	0.6448999999999999
Escape the Mazes	2017-03-02	13	49	21	34	0.6446
EMPORIUM	2017-05-17	11	92	42	53	0.644
2017 VR	2017-05-09	26	90	41	67	0.644
CUBOTS - The Origins	2017-08-05	2727	34	14	2741	0.6437999999999999
Ebony Spire: Heresy	2017-11-02	5	34	14	19	0.6437999999999999
ICED	2017-05-15	1015	112	52	1067	0.6436000000000001
Vaccine	2017-02-21	4	21	8	12	0.6436000000000001
Baseball Riot	2017-01-17	9	21	8	17	0.6436000000000001
5 Star Rio Resort	2017-06-30	11	21	8	19	0.6436000000000001
Double Memory	2017-09-19	2	21	8	10	0.6436000000000001
RollerCoaster Legends	2017-12-21	11	21	8	19	0.6436000000000001
Your Friend Hana	2017-04-07	320	410	204	524	0.6435
Battle Riders	2017-04-26	19	120	56	75	0.6435
Race Arcade	2017-04-05	23	57	25	48	0.6435
Cards of Chaos	2017-03-04	139	12	4	143	0.6435
Bubble Labs VR	2017-06-08	4	12	4	8	0.6435
Legion Tale	2017-09-20	2105	12	4	2109	0.6435
Voxel Interceptor	2017-09-19	2	12	4	6	0.6435
Scrap Galaxy	2017-12-01	5	12	4	9	0.6435
Santa's vacation	2017-11-22	2	12	4	6	0.6435
Warhammer 40,000: Space Wolf	2017-09-21	467	798	407	874	0.6431
Defenders of Tetsoidea II	2017-11-29	19	38	16	35	0.6426999999999999
Tree of Life	2017-08-17	3708	4425	2348	6056	0.6426000000000001
HackyZack	2017-03-28	837	161	77	914	0.6425
M1: A Death in the Desert	2017-08-08	2	23	9	11	0.6424
Deadly Contact	2017-12-22	16	23	9	25	0.6424
City Siege: Faction Island	2017-03-17	2398	77	35	2433	0.6423000000000001
Twelve Sky 2 Classic	2017-01-27	60	137	65	125	0.6422
The Art of Fight	2017-02-17	40	235	115	155	0.6421
Pizza Connection	2017-04-05	12	42	18	30	0.642
Solenars Edge Rebirth	2017-08-02	142	44	19	161	0.6417
Blockle	2017-05-08	25	50	22	47	0.6409999999999999
Stone Age Wars	2017-01-09	2959	136	65	3024	0.6409
My Name is Addiction	2017-09-30	5	52	23	28	0.6408
Vincere Totus Astrum	2017-02-21	1	2	0	1	0.6408
The Last Sunshine (Deprecated)	2017-01-11	3	2	0	3	0.6408
The Island of Eternal Struggle	2017-06-06	2	2	0	2	0.6408
Surface: Reel Life Collector's Edition	2017-02-10	3	2	0	3	0.6408
Bestseller: Curse of the Golden Owl	2017-10-07	3	2	0	3	0.6408
a nifty game	2017-09-01	7	2	0	7	0.6408
The Normal Day	2017-06-08	2	2	0	2	0.6408
Dangerous Games: Prisoners of Destiny Collector's Edition	2017-02-24	3	2	0	3	0.6408
The Raiders	2017-03-02	1	2	0	1	0.6408
Epsilon Jump Prime	2017-10-20	1	2	0	1	0.6408
Luxin Time	2017-06-24	3	2	0	3	0.6408
Twilight Phenomena: The Lodgers of House 13 Collector's Edition	2017-03-27	3	2	0	3	0.6408
Gappo's Legacy VR	2017-09-07	2	2	0	2	0.6408
Building Blocks / Master Builder of Egypt	2017-12-02	1	2	0	1	0.6408
Gunball	2017-06-28	3	2	0	3	0.6408
Runes of Avalon - Path of Magic	2017-07-26	2	2	0	2	0.6408
Sea of Lies: Nemesis Collector's Edition	2017-05-26	3	2	0	3	0.6408
StroodleDoodle	2017-09-14	2	2	0	2	0.6408
Winter Wolves Classic Games Collection	2017-10-25	4	2	0	4	0.6408
Kitty Nigiri	2017-09-05	2	2	0	2	0.6408
The First Time I Died	2017-07-05	2	2	0	2	0.6408
Darkest Wave	2017-11-25	1	2	0	1	0.6408
Space Geekz - The Crunchy Flakes Conspiracy	2017-10-13	2	2	0	2	0.6408
Squish and the Corrupted Crystal	2017-08-08	2	2	0	2	0.6408
Genie	2017-08-01	2	2	0	2	0.6408
Against the Gradient	2017-07-10	3	2	0	3	0.6408
Marble Masters: The Pit	2017-07-19	7	2	0	7	0.6408
火箭星战 Star-Rocket Strike	2017-07-28	4	2	0	4	0.6408
Knossos	2017-09-01	1	2	0	1	0.6408
Flight of Light	2017-08-03	2	2	0	2	0.6408
ColorCode	2017-08-29	2	2	0	2	0.6408
CANARI	2017-09-28	2	2	0	2	0.6408
Acorns Above: A World Gone Nuts	2017-09-08	2	2	0	2	0.6408
Exterminator: Escape!	2017-09-15	2	2	0	2	0.6408
Brimstone	2017-08-08	3	2	0	3	0.6408
Ungrounded: Ripple Unleashed VR	2017-08-20	3	2	0	3	0.6408
Piece of Memory 2:Prologue	2017-08-10	2	2	0	2	0.6408
Fierce Tales: Marcus' Memory Collector's Edition	2017-07-24	2	2	0	2	0.6408
Mayan Prophecies: Cursed Island Collector's Edition	2017-07-26	3	2	0	3	0.6408
Solmec: Hollow Planet	2017-09-05	2	2	0	2	0.6408
Aequitas Orbis	2017-11-02	8	2	0	8	0.6408
Neon Coliseum	2017-09-04	2	2	0	2	0.6408
Taras Bulba and platforms of Hoolion	2017-08-11	2	2	0	2	0.6408
Endless Reality	2017-08-30	1	2	0	1	0.6408
Korvae in space	2017-08-25	2	2	0	2	0.6408
Cats Lover	2017-08-30	2	2	0	2	0.6408
Chinomikon	2017-09-02	1	2	0	1	0.6408
Freshly fried shrimps seemed hot additionally named noth	2017-09-13	1	2	0	1	0.6408
TriElement	2017-09-26	3	2	0	3	0.6408
Bobbi_Cities	2017-10-23	1	2	0	1	0.6408
Rage Quest	2017-11-08	3	2	0	3	0.6408
Spirits of Mystery: The Dark Minotaur Collector's Edition	2017-09-25	3	2	0	3	0.6408
BHB: BioHazard Bot	2017-11-15	1	2	0	1	0.6408
SKIMMERZ	2017-10-14	2	2	0	2	0.6408
Mulletman and the Molemen	2017-11-01	2	2	0	2	0.6408
Super Arcade Boy in Defender of Planet Earth	2017-10-20	1	2	0	1	0.6408
EGE DistantPlanet NonXXX	2017-10-16	2	2	0	2	0.6408
Dreadnought Sol	2017-11-02	2	2	0	2	0.6408
Haunted Manor: Queen of Death Collector's Edition	2017-10-06	3	2	0	3	0.6408
The Adventures of Sam Carlisle: The Hunt for the Lost Treasure	2017-11-01	3	2	0	3	0.6408
Willowisp VR	2017-11-13	2	2	0	2	0.6408
Dark Dimensions: City of Ash Collector's Edition	2017-11-10	2	2	0	2	0.6408
Ominous Objects: Phantom Reflection Collector's Edition	2017-10-20	3	2	0	3	0.6408
EXIT 3 - Painter	2017-11-20	2	2	0	2	0.6408
MC Lars 2: Brotherhood	2017-11-10	3	2	0	3	0.6408
The Grimsworth Reports: Woodfall	2017-11-01	2	2	0	2	0.6408
Monsterplants vs Bowling : Arcade Edition	2017-12-07	8	2	0	8	0.6408
Alien Planet	2017-12-04	2	2	0	2	0.6408
BALL GAME	2017-11-10	2	2	0	2	0.6408
Puzzle & Blocks	2017-12-08	2	2	0	2	0.6408
TAOTH - The Adventures of the Herkulez	2017-12-11	2	2	0	2	0.6408
Subwar 2050	2017-11-29	2	2	0	2	0.6408
Switch - Or Die Trying	2017-03-07	37	14	5	42	0.6406999999999999
Equilibrium Of Divinity	2017-10-16	8	14	5	13	0.6406999999999999
Dark Tower	2017-03-14	3	14	5	8	0.6406999999999999
Moe Mekuri SP - 萌めくりSP -	2017-04-23	11	14	5	16	0.6406999999999999
Ricky Raccoon 2	2017-06-02	5	14	5	10	0.6406999999999999
Scrolls of the Lord	2017-11-15	2	14	5	7	0.6406999999999999
Munch	2017-02-17	8	27	11	19	0.6406000000000001
Elven Legend	2017-03-08	14	27	11	25	0.6406000000000001
Last Heroes 4	2017-04-14	634	27	11	645	0.6406000000000001
Magic Forest	2017-09-18	5	27	11	16	0.6406000000000001
Skyraine	2017-09-02	8	27	11	19	0.6406000000000001
Australian trip	2017-12-19	23	27	11	34	0.6406000000000001
Modern Combat Versus	2017-12-19	1123	4452	2386	3509	0.6405
Satellite Repairman	2017-02-02	2676	60	27	2703	0.6404000000000001
Feeding The Monster	2017-10-11	10	66	30	40	0.6402
Judas	2017-01-18	1876	86	40	1916	0.6401000000000001
Bloodworks	2017-12-31	27	76	35	62	0.6401000000000001
NOBUNAGA'S AMBITION: Reppuden with Power Up Kit	2017-08-30	154	29	12	166	0.64
Ino	2017-03-03	154	31	13	167	0.6395000000000001
Alien Rampage	2017-10-11	4	33	14	18	0.6391
Underworld Dungeon	2017-07-31	4	7	2	6	0.6389
The Legends of Owlia	2017-01-11	3	7	2	5	0.6389
Chowdertwo	2017-02-21	4255	7	2	4257	0.6389
Comit the Astrodian 2	2017-03-20	655	7	2	657	0.6389
Shattered Steel	2017-05-03	2	7	2	4	0.6389
Battlefield Alliance	2017-07-28	2	7	2	4	0.6389
REPULSE: Galactic Rivals	2017-11-13	3	7	2	5	0.6389
Adventure Golf VR	2017-11-07	4	7	2	6	0.6389
OSES	2017-09-14	6	7	2	8	0.6389
アルカナリッター	2017-12-07	4	7	2	6	0.6389
Primal Reign	2017-05-29	74	35	15	89	0.6388
M.A.C.E. Tower Defense	2017-07-16	12	35	15	27	0.6388
猫肉「Cat Meat」	2017-04-21	12	16	6	18	0.6388
Gone with the Demon	2017-01-25	6	16	6	12	0.6388
Gum Guy	2017-01-03	5037	16	6	5043	0.6388
In the name of sin	2017-10-30	5	16	6	11	0.6388
Azure Sky Project	2017-12-08	4	16	6	10	0.6388
Journey to Luonto	2017-11-28	9	16	6	15	0.6388
Labyronia Elements	2017-12-03	7	16	6	13	0.6388
Maximum Override	2017-03-09	41	198	98	139	0.6385000000000001
Galaxy Girls	2017-09-15	113	87	41	154	0.6381
Arrow Heads	2017-09-21	27	41	18	45	0.6381
Solarium	2017-07-27	50	85	40	90	0.638
Arms Race - TCWE	2017-10-05	7	45	20	27	0.6378
It Lurks in the Woods	2017-02-08	6	45	20	26	0.6378
High Noon VR	2017-11-14	9	45	20	29	0.6378
The Franz Kafka Videogame	2017-04-06	54	460	237	291	0.6377
Secret in Story	2017-06-19	9404	73	34	9438	0.6377
Rogue Islands	2017-09-12	16	53	24	40	0.6376
Fear of Clowns	2017-04-29	9	118	57	66	0.6375000000000001
Grim Dragons	2017-02-02	3	18	7	10	0.6375000000000001
Mighty Monster Mayhem	2017-04-20	14	18	7	21	0.6375000000000001
Plexus	2017-07-31	3	18	7	10	0.6375000000000001
OnsenVR	2017-12-01	5	18	7	12	0.6375000000000001
Ratty Catty	2017-09-19	58	651	340	398	0.6373
Zooicide	2017-06-30	72	271	137	209	0.6373
Ogre	2017-10-05	78	143	70	148	0.6373
Sudden Strike 3	2017-05-22	63	108	52	115	0.6371
StarShip Constructor	2017-07-20	66	175	87	153	0.6365999999999999
Wishmere	2017-09-26	6	20	8	14	0.6365
Cloudbase Prime	2017-07-26	21	20	8	29	0.6365
InMind 2 VR	2017-02-17	8	20	8	16	0.6365
Somewhere on Zibylon	2017-09-14	42	20	8	50	0.6365
Endless Horde	2017-04-11	2513	113	55	2568	0.6358
XenonValkyrie	2017-02-03	38	82	39	77	0.6358
Multishop Tycoon Deluxe	2017-03-10	9577	22	9	9586	0.6358
NOBUNAGA’S AMBITION: Shouseiroku with Power Up Kit	2017-07-25	105	22	9	114	0.6358
Dead Exit	2017-06-20	5	22	9	14	0.6358
Vehicle VR	2017-06-09	5	22	9	14	0.6358
Beauty Bounce	2017-02-22	43	72	34	77	0.6353
Starway Fleet	2017-08-29	10	72	34	44	0.6353
Football Blitz	2017-01-04	255	24	10	265	0.6353
The Uncertain: VR Experience	2017-04-25	8	24	10	18	0.6353
Void Memory	2017-10-30	23	128	63	86	0.6352000000000001
Joy Pony	2017-08-15	14	145	72	86	0.6349
OneScreen Solar Sails	2017-06-16	2	26	11	13	0.6349
Tiny Toyfare	2017-10-18	14	26	11	25	0.6349
A Day For A Kitten	2017-11-30	6	26	11	17	0.6349
Age of Gladiators II: Death League	2017-09-21	77	60	28	105	0.6347
Mars 2030	2017-07-31	16	58	27	43	0.6346
Bloody Zombies	2017-09-11	18	56	26	44	0.6346
Impresja	2017-07-27	7	28	12	19	0.6346
Alien Hallway 2	2017-10-05	30	93	45	75	0.6345000000000001
Three Days	2017-05-19	992	54	25	1017	0.6345000000000001
Ariel	2017-07-11	5	9	3	8	0.6345000000000001
Fine China	2017-05-05	4	9	3	7	0.6345000000000001
Breaking Wheel	2017-04-03	6	9	3	9	0.6345000000000001
Quizality	2017-03-14	5	9	3	8	0.6345000000000001
Mech Skeleton	2017-03-21	3	9	3	6	0.6345000000000001
Lander 8009 VR	2017-06-16	6	9	3	9	0.6345000000000001
Undarkened	2017-10-24	3	9	3	6	0.6345000000000001
Talk to Aya	2017-11-01	3	9	3	6	0.6345000000000001
Morph Girl	2017-08-30	7	52	24	31	0.6344
Hunt: The Unknown Quarry	2017-01-30	16	30	13	29	0.6344
Lightspeed Frontier	2017-03-07	11	30	13	24	0.6344
Practisim VR	2017-05-19	6	30	13	19	0.6344
Unreal Estate	2017-06-16	5	30	13	18	0.6344
Tales of Escape	2017-03-16	290	1183	637	927	0.6343
Delicious - Moms vs Dads	2017-12-12	53	50	23	76	0.6343
Bloody Mice	2017-08-19	4	32	14	18	0.6343
Freedom Fighter	2017-05-26	2337	42	19	2356	0.6341
Finding Hope	2017-01-30	1254	40	18	1272	0.6341
Tokaido	2017-12-04	29	83	40	69	0.6338
Auto Age: Standoff	2017-09-21	72	75	36	108	0.6332
Flamel's miracle（弗拉梅尔的奇迹）	2017-04-05	37	98	48	85	0.6331
Flower Design	2017-03-17	748	73	35	783	0.6331
Empire Architect	2017-10-06	75	115	57	132	0.6329
CryptoMoneya	2017-09-03	1765	115	57	1822	0.6329
Fly Simulator	2017-07-16	28	498	264	292	0.6327
Sine Mora EX	2017-08-08	139	342	179	318	0.6325999999999999
Pastelia Stories	2017-03-16	296	521	277	573	0.6324000000000001
NASCAR Heat 2	2017-09-12	252	251	130	382	0.6323
Ancient Battle: Rome	2017-08-15	7	11	4	11	0.6321
Javva Juice	2017-01-06	10	11	4	14	0.6321
Alchemist Defender VR	2017-11-22	3	11	4	7	0.6321
Bildo	2017-07-26	6	11	4	10	0.6321
sWORD MASTER	2017-12-03	4	11	4	8	0.6321
Tom's Mansion	2017-12-06	3	11	4	7	0.6321
Palace of Cards	2017-12-14	153	135	68	221	0.6317
Star Trek Timelines	2017-07-12	927	774	418	1345	0.6315999999999999
Space Wars: Interstellar Empires	2017-12-08	183	148	75	258	0.6315999999999999
Dice Tower Defense	2017-09-15	14	116	58	72	0.6315
After The End: The Harvest	2017-06-02	672	55	26	698	0.6315
Beachhead 2002	2017-05-02	8	53	25	33	0.6313000000000001
GOKEN	2017-09-29	60	53	25	85	0.6313000000000001
Covert Syndrome	2017-04-22	21	95	47	68	0.6311
Constellation Distantia	2017-02-28	3	13	5	8	0.6306
PROTOThYPE	2017-02-15	9	13	5	14	0.6306
Elven Legend 2: The Bewitched Tree	2017-05-12	10	13	5	15	0.6306
AESCULAP® OrthoPilot®Elite VR Palpation	2017-09-18	8	13	5	13	0.6306
Mystery Loss	2017-09-21	6	13	5	11	0.6306
Survive the Nights	2017-12-21	1716	2369	1318	3034	0.6305
Heroes of Arca	2017-02-16	17	45	21	38	0.6305
Chicago 1930	2017-09-11	18	87	43	61	0.6302000000000001
Debris	2017-10-23	17	85	42	59	0.63
Theory of Fear	2017-03-28	7	39	18	25	0.63
Make a word!	2017-09-29	10	39	18	28	0.63
Marble Run	2017-10-29	97	39	18	115	0.63
Go Go Electric Samurai	2017-08-15	13	15	6	19	0.6298
Captain Lycop: Invasion of the Heters	2017-02-10	488	15	6	494	0.6298
Boofle's Home	2017-03-27	4	15	6	10	0.6298
Concurrency	2017-05-16	945	15	6	951	0.6298
Simple Light Cycles	2017-06-16	6	15	6	12	0.6298
SQUAKE	2017-02-01	907	98	49	956	0.6296
Princess of Tavern Collector's Edition	2017-10-23	13	35	16	29	0.6296
Rival Books of Aster	2017-06-20	26	35	16	42	0.6296
Hellenica	2017-01-23	43	33	15	58	0.6294
Old Time Hockey	2017-03-28	68	161	83	151	0.6293
Incorp Inc	2017-04-04	153	17	7	160	0.6293
Popap	2017-03-18	624	17	7	631	0.6293
Sandra and Woo in the Cursed Adventure	2017-05-05	15	17	7	22	0.6293
ConcPerfect 2017	2017-07-30	5	17	7	12	0.6293
Touch My Spinner	2017-09-23	7	17	7	14	0.6293
Leisure Suit Larry 5 - Passionate Patti Does a Little Undercover Work	2017-12-18	8	31	14	22	0.6292
Wrecked: Get Your Ship Together	2017-04-14	14	29	13	27	0.6291
WWE 2K17	2017-02-07	1663	1096	605	2268	0.629
Remember, Remember	2017-05-12	12	27	12	24	0.629
Winged Sakura: Endless Dream	2017-10-06	22	19	8	30	0.629
The Grand Ball	2017-05-10	14	19	8	22	0.629
Puppet Kings	2017-12-11	3	19	8	11	0.629
Storage Inc 2	2017-02-21	11	25	11	22	0.6289
Box Looter 2018	2017-11-28	6	21	9	15	0.6289
Blossoms Bloom Brightest	2017-04-28	17	105	53	70	0.6288
Screamer	2017-08-31	3	23	10	13	0.6288
Ticket to Ride: First Journey	2017-09-27	222	193	101	323	0.6282
The Grand Canyon VR Experience	2017-01-13	16	48	23	39	0.6275000000000001
FoxyLand	2017-10-17	8	106	54	62	0.6273
Immersion Chess	2017-05-15	27	78	39	66	0.627
Subterra	2017-09-18	1497	76	38	1535	0.6267
Mr. Dubstep	2017-09-18	72	105	54	126	0.6256
Impulse of War	2017-02-24	241	287	155	396	0.6255
2D Neon Cube	2017-09-08	4	134	70	74	0.6253000000000001
Nyheim	2017-01-31	750	53	26	776	0.6252000000000001
BlackEye	2017-08-09	980	53	26	1006	0.6252000000000001
Angel Flare	2017-07-22	115	4	1	116	0.6251
vRhythm	2017-09-07	2	4	1	3	0.6251
Legions of Tyrandel	2017-09-22	79	4	1	80	0.6251
Perso	2017-04-20	3	4	1	4	0.6251
Blowhards	2017-02-28	24	4	1	25	0.6251
Minions, Monsters, and Madness	2017-01-10	7	4	1	8	0.6251
Orbiz	2017-02-16	30	4	1	31	0.6251
The Physiology of the Eye	2017-01-19	29	4	1	30	0.6251
Hoop Route	2017-08-30	3	4	1	4	0.6251
Cornflower Corbin	2017-08-17	7	4	1	8	0.6251
Nevertales: Smoke and Mirrors Collector's Edition	2017-05-08	5	4	1	6	0.6251
PsychLabVR	2017-05-04	5	4	1	6	0.6251
Danse Macabre: Crimson Cabaret Collector's Edition	2017-07-10	3	4	1	4	0.6251
Double Play: 2-Player VR Baseball	2017-07-21	3	4	1	4	0.6251
Humble Abode	2017-06-27	3	4	1	4	0.6251
MarionetteAI	2017-11-20	4	4	1	5	0.6251
DepthMera	2017-08-09	3	4	1	4	0.6251
Fos	2017-06-29	2	4	1	3	0.6251
Beyond the Horizon	2017-09-22	2	4	1	3	0.6251
Tower Offence!	2017-09-11	2	4	1	3	0.6251
Cruentis The Murderer vol.1	2017-09-20	2	4	1	3	0.6251
Soldier Killer	2017-08-15	2	4	1	3	0.6251
Pulses - Crystal Journeys	2017-09-11	2	4	1	3	0.6251
VR Crane Master	2017-08-09	3	4	1	4	0.6251
Chimeras: The Signs of Prophecy Collector's Edition	2017-07-21	4	4	1	5	0.6251
Dr. Dungeon's MADMAN!	2017-07-27	2	4	1	3	0.6251
Invictus: In the Shadow of Olympus	2017-12-18	3	4	1	4	0.6251
WackIt	2017-08-25	2	4	1	3	0.6251
Power of The Void	2017-10-26	2	4	1	3	0.6251
LOGistICAL: Japan	2017-10-06	12	4	1	13	0.6251
Pi	2017-10-16	1	4	1	2	0.6251
Halloween: Jigsaw Puzzles	2017-10-20	2	4	1	3	0.6251
Maze Up!	2017-11-08	2	4	1	3	0.6251
Rocket Armor	2017-12-08	2	4	1	3	0.6251
Family Jewels	2017-11-20	3	4	1	4	0.6251
VR Hybrid War 2117 - VR混合战争2117	2017-11-10	2	4	1	3	0.6251
HexaMon	2017-11-18	3	4	1	4	0.6251
Operation Red Dragon	2017-12-15	4	4	1	5	0.6251
Nevertales: Legends Collector's Edition	2017-12-18	3	4	1	4	0.6251
Tank Force	2017-10-23	434	1324	748	1182	0.625
Saurian	2017-08-02	609	997	560	1169	0.625
Bacon Tales - Between Pigs and Wolves	2017-10-12	1166	34	16	1182	0.6249
Gladiator: Sword of Vengeance	2017-01-31	22	34	16	38	0.6249
Princess Maker Refine	2017-02-17	71	220	118	189	0.6248
False Shelter	2017-04-20	2774	51	25	2799	0.6248
Spirit of Maya	2017-01-06	3903	32	15	3918	0.6245
Paperback: The Game	2017-11-29	1030	32	15	1045	0.6245
Rocks and Rockets	2017-10-04	11	32	15	26	0.6245
Spiral Splatter	2017-08-09	7	62	31	38	0.6242
Doodle Mafia	2017-04-20	335	84	43	378	0.624
Dragon Boar and Lady Rabbit	2017-12-27	5	30	14	19	0.624
Forgotten Lore	2017-10-05	300	47	23	323	0.6239
Beast Mode: Night of the Werewolf	2017-06-22	3	28	13	16	0.6235
Loot'N Shoot	2017-09-19	51	80	41	92	0.6232
Fighting Fantasy Legends	2017-07-27	61	109	57	118	0.6231
Sweven	2017-04-22	8	26	12	20	0.6231
Slice, Dice & Rice	2017-04-27	62	448	249	311	0.6229
The Hunting God	2017-07-29	10	78	40	50	0.6228
Orange Moon	2017-09-27	90	67	34	124	0.6228
Worlds Adrift	2017-05-24	2057	3468	2015	4072	0.6226
Army Men: Toys in Space	2017-12-20	9	41	20	29	0.6224000000000001
Ripple Effect	2017-05-31	16	41	20	36	0.6224000000000001
Ripple	2017-03-31	704	41	20	724	0.6224000000000001
Immortal Planet	2017-07-27	70	233	127	197	0.6222
The End o,,,o	2017-05-12	9	121	64	73	0.6221
Yukie: A Japanese Winter Fairy Tale	2017-07-14	3	22	10	13	0.6221
Awesome Metal Detecting	2017-05-01	42	238	130	172	0.622
Army Men II	2017-12-20	13	74	38	51	0.622
M.E.R.C.	2017-01-17	26	39	19	45	0.6219
SoulSaverOnline	2017-04-06	159	181	98	257	0.6215
Ancient Frontier	2017-09-21	63	81	42	105	0.6214000000000001
Akihabara - Feel the Rhythm	2017-01-26	226	50	25	251	0.6214000000000001
John Wick Chronicles	2017-02-09	142	170	92	234	0.621
Dustoff Heli Rescue 2	2017-05-30	11	18	8	19	0.621
Shadow Mist	2017-05-11	7	18	8	15	0.621
MegaRace 1	2017-11-09	2	18	8	10	0.621
Mayhem ZX	2017-10-18	2	6	2	4	0.621
Minotaur's Maze	2017-04-12	3	6	2	5	0.621
Metanet Hunter CD	2017-01-31	18	6	2	20	0.621
Pixel Gear	2017-06-12	4	6	2	6	0.621
Vulture Strike	2017-12-19	3	6	2	5	0.621
Orbs	2017-09-18	4	6	2	6	0.621
StarBallMadNess	2017-08-01	2	6	2	4	0.621
Embrace of Ocean: Story of Hope	2017-08-05	3	6	2	5	0.621
After Rain: Phoenix Rise	2017-12-15	2	6	2	4	0.621
The Relentless	2017-10-24	2	6	2	4	0.621
The Legend of the Dragonflame High School	2017-09-01	2	6	2	4	0.621
Gurugedara	2017-09-28	12	6	2	14	0.621
Tricks and Treats	2017-10-18	5	6	2	7	0.621
Fade Away	2017-10-02	2	6	2	4	0.621
Endless Treasure Hunt	2017-10-16	3	6	2	5	0.621
AcChen - Tile matching the Arcade way	2017-12-20	2	6	2	4	0.621
Kitten Madness	2017-12-31	4	6	2	6	0.621
Raining Coins	2017-12-06	2	6	2	4	0.621
Sleeping Dawn	2017-11-17	110	48	24	134	0.6209
Drive//Shaft	2017-11-30	7	48	24	31	0.6209
Clumsy Fred	2017-07-14	6	35	17	23	0.6207
Pylon: Rogue	2017-09-21	10	16	7	17	0.6204999999999999
Escape From BioStation	2017-07-03	125	16	7	132	0.6204999999999999
The Morgue Fissure Between Worlds	2017-03-30	4	16	7	11	0.6204999999999999
Knot	2017-02-09	6	16	7	13	0.6204999999999999
Catsby	2017-04-06	6	16	7	13	0.6204999999999999
Riot of the numbers	2017-01-19	1404	46	23	1427	0.6203000000000001
Elsewhere High: Chapter 1 - A Visual Novel	2017-03-31	37	46	23	60	0.6203000000000001
Freedom Defender	2017-08-25	6	93	49	55	0.6202000000000001
Into the Rhythm VR	2017-09-19	11	33	16	27	0.62
Super Army of Tentacles 3: The Search for Army of Tentacles 2	2017-05-30	759	14	6	765	0.62
EmbodyMe Beta	2017-03-23	7	14	6	13	0.62
Hailstorm VR	2017-09-15	5	14	6	11	0.62
Awesome Machine	2017-07-07	32	14	6	38	0.62
Hidden Animals: English - Spanish	2017-06-16	2	14	6	8	0.62
Algorithm	2017-10-23	3	14	6	9	0.62
Dino Scourge	2017-12-18	10	14	6	16	0.62
Zombie Quarantine	2017-06-23	123	8	3	126	0.6197
Spirit	2017-01-05	3	8	3	6	0.6197
RoboCritters	2017-07-04	6	8	3	9	0.6197
Vectonic	2017-02-15	6	8	3	9	0.6197
Goblin Harvest - The Mighty Quest	2017-03-06	4	8	3	7	0.6197
Earthquake Simulator VR	2017-07-03	4	8	3	7	0.6197
VR Interior Designer Pro	2017-04-05	33	8	3	36	0.6197
Blue Angels Aerobatic Flight Simulator	2017-08-17	3	8	3	6	0.6197
Choice of the Star Captain	2017-06-16	6	8	3	9	0.6197
Prelude for a Dream	2017-06-27	2	8	3	5	0.6197
Four Horsemen	2017-09-01	4	8	3	7	0.6197
Codename: Phantom	2017-11-22	2	8	3	5	0.6197
GALACTIC FIELD 2017 BATE	2017-09-29	3	8	3	6	0.6197
Olson's Boxing Challenge	2017-11-20	3	8	3	6	0.6197
Sugy the Christmas elf	2017-12-07	2	8	3	5	0.6197
Solitaire Club	2017-05-11	12	12	5	17	0.6196
Aztec Venture	2017-06-01	5	12	5	10	0.6196
The Rosebud Condominium	2017-08-09	3	12	5	8	0.6196
Barrels Up	2017-11-22	3	12	5	8	0.6196
Time Killers: Spot Race	2017-11-13	2	12	5	7	0.6196
MahJong	2017-11-08	12	12	5	17	0.6196
Avalon: The Journey Begins	2017-10-26	2	10	4	6	0.6195
Glyphs Apprentice	2017-03-16	57	10	4	61	0.6195
Nightmare Adventures: The Turning Thorn	2017-04-17	3	10	4	7	0.6195
Hero of Light VR	2017-11-14	3	10	4	7	0.6195
Tanki Online	2017-03-02	466	3466	2044	2510	0.6194
Romancing SaGa 2™	2017-12-15	189	151	82	271	0.6194
Illyriad - Grand Strategy MMO	2017-01-11	164	96	51	215	0.6191
Regenesis Arcade Lite	2017-11-20	12	29	14	26	0.6186
Dead Realm	2017-05-23	1844	2930	1732	3576	0.6184000000000001
Gakuen Club	2017-05-10	25	40	20	45	0.6183
INFINITI VR	2017-03-28	14	40	20	34	0.6183
Kuro survival	2017-06-21	2868	40	20	2888	0.6183
The Artifact	2017-06-02	243	129	70	313	0.6182
Strike Team Hydra	2017-12-08	6	27	13	19	0.6178
Tower 57	2017-11-16	303	439	251	554	0.6172
NOBUNAGA'S AMBITION: Ranseiki with Power Up Kit	2017-10-18	37	25	12	49	0.6169
Castle Story	2017-08-17	1565	5440	3265	4830	0.6168
Dwarflings	2017-03-16	1791	36	18	1809	0.6168
In Vitra	2017-03-24	44	36	18	62	0.6168
Alienzix	2017-08-26	3	36	18	21	0.6168
Urban Rivals	2017-10-18	179	320	182	361	0.6163000000000001
Pathfinder Adventures	2017-06-15	405	467	269	674	0.6161
Antaria Online R	2017-10-04	143	219	123	266	0.6161
Drums Hero PC	2017-06-22	276	23	11	287	0.616
WireNet	2017-08-26	3	23	11	14	0.616
Protect Me	2017-11-01	2	23	11	13	0.616
Epic Tavern	2017-09-13	56	198	111	167	0.6157
SORE	2017-10-05	87	189	106	193	0.6153000000000001
Marvel vs. Capcom: Infinite	2017-09-19	3603	1557	926	4529	0.615
Gettysburg: The Tide Turns	2017-07-14	49	41	21	70	0.615
Deadbeat Heroes	2017-10-10	101	57	30	131	0.6149
Burgers 2	2017-01-14	42	21	10	52	0.6149
Gil's Lucid Dreams	2017-10-17	862	21	10	872	0.6149
Spacetours VR - Ep1 The Solar System	2017-03-08	11	21	10	21	0.6149
Warpaint	2017-03-17	8	21	10	18	0.6149
The Thing With Mistletoes	2017-02-10	14	55	29	43	0.6141
Infinite Tanks	2017-03-25	91	121	67	158	0.614
Space Fighter	2017-09-14	39	69	37	76	0.614
Assault on the Necrospire	2017-08-21	6	19	9	15	0.6138
The Little War	2017-12-28	9	19	9	18	0.6138
Lifeline	2017-03-17	132	88	48	180	0.6136
Ancient Go	2017-05-30	10	67	36	46	0.6133
AZURA	2017-11-13	6	168	95	101	0.6129
Legend of the Skyfish	2017-02-24	5	28	14	19	0.6129
Trackmania² Lagoon	2017-05-23	102	173	98	200	0.6128
Mushroom Wars 2	2017-10-06	241	577	340	581	0.6127
Cannons-Defenders: Steam Edition	2017-04-07	2330	91	50	2380	0.6127
新流星搜劍錄	2017-12-21	810	691	409	1219	0.6126
Diluvion	2017-02-02	621	658	389	1010	0.6126
Winexy	2017-01-13	1881	103	57	1938	0.6126
SoundLites	2017-07-16	18	17	8	26	0.6125
VR Formula	2017-08-18	5	17	8	13	0.6125
Cross Set Infinity	2017-10-28	7	17	8	15	0.6125
Rainyday	2017-10-06	3	17	8	11	0.6125
Endless Inside	2017-12-22	4	17	8	12	0.6125
PRO EVOLUTION SOCCER 2018	2017-09-13	7082	2539	1541	8623	0.6123
Corrupt	2017-09-15	6	56	30	36	0.6118
You... and who else?	2017-03-17	465	26	13	478	0.6118
Q.U.I.R.K.	2017-03-29	21	26	13	34	0.6118
Cavern of Time	2017-02-10	974	49	26	1000	0.6117
Fallout 4 VR	2017-12-11	2664	4384	2688	5352	0.6116
Nephise Begins	2017-04-24	776	735	438	1214	0.6115
Revenant Saga	2017-03-01	6	15	7	13	0.6111
Stunt Toys	2017-04-12	4	15	7	11	0.6111
No Clue VR	2017-11-08	21	15	7	28	0.6111
Last Stonelord	2017-09-27	7	15	7	14	0.6111
Cottage Garden	2017-11-01	8	15	7	15	0.6111
Axis Football 2017	2017-08-16	30	107	60	90	0.6106
BLADENET	2017-10-06	30	144	82	112	0.6104
Disney's The Lion King	2017-12-18	15	52	28	43	0.61
Fruit Arranger	2017-01-23	2925	172	99	3024	0.6098
Franchise Hockey Manager 4	2017-10-06	190	93	52	242	0.6098
Manastorm	2017-01-03	6	45	24	30	0.6098
A Demon's Game - Episode 1	2017-02-10	1423	31	16	1439	0.6098
Unearthing Mars VR	2017-06-23	10	38	20	30	0.6097
Recession	2017-07-11	10	13	6	16	0.6095
HEPH	2017-01-24	3	13	6	9	0.6095
VRog	2017-02-10	3	13	6	9	0.6095
Travel Riddles: Trip To Italy	2017-07-13	7	13	6	13	0.6095
Tractorball	2017-10-04	6	13	6	12	0.6095
Civil War: 1864	2017-10-06	6	13	6	12	0.6095
Immersive Poetry	2017-10-16	5	13	6	11	0.6095
Sea Of Fatness	2017-10-20	3	13	6	9	0.6095
Kraken	2017-10-24	3	13	6	9	0.6095
Skylight	2017-12-29	5	13	6	11	0.6095
Christmas Stories: Hans Christian Andersen's Tin Soldier Collector's Edition	2017-12-08	12	13	6	18	0.6095
Business Tour - Online Multiplayer Board Game	2017-07-27	7707	40750	25707	33414	0.6092000000000001
Robo Do It	2017-02-21	1081	22	11	1092	0.609
Dreamlike Worlds	2017-03-07	38	22	11	49	0.609
History2048 - 3D puzzle number game	2017-06-16	11	22	11	22	0.609
Midnight Ultra	2017-11-01	7	55	30	37	0.6086
Johnny Graves—The Unchosen One	2017-04-06	5	29	15	20	0.6085
BLACK DAY	2017-09-18	30	202	118	148	0.6082
Hunt For Gods	2017-11-15	34	60	33	67	0.6082
Man O' War: Corsair	2017-04-19	196	468	281	477	0.6078
Take the Cake	2017-11-28	698	11	5	703	0.6076
Ballistic	2017-02-20	5	11	5	10	0.6076
Blastercell	2017-05-11	1476	11	5	1481	0.6076
Fastigium: Dead End	2017-04-01	3	11	5	8	0.6076
PingBall	2017-04-12	4	11	5	9	0.6076
STICK ENGINE	2017-08-31	5	11	5	10	0.6076
Panzer Killer	2017-06-28	2	11	5	7	0.6076
Purgation	2017-10-06	9	11	5	14	0.6076
Pet Squad Racing	2017-10-06	3	11	5	8	0.6076
Destroy Space Aliens	2017-11-29	4	11	5	9	0.6076
War Planet Online: Global Conquest	2017-12-19	650	451	271	921	0.6075
Super Lovely Planet	2017-07-28	10	20	10	20	0.6074
Spirit Realm	2017-07-21	9	20	10	19	0.6074
The Naked Game	2017-12-15	5	20	10	15	0.6074
Everyday Lite	2017-12-13	16	20	10	26	0.6074
Yozora Rhapsody	2017-03-16	1045	27	14	1059	0.6071
On a Roll	2017-08-30	118	245	145	263	0.6069
Mini Guns	2017-11-02	289	256	152	441	0.6066
Castle of no Escape	2017-06-22	769	78	44	813	0.6066
Panda Run	2017-08-31	8	78	44	52	0.6066
Gun-Running War Dogs	2017-08-21	79	39	21	100	0.6065
Last Man Standing	2017-03-29	11857	11084	7034	18891	0.6059
The Far Frontier	2017-10-27	4457	32	17	4474	0.6059
Valentine Panic	2017-10-13	5	25	13	18	0.6055
Hairy Little Buggers	2017-06-23	10	18	9	19	0.6055
#Archery	2017-12-19	7	18	9	16	0.6055
Perspectives: Aleppo-Helsinki	2017-11-16	4	18	9	13	0.6055
The Sun Never Sets	2017-06-06	2245	18	9	2254	0.6055
ARENA an Age of Barbarians story	2017-09-15	43	109	63	106	0.6054
Reef Shot	2017-12-04	17	9	4	21	0.6054
Babylon 2055 Pinball	2017-03-29	21	9	4	25	0.6054
Flatshot	2017-12-23	4	9	4	8	0.6054
Metal Assault	2017-03-15	4	9	4	8	0.6054
ThinkAhead	2017-07-14	1	9	4	5	0.6054
Fateholders of Tetsoidea	2017-07-21	3	9	4	7	0.6054
Fapic	2017-08-14	2	9	4	6	0.6054
Undercity	2017-09-19	4	9	4	8	0.6054
EMPYRE: Lords of the Sea Gates	2017-10-04	11	9	4	15	0.6054
The Merchant Memoirs	2017-10-21	2	9	4	6	0.6054
Zen Blocks	2017-12-04	2	9	4	6	0.6054
Realpolitiks	2017-02-16	1148	694	426	1574	0.6052000000000001
STELLATUM	2017-09-16	43	99	57	100	0.6052000000000001
Deus Vult	2017-05-27	220	94	54	274	0.6052000000000001
Prime Arena	2017-10-19	60	59	33	93	0.6052000000000001
Once in Yaissor 2	2017-12-29	3	37	20	23	0.6052000000000001
Supreme Ruler The Great War	2017-08-01	88	69	39	127	0.6051
Direct	2017-08-17	5	42	23	28	0.6047
Archamon	2017-11-24	16	30	16	32	0.6043999999999999
Grape Jelly	2017-10-03	4	30	16	20	0.6043999999999999
Deep Blue	2017-05-17	2001	57	32	2033	0.6042000000000001
Call to Power II	2017-04-18	28	57	32	60	0.6042000000000001
GAIA 2200	2017-08-03	11	23	12	23	0.6037
Elbub	2017-12-08	11	23	12	23	0.6037
Possessed	2017-05-17	945	85	49	994	0.6036
My Free Zoo	2017-11-28	509	321	195	704	0.6035
Virus Crashers	2017-02-21	4	16	8	12	0.6034
Hunter Story	2017-10-12	136	65	37	173	0.6032000000000001
Disputed Space	2017-12-08	5	60	34	39	0.6032000000000001
Descent - Silence of Mind	2017-08-02	5	55	31	36	0.6032000000000001
Spellgear	2017-04-07	34	50	28	62	0.6032000000000001
Birthdays the Beginning	2017-05-09	643	513	316	959	0.6031000000000001
Tank On Tank Digital - West Front	2017-05-09	8	28	15	23	0.6028
Epic Battle Simulator 2	2017-11-02	11	28	15	26	0.6028
Snakeez	2017-10-02	3	28	15	18	0.6028
TurretCraft	2017-04-05	5	7	3	8	0.6028
SWAM	2017-01-06	55	7	3	58	0.6028
Arizona Rose and the Pharaohs' Riddles	2017-01-18	6	7	3	9	0.6028
Oodlescape - The Apocalypse	2017-02-27	3	7	3	6	0.6028
MYSTIC VR	2017-07-21	3	7	3	6	0.6028
Children of Apollo	2017-11-09	3	7	3	6	0.6028
The Istrys	2017-09-01	5	7	3	8	0.6028
All Haze Eve	2017-09-01	3	7	3	6	0.6028
Abyssal Fall	2017-08-26	4	7	3	7	0.6028
Jumphobia Classic	2017-09-04	3	7	3	6	0.6028
TRYON	2017-09-15	4	7	3	7	0.6028
Viral	2017-10-13	2	7	3	5	0.6028
Colony	2017-12-15	2	7	3	5	0.6028
Wraith	2017-10-15	2	7	3	5	0.6028
Guide The Ball	2017-11-15	2	7	3	5	0.6028
Seek Not a Lighthouse	2017-11-20	2	7	3	5	0.6028
Cyberline Racing	2017-03-22	2354	96	56	2410	0.6026
Neon Hardcore	2017-07-21	13	104	61	74	0.6023
Genetic Disaster	2017-12-18	16	63	36	52	0.6023
Occultus	2017-11-01	12	33	18	30	0.6023
Sonic Forces	2017-11-07	2058	4027	2575	4633	0.6022
Remaya Idle	2017-11-20	197	53	30	227	0.6020000000000001
Mr. Triangle's Adventure	2017-02-01	1421	21	11	1432	0.6017
VRIQ	2017-05-03	5	21	11	16	0.6017
Captain Firebeard and the Bay of Crows	2017-10-04	3	21	11	14	0.6017
CDF Starfighter VR	2017-05-26	9	66	38	47	0.6015
Winds Of Trade	2017-02-13	37	105	62	99	0.6012
Flatspace IIk	2017-04-21	34	14	7	41	0.6009000000000001
Neighbourhood Necromancer	2017-05-12	9	14	7	16	0.6009000000000001
Einar	2017-07-20	118	890	561	679	0.6007
Solaria Moon	2017-09-06	8	41	23	31	0.6006
Killbox	2017-08-24	13	41	23	36	0.6006
SWAT 3: Tactical Game of the Year Edition	2017-04-18	13	184	112	125	0.5997
Dreamals	2017-04-27	2	5	2	4	0.5997
Bocce Beach	2017-02-17	3	5	2	5	0.5997
Psyche Soldier VR	2017-12-15	4	5	2	6	0.5997
Embrace The Fear	2017-01-13	5	5	2	7	0.5997
All-Star Fielding Challenge VR	2017-04-03	3	5	2	5	0.5997
Puzzle Guardians	2017-04-18	7	5	2	9	0.5997
Moriarty: Endgame VR	2017-03-31	15	5	2	17	0.5997
Sakeretsu	2017-06-21	4	5	2	6	0.5997
StratoBash	2017-06-02	32	5	2	34	0.5997
Rock, Ken, Bo	2017-05-05	42	5	2	44	0.5997
xDrive VR	2017-06-16	2	5	2	4	0.5997
Time Gun	2017-07-07	2	5	2	4	0.5997
Deep Horizon	2017-07-10	2	5	2	4	0.5997
7 Pillars	2017-06-21	2	5	2	4	0.5997
Quadrablaze	2017-12-21	3	5	2	5	0.5997
SpaceMerc	2017-09-06	2	5	2	4	0.5997
DreamTank	2017-10-13	2	5	2	4	0.5997
Airi's World	2017-07-13	2	5	2	4	0.5997
XMinutes: Wings	2017-07-25	8	5	2	10	0.5997
Damn	2017-09-08	13	5	2	15	0.5997
Captivus	2017-10-03	6	5	2	8	0.5997
Hippo Sports	2017-09-28	2	5	2	4	0.5997
Nine Worlds - A Viking saga	2017-09-16	2	5	2	4	0.5997
TRIPLICATA	2017-12-21	2	5	2	4	0.5997
Cubion	2017-11-05	2	5	2	4	0.5997
The Last Monster Master	2017-09-28	8	5	2	10	0.5997
Naughty Elves	2017-12-08	2	5	2	4	0.5997
C64 & AMIGA Classix Remakes Sixpack 2	2017-11-25	2	5	2	4	0.5997
BOOKS	2017-08-23	9	88	52	61	0.5996
Doc Apocalypse	2017-12-22	965	19	10	975	0.5994
Retro Pinball	2017-02-02	3	19	10	13	0.5994
Kira	2017-03-22	7	19	10	17	0.5994
Evil Park	2017-09-01	6	19	10	16	0.5994
The Golf Club 2™	2017-06-27	455	488	306	761	0.5993
Heroes Tactics	2017-06-22	317	163	99	416	0.5993
Chosen 2	2017-03-10	895	150	91	986	0.599
Die With Glory	2017-05-11	725	34	19	744	0.5989
Aerial Destruction	2017-05-18	1135	81	48	1183	0.5984
Off-Road Paradise: Trial 4x4	2017-02-06	13	60	35	48	0.5982999999999999
Fishermurs	2017-04-14	1645	68	40	1685	0.5981000000000001
神舞幻想 Faith of Danschant	2017-12-22	2364	2779	1804	4168	0.598
Rapture - World Conquest	2017-08-01	4	12	6	10	0.598
Greyhound Manager 2 Rebooted	2017-02-09	9	12	6	15	0.598
Infernal Racket	2017-10-20	3	12	6	9	0.598
Zombie Hobby VR	2017-06-29	68	12	6	74	0.598
Andromeda Wing	2017-08-25	3	12	6	9	0.598
Zomborg	2017-11-10	7	92	55	62	0.5979
Drizzlepath: Glass	2017-02-15	6	103	62	68	0.5976
Star Merchant	2017-03-07	1653	71	42	1695	0.5975
Ashes	2017-06-28	4	37	21	25	0.5975
Empathy: Path of Whispers	2017-05-16	25	117	71	96	0.5971000000000001
PooSky	2017-10-11	3	58	34	37	0.5971000000000001
Craft Keep VR	2017-04-21	24	74	44	68	0.5970000000000001
Aetherspace	2017-07-03	40	45	26	66	0.5969
Clockwise	2017-05-01	1039	27	15	1054	0.5968
Cosmic Awakening VR	2017-08-25	5	17	9	14	0.5968
Avalon Legends Solitaire	2017-03-09	8	17	9	17	0.5968
RED CUBE VR	2017-05-10	12	22	12	24	0.5966
Canadian Football 2017	2017-07-26	14	22	12	26	0.5966
The Fall of Lazarus	2017-10-04	11	61	36	47	0.5965
Granado Espada	2017-10-16	4505	659	422	4927	0.5962
The Mexican Dream	2017-09-05	11	80	48	59	0.5961
Teenage Mutant Ninja Turtles: Portal Power	2017-12-14	17	48	28	45	0.596
Robots In The Wild	2017-02-15	3	3	1	4	0.596
Fast and Curious	2017-02-02	24	3	1	25	0.596
Osy Osmosis	2017-03-20	4	3	1	5	0.596
Super Rock Blasters!	2017-01-17	3	3	1	4	0.596
A Large Quantity Of Mushrooms	2017-03-23	1	3	1	2	0.596
The table at war VR	2017-01-16	4	3	1	5	0.596
Don't Touch The Zombies	2017-05-11	3	3	1	4	0.596
Kung Fu Ping Pong	2017-02-13	4	3	1	5	0.596
Space Slam	2017-01-12	2	3	1	3	0.596
SpaceJourney VR	2017-02-06	3	3	1	4	0.596
Nine	2017-01-23	2	3	1	3	0.596
Exterminator	2017-04-06	2	3	1	3	0.596
Cyber Complex	2017-08-04	49	3	1	50	0.596
Rise of Balloons	2017-05-18	2	3	1	3	0.596
Magic Heroes: Save Our Park	2017-04-18	3	3	1	4	0.596
Grim Facade: Sinister Obsession Collector’s Edition	2017-06-02	3	3	1	4	0.596
Perplexigon	2017-09-22	2	3	1	3	0.596
Blockara	2017-06-22	2	3	1	3	0.596
Ghostie Quest	2017-08-04	2	3	1	3	0.596
Dawn of H'btakh	2017-07-07	1	3	1	2	0.596
Hoop Shot VR	2017-07-18	2	3	1	3	0.596
PROJECT AZRIEL	2017-10-20	3	3	1	4	0.596
Spirits: Ciel Bleu	2017-07-08	1	3	1	2	0.596
MokMok	2017-08-01	2	3	1	3	0.596
AliveInVR	2017-12-06	3	3	1	4	0.596
Torn Familjen	2017-09-08	2	3	1	3	0.596
Escape From Space Shredder	2017-07-21	2	3	1	3	0.596
Galaxia Conquestum	2017-09-15	2	3	1	3	0.596
The Nightmare from Beyond	2017-09-12	2	3	1	3	0.596
Zombie Commando 3D	2017-08-28	5	3	1	6	0.596
Tower Miners	2017-09-15	3	3	1	4	0.596
Wingless	2017-08-22	2	3	1	3	0.596
Derora	2017-12-13	2	3	1	3	0.596
Kingdom: The Far Reaches	2017-09-08	2	3	1	3	0.596
LOGistICAL: Norway	2017-09-22	7	3	1	8	0.596
Crazy Mob	2017-09-26	1	3	1	2	0.596
WARZONE	2017-10-17	2	3	1	3	0.596
Blasteron	2017-11-09	3	3	1	4	0.596
American Angst (Steam Deluxe Edition)	2017-10-26	3	3	1	4	0.596
Snake Treasure Chest	2017-10-10	2	3	1	3	0.596
Maze of Gaea	2017-11-24	2	3	1	3	0.596
Deadeye Dungeon	2017-10-26	3	3	1	4	0.596
Fragments	2017-11-09	3	3	1	4	0.596
Hide N Seek VR	2017-11-07	6	3	1	7	0.596
Stay Woke Etheral Edition	2017-11-20	2	3	1	3	0.596
最強の囲碁 ～名人への道～ / Igo Meijin	2017-12-05	3	3	1	4	0.596
Osmorrow	2017-12-27	3	3	1	4	0.596
WaywaY	2017-12-20	1	3	1	2	0.596
Star Merc	2017-02-10	5944	35	20	5964	0.5958
Molten Armor	2017-10-20	14	35	20	34	0.5958
Abscond	2017-12-08	3	35	20	23	0.5958
Wild Terra Online	2017-12-18	316	1032	668	984	0.5957
Defense of Roman Britain	2017-07-21	6	30	17	23	0.5952000000000001
hack_me	2017-01-05	1589	1279	833	2422	0.5951
Dude Simulator	2017-07-13	9468	1157	754	10222	0.5946
Phantom Trigger	2017-08-10	39	54	32	71	0.5946
Alter Ego	2017-08-08	15	25	14	29	0.5946
Ping Pong League	2017-02-28	13	73	44	57	0.5945
Vanguard V	2017-05-31	2	10	5	7	0.5943
(VR)西汉帝陵 The Han Dynasty Imperial Mausoleums	2017-01-21	3	10	5	8	0.5943
HeapVR	2017-02-27	5	10	5	10	0.5943
Float Gallery	2017-07-19	9	10	5	14	0.5943
Astral Traveler	2017-09-13	5	10	5	10	0.5943
BootyBuns & 21	2017-08-17	6	10	5	11	0.5943
MINE!	2017-09-05	4	10	5	9	0.5943
Prison Chainball Massacre	2017-11-09	4	10	5	9	0.5943
Radar Warfare	2017-10-25	3	10	5	8	0.5943
The Mystery Room	2017-12-01	12	10	5	17	0.5943
World of Speed	2017-08-22	96	319	203	299	0.5942000000000001
Match More	2017-01-06	2	1	0	2	0.5942000000000001
Aviators	2017-01-19	4	1	0	4	0.5942000000000001
Abyssal Zone	2017-01-26	2	1	0	2	0.5942000000000001
Dark Canvas: A Brush With Death Collector's Edition	2017-03-21	3	1	0	3	0.5942000000000001
Of Light and Darkness	2017-02-23	2	1	0	2	0.5942000000000001
Holo-Graham	2017-02-20	1	1	0	1	0.5942000000000001
Dodge Master	2017-02-22	2	1	0	2	0.5942000000000001
FormulaNext	2017-01-26	1	1	0	1	0.5942000000000001
Demon Grade	2017-10-27	1	1	0	1	0.5942000000000001
Emperor Kingdom	2017-02-15	1	1	0	1	0.5942000000000001
Buccaneers, Bounty & Boom!	2017-03-08	3	1	0	3	0.5942000000000001
Ominous Objects: Family Portrait Collector's Edition	2017-03-08	4	1	0	4	0.5942000000000001
ClockwiZZZe	2017-05-01	10	1	0	10	0.5942000000000001
Hello inc VR	2017-04-14	2	1	0	2	0.5942000000000001
CubeBall VR	2017-05-11	1	1	0	1	0.5942000000000001
COMET STRIKE	2017-04-28	3	1	0	3	0.5942000000000001
Botanica: Into the Unknown Collector's Edition	2017-04-26	3	1	0	3	0.5942000000000001
VRun	2017-06-01	2	1	0	2	0.5942000000000001
Isle in the Sky	2017-06-12	1	1	0	1	0.5942000000000001
Booty Diver	2017-09-20	2	1	0	2	0.5942000000000001
The Montana Chronicles: Montana's Croatoa	2017-07-07	2	1	0	2	0.5942000000000001
Echo Nine	2017-11-07	3	1	0	3	0.5942000000000001
DC Wonder: Unlimited	2017-06-14	2	1	0	2	0.5942000000000001
Puzzle Bloc Invasion	2017-12-15	1	1	0	1	0.5942000000000001
Persian: The Great Lamp Heist	2017-07-16	1	1	0	1	0.5942000000000001
Never Not Shooting	2017-08-22	2	1	0	2	0.5942000000000001
RectRacer	2017-06-29	2	1	0	2	0.5942000000000001
Void Wisp	2017-07-05	1	1	0	1	0.5942000000000001
Puzzle Mania	2017-11-20	3	1	0	3	0.5942000000000001
4th of July VR	2017-07-26	1	1	0	1	0.5942000000000001
Mazeglaser	2017-09-15	1	1	0	1	0.5942000000000001
One Bit	2017-07-11	2	1	0	2	0.5942000000000001
The Voice in the Void	2017-08-01	1	1	0	1	0.5942000000000001
Z ViRus: V.I.R.M Uprising	2017-08-01	1	1	0	1	0.5942000000000001
Black Mist	2017-08-04	1	1	0	1	0.5942000000000001
Brain Crush	2017-08-18	1	1	0	1	0.5942000000000001
The Mirage : Illusion of wish	2017-11-15	2	1	0	2	0.5942000000000001
Slice&Dice	2017-08-04	1	1	0	1	0.5942000000000001
Trundle	2017-07-31	3	1	0	3	0.5942000000000001
Formula E Grand Prix	2017-08-22	2	1	0	2	0.5942000000000001
Asteroid Hunter	2017-10-02	2	1	0	2	0.5942000000000001
Lightwire	2017-08-24	4	1	0	4	0.5942000000000001
Lone Vessel	2017-11-08	2	1	0	2	0.5942000000000001
BoidWatch	2017-09-01	1	1	0	1	0.5942000000000001
80.08	2017-08-15	1	1	0	1	0.5942000000000001
The Museum of ThroughView	2017-08-17	2	1	0	2	0.5942000000000001
Little Earth	2017-08-23	2	1	0	2	0.5942000000000001
Building Block Heroes	2017-10-03	2	1	0	2	0.5942000000000001
Dead Reckoning: Brassfield Manor Collector's Edition	2017-09-13	3	1	0	3	0.5942000000000001
The Final Days: Eternal Night	2017-08-29	1	1	0	1	0.5942000000000001
Piatka	2017-09-16	3	1	0	3	0.5942000000000001
Empty Handed	2017-10-05	1	1	0	1	0.5942000000000001
Maze Trials	2017-10-09	1	1	0	1	0.5942000000000001
BadRobots VR	2017-09-18	1	1	0	1	0.5942000000000001
Enceladus	2017-11-01	2	1	0	2	0.5942000000000001
Color Sudoku	2017-09-26	2	1	0	2	0.5942000000000001
Space Ship Commander	2017-10-04	2	1	0	2	0.5942000000000001
Hikaru's Cube	2017-09-16	1	1	0	1	0.5942000000000001
n-body VR	2017-10-11	2	1	0	2	0.5942000000000001
Legend of Egypt - Pharaohs Garden	2017-10-06	5	1	0	5	0.5942000000000001
Critters - Cute Cubs in a Cruel World	2017-11-06	4	1	0	4	0.5942000000000001
Rockland VR	2017-12-14	1	1	0	1	0.5942000000000001
Romans From Mars 360	2017-12-22	1	1	0	1	0.5942000000000001
Pilli Adventure	2017-12-07	1	1	0	1	0.5942000000000001
Dark Canvas: Blood and Stone Collector's Edition	2017-10-02	3	1	0	3	0.5942000000000001
Twilight Phenomena: Strange Menagerie Collector's Edition	2017-10-13	2	1	0	2	0.5942000000000001
Robot's Mystery	2017-11-29	1	1	0	1	0.5942000000000001
Hope is in 23	2017-10-20	1	1	0	1	0.5942000000000001
Thug Life	2017-12-21	2	1	0	2	0.5942000000000001
RibbonChase	2017-11-15	1	1	0	1	0.5942000000000001
Trooper 1	2017-10-23	1	1	0	1	0.5942000000000001
Salvation in Corruption	2017-11-10	2	1	0	2	0.5942000000000001
Kink	2017-10-31	2	1	0	2	0.5942000000000001
Salt Thrust	2017-11-18	1	1	0	1	0.5942000000000001
Battle Trendaria	2017-11-09	2	1	0	2	0.5942000000000001
Square Massacre	2017-12-13	1	1	0	1	0.5942000000000001
Terra Tanks: Defenders of the Earth	2017-12-15	2	1	0	2	0.5942000000000001
Stacker	2017-12-04	2	1	0	2	0.5942000000000001
SUSHIDO VS ZOMBIES	2017-12-19	1	1	0	1	0.5942000000000001
You Are a Torpedo AI	2017-11-20	4	1	0	4	0.5942000000000001
WWII英雄列伝 最強の虎　クルト・クニスペル	2017-12-14	3	1	0	3	0.5942000000000001
Re-bot	2017-12-05	2	1	0	2	0.5942000000000001
PLAY337抓雞 CATCH CHICKEN	2017-12-15	1	1	0	1	0.5942000000000001
Power Supplied	2017-12-12	1	1	0	1	0.5942000000000001
One Against The Galaxy	2017-12-01	1	1	0	1	0.5942000000000001
CITY BALLS VR	2017-12-20	1	1	0	1	0.5942000000000001
Haunted Train: Frozen in Time Collector's Edition	2017-12-20	3	1	0	3	0.5942000000000001
The Most Challenging Game	2017-12-21	1	1	0	1	0.5942000000000001
Little Smart Planet	2017-12-26	2	1	0	2	0.5942000000000001
RC Plane 3	2017-08-08	24	140	87	111	0.594
Prevent The Fall	2017-07-31	10	57	34	44	0.594
VR Shooter Guns	2017-09-07	728	20	11	739	0.594
Steel Punk Ball	2017-07-25	4	20	11	15	0.594
Maze Bandit	2017-07-06	6	15	8	14	0.5937
Promethium	2017-08-18	5	15	8	13	0.5937
Askutron Quiz Show	2017-11-12	9	15	8	17	0.5937
Bernackels' Shoggoth	2017-12-08	9	15	8	17	0.5937
Project Cabin	2017-12-01	3	15	8	11	0.5937
Purrfect Date	2017-12-15	115	278	177	292	0.5934
Blocksworld	2017-09-26	188	451	291	479	0.5931000000000001
仙剑奇侠传五(Chinese Paladin：Sword and Fairy 5)	2017-09-12	323	655	426	749	0.593
Mastema: Out of Hell	2017-03-03	603	74	45	648	0.593
The Long Journey Home	2017-05-30	1390	1085	712	2102	0.5929
The Fan	2017-05-10	47	77	47	94	0.5927
The Wisbey Mystery	2017-01-18	27	58	35	62	0.5922
The King's Heroes	2017-09-22	477	23	13	490	0.5921000000000001
Mental Asylum VR	2017-01-14	4	23	13	17	0.5921000000000001
Onyx	2017-04-21	962	18	10	972	0.5910000000000001
Near Death Experience	2017-06-10	6	18	10	16	0.5910000000000001
Yatzy	2017-11-21	7	18	10	17	0.5910000000000001
Amber's Magic Shop	2017-06-08	29	26	15	44	0.5906
Devoid of Shadows	2017-07-13	15	119	75	90	0.5902000000000001
Faces of Illusion: The Twin Phantoms	2017-01-19	41	99	62	103	0.5901
Magic Box	2017-01-19	1193	48	29	1222	0.5901
Greenwood the Last Ritual	2017-01-19	1801	37	22	1823	0.5901
Preta: Vendetta Rising	2017-08-29	34	37	22	56	0.5901
NOBUNAGA'S AMBITION: Soutenroku with Power Up Kit	2017-12-06	40	37	22	62	0.5901
Winning Post 8 2017	2017-03-02	1034	13	7	1041	0.59
Never Forget Me	2017-01-10	4	13	7	11	0.59
Nice Slice	2017-02-21	5	13	7	12	0.59
BeefeaterXO	2017-02-14	7	13	7	14	0.59
Fuzecat	2017-05-23	4	13	7	11	0.59
Venture Forth	2017-06-20	147	8	4	151	0.5897
Werther Quest	2017-01-19	10	8	4	14	0.5897
Samurai Sword VR	2017-01-31	4	8	4	8	0.5897
Radiant Crusade	2017-04-06	2	8	4	6	0.5897
Maski VR	2017-05-22	5	8	4	9	0.5897
CyberClub-2077	2017-09-28	4	8	4	8	0.5897
Galact Quest	2017-05-10	3	8	4	7	0.5897
Freeze Climbing	2017-05-12	2	8	4	6	0.5897
ChainMan	2017-08-15	7	8	4	11	0.5897
Beta Runner	2017-07-25	2	8	4	6	0.5897
Mega Maze	2017-06-23	2	8	4	6	0.5897
Vikings - Wolves of Midgard	2017-03-24	4043	2511	1692	5735	0.5895
Blast Out	2017-09-21	51	29	17	68	0.5895
Better Off Tread	2017-09-12	44	54	33	77	0.5893
Cricket Captain 2017	2017-07-06	218	21	12	230	0.5892000000000001
Flame of Memory	2017-12-08	4608	21	12	4620	0.5892000000000001
Break Time!	2017-02-08	7	21	12	19	0.5892000000000001
BeeFense	2017-04-13	5	21	12	17	0.5892000000000001
Stack	2017-05-18	1741	21	12	1753	0.5892000000000001
Castle of Shikigami	2017-06-16	41	63	39	80	0.5885
Puzzle Dating	2017-09-14	4	35	21	25	0.588
Nightmare Boy	2017-10-25	12	24	14	26	0.5879
the Line	2017-12-07	3	24	14	17	0.5879
ZRoll	2017-04-17	2165	122	78	2243	0.5877
Battles of the Ancient World	2017-09-15	6	16	9	15	0.5875
Magical Mysteries: Path of the Sorceress	2017-08-18	22	16	9	31	0.5875
NakedMan VS The Clothes	2017-02-17	3	16	9	12	0.5875
Slice of Life	2017-11-30	3	16	9	12	0.5875
Mobile Zombie	2017-10-13	12	16	9	21	0.5875
Line of Sight	2017-01-31	4120	5401	3708	7828	0.5870000000000001
Clumsy Moose Season	2017-11-14	9	27	16	25	0.5870000000000001
Double Dragon IV	2017-01-31	330	435	289	619	0.5869
Don Bradman Cricket 17	2017-01-16	232	159	103	335	0.5869
The Flaws of Gravity	2017-05-06	32	141	91	123	0.5869
Twilight Town	2017-12-04	54	67	42	96	0.5868
Outbreak	2017-01-17	193	73	46	239	0.5866
Skyforge	2017-04-13	3499	2457	1679	5178	0.5864
Siegecraft Commander	2017-01-17	23	30	18	41	0.5863
Mighty Party	2017-03-30	577	1356	922	1499	0.5860000000000001
Nongünz	2017-05-19	287	250	165	452	0.5857
Luna Online: Reborn	2017-10-17	839	247	163	1002	0.5857
JET HERO	2017-02-16	43	33	20	63	0.5857
Gloria Sinica: Han Xiongnu Wars	2017-12-07	3580	2284	1565	5145	0.5856
Lionheart	2017-07-31	15	11	6	21	0.5855
Outrageous Grounds: The Maze	2017-01-27	5	11	6	11	0.5855
Welcome Home, Love	2017-03-17	3	11	6	9	0.5855
Dead Link: Pages Torn	2017-11-29	5	11	6	11	0.5855
Win That War!	2017-04-07	19	22	13	32	0.5849000000000001
Zombie Apocalypse	2017-02-15	11	45	28	39	0.5846
Quarantine	2017-05-24	93	247	164	257	0.5845
Space Hero Line	2017-08-24	4	57	36	40	0.5841
Other worlds India	2017-01-20	3131	66	42	3173	0.584
The Rodinia Project	2017-08-09	7	28	17	24	0.5836
Agents of Mayhem	2017-08-15	3687	2654	1840	5527	0.5834
Bambino Rally 3	2017-04-01	2	31	19	21	0.5833
One Of The Last	2017-12-20	6	31	19	25	0.5833
Voxelaxy	2017-09-18	8	31	19	27	0.5833
Dystopy	2017-03-01	5	14	8	13	0.5833
Ophidia	2017-05-25	2	14	8	10	0.5833
Lycah	2017-07-21	3	14	8	11	0.5833
Treasure At The Top	2017-09-16	11	14	8	19	0.5833
Grand Academy for Future Villains	2017-09-14	56	14	8	64	0.5833
The Ghosts of Hackney Mills	2017-11-20	3	14	8	11	0.5833
Ancient Treasure	2017-12-19	7	14	8	15	0.5833
Marinatide	2017-10-19	4	6	3	7	0.5833
Dark Dimensions: City of Fog Collector's Edition	2017-01-18	3	6	3	6	0.5833
Beyond The City VR	2017-02-10	2	6	3	5	0.5833
Witches' Legacy: Slumbering Darkness Collector's Edition	2017-02-08	4	6	3	7	0.5833
VectorWars	2017-05-02	14	6	3	17	0.5833
Safari Venture	2017-05-12	7	6	3	10	0.5833
India Garden	2017-06-02	5	6	3	8	0.5833
CodeRed: Agent Sarah's Story - Day One	2017-12-12	3	6	3	6	0.5833
"Libra of the Vampire Princess: Lycoris & Aoi in ""The Promise"" PLUS Iris in ""Homeworld"" "	2017-07-08	8	6	3	11	0.5833
The Agency of Anomalies: The Last Performance Collector's Edition	2017-06-12	3	6	3	6	0.5833
Nurbits	2017-07-17	3	6	3	6	0.5833
Xenoslaive Overdrive	2017-07-17	2	6	3	5	0.5833
Dodgeball	2017-08-04	7	6	3	10	0.5833
BlockDude	2017-08-08	2	6	3	5	0.5833
Zaba The Frog	2017-08-31	3	6	3	6	0.5833
Hexlide	2017-09-29	3	6	3	6	0.5833
Cobos	2017-10-17	4	6	3	7	0.5833
Unrested Development	2017-10-09	2	6	3	5	0.5833
Dream Channel	2017-11-27	13	6	3	16	0.5833
Frutakia 2	2017-11-29	2	6	3	5	0.5833
Krampus Quest	2017-12-20	4	6	3	7	0.5833
You Doesn't Exist	2017-09-26	19	40	25	44	0.5827
Drive Isle	2017-08-15	8	58	37	45	0.5826
Super Rude Bear Resurrection	2017-05-05	230	98	64	294	0.5822999999999999
Electronics Circuits Simulator	2017-07-06	12	17	10	22	0.5821000000000001
The Last Weekend	2017-03-03	62	219	147	209	0.5817
NIGHTSTAR: Rogue Wings	2017-03-30	5	20	12	17	0.5814
Quick Draw	2017-01-10	8	23	14	22	0.5809000000000001
Messiah	2017-01-16	5	23	14	19	0.5809000000000001
Amazing Human	2017-12-29	5	23	14	19	0.5809000000000001
Vive le Roi	2017-02-23	5	50	32	37	0.5807
The Cabin: VR Escape the Room	2017-01-05	82	50	32	114	0.5807
Super Blackjack Battle 2 Turbo Edition - The Card Warriors	2017-03-03	100	26	16	116	0.5807
Mr Blaster	2017-07-14	758	38	24	782	0.5805
Dungeons & Geese	2017-08-04	45	32	20	65	0.5805
MyTD	2017-12-02	21	32	20	41	0.5805
Dry Erase: Infinite VR Whiteboard	2017-07-19	5	29	18	23	0.5805
Trivia Night	2017-06-24	572	29	18	590	0.5805
Aces High III	2017-08-23	90	207	140	230	0.58
Tap Adventure: Time Travel	2017-03-03	2933	553	382	3315	0.5798
The Mors	2017-09-23	3	9	5	8	0.5796
Quote	2017-01-31	5	9	5	10	0.5796
Olav: the story of one boy	2017-04-30	3003	9	5	3008	0.5796
Dämmerlicht	2017-02-17	3	9	5	8	0.5796
Mall Mayhem	2017-10-06	2	9	5	7	0.5796
Million Arthur VR: Character Command RPG	2017-10-12	4	9	5	9	0.5796
Story of the Survivor : Prisoner	2017-09-20	2	9	5	7	0.5796
VR Table Sports	2017-08-19	4	9	5	9	0.5796
Gone Astray	2017-10-09	3	9	5	8	0.5796
Anime Bubble Pop	2017-12-02	2	9	5	7	0.5796
Choice of the Ninja	2017-11-17	8	9	5	13	0.5796
Wizrogue - Labyrinth of Wizardry	2017-02-24	135	98	65	200	0.5794
Antisphere	2017-07-14	1201	57	37	1238	0.5794
Offensive Combat: Redux!	2017-08-18	331	212	144	475	0.5792
斩毒：黑与白（Narcotics Police:Black and White）	2017-05-29	13	95	63	76	0.5792
Gachimuchi	2017-11-14	6	76	50	56	0.5792
Star Sweet	2017-12-11	8	54	35	43	0.5792
Precursors	2017-02-04	10	48	31	41	0.5788000000000001
Janus VR	2017-04-01	19	39	25	44	0.5782
The Bedtime Story	2017-02-27	3	12	7	10	0.5782
Kronos	2017-02-03	4	12	7	11	0.5782
An Oath to the Stars	2017-08-03	3	12	7	10	0.5782
I'm Awesome	2017-06-07	39	12	7	46	0.5782
Civil War: 1865	2017-04-07	5	12	7	12	0.5782
Rollercoaster Xperience	2017-08-23	4	12	7	11	0.5782
Bohnanza The Duel	2017-12-27	7	12	7	14	0.5782
Depopulation	2017-11-24	7	12	7	14	0.5782
MARS VR(全球使命VR)	2017-04-06	5	30	19	24	0.5777
Jade's Journey 2	2017-05-12	1243	21	13	1256	0.5773
Solitaire - Cat Pirate Portrait	2017-07-12	4	21	13	17	0.5773
Obscura	2017-07-27	5	18	11	16	0.5773
Lucky Night	2017-12-07	13	18	11	24	0.5773
Overcoming Pain	2017-12-26	6	18	11	17	0.5773
Strategy & Tactics: Dark Ages	2017-08-04	907	111	75	982	0.5767
Sylvio 2	2017-10-11	11	40	26	37	0.5761000000000001
GunFleet	2017-02-06	148	122	83	231	0.5760000000000001
Armor Clash II	2017-04-04	11	66	44	55	0.5758
Terra Mystica	2017-06-08	124	133	91	215	0.5754
Boy Next Door	2017-10-16	3	50	33	36	0.5754
Reboant	2017-11-22	6	34	22	28	0.5754
Neverout	2017-05-18	335	83	56	391	0.5752
Super POTUS Trump	2017-08-09	49	261	182	231	0.5749000000000001
Neo ATLAS 1469	2017-02-14	151	28	18	169	0.5746
Kama Bullet Heritage	2017-08-11	4	54	36	40	0.5743
Climbtime	2017-05-04	8	25	16	24	0.5740999999999999
John, The Zombie	2017-11-22	10	132	91	101	0.5739
Eekeemoo - Splinters of the Dark Shard	2017-03-14	4	4	2	6	0.5739
Stonehenge VR SANDBOX	2017-10-12	6	4	2	8	0.5739
B.C.E.	2017-09-12	9	4	2	11	0.5739
Glorch's Great Escape: Walking is for Chumps	2017-04-03	233	4	2	235	0.5739
Shadows	2017-08-24	2	4	2	4	0.5739
Space Station Loma: OPERATIONS	2017-03-17	2	4	2	4	0.5739
Princess Kidnapper 2 - VR	2017-03-20	2	4	2	4	0.5739
Zarya and the Cursed Skull	2017-03-09	1	4	2	3	0.5739
American VR Coasters	2017-07-08	5	4	2	7	0.5739
Ashes of Kanaka	2017-04-26	4	4	2	6	0.5739
Weather Lord: In Search of the Shaman	2017-06-08	99	4	2	101	0.5739
Rite of Passage: Child of the Forest Collector's Edition	2017-06-05	4	4	2	6	0.5739
Micro Cosmic Worlds	2017-07-20	2	4	2	4	0.5739
Orbit Defender	2017-10-04	4	4	2	6	0.5739
Staff Wars: Wizard Rumble	2017-08-04	5	4	2	7	0.5739
ExZeus 2	2017-08-16	3	4	2	5	0.5739
Mysterious Adventure of Michael	2017-07-21	1	4	2	3	0.5739
Crime Solitaire 2: The Smoking Gun	2017-07-26	3	4	2	5	0.5739
EXON: The Impossible Challenge	2017-08-14	2	4	2	4	0.5739
Rules of Destruction	2017-08-25	2	4	2	4	0.5739
Bomsy	2017-11-02	7	4	2	9	0.5739
Love Chronicles: The Sword and the Rose Collector's Edition	2017-09-01	3	4	2	5	0.5739
Protagon	2017-08-25	1	4	2	3	0.5739
Mecho Tales	2017-09-30	3	4	2	5	0.5739
The Ultimate Trivia Challenge	2017-10-27	4	4	2	6	0.5739
Kawanakajima no Kassen	2017-12-06	3	4	2	5	0.5739
Hallowed Encounter	2017-11-02	1	4	2	3	0.5739
The Succubi Trap	2017-10-26	2	4	2	4	0.5739
YOUFIGHT	2017-11-02	98	4	2	100	0.5739
Deep Space: Unknown Universe	2017-12-01	2	4	2	4	0.5739
DEBUFF	2017-12-14	3	4	2	5	0.5739
Pro Strategy Football 2018	2017-12-15	8	4	2	10	0.5739
Gods and Nemesis: of Ghosts from Dragons	2017-04-02	4	22	14	18	0.5736
SteamHammerVR	2017-07-31	10	22	14	24	0.5736
FallenCore	2017-11-10	11	22	14	25	0.5736
Hyper Knights: Battles	2017-12-04	12	48	32	44	0.5734
Crimson Memories	2017-10-03	233	58	39	272	0.5733
Illville: Return instructions	2017-11-09	4	19	12	16	0.5731
rooMaze	2017-03-03	1611	106	73	1684	0.5729
Dragon's Prophet Turkiye	2017-11-22	391	82	56	447	0.5729
Zombie Waiting	2017-11-11	2	16	10	12	0.5726
The Under	2017-11-25	7	16	10	17	0.5726
Battleship Lonewolf	2017-11-23	10	16	10	20	0.5726
Civil War: Bull Run 1861	2017-07-21	4	13	8	12	0.5721
Resurgence	2017-09-12	3171	13	8	3179	0.5721
City of Rott: Streets of Rott	2017-02-14	19	13	8	27	0.5721
Gold Rush! 2	2017-04-28	1741	13	8	1749	0.5721
Arkaia: The Enigmatic Isle	2017-09-29	4	13	8	12	0.5721
Mr Rabbit's Alphabet Forest Adventure	2017-07-17	10	13	8	18	0.5721
The Automatician	2017-07-24	6	13	8	14	0.5721
Deadly Traps	2017-08-29	2	13	8	10	0.5721
Office Space: Idle Profits	2017-10-18	660	199	140	800	0.5720000000000001
Vostok Inc.	2017-07-26	162	59	40	202	0.5720000000000001
Reflecting Fate	2017-07-10	10	29	19	29	0.5719
STONEBOND: The Gargoyle's Domain	2017-01-28	3	7	4	7	0.5718
Trainscape	2017-06-28	3	7	4	7	0.5718
Bitcoin VR	2017-03-31	4	7	4	8	0.5718
Cult: Fear Inside	2017-09-29	3	7	4	7	0.5718
ALaLa: Wake Mi Up!	2017-05-16	3	7	4	7	0.5718
WILOO	2017-08-03	2	7	4	6	0.5718
VR Escape The Puzzle Room	2017-09-20	3	7	4	7	0.5718
Food Mahjong	2017-09-17	5	7	4	9	0.5718
Jigsaw Puzzles	2017-09-17	3	7	4	7	0.5718
El Ministerio del Tiempo VR: Salva el tiempo	2017-10-09	5	7	4	9	0.5718
Choice of Broadsides	2017-10-19	5	7	4	9	0.5718
Cat Girl	2017-08-28	232	279	198	430	0.5717
The Hunt	2017-06-06	5	10	6	11	0.5717
Space Jammers	2017-03-08	4	10	6	10	0.5717
Ski Jump VR	2017-06-08	5	10	6	11	0.5717
Deltaplan Simulator	2017-08-03	5	10	6	11	0.5717
Castaway Home Designer	2017-07-15	8	10	6	14	0.5717
Cove Point Fun Center VR	2017-11-20	3	10	6	9	0.5717
Casual Spider Solitaire	2017-10-04	10	10	6	16	0.5717
Maggie's Movies - Camera, Action!	2017-09-14	16	26	17	33	0.5712
Circularity	2017-10-03	6	26	17	23	0.5712
Project Mercury	2017-09-20	433	289	206	639	0.5709000000000001
Gevaudan	2017-06-08	7	81	56	63	0.5705
PUBG: BATTLEGROUNDS	2017-12-21	3257248	1235880	927317	4184565	0.5704
Cleo's Lost Idols	2017-11-16	21	23	15	36	0.5703
Brass	2017-10-11	11	23	15	26	0.5703
Magic matchstick	2017-10-10	10	23	15	25	0.5703
Pony World 2	2017-04-07	4	33	22	26	0.5702
Dimension Jump	2017-03-15	62	33	22	84	0.5702
The Inevitability	2017-04-17	1350	57	39	1389	0.5700999999999999
Devade	2017-03-29	509	40	27	536	0.5698
Behind The Door	2017-08-16	6	54	37	43	0.5695
The Agony	2017-06-14	2796	166	118	2914	0.5690999999999999
Rise of One	2017-09-07	19	51	35	54	0.5688000000000001
The Charming Empire	2017-04-19	37	44	30	67	0.5688000000000001
The Culling	2017-10-05	12995	10177	7611	20606	0.5683
The Journey: Bob's Story.	2017-09-08	980	17	11	991	0.5683
Tomorrow	2017-02-08	8	17	11	19	0.5683
Boiling Bolt	2017-12-05	127	17	11	138	0.5683
Hearts of Chaos	2017-01-06	587	17	11	598	0.5683
Lost Shipwreck	2017-09-29	6	17	11	17	0.5683
ZhanDou	2017-10-27	13	17	11	24	0.5683
Autobahn Police Simulator 2	2017-12-07	209	672	492	701	0.5681
Expelled	2017-11-01	14	48	33	47	0.568
Disco Time 80s VR	2017-06-07	6	41	28	34	0.568
Inmates	2017-10-05	20	162	116	136	0.5675
From Shadows	2017-08-10	814	24	16	830	0.5673
Guppy	2017-11-21	4	24	16	20	0.5673
Survival Zombies The Inverted Evolution	2017-05-08	204	571	419	623	0.5671
Fallen Times	2017-10-09	5	63	44	49	0.5671
Shiness: The Lightning Kingdom	2017-04-18	190	270	196	386	0.5669
Shoot Mania VR: Fun Zombies	2017-02-17	11	14	9	20	0.5669
A-Escape VR	2017-03-31	5	14	9	14	0.5669
Lemuria: Lost in Space	2017-03-17	49	14	9	58	0.5669
Biotoxin: The Dark Days	2017-03-02	203	14	9	212	0.5669
Nightingale Downs	2017-10-23	3	14	9	12	0.5669
The adventure of Kroos	2017-12-07	6	14	9	15	0.5669
Trivia Vault: 1980's Trivia	2017-08-16	4	60	42	46	0.5664
Princess Maker 3: Fairy Tales Come True	2017-06-27	79	169	122	201	0.5661
3D Hardcore Cube 2	2017-12-18	3	35	24	27	0.5660000000000001
The God Paradox	2017-09-19	11	21	14	25	0.5660000000000001
SEGFAULT	2017-11-18	24	21	14	38	0.5660000000000001
Soul Saber 2	2017-03-16	41	139	100	141	0.5659000000000001
Hurricane	2017-03-06	1722	94	67	1789	0.5657
Hunter's Grimm	2017-03-03	3605	174	126	3731	0.5656
A SECOND BEFORE US	2017-05-11	2473	57	40	2513	0.5656
Girls and Dungeons	2017-09-08	12	39	27	39	0.5653
Startide	2017-09-08	4	11	7	11	0.5653
Paddle Battle	2017-10-25	2	11	7	9	0.5653
DUELEUM	2017-09-15	15	11	7	22	0.5653
Modest Kind	2017-12-21	3	11	7	10	0.5653
Lumberjack VR	2017-10-13	56	11	7	63	0.5653
Vitamin Girl	2017-10-11	2	11	7	9	0.5653
Train Station Simulator	2017-12-14	49	148	107	156	0.5652
Sonny	2017-04-18	120	226	165	285	0.5651
Knightfall™: Rivals	2017-07-20	40	58	41	81	0.5644
Ultimus bellum	2017-11-08	1500	18	12	1512	0.5644
RoboMatch	2017-03-31	990	36	25	1015	0.5640999999999999
Wrath of Loki VR Adventure	2017-11-16	10	36	25	35	0.5640999999999999
Lost in the tomb	2017-11-10	3	29	20	23	0.5636
Hitbox	2017-01-30	56	78	56	112	0.5633
Champions of Odin	2017-08-25	3	8	5	8	0.5632
Lotia®	2017-06-03	20	8	5	25	0.5632
The Fleet	2017-06-16	8	8	5	13	0.5632
Renegade Grounds: Episode 1	2017-09-01	69	8	5	74	0.5632
AddForce	2017-09-22	3	8	5	8	0.5632
Parking Cop Simulator	2017-12-15	3	8	5	8	0.5632
Lantern of Worlds	2017-10-05	3	8	5	8	0.5632
Brink of Extinction	2017-11-30	5	8	5	10	0.5632
Mystery Case Files: The Revenant's Hunt Collector's Edition	2017-11-21	6	8	5	11	0.5632
The Resistance	2017-12-08	2	8	5	7	0.5632
EVE: Valkyrie - Warzone	2017-09-26	156	233	172	328	0.563
Waking the Glares	2017-03-17	12	22	15	27	0.5629
Prisoner	2017-07-17	20	22	15	35	0.5629
Creeping Terror	2017-10-31	4	22	15	19	0.5629
Unhappy Ever After	2017-01-20	147	15	10	157	0.5625
Dragon Essence - Color My World -	2017-06-08	6	15	10	16	0.5625
RGBverse	2017-04-07	5	15	10	15	0.5625
SoulFrost	2017-08-01	2	15	10	12	0.5625
Haunted Dungeons: Hyakki Castle	2017-11-15	34	15	10	44	0.5625
YAGZZ!	2017-09-25	2	15	10	12	0.5625
La Tale - Evolved	2017-11-30	149	260	193	342	0.5622
Evil Possession	2017-05-17	8	60	43	51	0.5621
Deadhold	2017-08-25	18	26	18	36	0.562
Yandere School	2017-09-01	17	210	156	173	0.5613
Ominous Tales: The Forsaken Isle	2017-06-19	9	19	13	22	0.561
Dinosaur Forest	2017-05-17	687	388	292	979	0.5607
Genghis Khan	2017-01-24	13	5	3	16	0.5605
NOBUNAGA'S AMBITION: Zenkokuban	2017-01-24	17	5	3	20	0.5605
Vienna Automobile Society	2017-09-15	5	5	3	8	0.5605
Wanderer: The Rebirth	2017-01-12	3	5	3	6	0.5605
Atramentum VR	2017-03-17	2	5	3	5	0.5605
Mystery Tales: The Lost Hope Collector's Edition	2017-02-22	5	5	3	8	0.5605
Drift 7 Islands	2017-03-07	2	5	3	5	0.5605
Planet Defender	2017-03-30	4	5	3	7	0.5605
Violent killer VR	2017-03-17	4	5	3	7	0.5605
Outer Rim	2017-03-31	2	5	3	5	0.5605
Dark	2017-07-28	7	5	3	10	0.5605
Conran - The dinky Raccoon	2017-04-13	7	5	3	10	0.5605
Cryptocracy	2017-04-11	4	5	3	7	0.5605
Shadows in the Darkness	2017-10-19	5	5	3	8	0.5605
Sorgina: A Tale of Witches	2017-05-30	25	5	3	28	0.5605
Weather Lord	2017-06-08	99	5	3	102	0.5605
OfficeBotsVR	2017-08-21	2	5	3	5	0.5605
Fight Sparring VR	2017-07-24	2	5	3	5	0.5605
Underdone	2017-09-13	2	5	3	5	0.5605
Outracer	2017-08-15	2	5	3	5	0.5605
SuperWurfels	2017-09-09	2	5	3	5	0.5605
Ruby Hunter	2017-10-20	4	5	3	7	0.5605
2D Mahjong Temple	2017-08-17	3	5	3	6	0.5605
Star Waker	2017-08-25	6	5	3	9	0.5605
Celtabula	2017-09-17	2	5	3	5	0.5605
Interworlds	2017-10-24	2	5	3	5	0.5605
Corridor 15 First	2017-11-29	3	5	3	6	0.5605
Time Killers: CatchOut	2017-10-31	2	5	3	5	0.5605
CG the Seven Virus Knights	2017-12-05	2	5	3	5	0.5605
THE BOX VR	2017-12-07	4	5	3	7	0.5605
Stage Presence	2017-02-28	97	23	16	113	0.5602
Defend Your Castle	2017-10-18	9	23	16	25	0.5602
Titanic: The Experience	2017-10-30	9	160	119	128	0.56
The Albatross	2017-02-16	2768	66	48	2816	0.56
Battle of Frigates	2017-09-21	51	62	45	96	0.56
Behind You	2017-02-21	2	12	8	10	0.56
Crimson Sword Saga: The Peloran Wars	2017-01-06	855	12	8	863	0.56
Tank Battle: 1945	2017-02-16	5	12	8	13	0.56
A Country Of One	2017-05-31	5	12	8	13	0.56
Virtually Impossible	2017-04-13	10	12	8	18	0.56
Autumn Night 3D Shooter	2017-05-09	4	27	19	23	0.5597
No70: Eye of Basir	2017-06-28	41	199	149	190	0.5595
Torn Tales	2017-01-17	2256	31	22	2278	0.5594
Club Manager 2017	2017-03-24	93	31	22	115	0.5594
Reaping Rewards	2017-06-09	9	35	25	34	0.5592
Joumee The Hedgehog	2017-11-23	5	35	25	30	0.5592
Bubsy: The Woolies Strike Back	2017-10-31	34	104	77	111	0.559
The Astral Hero	2017-05-06	2731	63	46	2777	0.559
The SoulKeeper VR	2017-08-16	27	47	34	61	0.559
MetaMorph	2017-12-13	968	51	37	1005	0.5589000000000001
Games of Glory	2017-04-25	180	322	244	424	0.5587
Ninja Shodown	2017-09-26	4	16	11	15	0.5586
The DRG Initiative	2017-12-14	24	16	11	35	0.5586
The Crowded Party Game Collection	2017-05-30	6	16	11	17	0.5586
Super Trashforce	2017-11-22	3	16	11	14	0.5586
Detached	2017-05-18	32	198	149	181	0.5585
Think of the Children	2017-10-19	42	122	91	133	0.5583
Timen runner	2017-05-26	1411	64	47	1458	0.5581
Bang Bang Car	2017-04-19	8	20	14	22	0.5579999999999999
The Sniper VR	2017-08-25	8	20	14	22	0.5579999999999999
Banana Town	2017-10-07	8	20	14	22	0.5579999999999999
Steampunk Syndicate	2017-04-14	960	44	32	992	0.5576
Pink Rage Otome	2017-07-28	5	32	23	28	0.5575
FL337	2017-06-21	2	2	1	3	0.5569
Immerse Creator	2017-04-18	3	2	1	4	0.5569
Second Coming	2017-02-10	2	2	1	3	0.5569
Drone: Remote Tactical Warfare	2017-07-20	3	2	1	4	0.5569
Crimson Nights	2017-01-02	2	2	1	3	0.5569
Tricky Trail RC	2017-03-16	2	2	1	3	0.5569
VR Squash 2017	2017-11-20	2	2	1	3	0.5569
Spud Cricket VR	2017-11-02	2	2	1	3	0.5569
LASER STRIKERS	2017-04-17	4	2	1	5	0.5569
VR Batting	2017-03-20	4	2	1	5	0.5569
Duel VR	2017-04-30	6	2	1	7	0.5569
Haunted Manor: Lord of Mirrors Collector's Edition	2017-04-03	4	2	1	5	0.5569
PowerFist VR	2017-07-13	2	2	1	3	0.5569
Weather Lord: Hidden Realm	2017-06-08	51	2	1	52	0.5569
Dialogue: A Writer's Story	2017-09-20	2	2	1	3	0.5569
Aftermath Y2K	2017-07-10	2	2	1	3	0.5569
Roll Out	2017-07-31	4	2	1	5	0.5569
Expanse	2017-08-25	3	2	1	4	0.5569
Breadwinner VR	2017-10-24	2	2	1	3	0.5569
Hover Bots VR	2017-07-14	2	2	1	3	0.5569
Toys Gun Fire Boom	2017-09-03	2	2	1	3	0.5569
Letter-Setter	2017-08-17	1	2	1	2	0.5569
Fall Fear Fly Redemption	2017-10-16	2	2	1	3	0.5569
Slimebrawl	2017-11-20	3	2	1	4	0.5569
Two Escapes	2017-08-30	2	2	1	3	0.5569
The Flying Turtle Jewel Quest	2017-08-25	3	2	1	4	0.5569
FARIA: Starfall	2017-09-15	4	2	1	5	0.5569
JumpFist	2017-09-19	2	2	1	3	0.5569
Pray for Death	2017-10-20	1	2	1	2	0.5569
Chop Chop Princess!	2017-11-08	2	2	1	3	0.5569
Space Quiz	2017-10-27	2	2	1	3	0.5569
Big Bang Billiards	2017-12-23	4	2	1	5	0.5569
Houston, We Have Spinach!	2017-11-24	3	2	1	4	0.5569
SpaceCoaster VR	2017-11-15	3	2	1	4	0.5569
Paddle Master VR	2017-11-19	2	2	1	3	0.5569
Mystery Stone from Heaven	2017-11-17	2	2	1	3	0.5569
Fire Flight	2017-12-15	3	2	1	4	0.5569
City Builder	2017-12-19	2	2	1	3	0.5569
MiniBotz	2017-01-25	34	9	6	40	0.5566
HVRGUN	2017-01-19	4	9	6	10	0.5566
A Lost Room	2017-04-05	5	9	6	11	0.5566
NOBUNAGA'S AMBITION: Haouden with Power Up Kit	2017-06-27	22	9	6	28	0.5566
Meta Star	2017-08-23	4	9	6	10	0.5566
Bad Thoughts	2017-09-16	5	9	6	11	0.5566
Blue Snake Adventures	2017-10-20	3	9	6	9	0.5566
HEXOPODS	2017-11-17	3	9	6	9	0.5566
DoubleTap	2017-12-18	4	9	6	10	0.5566
Virus Z	2017-07-24	16	37	27	43	0.5559000000000001
Forestation	2017-12-14	5	37	27	32	0.5559000000000001
X Rebirth VR Edition	2017-12-07	91	145	110	201	0.5557
Hero Barrier	2017-03-01	2481	33	24	2505	0.5557
The New Queen	2017-01-13	1015	13	9	1024	0.5555
Treehouse Basketball	2017-02-15	7	13	9	16	0.5555
Forestry	2017-04-07	6	13	9	15	0.5555
Ninja Avenger Dragon Blade	2017-03-17	43	13	9	52	0.5555
Murder...	2017-08-04	4	13	9	13	0.5555
Destroyer: Invasion	2017-07-14	9	13	9	18	0.5555
Starship Clicker	2017-11-30	5	13	9	14	0.5555
Dead Rising 4	2017-03-14	2178	3594	2828	5006	0.5554
Market Tycoon	2017-05-11	31	186	142	173	0.5554
Akin Vol 2	2017-07-28	4	25	18	22	0.5553
Containment Corps	2017-09-21	14	25	18	32	0.5553
Don't Panic!	2017-10-06	4	25	18	22	0.5553
Eternal Return	2017-02-24	16	21	15	31	0.5552
The Ruins: VR Escape the Room	2017-04-13	30	21	15	45	0.5552
Avem33	2017-08-04	65	21	15	80	0.5552
Nakiti Generations	2017-12-15	5	17	12	17	0.5552
Zorbit's Orbits	2017-11-10	67	17	12	79	0.5552
VR SUPER SPORTS	2017-03-14	27	63	47	74	0.5551
EGOS - Tales of Fallen Souls	2017-07-28	14034	42	31	14065	0.5547
Snake: Road to apple	2017-11-24	16	55	41	57	0.5545
Strangers in a Strange Land	2017-07-27	25	51	38	63	0.5542
Pyro VR	2017-02-09	8	34	25	33	0.554
Catch a Lover	2017-07-24	156	223	172	328	0.5539000000000001
Tokyo Twilight Ghost Hunters Daybreak: Special Gigs	2017-03-17	18	47	35	53	0.5538000000000001
Blitzkrieg 3	2017-06-02	1149	3918	3107	4256	0.5537
Bitcoin Collector	2017-09-13	6	87	66	72	0.5536
Kitten Rampage	2017-09-06	16	52	39	55	0.5531
The Adventurer - Episode 1: Beginning of the End	2017-07-29	2191	162	125	2316	0.5527000000000001
Fated Souls 3	2017-03-10	679	22	16	695	0.5527000000000001
My Little Worms	2017-09-22	10	22	16	26	0.5527000000000001
StellarHub	2017-08-17	3412	98	75	3487	0.5524
Azkend 2: The World Beneath	2017-01-03	19	18	13	32	0.5522
Adventures of Abrix	2017-03-17	235	18	13	248	0.5522
Space Way	2017-10-13	98	18	13	111	0.5522
Freaky Awesome	2017-10-18	72	131	101	173	0.5521
Say Goodbye	2017-01-03	41	108	83	124	0.552
Bulby - Diamond Course	2017-01-19	1316	31	23	1339	0.5519
Ashworld	2017-09-19	7	14	10	17	0.5517000000000001
Star Rangers VR - Free Demo	2017-09-15	12	14	10	22	0.5517000000000001
Solitaire	2017-11-21	11	14	10	21	0.5517000000000001
Savage Offroad	2017-12-07	4	14	10	14	0.5517000000000001
Keep Balance VR	2017-02-18	6	6	4	10	0.5514
Solaright	2017-04-13	2	6	4	6	0.5514
Scrollonoid	2017-06-15	3	6	4	7	0.5514
The Cleansing	2017-09-28	7	6	4	11	0.5514
Exocomets	2017-07-13	4	6	4	8	0.5514
Law Mower	2017-08-10	4	6	4	8	0.5514
Wordabeasts	2017-12-20	6	6	4	10	0.5514
Trials of the Thief-Taker	2017-08-10	36	6	4	40	0.5514
Infection Rate	2017-09-08	4	6	4	8	0.5514
Moving Day	2017-11-22	2	6	4	6	0.5514
SpaceRoads	2017-11-07	2255	10	7	2262	0.5513
Housekeeping VR	2017-02-21	5	10	7	12	0.5513
Quantic Pinball	2017-03-29	43	10	7	50	0.5513
Eraser & Builder	2017-02-25	198	10	7	205	0.5513
Trajectory	2017-03-10	4	10	7	11	0.5513
Handball Manager - TEAM	2017-05-05	5	10	7	12	0.5513
Genghis Khan II: Clan of the Gray Wolf	2017-06-27	16	10	7	23	0.5513
Micro Miners	2017-10-28	4	10	7	11	0.5513
Drummer Talent VR	2017-05-06	5	27	20	25	0.5512
Hero Rush: Mad King	2017-10-04	13	27	20	33	0.5512
DOOM VFR	2017-11-30	512	1471	1173	1685	0.5511
Crafting Dead	2017-08-18	67	82	63	130	0.5509000000000001
Lionessy Story	2017-06-03	419	41	31	450	0.5504
Displaced	2017-07-26	170	102	79	249	0.5503
月之暗面 The Dark Side Of The Moon	2017-08-22	20	32	24	44	0.5503
Arcfall	2017-05-17	136	190	149	285	0.55
3D Hardcore Cube	2017-08-23	6	93	72	78	0.55
Autocraft	2017-09-20	62	167	131	193	0.5495
Radline: Quarantine	2017-05-29	26	70	54	80	0.5494
Trio	2017-06-08	12	56	43	55	0.5492
Dumbass Drivers!	2017-05-04	684	42	32	716	0.5491
Trivia Vault: Super Heroes Trivia 2	2017-09-12	4	42	32	36	0.5491
Znkl - 177	2017-11-24	6	42	32	38	0.5491
Galactic Lords	2017-11-13	6	33	25	31	0.5488000000000001
Archangel™: Hellfire	2017-08-02	42	201	159	201	0.5484
Lockdown: Stand Alone	2017-12-21	7	24	18	25	0.5484
SpaceDweller	2017-09-20	121	15	11	132	0.5484
Metal Soldiers 2	2017-12-13	8	15	11	19	0.5484
Infinitum	2017-01-04	2728	67	52	2780	0.5481
L.A. Noire: The VR Case Files	2017-12-15	115	488	391	506	0.5479999999999999
Totally Mayhem	2017-08-03	8	29	22	30	0.5477000000000001
Trivia Vault: Classic Rock Trivia	2017-08-17	3	53	41	44	0.5476
Reading Simulator	2017-12-29	7	53	41	48	0.5476
The Archotek Project	2017-04-28	1581	452	363	1944	0.5473
Tank Assault X	2017-04-05	1631	20	15	1646	0.5471
Died Of Fear	2017-07-07	5	20	15	20	0.5471
Geology Business	2017-02-24	48	44	34	82	0.5468999999999999
Grim Seventh	2017-01-20	207	11	8	215	0.5468999999999999
I Want Toilet!!!!!!	2017-08-11	3	11	8	11	0.5468999999999999
Matryoshka Strike	2017-09-12	5	11	8	13	0.5468999999999999
Old Adventure	2017-12-12	2	11	8	10	0.5468999999999999
Take On Mars	2017-02-09	435	1071	869	1304	0.5467000000000001
Raiden V: Director's Cut	2017-10-10	52	250	200	252	0.5467000000000001
Jellyfish	2017-09-15	3	30	23	26	0.5462
Urlaubsflug Simulator – Holiday Flight Simulator	2017-04-13	42	75	59	101	0.5461
ZiL Truck RallyCross	2017-04-07	5	45	35	40	0.5459
Deep Sorrow	2017-11-12	4	40	31	35	0.5459
Catan Universe	2017-04-25	7376	6053	4980	12356	0.5457
Pixelord	2017-11-01	2	16	12	14	0.5455
The guard of dungeon	2017-03-07	1751	87	69	1820	0.5451
Pararea Beta	2017-09-16	17	21	16	33	0.545
Mall Empire	2017-02-16	11	51	40	51	0.5449
Galactic Missile Defense	2017-06-08	507	26	20	527	0.5448
Gemstone Keeper	2017-03-31	47	7	5	52	0.5448
Empire of the Fallen Steel	2017-12-18	2	7	5	7	0.5448
Amazon Odyssey	2017-10-26	4	7	5	9	0.5448
Meganoid	2017-03-29	5	7	5	10	0.5448
Harvest Simulator VR	2017-11-25	4	7	5	9	0.5448
Castles	2017-07-14	4	7	5	9	0.5448
Funtoon's World	2017-08-04	2	7	5	7	0.5448
Mustdashe	2017-09-08	2	7	5	7	0.5448
SoTo	2017-12-19	2	7	5	7	0.5448
Domino Dungeon	2017-10-04	2	7	5	7	0.5448
The beauties&zombies of beach for VR	2017-10-20	4	7	5	9	0.5448
Jida Chronicle Chaos frontier	2017-12-28	3	7	5	8	0.5448
Cars with Guns: It's About Time	2017-12-18	5	7	5	10	0.5448
Legend of Ares	2017-06-01	55	31	24	79	0.5447
Fall of Light: Darkest Edition	2017-09-28	32	167	135	167	0.5435
War Trigger 2	2017-11-22	278	492	403	681	0.5433
Demon Lord	2017-03-21	11	12	9	20	0.5433
Roomscale Coaster	2017-03-01	633	12	9	642	0.5433
VisionOriginVR	2017-05-19	8	12	9	17	0.5433
2 Planets Fire and Ice	2017-08-07	5	12	9	14	0.5433
Maze Run VR	2017-09-02	3	12	9	12	0.5433
Vector Velocity	2017-11-23	2	12	9	11	0.5433
Romance of the Three Kingdoms IV with Power Up Kit 	2017-03-21	24	17	13	37	0.543
The Last Cargo	2017-03-04	5	17	13	18	0.543
My Own Little Planet	2017-04-14	5000	17	13	5013	0.543
Dark Passenger	2017-04-26	857	17	13	870	0.543
Boom Island	2017-10-16	3	17	13	16	0.543
Christmas Race	2017-12-01	9	38	30	39	0.5424
Kitten Squad	2017-01-05	35	93	75	110	0.5421
Shout Of Survival	2017-11-30	5	3	2	7	0.5417000000000001
Medieval Story	2017-08-04	6	3	2	8	0.5417000000000001
Hawks Tactical	2017-01-02	3	3	2	5	0.5417000000000001
MonkeyKing VR	2017-02-07	2	3	2	4	0.5417000000000001
The Artist	2017-02-16	7	3	2	9	0.5417000000000001
Tales of Terror: Crimson Dawn	2017-03-01	2	3	2	4	0.5417000000000001
TROID BLASTER	2017-02-24	2	3	2	4	0.5417000000000001
TRANCE VR	2017-05-26	2	3	2	4	0.5417000000000001
Bottle Flip Challenge VR	2017-04-09	4	3	2	6	0.5417000000000001
RUN	2017-05-20	2	3	2	4	0.5417000000000001
Double Clue: Solitaire Stories	2017-05-03	2	3	2	4	0.5417000000000001
Bionic Attack	2017-05-20	2	3	2	4	0.5417000000000001
Zombie Kill	2017-05-15	6	3	2	8	0.5417000000000001
The Glade	2017-05-29	2	3	2	4	0.5417000000000001
Myths of the World: Stolen Spring Collector's Edition	2017-05-31	3	3	2	5	0.5417000000000001
Psychic Isolation	2017-08-15	4	3	2	6	0.5417000000000001
Little Miss Lonely	2017-06-12	2	3	2	4	0.5417000000000001
Curse of the Great Forest	2017-06-24	2	3	2	4	0.5417000000000001
Bump+Smack	2017-08-09	2	3	2	4	0.5417000000000001
Lil' Blue Buddy	2017-06-27	1	3	2	3	0.5417000000000001
Dirty Fighter 2	2017-07-07	3	3	2	5	0.5417000000000001
Prime Shift	2017-08-04	3	3	2	5	0.5417000000000001
Fungoids - Steam version	2017-08-02	1	3	2	3	0.5417000000000001
Creepy Races	2017-07-31	3	3	2	5	0.5417000000000001
Infested Nation	2017-07-28	2	3	2	4	0.5417000000000001
Gulu	2017-07-29	4	3	2	6	0.5417000000000001
Watch Out	2017-09-01	2	3	2	4	0.5417000000000001
Robin of Loxley the Legend of Sherwood	2017-10-28	1	3	2	3	0.5417000000000001
Dark Dimensions: Wax Beauty Collector's Edition	2017-08-24	3	3	2	5	0.5417000000000001
Mafia is Alive	2017-10-05	8	3	2	10	0.5417000000000001
Onager!	2017-09-22	2	3	2	4	0.5417000000000001
Lava Rolling Kid	2017-11-11	3	3	2	5	0.5417000000000001
Mula: The Cycle of Shadow	2017-12-16	3	3	2	5	0.5417000000000001
大乱斗 Chaos Battle	2017-10-13	4	3	2	6	0.5417000000000001
Frontiers.io	2017-10-12	2	3	2	4	0.5417000000000001
PeoplePackages	2017-11-07	2	3	2	4	0.5417000000000001
Eseapner	2017-11-22	2	3	2	4	0.5417000000000001
Tronix Defender	2017-11-13	3	3	2	5	0.5417000000000001
Danger Close!	2017-12-01	1	3	2	3	0.5417000000000001
Choice of the Rock Star	2017-11-17	5	3	2	7	0.5417000000000001
Free Yourself - The Gravity Puzzle Game Starring YOU	2017-12-29	1	3	2	3	0.5417000000000001
England Exchange	2017-05-05	66	62	50	116	0.5407000000000001
C:\raft	2017-10-02	6	18	14	20	0.5407000000000001
Army General	2017-04-26	20	29	23	43	0.5402
Romance of the Three Kingdoms VI with Power Up Kit	2017-06-27	19	13	10	29	0.5402
Thomaz	2017-07-10	11	13	10	21	0.5402
Cute Monsters Battle Arena	2017-08-26	5	13	10	15	0.5402
Last Toon Standing	2017-10-21	7	13	10	17	0.5402
Desolate Wastes: Vendor Chronicles	2017-07-21	3134	92	75	3209	0.54
ReVeN: XBridge	2017-05-23	5	8	6	11	0.5398
Escape the Bunker	2017-01-02	5	8	6	11	0.5398
Murder In Tehran's Alleys 2016	2017-06-08	3	8	6	9	0.5398
LIBERTY VR	2017-07-03	4	8	6	10	0.5398
Dark Mystery	2017-08-14	3	8	6	9	0.5398
HORDE ATTACK	2017-09-15	3	8	6	9	0.5398
Vinewing	2017-11-07	7	8	6	13	0.5398
The soldier in the mine	2017-08-14	5	52	42	47	0.5397
Kings and Heroes	2017-11-16	286	443	369	655	0.5395000000000001
Reaching for Petals: VR Edition	2017-10-19	4	24	19	23	0.5395000000000001
Super Shoot Owl	2017-12-01	12	24	19	31	0.5395000000000001
Might & Mayhem	2017-06-05	91	47	38	129	0.5391
Brutal Runner	2017-10-13	11	53	43	54	0.5389
The Lost Heir 3: Demon War	2017-03-17	45	19	15	60	0.5387
Battlevoid: Sector Siege	2017-10-25	154	90	74	228	0.5383
Metro Conflict: The Origin	2017-12-14	687	815	686	1373	0.5382
Grace of Zordan	2017-10-25	48	85	70	118	0.5378000000000001
Robinson: The Journey	2017-02-09	34	250	209	243	0.5376
Hunting Simulator	2017-06-09	66	167	139	205	0.5376
BATTLECREW Space Pirates	2017-07-10	153	104	86	239	0.5376
Teria	2017-01-17	2908	37	30	2938	0.5376
CYBER (VR)	2017-08-31	75	14	11	86	0.5375
Crisis Action VR	2017-09-11	8	14	11	19	0.5375
Pharmakon	2017-07-20	3	14	11	14	0.5375
Ziggurat 3D Chess	2017-07-30	15	14	11	26	0.5375
Magic Siege - Defender	2017-11-30	9	50	41	50	0.5368
Dream Coaster VR Remastered	2017-08-10	20	44	36	56	0.5367000000000001
MinosMaze - The Minotaur's Labyrinth	2017-05-01	380	32	26	406	0.5366
Qbike: Cyberpunk Motorcycles	2017-07-28	8	32	26	34	0.5366
Infinite Scuba	2017-01-12	4	9	7	11	0.5359
Smackitball	2017-02-27	4	9	7	11	0.5359
Boss Defiance	2017-09-01	37	9	7	44	0.5359
EVIL STAR	2017-11-06	35	33	27	62	0.5355
Super Turbo Demon Busters!	2017-12-08	67	91	76	143	0.5353
FlyingRock: Arena	2017-06-23	21	27	22	43	0.5353
FIELD BREAKING	2017-06-03	6	21	17	23	0.5352
逆袭幻想传Reverse Fantasy Legend	2017-11-23	6	21	17	23	0.5352
Frontier Runner	2017-12-18	11	21	17	28	0.5352
Global Soccer: A Management Game 2017	2017-05-24	11	15	12	23	0.5352
Apez 	2017-10-04	4	15	12	16	0.5352
Billiards	2017-09-06	5	15	12	17	0.5352
Gravity Ball	2017-10-05	3	15	12	15	0.5352
Operation Desert Road	2017-10-20	3	15	12	15	0.5352
Divided We Fall	2017-10-02	70	127	107	177	0.5345000000000001
Dream Stone	2017-03-08	5264	34	28	5292	0.5345000000000001
Dark and Light	2017-07-20	14089	6020	5198	19287	0.5344
Heroes Evolved	2017-01-23	309	346	295	604	0.5341
Wands	2017-12-19	26	41	34	60	0.534
Seeking Evil: The Wendigo	2017-09-11	18	35	29	47	0.5335
Drift Horizon Online	2017-03-24	3591	406	348	3939	0.5332
Fish or Die	2017-04-25	3	4	3	6	0.5332
Block Rocking Beats	2017-06-30	3	4	3	6	0.5332
SnarfQuest Tales, Episode 1: The Beginning	2017-03-17	2	4	3	5	0.5332
Seabed Prelude	2017-02-24	7	4	3	10	0.5332
ToledoVR	2017-01-16	3	4	3	6	0.5332
Ready, Aim, Splat!	2017-01-12	6	4	3	9	0.5332
Brush Up VR	2017-02-01	5	4	3	8	0.5332
Bunny Madness Anarchy	2017-08-31	13	4	3	16	0.5332
Power Tools VR	2017-10-25	2	4	3	5	0.5332
Mini Rollers	2017-06-16	5	4	3	8	0.5332
Demon Mark: A Russian Saga	2017-06-01	22	4	3	25	0.5332
Nightcrawler VR Bowling	2017-06-16	4	4	3	7	0.5332
Mob Stadium	2017-06-15	2	4	3	5	0.5332
Mocove Arts VR	2017-06-22	2	4	3	5	0.5332
BOUNCED	2017-07-17	2	4	3	5	0.5332
No Escape	2017-12-14	2	4	3	5	0.5332
Dirty Fighter 1	2017-07-21	3	4	3	6	0.5332
Downloaded: Fragments of a Forgotten Soul	2017-08-09	2	4	3	5	0.5332
Gunducky Industries	2017-08-29	2	4	3	5	0.5332
Tiny Force Deluxe	2017-10-12	4	4	3	7	0.5332
Next Stop Zombie	2017-12-21	2	4	3	5	0.5332
EZ4u	2017-09-19	1	4	3	4	0.5332
Pathstow Mystery VR	2017-10-20	3	4	3	6	0.5332
Daily Run	2017-10-15	17	90	76	93	0.5331
Catacombs 1: Demon War	2017-07-12	5	16	13	18	0.5331
Abstract Arena	2017-08-03	4	16	13	17	0.5331
Above: The Fallen	2017-09-18	3	16	13	16	0.5331
Music Band Manager	2017-12-07	87	190	162	249	0.533
辣条杂货店:令人感动的穿越时光回到童年，中国小贩逆袭人生故事剧情，经典策略模拟经营休闲养成竞技娱乐独立游戏	2017-08-17	73	169	144	217	0.5329
Deathlike: Awakening	2017-04-28	4	10	8	12	0.5327000000000001
Hare	2017-09-27	4	10	8	12	0.5327000000000001
Waste Cleaner	2017-09-23	3	10	8	11	0.5327000000000001
Bits n Bullets	2017-10-24	2	10	8	10	0.5327000000000001
Extreme-G 2	2017-05-03	30	57	48	78	0.5323
Way of Defector	2017-12-12	14	30	25	39	0.5319
Helium	2017-03-10	8	58	49	57	0.5318
Bang Bang Fruit	2017-02-14	2756	94	80	2836	0.5317000000000001
Kingdom of Loot	2017-04-14	245	198	170	415	0.5316
Ablepsia	2017-09-27	10	95	81	91	0.5314
RAID: World War II	2017-09-26	1530	1123	977	2507	0.5313
PLANETS OF WAR	2017-07-01	25	118	101	126	0.5312
Snake Eyes Dungeon	2017-12-21	9	38	32	41	0.531
Yashik	2017-12-04	3	38	32	35	0.531
Romance with Chocolate - Hidden Objects	2017-09-28	10	31	26	36	0.5309
Longsword Tabletop Tactics	2017-07-20	28	75	64	92	0.5306000000000001
WWE 2K18	2017-10-17	2444	1153	1007	3451	0.5304
Trivia Vault: Mini Mixed Trivia 3	2017-09-20	4	46	39	43	0.5304
The Chemist	2017-11-03	9	54	46	55	0.53
FIRST STEAM GAME VHS - COLOR RETRO RACER : MILES CHALLENGE	2017-12-30	49	32	27	76	0.53
Holobunnies: Pause Cafe	2017-03-22	10	11	9	19	0.53
The Rabbit Hole	2017-05-26	22	11	9	31	0.53
Delirium	2017-08-31	136	11	9	145	0.53
ESports Club	2017-06-29	891	827	723	1614	0.5299
Elite Warriors: Vietnam	2017-02-02	5	18	15	20	0.5297
Formless Adventure	2017-07-20	550	18	15	565	0.5297
aMAZE 3D	2017-07-13	4	70	60	64	0.5296000000000001
Lift It	2017-01-20	4510	63	54	4564	0.5293
Dragon Kingdom War	2017-02-10	1847	41	35	1882	0.5288
Inner Voices	2017-05-10	211	41	35	246	0.5288
Trivia Vault: Mini Mixed Trivia 2	2017-09-18	5	41	35	40	0.5288
Dead By Murder	2017-10-03	5	26	22	27	0.5288
Wonky Ship	2017-11-20	17	26	22	39	0.5288
Porno Studio Tycoon	2017-05-05	75	120	104	179	0.5287
Trivia Vault: Super Heroes Trivia	2017-08-15	3	57	49	52	0.5285
Arena: Blood on the Sand VR	2017-01-11	5460	19	16	5476	0.5283
Lost in the Ocean VR	2017-02-24	6	19	16	22	0.5283
Multiplayer FPS Tutorial Demo	2017-07-06	27	106	92	119	0.5282
TankCraft	2017-01-09	406	12	10	416	0.5278
Destination Ares	2017-09-22	6	12	10	16	0.5278
Weeping Skies	2017-06-19	6	12	10	16	0.5278
Kukui	2017-08-09	15	12	10	25	0.5278
Butterfly Moment	2017-09-22	2	12	10	12	0.5278
Meriwether: An American Epic	2017-12-04	2	5	4	6	0.5278
Perch	2017-01-05	3	5	4	7	0.5278
Paulo's Wing	2017-02-23	2	5	4	6	0.5278
My Vet Practice – Marine Patrol	2017-03-06	4	5	4	8	0.5278
OMEGA PATTERN - VISUAL NOVEL	2017-05-26	4	5	4	8	0.5278
Bebop and Tempo	2017-06-19	4	5	4	8	0.5278
LOG the game!	2017-07-07	2	5	4	6	0.5278
Planetbound	2017-06-27	2	5	4	6	0.5278
This is not RPG	2017-06-29	3	5	4	7	0.5278
Slasher VR	2017-10-04	3	5	4	7	0.5278
Miniature TD	2017-08-15	2	5	4	6	0.5278
Azai - TD	2017-08-04	2	5	4	6	0.5278
Goblin Storm	2017-12-19	7	5	4	11	0.5278
Jam Session VR	2017-12-06	3	5	4	7	0.5278
Awe of Despair	2017-11-22	2	5	4	6	0.5278
Imperi	2017-11-17	4	5	4	8	0.5278
Chinese Paladin：Sword and Fairy 6	2017-11-15	68	176	154	222	0.5275
Trivia Vault: Classic Rock Trivia 2	2017-08-23	6	43	37	43	0.5275
MyFactory	2017-09-22	45	43	37	82	0.5275
Killing Floor: Incursion	2017-11-14	83	486	429	512	0.5271
The Last Hope Trump vs Mafia	2017-01-20	1369	232	204	1573	0.527
SYREN	2017-02-16	11	20	17	28	0.527
Destination: Pluto The VR Experience	2017-01-20	9	20	17	26	0.527
Super	2017-09-30	22	20	17	39	0.527
Chinese Souls-Hua Garden/华夏园	2017-07-15	6	20	17	23	0.527
Jelly in the sky	2017-12-11	20	69	60	80	0.5268
Lords of New York	2017-01-19	282	28	24	306	0.5268
Task is to Survive	2017-10-31	3	28	24	27	0.5268
Summer Nightmare	2017-12-06	39	256	226	265	0.5263
Defence to death	2017-05-11	1642	115	101	1743	0.526
Zahalia: The Knights of Galiveth	2017-05-01	617	13	11	628	0.5259
Table Football Pro	2017-05-22	6	13	11	17	0.5259
Gift To Humanity	2017-12-01	413	13	11	424	0.5259
Ballistic Mini Golf	2017-10-24	27	46	40	67	0.5258
Stolen Steel VR	2017-02-22	7	21	18	25	0.5258
Dinosis Survival	2017-07-07	32	153	135	167	0.5256000000000001
TARTARUS	2017-11-22	43	110	97	140	0.5251
Algotica Iterations	2017-03-23	257	92	81	338	0.5251
M.A.C.E.	2017-03-16	223	30	26	249	0.5251
Two Worlds II HD - Call of the Tenebrae	2017-07-13	11811	30	26	11837	0.5251
Lawnmower Game 2: Drifter	2017-12-06	3	30	26	29	0.5251
Crazy Fishing	2017-05-25	14	57	50	64	0.5246999999999999
Unforgiven VR	2017-02-23	7	22	19	26	0.5246999999999999
Dangerous Bullets	2017-05-21	2444	22	19	2463	0.5246999999999999
ZAP Master	2017-09-01	5	22	19	24	0.5246999999999999
Queen Of Thieves	2017-01-20	44	14	12	56	0.5242
Rage Against The Zombies	2017-01-19	29	14	12	41	0.5242
VR SUSHI BAR	2017-06-05	3	6	5	8	0.5239
Freedom: A Time to Reckon	2017-11-10	2	6	5	7	0.5239
Six-ear Macaque	2017-10-14	7	6	5	12	0.5239
Apocalypse Knights 2.0	2017-08-30	6	6	5	11	0.5239
Alimardan's Mischief	2017-08-24	2	6	5	7	0.5239
Soundscape Classic	2017-11-01	4	6	5	9	0.5239
40 Days	2017-11-29	3	6	5	8	0.5239
Mint	2017-07-21	5	41	36	41	0.5236999999999999
ZombieFight VR	2017-06-15	10	32	28	38	0.5236999999999999
Air Combat Arena	2017-11-29	4	32	28	32	0.5236999999999999
Spacelords	2017-09-22	2093	1669	1505	3598	0.5236
CRIMSON METAL	2017-05-04	1197	139	124	1321	0.5232
Trivia Vault: Mini Mixed Trivia	2017-09-16	4	42	37	41	0.5232
Suicide Adventures	2017-09-22	3	33	29	32	0.523
Cabals: Card Blitz	2017-02-08	58	52	46	104	0.5229
Lethis - Daring Discoverers	2017-06-08	38	15	13	51	0.5228
Range Day VR	2017-08-10	5	15	13	18	0.5228
Master of ABC	2017-08-03	3	15	13	16	0.5228
Solitaire Mystery: Stolen Power	2017-08-24	5	15	13	18	0.5228
Red Wake Carnage	2017-08-31	1567	174	156	1723	0.5225
Sky Road	2017-12-08	9	44	39	48	0.5222
Blue Whale	2017-10-31	5	25	22	27	0.522
Star Control III	2017-10-19	10	16	14	24	0.5215
1166	2017-04-02	41	16	14	55	0.5215
Cynoclept: The Game	2017-08-25	4	16	14	18	0.5215
BACK TO THE EGG!	2017-12-27	3	16	14	17	0.5215
LSD	2017-10-31	22	141	127	149	0.5213
Mystic Journey: Tri Peaks Solitaire	2017-05-11	127	77	69	196	0.5213
Cube Color	2017-11-22	5	26	23	28	0.5212
King of Spin VR	2017-10-10	7	7	6	13	0.5211
Dreadful	2017-09-14	3	7	6	9	0.5211
Pyramid VR	2017-08-31	3	7	6	9	0.5211
Chateau Garden	2017-07-07	6	7	6	12	0.5211
Lost Legends: The Pharaoh's Tomb	2017-06-30	3	7	6	9	0.5211
SURV	2017-07-25	3	7	6	9	0.5211
Gunship Battle2 VR: Steam Edition	2017-11-14	4	7	6	10	0.5211
Astroe	2017-09-30	4	7	6	10	0.5211
The Red Front	2017-10-05	3	7	6	9	0.5211
Verzaken!	2017-11-06	2	7	6	8	0.5211
Dogstar	2017-12-13	2	7	6	8	0.5211
Stable Orbit	2017-09-27	81	189	171	252	0.5208
Nuclear Contingency	2017-01-03	2516	145	131	2647	0.5207
Trivia Vault: Technology Trivia Deluxe	2017-12-21	3	37	33	36	0.5207
Commands & Colors: The Great War	2017-01-19	29	48	43	72	0.5204
JumpSky	2017-11-01	25	59	53	78	0.5203
Streetball VR	2017-06-01	5	17	15	20	0.5203
Death Train VR	2017-09-21	306	17	15	321	0.5203
Virtual Reality Girls	2017-11-25	12	17	15	27	0.5203
Les Fleursword	2017-08-24	38	160	145	183	0.5202
Machine World 2	2017-07-28	67	97	88	155	0.5193
World Basketball Manager 2	2017-06-22	15	18	16	31	0.5193
Bunny Bounce	2017-03-10	45	40	36	81	0.5192
Acaratus	2017-05-25	21	29	26	47	0.5192
Blue Bird	2017-04-14	21	29	26	47	0.5192
Nano Project	2017-05-24	21	8	7	28	0.5189
Indeep | The casual dungeon crawler	2017-08-17	3	8	7	10	0.5189
VR STOCK CAR RACERS	2017-12-12	3	8	7	10	0.5189
ZHUST - THE ILLUSION SOUL	2017-06-09	4	19	17	21	0.5184000000000001
TankVR	2017-10-09	3	19	17	20	0.5184000000000001
FlatOut 4: Total Insanity	2017-04-04	64	917	845	909	0.5183
Insane Cold: Back to the Ice Age	2017-12-16	22	54	49	71	0.5183
Syberia 3	2017-04-20	2124	1934	1789	3913	0.5178
Darkest Hunters	2017-09-27	203	56	51	254	0.5177
Sons of Triskelion	2017-04-11	698	20	18	716	0.5176
Super Ultra Monster Smash!	2017-08-07	3	20	18	21	0.5176
POBEDA	2017-05-09	1564	70	64	1628	0.5173
Jidousha Shakai	2017-04-29	56	149	137	193	0.5172
Darwin's bots	2017-03-27	5	9	8	13	0.5171
Space Panic: Room Escape (VR)	2017-06-23	4	9	8	12	0.5171
Black River	2017-04-04	985	21	19	1004	0.5168
Hegis' Grasp: Evil Resurrected	2017-10-13	6	21	19	25	0.5168
Business-hooiznes	2017-08-25	3	35	32	35	0.5161
The Song of Terminus 終焉的迴響:護界者之歌	2017-10-27	21	35	32	53	0.5161
Calm Waters	2017-06-12	7	22	20	27	0.5161
Tower Defense - Fantasy Tower Game	2017-03-22	14	22	20	34	0.5161
Undertaker's	2017-08-02	6	10	9	15	0.5156000000000001
CrownFall	2017-08-17	7	10	9	16	0.5156000000000001
Colorless Life	2017-07-25	5	23	21	26	0.5155
Consortium: The Tower	2017-09-22	11	24	22	33	0.5149
Welcome to Hanwell	2017-10-20	21	143	133	154	0.5147999999999999
Beach Bowling Dream VR	2017-01-13	2	11	10	12	0.5144
Mad-Sector	2017-07-14	3	11	10	13	0.5144
Girls and Quiz	2017-07-11	4	11	10	14	0.5144
The Escape	2017-12-29	10	11	10	20	0.5144
Fluffy Friends 2	2017-11-17	11	27	25	36	0.5134000000000001
Across The Line	2017-02-02	5	12	11	16	0.5134000000000001
Land Doctrine	2017-03-14	5	12	11	16	0.5134000000000001
Legends Of Iona RPG	2017-08-22	4	12	11	15	0.5134000000000001
Space Panic Defense	2017-11-24	7	12	11	18	0.5134000000000001
Party Hard Tycoon	2017-10-19	167	161	151	318	0.5132
Trivia Vault: Science & History Trivia 2	2017-09-01	7	44	41	48	0.513
Metonymy	2017-10-25	9	29	27	36	0.5126
Esports Life: Ep.1 - Dreams of Glory	2017-11-30	96	104	98	194	0.5119
Beachhead: DESERT WAR	2017-05-02	4	14	13	17	0.5117
Beyond the Invisible: Evening	2017-06-22	11	14	13	24	0.5117
Rage Room	2017-12-25	14	14	13	27	0.5117
Argo	2017-06-22	6659	5691	5424	12083	0.5113000000000001
Crushing Blow	2017-08-16	9	15	14	23	0.511
TRANSCEND 	2017-12-02	5	15	14	19	0.511
Project: R.E.B.O.O.T 2	2017-01-27	1313	35	33	1346	0.5106
Operation swat	2017-01-27	1944	35	33	1977	0.5106
BADASS	2017-04-07	1154	36	34	1188	0.5103
Survival Tycoon	2017-07-15	7	36	34	41	0.5103
The Village	2017-10-12	1847	59	56	1903	0.5099
Wordlase	2017-04-29	304	38	36	340	0.5098
Sunrise survival	2017-08-03	95	223	213	308	0.5096
The Theodore Adventures	2017-07-20	2	18	17	19	0.5094
Machine Hunt	2017-05-15	2138	270	259	2397	0.5088
TransRoad: USA	2017-11-09	405	193	185	590	0.5088
Felix Jumpman	2017-01-25	1904	48	46	1950	0.5079
Block Warriors	2017-09-06	53	343	331	384	0.5075999999999999
Cyborg Invasion Shooter	2017-11-07	5	23	22	27	0.5075999999999999
RUGBY 18	2017-10-27	34	53	51	85	0.5072
仙剑奇侠传六(Chinese Paladin：Sword and Fairy 6)	2017-11-15	217	753	730	947	0.5069
Oracle	2017-02-28	3485	121	117	3602	0.5068
Animal Rivals	2017-04-19	1758	26	25	1783	0.5068
No Lights	2017-08-07	11	58	56	67	0.5067
Professor Watts: Memory Match	2017-07-28	27	27	26	53	0.5065999999999999
Harvest Life	2017-11-11	25	128	124	149	0.5064
Tyd wag vir Niemand	2017-07-07	1583	28	27	1610	0.5064
The Awakening	2017-09-21	33	28	27	60	0.5064
The Esoterica: Hollow Earth	2017-02-02	21	62	60	81	0.5063000000000001
Holy Potatoes! What the Hell?!	2017-10-13	52	67	65	117	0.5058
Dino Dini's Kick Off Revival	2017-09-12	21	32	31	52	0.5057
Nancy Drew: The Shattered Medallion	2017-03-06	17	32	31	48	0.5057
Incline	2017-10-10	68	227	221	289	0.5056
ATV Drift & Tricks	2017-11-14	11	35	34	45	0.5052000000000001
Redium	2017-11-10	12	35	34	46	0.5052000000000001
The Butterfly Sign: Human Error	2017-03-16	1634	39	38	1672	0.5047
RoBros	2017-06-14	27	39	38	65	0.5047
Pixel Car	2017-11-01	4	39	38	42	0.5047
Ruthless Safari	2017-08-12	7	134	131	138	0.5046
Trivia Vault: Science & History Trivia	2017-08-14	3	43	42	45	0.5043
PRO EVOLUTION SOCCER 2018 LITE	2017-11-16	1695	783	769	2464	0.504
Trivia Vault: Mini Mixed Trivia 4	2017-09-21	4	47	46	50	0.504
Jackpot Poker by PokerStars	2017-03-20	72	183	180	252	0.5034000000000001
Grav Blazer	2017-07-18	5	58	57	62	0.5033
Rento Fortune - Multiplayer Board Game	2017-07-14	3485	1495	1477	4962	0.5028
Project First Contact	2017-07-26	1914	96	95	2009	0.5021
Starship Theory	2017-07-05	896	518	517	1413	0.5004
Ways of History	2017-09-01	291	118	118	409	0.5
Road Dogs	2017-09-26	55	67	67	122	0.5
Aloha Paradise Hotel	2017-10-25	51	44	44	95	0.5
Happy Campers	2017-04-10	64	35	35	99	0.5
Permute	2017-03-17	2817	27	27	2844	0.5
Cirque du Soleil	2017-09-27	30	23	23	53	0.5
Three Twenty One	2017-06-30	18	22	22	40	0.5
Lobster Empire	2017-12-18	29	21	21	50	0.5
Viking Rage	2017-04-28	9	20	20	29	0.5
Orb The Ball	2017-09-18	3	18	18	21	0.5
Nullysun	2017-10-26	10	18	18	28	0.5
King Of Dirt	2017-03-01	6	15	15	21	0.5
Peninsular War Battles	2017-09-01	6	15	15	21	0.5
God of Failure	2017-12-19	4	15	15	19	0.5
Minotaur	2017-08-11	43	14	14	57	0.5
Subject A-119	2017-06-09	4	14	14	18	0.5
冒险之路(Adventure Road)	2017-09-09	36	14	14	50	0.5
Obscure - Challenge Your Mind	2017-07-19	4	12	12	16	0.5
Chaos Souls	2017-11-07	4	12	12	16	0.5
Exorcism: Case Zero	2017-10-13	3	12	12	15	0.5
Dean Daimon	2017-10-21	4	12	12	16	0.5
Twine3D	2017-12-26	2	12	12	14	0.5
Narborion Saga	2017-03-20	10	11	11	21	0.5
Galactic Core: The Lost Fleet	2017-03-17	3	10	10	13	0.5
Lone Pirate VR	2017-05-26	3	10	10	13	0.5
Circuit Warz	2017-07-04	27	10	10	37	0.5
Infinity Trip	2017-12-08	3	10	10	13	0.5
AI Rebellion	2017-05-02	101	9	9	110	0.5
THORNYWAY - The Game	2017-09-11	4	9	9	13	0.5
Mr Rabbit's Jigsaw Puzzle	2017-09-13	11	9	9	20	0.5
Sniper Hunter Adventure 3D	2017-10-13	3	9	9	12	0.5
Voxel Tank VR	2017-10-23	2	9	9	11	0.5
Tales of the Lumminai	2017-12-08	516	8	8	524	0.5
Draft Day Sports: Pro Basketball 2018	2017-11-30	20	8	8	28	0.5
Biomydra	2017-03-09	9	7	7	16	0.5
The Adventures of Alvis	2017-04-03	2	7	7	9	0.5
The Murder Room VR	2017-06-01	3	7	7	10	0.5
Robot Pirates	2017-06-09	2	7	7	9	0.5
Spartan VR	2017-08-25	2	7	7	9	0.5
Sword Bros	2017-11-10	4	7	7	11	0.5
MORTEM	2017-08-17	3	6	6	9	0.5
世阳教你学防灾	2017-04-04	2	6	6	8	0.5
Blackjack Bailey VR	2017-04-27	2	6	6	8	0.5
The Ghost of Joe Papp	2017-12-01	2	6	6	8	0.5
Ragna Maya	2017-09-08	7	6	6	13	0.5
Draft Day Sports: College Basketball 2017	2017-11-15	19	6	6	25	0.5
VR Ping Pong Paradise	2017-12-26	3	6	6	9	0.5
Fourtex Jugo	2017-04-13	6	5	5	11	0.5
The baron got you again	2017-08-03	3	5	5	8	0.5
TMM: Entourage	2017-09-01	3	5	5	8	0.5
Dungeon Manager ZV 2	2017-02-17	7	5	5	12	0.5
Rayless	2017-01-25	361	5	5	366	0.5
Jewel Venture	2017-08-02	4	5	5	9	0.5
Sobreviva - Low Poly	2017-08-23	1	5	5	6	0.5
TangramsVR	2017-09-14	3	5	5	8	0.5
The Way Of Love: Sub Zero	2017-10-17	2	4	4	6	0.5
Quiz Night Tonight!	2017-03-03	6	4	4	10	0.5
Fractal	2017-01-13	74	4	4	78	0.5
Equilibrium VR	2017-01-01	2	4	4	6	0.5
Wild Unknown	2017-03-06	5	4	4	9	0.5
Mystery Riddles	2017-03-15	5	4	4	9	0.5
Master Shot VR	2017-06-15	3	4	4	7	0.5
Fancy Fishing VR	2017-03-03	5	4	4	9	0.5
You Shall Not Jump: PC Master Race Edition	2017-06-22	3	4	4	7	0.5
Sorcerer's Dream	2017-07-14	3	4	4	7	0.5
Choice of Zombies	2017-07-14	6	4	4	10	0.5
Puzzle: Underwater World	2017-08-02	1	4	4	5	0.5
Run Crabby Run	2017-08-02	3	4	4	7	0.5
Walking Heavy	2017-10-20	3	4	4	7	0.5
Loot Collection: Mahjong	2017-10-05	4	4	4	8	0.5
Pinball	2017-11-10	2	4	4	6	0.5
The Valley In My Mind	2017-12-23	10	4	4	14	0.5
Elemental World Part 1:Rise Of The Guardians	2017-11-08	3	3	3	6	0.5
Your Star	2017-01-03	9	3	3	12	0.5
SECLUSION	2017-02-10	5	3	3	8	0.5
EZRA: The Stranger	2017-02-04	2	3	3	5	0.5
I'm Titanium	2017-07-28	2017	3	3	2020	0.5
Perfect Plan 	2017-03-30	2	3	3	5	0.5
End of the Road VR	2017-06-29	6	3	3	9	0.5
VR Scape	2017-05-26	3	3	3	6	0.5
Vault Resort	2017-08-11	2	3	3	5	0.5
StickDodgeVR	2017-08-03	1	3	3	4	0.5
Mino Saga	2017-12-21	1	3	3	4	0.5
Wings of Peace VR: DayBreak	2017-11-10	3	3	3	6	0.5
Unlimited	2017-07-19	2	3	3	5	0.5
生死线 Dead Line	2017-09-07	4	3	3	7	0.5
Deadly Rescue	2017-08-11	3	3	3	6	0.5
My Way VR	2017-11-20	3	3	3	6	0.5
The Simple Apocalypse	2017-09-22	5	3	3	8	0.5
Hidden Object - Tools	2017-09-28	2	3	3	5	0.5
Solar Collector	2017-11-10	3	3	3	6	0.5
Hyperide VR	2017-10-26	2	3	3	5	0.5
Android John 2.1	2017-12-08	3	3	3	6	0.5
The Dead Cloud Forest	2017-12-26	2	3	3	5	0.5
VeeR Pong	2017-05-29	4	2	2	6	0.5
Boost	2017-01-11	3	2	2	5	0.5
Ski Sport: Jumping VR	2017-01-30	3	2	2	5	0.5
1-2-Swift	2017-01-30	3	2	2	5	0.5
Twin Roads	2017-07-05	2	2	2	4	0.5
Upside-Down Dimensions	2017-08-09	2	2	2	4	0.5
Neon Galaxy	2017-07-06	2	2	2	4	0.5
VR Guest	2017-06-21	1	2	2	3	0.5
Audioship	2017-07-25	4	2	2	6	0.5
Dragon's Lunch	2017-09-12	3	2	2	5	0.5
The Elmian Warrior	2017-07-20	2	2	2	4	0.5
Deadliners	2017-08-01	3	2	2	5	0.5
DEFENDER OF EARTH VS THE ALIEN ARMADA	2017-09-12	2	2	2	4	0.5
Toy Goblins	2017-10-06	2	2	2	4	0.5
Gender Bender	2017-09-04	2	2	2	4	0.5
Unbalance	2017-09-20	4	2	2	6	0.5
Pegasus Door	2017-09-07	1	2	2	3	0.5
Buffy Stole Your Sandwich	2017-10-17	1	2	2	3	0.5
Zombie Nightmare	2017-10-29	3	2	2	5	0.5
Inner Mazes - Souls Guides	2017-11-10	2	2	2	4	0.5
Tales of Terror: House on the Hill Collector's Edition	2017-10-24	4	2	2	6	0.5
Monkeys Ahoy	2017-12-20	2	2	2	4	0.5
Bug Battle	2017-12-08	2	2	2	4	0.5
Brawlerz Arena	2017-05-27	4	1	1	5	0.5
Quantized	2017-12-22	2	1	1	3	0.5
Tower in the Sky	2017-05-01	2	1	1	3	0.5
Snakes - N - Ladders : Origins - Episode 1	2017-02-15	1	1	1	2	0.5
Project Almighty	2017-12-05	1	1	1	2	0.5
The Strayed	2017-01-03	1	1	1	2	0.5
Archipelago: Navigable VR Comic	2017-01-06	3	1	1	4	0.5
Defuser VR	2017-02-11	1	1	1	2	0.5
Disc League	2017-05-17	10	1	1	11	0.5
Deep End	2017-03-31	2	1	1	3	0.5
Demon Blade VR	2017-09-15	2	1	1	3	0.5
Cellz	2017-10-31	2	1	1	3	0.5
Through The Dark: Prologue	2017-05-25	1	1	1	2	0.5
Run Jump Die Repeat	2017-06-15	2	1	1	3	0.5
Fisher Fans VR	2017-08-01	2	1	1	3	0.5
Mahjong Masters: Temple of the Ten Gods	2017-06-19	3	1	1	4	0.5
Don't Die!	2017-10-11	2	1	1	3	0.5
Run For Coins	2017-08-03	2	1	1	3	0.5
Triangulate	2017-08-11	1	1	1	2	0.5
Break The Cookie	2017-07-12	1	1	1	2	0.5
Solar System Journey VR	2017-07-24	1	1	1	2	0.5
The Western Hunter	2017-07-08	3	1	1	4	0.5
Heaven And Earth 	2017-12-13	2	1	1	3	0.5
Town doubt	2017-08-17	3	1	1	4	0.5
Topdown Showdown	2017-08-31	7	1	1	8	0.5
ShadowCalls 暗影召唤	2017-08-09	2	1	1	3	0.5
Throne of the Dead VR	2017-08-23	1	1	1	2	0.5
RoadRunner VR	2017-10-16	1	1	1	2	0.5
Triton Wing	2017-08-22	1	1	1	2	0.5
The Mines of Morseph	2017-10-03	1	1	1	2	0.5
PolyKat	2017-09-06	3	1	1	4	0.5
Guardians of Life VR	2017-09-25	2	1	1	3	0.5
Escape Fantasy	2017-09-23	3	1	1	4	0.5
Pop Pop Boom Boom	2017-12-01	3	1	1	4	0.5
Edmonton Trolley Car	2017-09-12	2	1	1	3	0.5
Captain 13 Beyond the Hero	2017-09-29	1	1	1	2	0.5
The Trace	2017-10-19	1	1	1	2	0.5
Forsaken Generation	2017-10-02	3	1	1	4	0.5
Divide & Conquer	2017-11-29	2	1	1	3	0.5
ELE BLAZE	2017-10-10	4	1	1	5	0.5
Cursed Isles	2017-10-13	1	1	1	2	0.5
Record Store Nightmare	2017-10-22	2	1	1	3	0.5
Last Salvo	2017-12-20	1	1	1	2	0.5
Sound Soarer	2017-10-11	1	1	1	2	0.5
ALVAROK	2017-11-02	2	1	1	3	0.5
More Than Just Chess	2017-11-03	2	1	1	3	0.5
Seal Guardian	2017-12-08	1	1	1	2	0.5
HeadSquare	2017-11-28	2	1	1	3	0.5
SpacePig	2017-11-21	1	1	1	2	0.5
Final Cut: Homage Collector's Edition	2017-12-11	3	1	1	4	0.5
CRONEWORLD RPG GAME CH1	2017-12-04	2	1	1	3	0.5
Deus Ex: Mankind Divided™ VR Experience	2017-01-24	37	139	140	177	0.4985
Keyboard Killers	2017-09-21	247	195	197	444	0.4979
BREACH IT	2017-05-30	24	95	96	120	0.4979
Fear For Freedom	2017-08-31	21	81	82	103	0.4976
Granado Espada	2017-02-23	268	120	122	390	0.49670000000000003
NeverEnd	2017-02-16	1775	58	59	1834	0.49670000000000003
A Wonder	2017-11-14	34	58	59	93	0.49670000000000003
The Rare Nine	2017-10-31	4	42	43	47	0.49570000000000003
The Horus Heresy: Battle of Tallarn	2017-02-08	30	36	37	67	0.495
Stone Flower	2017-09-22	13	34	35	48	0.49479999999999996
Witanlore: Dreamtime	2017-01-24	19	33	34	53	0.49460000000000004
NecroWorm	2017-05-18	578	106	109	687	0.4944
Sacra Terra: Kiss of Death Collector’s Edition	2017-02-02	20	63	65	85	0.494
Spiritual Warfare & Wisdom Tree Collection	2017-04-25	8	28	29	37	0.4938
Raid On Coasts	2017-08-12	6	27	28	34	0.4936
River City Melee : Battle Royal Special	2017-09-29	31	57	59	90	0.49340000000000006
Premium Pool Arena	2017-04-14	42	57	59	101	0.49340000000000006
Purple Heart	2017-11-27	5	57	59	64	0.49340000000000006
Warfront Defenders	2017-08-07	27044	22	23	27067	0.4924
Drift Zone	2017-12-14	10	22	23	33	0.4924
Free Bowling 3D	2017-10-07	5	43	45	50	0.4916
NitroRage	2017-07-04	14	41	43	57	0.49119999999999997
Trivia Vault: Video Game Trivia Deluxe	2017-10-24	4	41	43	47	0.49119999999999997
Black Mirror	2017-11-28	187	255	266	453	0.49100000000000005
Dark Throne	2017-03-03	7	17	18	25	0.49060000000000004
World War Party: Game Of Trump	2017-11-04	8	17	18	26	0.49060000000000004
Trivia Vault: Mixed Trivia	2017-08-11	4	37	39	43	0.4904
Seasteader	2017-02-24	7	16	17	24	0.4901
Z-End	2017-12-08	6	15	16	22	0.48960000000000004
Killers and Thieves	2017-05-23	217	72	76	293	0.48950000000000005
Creature Clicker - Capture, Train, Ascend!	2017-04-28	1263	192	202	1465	0.4894
STRIPPER ANYA: DEMON SLAYER	2017-07-31	4	14	15	19	0.489
BattleTrucks	2017-04-03	1495	30	32	1527	0.48850000000000005
ZombVR	2017-11-17	4	13	14	18	0.4883
Crypt Hunter	2017-09-14	4	13	14	18	0.4883
iREC	2017-01-16	4172	146	155	4327	0.4877
1914: Prelude to Chaos	2017-05-08	3238	59	63	3301	0.4875
Celestial Breach	2017-10-13	7	12	13	20	0.4875
Puzzle Wishes	2017-01-25	19	12	13	32	0.4875
Visitors: Marine Invasion	2017-07-13	3	12	13	16	0.4875
Thin Judgment	2017-07-10	26	12	13	39	0.4875
All Evil Night	2017-08-21	2	12	13	15	0.4875
Battle Runner	2017-11-30	3	12	13	16	0.4875
Dragonflight	2017-07-28	10	58	62	72	0.48729999999999996
Shopping Tycoon	2017-09-12	12	25	27	39	0.4866
Duck Hunting	2017-04-07	1068	11	12	1080	0.4866
Er-Spectro	2017-12-28	2	11	12	14	0.4866
The Exiled	2017-02-23	558	223	238	796	0.4863
Laraan	2017-01-11	1120	126	135	1255	0.48600000000000004
Sovereignty: Crown of Kings	2017-02-02	219	138	148	367	0.4857
ERISLE	2017-03-10	16	10	11	27	0.48560000000000003
Lost in Nature	2017-03-14	7	10	11	18	0.48560000000000003
Midnight at the Red Light : An Investigation	2017-12-16	4	10	11	15	0.48560000000000003
Sango Guardian Chaos Generation Steamedition	2017-08-08	6	10	11	17	0.48560000000000003
Golf 2D	2017-10-17	4	36	39	43	0.4854
Economic Conquest	2017-05-24	20	22	24	44	0.4851
Supermarket Tycoon	2017-08-30	11	22	24	35	0.4851
Chinese Paladin：Sword and Fairy	2017-10-12	275	941	1006	1281	0.485
Solitaire	2017-02-20	27	61	66	93	0.48490000000000005
WWII Online	2017-09-05	458	1627	1739	2197	0.48479999999999995
Romance of the Three Kingdoms III	2017-02-22	20	9	10	30	0.4844
CYBER JOLT	2017-02-22	104	9	10	114	0.4844
4x4 Road Race	2017-02-02	3	9	10	13	0.4844
Kursk - Battle at Prochorovka	2017-07-13	4	9	10	14	0.4844
The Hospital: Allison's Diary	2017-11-09	4	9	10	14	0.4844
Blue Horizon	2017-08-18	20	33	36	56	0.4843
Professor Watts Word Search: Into The Ocean	2017-07-16	4	33	36	40	0.4843
High Profits	2017-01-13	2099	464	499	2598	0.4841
NOBUNAGA'S AMBITION: Taishi	2017-11-30	5626	438	472	6098	0.48369999999999996
Heroes of Paragon	2017-07-05	125	42	46	171	0.4832
Amigo VR	2017-04-13	6	19	21	27	0.4832
Midnight's Blessing 2	2017-01-20	1026	8	9	1035	0.4829
Speed and Scream	2017-05-11	4	8	9	13	0.4829
Kingdom City Drowning Ep1 - The Champion	2017-08-30	3	8	9	12	0.4829
Demon&Fairy	2017-11-19	3	8	9	12	0.4829
Sniper Fury	2017-06-13	664	1219	1317	1981	0.4825
NeoBoom2	2017-10-30	61	29	32	93	0.4825
Scrap	2017-10-19	17	29	32	49	0.4825
Relax Walk VR	2017-05-31	9	27	30	39	0.4814
Survival Driver	2017-08-16	1745	37	41	1786	0.48119999999999996
The Cavern	2017-10-24	3	7	8	11	0.4811
Frontier VR	2017-03-17	47	7	8	55	0.4811
The Maid_san's Caving Adventure - メイドさん洞窟探検 -	2017-06-22	3	7	8	11	0.4811
Luxocraft	2017-07-17	2	7	8	10	0.4811
Dungeon Builder S	2017-07-14	4	7	8	12	0.4811
Djilyaro	2017-11-24	2	7	8	10	0.4811
Cosmic Pioneer	2017-06-07	3039	26	29	3068	0.4808
Brain Storm : Tower Bombarde	2017-07-28	2	16	18	20	0.4807
SCHOOL SIMULATOR	2017-09-10	5	16	18	23	0.4807
Go Kart Survival	2017-12-19	2	16	18	20	0.4807
Game Machines: Arcade Casino	2017-10-19	3	16	18	21	0.4807
Brick Breaker Ultimate	2017-10-02	6	25	28	34	0.4802
Quad Hopping	2017-08-23	4	34	38	42	0.47990000000000005
Dinosaur Hunt First Blood	2017-09-15	8	83	92	100	0.4797
Zulu Response	2017-06-12	23	24	27	50	0.47950000000000004
Toricky	2017-01-14	21	6	7	28	0.4789
Tears Revolude	2017-01-30	3	6	7	10	0.4789
20something	2017-01-26	3	6	7	10	0.4789
Final Rest	2017-03-20	3	6	7	10	0.4789
Dunia: Masters	2017-06-15	2	6	7	9	0.4789
Qbike: Crypto Motorcycles	2017-10-05	6	6	7	13	0.4789
Burn, Clown, Burn!	2017-11-17	2	6	7	9	0.4789
King Of Bali	2017-07-21	38	79	88	126	0.47880000000000006
VALIANT KNIGHTS Typing Battle	2017-03-27	4	14	16	20	0.47850000000000004
Don't Chat With Strangers	2017-01-06	21	68	76	97	0.47840000000000005
Runeyana	2017-03-21	2122	22	25	2147	0.478
CastleMiner Warfare	2017-08-17	12	39	44	56	0.4778
Tomb Joe	2017-04-24	1396	82	92	1488	0.4773
Cutie Paws	2017-11-07	5	13	15	20	0.4772
Battle Islands: Commanders	2017-02-14	375	401	446	821	0.4769
Dragon Blood	2017-02-01	500	54	61	561	0.4768
Trivia Vault: 1980's Trivia 2	2017-08-22	4	45	51	55	0.47659999999999997
Steamburg	2017-11-02	4	20	23	27	0.47630000000000006
Divide	2017-11-17	4	5	6	10	0.4761
Mission 1545	2017-12-01	2	5	6	8	0.4761
Robots.io	2017-09-13	4	5	6	10	0.4761
Edge Of Existence	2017-12-15	4	5	6	10	0.4761
Flip the Table	2017-12-13	3	5	6	9	0.4761
Slumlord Simulator	2017-11-30	4	5	6	10	0.4761
Pale Moon Crisis	2017-01-30	6	12	14	20	0.4758
Riskers	2017-10-17	118	35	40	158	0.4757
Bayou Island - Point and Click Adventure	2017-02-28	4	35	40	44	0.4757
Death Point	2017-08-31	6	19	22	28	0.4753
The Killbox: LEO	2017-10-23	31	40	46	77	0.4742
Starfighter Origins	2017-04-25	9	18	21	30	0.4742
Construct: Embers of Life	2017-08-07	5	11	13	18	0.47409999999999997
VR Golf Online	2017-02-08	8	11	13	21	0.47409999999999997
Warhammer 40,000: Dawn of War III	2017-04-27	25676	9763	10911	36587	0.4736
Hiking Simulator 2017	2017-08-25	4	31	36	40	0.4732
Poker Show VR	2017-05-30	4	24	28	32	0.4732
FEMINAZI: 3000	2017-09-19	5	38	44	49	0.4731
Navalia	2017-06-02	34	17	20	54	0.473
Happy New Year Clicker	2017-12-13	4	44	51	55	0.47250000000000003
Elder Chaos	2017-11-01	25	37	43	68	0.47250000000000003
Inner Chains	2017-05-18	114	221	252	366	0.47240000000000004
Aqua Fish	2017-12-28	8	30	35	43	0.47240000000000004
Valnir Rok	2017-09-26	619	442	502	1121	0.4723
Cave Runner	2017-12-26	10	23	27	37	0.4722
The Battle Of Mahjong	2017-09-14	6	10	12	18	0.4722
Ruction: The Golden Tablet	2017-02-01	3	4	5	8	0.4722
DARK SHORES	2017-02-13	3	4	5	8	0.4722
Dark Mechanism	2017-05-11	2	4	5	7	0.4722
Puppy Doge VR	2017-05-11	2	4	5	7	0.4722
Elementals Reborn	2017-08-21	5	4	5	10	0.4722
SwapQuest	2017-08-22	3	4	5	8	0.4722
Red Number: Prologue	2017-08-14	10	4	5	15	0.4722
Druid's Tale: Crystal Cave	2017-10-13	3	4	5	8	0.4722
Whirlpool	2017-12-13	3	4	5	8	0.4722
Undead	2017-10-11	44	16	19	63	0.4717
Protect your planet	2017-11-01	4	16	19	23	0.4717
Pro Basketball Manager 2017	2017-01-19	50	22	26	76	0.4712
Government Simulator	2017-12-04	158	80	93	251	0.4704
Factory Engineer	2017-03-20	50	60	70	120	0.4704
Hover Skate VR	2017-03-17	7	15	18	25	0.4703
Survival driver 2: Heavy vehicles	2017-08-23	3	15	18	21	0.4703
Colorful Life	2017-07-17	4	9	11	15	0.47000000000000003
Lightning: D-Day	2017-07-14	4	9	11	15	0.47000000000000003
BusinessMan	2017-07-28	5	9	11	16	0.47000000000000003
I was here	2017-10-05	5	9	11	16	0.47000000000000003
Intelligent Design: An Evolutionary Sandbox	2017-05-12	128	64	75	203	0.4694
VThree	2017-02-28	9	45	53	62	0.4694
AereA	2017-06-02	108	26	31	139	0.46909999999999996
P-Walker's Simulation	2017-05-24	1423	32	38	1461	0.469
Analemma	2017-10-26	3	14	17	20	0.4687
Poker World	2017-08-28	112	145	169	281	0.4685
Stupid Raft Battle Simulator	2017-02-23	8	19	23	31	0.46770000000000006
MakeThatMoney	2017-03-22	926	19	23	949	0.46770000000000006
Langoth	2017-02-27	4164	30	36	4200	0.46740000000000004
Hot Plates	2017-06-16	28	8	10	38	0.4673
Passengers: Awakening	2017-03-14	7	8	10	17	0.4673
Neurowake	2017-07-21	16	8	10	26	0.4673
FIGHTING BOX	2017-10-25	2	8	10	12	0.4673
Heavy Destinies	2017-11-01	3	8	10	13	0.4673
Landless	2017-05-11	37	88	104	141	0.4669
Battles of the Valiant Universe CCG	2017-05-09	6	13	16	22	0.4669
Vecitas	2017-04-12	961	13	16	977	0.4669
3 days: Zoo Mystery	2017-12-01	4	13	16	20	0.4669
Blood Harvest 2	2017-12-08	4	13	16	20	0.4669
ChemCaper: Act I - Petticles in Peril	2017-11-01	23	3	4	27	0.4668
Ouroboros: Prelude	2017-09-29	3	3	4	7	0.4668
airRevo VR	2017-03-01	2	3	4	6	0.4668
Call Of The Ocean	2017-12-19	3	3	4	7	0.4668
Rome Circus Maximus: Chariot Race VR	2017-09-27	2	3	4	6	0.4668
Professional Farmer: American Dream	2017-10-19	5	3	4	9	0.4668
Water Pipeline	2017-09-11	2	3	4	6	0.4668
Aw Nutz	2017-09-28	6	3	4	10	0.4668
Rush on Rome	2017-10-17	2	3	4	6	0.4668
The Cave VR	2017-10-19	2	3	4	6	0.4668
Magilore	2017-11-26	3	3	4	7	0.4668
MinSweeper	2017-10-30	3	3	4	7	0.4668
Soldiers of the Universe	2017-11-30	20	207	243	263	0.46640000000000004
Tokyo Tattoo Girls	2017-11-14	22	23	28	50	0.46590000000000004
KOLOBOK	2017-12-11	6	44	53	59	0.46530000000000005
Bug Killers	2017-08-05	5	17	21	26	0.4648
ITownGamePlay UNIVERSE	2017-07-20	63	22	27	90	0.4647
Airstrike One	2017-09-25	23	22	27	50	0.4647
Action Rush	2017-12-15	4	22	27	31	0.4647
Unit 4	2017-05-24	27	27	33	60	0.4645
Murder In Tehran's Alleys 1933	2017-06-08	3	7	9	12	0.46409999999999996
Village Of Souls	2017-07-24	23	7	9	32	0.46409999999999996
Forbidden Love	2017-09-11	12	7	9	21	0.46409999999999996
The Ultimate Heist	2017-12-21	3	7	9	12	0.46409999999999996
Drift (Over) Drive	2017-09-24	25457	21	26	25483	0.46340000000000003
The Last Journey	2017-04-25	12	21	26	38	0.46340000000000003
Ashes of Immortality II - Bad Blood	2017-02-13	1009	16	20	1029	0.4632
1812: The Invasion of Canada	2017-08-04	8	16	20	28	0.4632
Super Hardcore	2017-07-12	7	16	20	27	0.4632
Dawn of Andromeda	2017-05-04	94	104	125	219	0.4631
Space Needle VR 	2017-04-20	9	11	14	23	0.4625
My Personal Angel	2017-07-21	4	11	14	18	0.4625
Ravager	2017-09-01	3	11	14	17	0.4625
Run, my little pixel	2017-10-21	3	11	14	17	0.4625
Bike of the Wild	2017-11-15	5	11	14	19	0.4625
To The Light	2017-07-03	22	60	73	95	0.4623
Dead Purge: Outbreak	2017-07-14	16	39	48	64	0.4617
PLUTONIUM	2017-05-09	30	94	114	144	0.46159999999999995
Crazy Veggies	2017-04-28	811	24	30	841	0.4611
Orbital Racer	2017-12-14	8	33	41	49	0.4607
Last Soldier	2017-08-11	6	28	35	41	0.46030000000000004
Uplands Motel: VR Thriller	2017-08-07	3	6	8	11	0.46020000000000005
Escape Room	2017-07-04	2	6	8	10	0.46020000000000005
The Stone	2017-08-25	3	6	8	11	0.46020000000000005
Steampunk Syndicate 2	2017-09-21	7	6	8	15	0.46020000000000005
Call Me Skyfish	2017-08-15	2	6	8	10	0.46020000000000005
Casinopia: The Blackjack	2017-10-12	11	6	8	19	0.46020000000000005
Battle for the last chicken	2017-12-20	5	6	8	13	0.46020000000000005
Cowboy's Adventure	2017-06-30	4	37	46	50	0.4601
The Girl on the Train	2017-10-23	10	46	57	67	0.4598
True Blades	2017-05-29	6	10	13	19	0.4598
Hearing	2017-08-07	3	14	18	21	0.4593
johnsgame	2017-03-06	3	18	23	26	0.45880000000000004
AVATARIKA	2017-04-11	99	91	112	211	0.4587
Scribbled Arena	2017-05-12	65	2	3	68	0.4583
Space, VR!	2017-03-02	2	2	3	5	0.4583
RacetronicVR	2017-11-13	3	2	3	6	0.4583
Backfire	2017-05-18	2	2	3	5	0.4583
Marimba VR	2017-01-02	1	2	3	4	0.4583
Deadly Edge	2017-07-28	9	2	3	12	0.4583
A God-Like Backhand!	2017-02-16	2	2	3	5	0.4583
Biosupremacy	2017-03-09	3	2	3	6	0.4583
Chess and Checkers VR	2017-03-15	2	2	3	5	0.4583
Calavera: Day of the Dead Collector's Edition	2017-05-24	2	2	3	5	0.4583
Naklua VR	2017-11-10	2	2	3	5	0.4583
Cavern Crumblers	2017-08-10	2	2	3	5	0.4583
Loptice	2017-06-23	2	2	3	5	0.4583
Time To Walk Alone	2017-06-30	2	2	3	5	0.4583
逮到你了!	2017-08-04	3	2	3	6	0.4583
Super Blockbreak 3D	2017-07-29	2	2	3	5	0.4583
Turret Sector	2017-08-07	3	2	3	6	0.4583
Huedango	2017-08-25	2	2	3	5	0.4583
the Breath.	2017-09-19	2	2	3	5	0.4583
Uplands Motel	2017-09-12	2	2	3	5	0.4583
The Armament Project	2017-09-29	2	2	3	5	0.4583
Trial of the Demon Hunter	2017-12-19	4	2	3	7	0.4583
The Occupant	2017-10-27	2	2	3	5	0.4583
Soccer Simulation	2017-11-29	11	2	3	14	0.4583
Bounce Ball	2017-10-13	2	2	3	5	0.4583
Defenders of Tetsoidea	2017-10-30	2	2	3	5	0.4583
Duel Jousting	2017-11-15	2	2	3	5	0.4583
Dolphins-Cyborgs and open space	2017-12-30	3	26	33	36	0.45799999999999996
Deus Ex: Breach™	2017-01-24	544	135	166	710	0.45770000000000005
Empires	2017-05-31	5	17	22	27	0.457
Damascus Gear Operation Tokyo HD	2017-08-09	31	13	17	48	0.457
DeadTruth: The Dark Path Ahead	2017-01-21	128	9	12	140	0.45670000000000005
VR Coaster Extreme	2017-04-18	9	9	12	21	0.45670000000000005
Castle Defender	2017-06-15	2	9	12	14	0.45670000000000005
Anti Gravity Warriors VR	2017-10-24	10	9	12	22	0.45670000000000005
Take Off - The Flight Simulator	2017-10-10	17	50	63	80	0.45630000000000004
Kitchen Simulator 2	2017-08-17	5	37	47	52	0.4561
Finnish Roller	2017-01-31	1688	58	73	1761	0.4559
The Adventures of Fluffy	2017-07-06	3826	20	26	3852	0.45520000000000005
Age of Heroes: Conquest	2017-04-17	75	20	26	101	0.45520000000000005
Road Fist	2017-01-20	2	5	7	9	0.45520000000000005
Garden Tale	2017-09-13	5	5	7	12	0.45520000000000005
Haunted Hotel II: Believe the Lies	2017-05-19	3	5	7	10	0.45520000000000005
Space Hit	2017-06-30	1	5	7	8	0.45520000000000005
Watergate Xtreme	2017-08-06	2	5	7	9	0.45520000000000005
Albert Mort - Desert Heat	2017-08-23	5	5	7	12	0.45520000000000005
Adam Waste	2017-11-21	3	5	7	10	0.45520000000000005
ArkanoidSmoking	2017-08-14	4	5	7	11	0.45520000000000005
Leon's crusade (La cruzada de León)	2017-08-11	2	5	7	9	0.45520000000000005
60 Second Strike	2017-10-05	5	5	7	12	0.45520000000000005
Hunter of Antiques	2017-12-01	2	5	7	9	0.45520000000000005
The Sapper	2017-11-15	4	16	21	25	0.455
The Pasture	2017-01-17	3787	86	108	3895	0.4549
- Arcane Raise -	2017-03-10	1128	97	122	1250	0.45420000000000005
Lucky Panda	2017-11-07	6	47	60	66	0.45409999999999995
Rezrog	2017-05-31	220	143	179	399	0.4539
Lock's Quest	2017-05-30	34	42	54	88	0.4533
Nash Racing	2017-08-02	976	70	89	1065	0.4532
Farm World	2017-04-05	7	8	11	18	0.45310000000000006
Hold the Line: The American Revolution	2017-08-18	7	8	11	18	0.45310000000000006
Radical Spectrum: Volume 2	2017-08-16	829	8	11	840	0.45310000000000006
Dice 1000 online	2017-10-17	6	15	20	26	0.4529
JCB Pioneer: Mars	2017-09-01	48	65	83	131	0.45270000000000005
HOMEBOUND	2017-02-16	19	49	63	82	0.4526
Dinosaurs A Prehistoric Adventure	2017-12-18	61	88	112	173	0.4522
Africa Hunting	2017-12-06	2	29	38	40	0.45170000000000005
Chopper: Attack helicopters	2017-09-15	4	11	15	19	0.4516
Bloody Glimpse	2017-10-04	11	78	100	111	0.4512
The Thing: Space X	2017-09-20	3	32	42	45	0.4509
Evil Spirits	2017-08-24	4	21	28	32	0.45060000000000006
Brick Breaker	2017-02-20	43	39	51	94	0.45049999999999996
Beyond Enemy Lines	2017-02-21	7	17	23	30	0.4495
BeanVR	2017-06-01	18	20	27	45	0.44880000000000003
Arcane Maelstrom	2017-04-14	3	7	10	13	0.4487
Interplay Solitaire	2017-05-15	7	7	10	17	0.4487
RiotZ	2017-07-06	4971	7	10	4981	0.4487
Citadale - The Legends Trilogy	2017-09-13	2	7	10	12	0.4487
Arc Continuum	2017-05-04	3	4	6	9	0.4486
ReSizE	2017-10-12	2	4	6	8	0.4486
Amazing Thailand VR Experience	2017-11-13	3	4	6	9	0.4486
Space Panic Arena	2017-08-04	2	4	6	8	0.4486
VirtuGO	2017-09-08	2	4	6	8	0.4486
Epic Royal	2017-11-24	6	4	6	12	0.4486
Uizuno Blade VR	2017-12-27	3	4	6	9	0.4486
Until the last	2017-09-11	3	10	14	17	0.4483
Flappy Galaxy	2017-10-19	4	10	14	18	0.4483
VR Amazing Files: Horror Hospital	2017-01-18	5	13	18	23	0.44780000000000003
Kingdom Defense	2017-12-01	39	43	57	96	0.4474
Hold your houses	2017-02-01	3009	29	39	3048	0.44700000000000006
What The Heck, Dude?	2017-01-10	3111	138	179	3290	0.44670000000000004
Defendoooooor!!	2017-08-31	3	22	30	33	0.4464
Husk	2017-02-03	200	283	364	564	0.44630000000000003
Dragon Glory	2017-10-10	90	35	47	137	0.4462
Thunderbird: The Legend Begins	2017-02-10	5	15	21	26	0.4448
Million Arthur VR	2017-05-25	36	15	21	57	0.4448
Oh My Godheads	2017-12-05	34	15	21	55	0.4448
AEGYPTUS	2017-08-15	2	15	21	23	0.4448
ClickBit	2017-12-02	12	18	25	37	0.4447
Relaxing VR Games: Mahjong	2017-03-02	3	9	13	16	0.44450000000000006
PARSE	2017-11-06	2	9	13	15	0.44450000000000006
Prophecy I - The Viking Child	2017-10-25	2	9	13	15	0.44450000000000006
Truth: Disorder	2017-12-05	3	24	33	36	0.44430000000000003
Bitcoin Collector: Spinners Attack	2017-10-10	4	27	37	41	0.4441
Bunka no Kenkyu - Revival of Queen Leyak -	2017-09-15	4	6	9	13	0.4434
Devil In The Capital	2017-07-04	3	6	9	12	0.4434
Pocket Universe : Create Your Community	2017-10-13	4	6	9	13	0.4434
Beyond the Wall	2017-08-08	4	6	9	13	0.4434
AMBUSH tactics	2017-09-26	2	6	9	11	0.4434
Virtual Race Car Engineer 2018	2017-10-24	7	6	9	16	0.4434
Mount Hill	2017-11-16	3	6	9	12	0.4434
Reproduction Man	2017-01-10	2	1	2	4	0.44310000000000005
Twisted	2017-01-06	2	1	2	4	0.44310000000000005
UMA-War VR	2017-01-06	2	1	2	4	0.44310000000000005
The Existence Abstract	2017-06-05	1	1	2	3	0.44310000000000005
Nukklerma: Robot Warfare	2017-01-05	2	1	2	4	0.44310000000000005
LifeBase	2017-03-23	2	1	2	4	0.44310000000000005
Neon8	2017-12-31	2	1	2	4	0.44310000000000005
Fear the Dead	2017-03-08	5	1	2	7	0.44310000000000005
Trapped Within	2017-10-24	1	1	2	3	0.44310000000000005
Riley Short: Analog Boy - Episode 1	2017-06-01	1	1	2	3	0.44310000000000005
Haunted Legends: The Bronze Horseman Collector's Edition	2017-04-21	3	1	2	5	0.44310000000000005
Haunted Train: Spirits of Charon Collector's Edition	2017-05-10	3	1	2	5	0.44310000000000005
Reckless Space Pirates	2017-06-16	6	1	2	8	0.44310000000000005
SOLITAIRE ULTRA	2017-08-07	3	1	2	5	0.44310000000000005
Hero of the Galactic Core	2017-08-11	2	1	2	4	0.44310000000000005
The Nose	2017-09-16	2	1	2	4	0.44310000000000005
The Climber	2017-07-25	2	1	2	4	0.44310000000000005
Song Samurai	2017-08-16	2	1	2	4	0.44310000000000005
DIVER - SEA SURVIVAL SIMULATOR	2017-09-03	1	1	2	3	0.44310000000000005
The Dark Age I : Zordon's Empire	2017-08-30	2	1	2	4	0.44310000000000005
MonsterS in haha Island (群妖志) 	2017-08-19	2	1	2	4	0.44310000000000005
Parkour	2017-09-02	2	1	2	4	0.44310000000000005
YOU ARE KING	2017-09-19	1	1	2	3	0.44310000000000005
Brinko	2017-09-21	4	1	2	6	0.44310000000000005
The Unseen	2017-10-27	5	1	2	7	0.44310000000000005
Turf Wars	2017-11-10	3	1	2	5	0.44310000000000005
Jewel of WonderLand	2017-10-02	3	1	2	5	0.44310000000000005
DiamondFalls	2017-10-10	1	1	2	3	0.44310000000000005
Desert Craft	2017-10-31	2	1	2	4	0.44310000000000005
Fallen Kingdom	2017-11-05	2	1	2	4	0.44310000000000005
魔光	2017-12-04	2	1	2	4	0.44310000000000005
Podium Bash	2017-11-02	2	1	2	4	0.44310000000000005
Hell Space	2017-11-22	1	1	2	3	0.44310000000000005
Three Kingdoms VR - Jade Knight	2017-12-29	2	1	2	4	0.44310000000000005
Merv Reborn	2017-11-01	2	1	2	4	0.44310000000000005
Station Commander	2017-12-18	2	1	2	4	0.44310000000000005
Donjon Defense	2017-12-14	2	1	2	4	0.44310000000000005
Limit of defense	2017-12-16	2	1	2	4	0.44310000000000005
Disassembly Line	2017-12-25	1	1	2	3	0.44310000000000005
Dawn City	2017-12-29	2	1	2	4	0.44310000000000005
Planetoid	2017-02-24	3153	23	32	3185	0.4425
Forest Escape	2017-10-21	3	23	32	35	0.4425
Robot King Part I: Rebooted and Ready	2017-10-14	19	20	28	47	0.4425
Mille Bornes	2017-11-22	11	20	28	39	0.4425
FreeFly Burning	2017-08-23	11	32	44	55	0.4424
冒险村传说（Tales of Legends）	2017-02-06	1983	38	52	2035	0.4422
Wanderlust	2017-11-01	6	38	52	58	0.4422
Jump Stars	2017-06-09	7	14	20	27	0.44200000000000006
Trojan Inc.	2017-06-07	5	14	20	25	0.44200000000000006
All That Remains	2017-11-10	2	14	20	22	0.44200000000000006
Stickman Destruction 2	2017-12-27	4	14	20	24	0.44200000000000006
Fragmented	2017-08-15	379	844	1104	1483	0.4401
DEAD SOME DAY	2017-06-22	10	8	12	22	0.44
Bullet VR	2017-07-17	4	8	12	16	0.44
SPACE BATTLE: Humanity	2017-07-19	4	8	12	16	0.44
Fly Destroyer	2017-10-27	20	8	12	32	0.44
Tactical Operations	2017-12-04	3	8	12	15	0.44
M.A.X. 2: Mechanized Assault & Exploration	2017-12-18	6	8	12	18	0.44
Sky Hunter	2017-11-09	7	16	23	30	0.43979999999999997
Don't Look Back	2017-03-03	3	3	5	8	0.43950000000000006
Chronicles of a Dark Lord: Tides of Fate Remastered	2017-03-31	159	3	5	164	0.43950000000000006
Puzzle Showdown 4K	2017-05-30	21	3	5	26	0.43950000000000006
Game of Emperors	2017-07-13	11	3	5	16	0.43950000000000006
Steampunk Action Battle Simulator	2017-07-08	2	3	5	7	0.43950000000000006
Damned Hours	2017-10-02	4	3	5	9	0.43950000000000006
Klondike Solitaire Kings	2017-08-16	6	3	5	11	0.43950000000000006
Lost with Dinosaurs	2017-09-09	11	50	69	80	0.4391
Cycle	2017-07-25	10	13	19	29	0.439
Cyber Utopia	2017-06-16	33	41	57	90	0.4388
Evangeline™	2017-02-10	4	10	15	19	0.4375
My Boyfriend – He loves me, he loves me not	2017-03-14	3	10	15	18	0.4375
aMAZEing adventures	2017-12-21	17	5	8	25	0.4368
Top Secret	2017-11-27	1	5	8	9	0.4368
Shock Tactics	2017-04-11	108	53	74	182	0.4365
DEFECTIVE	2017-09-05	3	20	29	32	0.4364
World of Castles	2017-09-16	34	64	89	123	0.4362
Monopoly Plus	2017-09-07	3180	5702	7497	10677	0.43590000000000007
VR Theme Park Rides	2017-06-08	5	12	18	23	0.43560000000000004
Kungfu Beggar	2017-11-23	5	17	25	30	0.4355
Jaguar I-PACE Concept Virtual Reality Experience	2017-11-13	15	7	11	26	0.4347
Clumsy Knight 2	2017-04-07	13	7	11	24	0.4347
Tower!2011:SE	2017-05-03	8	7	11	19	0.4347
Jump! Jump! Jump!	2017-12-28	3	7	11	14	0.4347
Alchemyland 	2017-08-02	2489	59	83	2572	0.43450000000000005
Project RPG Remastered	2017-01-10	1943	75	105	2048	0.4341
Amazeing Lemons	2017-12-06	3	19	28	31	0.4341
iStorm	2017-04-17	50	47	67	117	0.4333
Agricola: All Creatures Big and Small	2017-02-14	48	44	63	111	0.4329
Fluffy Creatures VS The World	2017-04-10	2578	111	155	2733	0.43270000000000003
We Are Chicago	2017-02-09	13	11	17	30	0.43170000000000003
Vagrant Hearts Zero	2017-04-28	835	11	17	852	0.43170000000000003
TITANS: Dawn of Tribes	2017-06-15	86	122	171	257	0.4315
Psi Project	2017-11-10	10	58	83	93	0.4313
Everyday Golf VR	2017-07-13	11	35	51	62	0.43119999999999997
Insert Paper	2017-10-10	4	13	20	24	0.43060000000000004
Psi Project: Legacy	2017-11-27	8	37	54	62	0.4305
Community Inc	2017-08-03	90	79	113	203	0.42960000000000004
HOUND	2017-03-28	7	24	36	43	0.429
The Last Patient	2017-03-16	694	17	26	720	0.4288
Redneck Deer Huntin'	2017-06-20	2	6	10	12	0.4283
Dash Fleet	2017-04-10	947	6	10	957	0.4283
EastwoodVR	2017-05-15	1741	6	10	1751	0.4283
Haunted Hotel: Stay in the Light	2017-06-30	3	6	10	13	0.4283
Tupã	2017-07-29	2	6	10	12	0.4283
Fantasy ERA	2017-08-10	2	6	10	12	0.4283
Casino Slot Machines	2017-12-26	5	6	10	15	0.4283
A Haunting: Witching Hour	2017-10-31	3	4	7	10	0.4282
Clash of Robots	2017-11-10	11	4	7	18	0.4282
Enlysia	2017-09-22	5	4	7	12	0.4282
SojournVR	2017-10-31	6	4	7	13	0.4282
36 Fragments of Midnight	2017-08-07	2	4	7	9	0.4282
King's Table - The Legend of Ragnarok	2017-10-25	2	4	7	9	0.4282
JumpBall 2	2017-11-21	6	4	7	13	0.4282
Rock-n-Rogue A Boo Bunny Plague Adventure	2017-01-19	19	8	13	32	0.4279
Flying Salvager	2017-12-08	3	8	13	16	0.4279
Anime Girls VR	2017-12-23	3	8	13	16	0.4279
Real Farm	2017-10-20	37	119	170	207	0.4278
Illusoria	2017-05-30	5	14	22	27	0.4264
EnterVR	2017-02-13	2	2	4	6	0.4261
Gluon	2017-05-02	4	2	4	8	0.4261
Invicta Beam	2017-04-04	8	2	4	12	0.4261
The Falling Nights	2017-05-19	2	2	4	6	0.4261
Hex Tunnel	2017-07-04	1	2	4	5	0.4261
Anxiety	2017-07-21	3	2	4	7	0.4261
MicroSpy	2017-07-21	3	2	4	7	0.4261
Tiny Thief	2017-08-03	1	2	4	5	0.4261
The Last Sorcerer	2017-09-12	1	2	4	5	0.4261
C64 & AMIGA Classix Remakes Sixpack	2017-08-11	4	2	4	8	0.4261
The Power Factory	2017-09-29	3	2	4	7	0.4261
Loud or Quiet	2017-11-20	1	2	4	5	0.4261
Masked and Mysterious	2017-11-18	2	2	4	6	0.4261
T-Rex Time Machine	2017-12-07	11	2	4	15	0.4261
Indoor Rock Climbing VR	2017-12-29	2	2	4	6	0.4261
Once upon a time	2017-09-24	7	16	25	32	0.42590000000000006
Schlag den Star - Das Spiel	2017-11-30	25	30	46	71	0.4232
The Dome	2017-03-03	11	13	21	32	0.4227
W4RR-i/o-RS	2017-11-30	3	13	21	24	0.4227
Behind These Eyes	2017-08-17	3	9	15	18	0.42240000000000005
Solar System	2017-11-17	3	19	30	33	0.42229999999999995
STEAM HAMMER	2017-05-12	296	230	333	629	0.42210000000000003
Kim Jong-Boom	2017-10-01	115	38	58	173	0.42210000000000003
Ludoria	2017-03-03	18	7	12	30	0.4218
Final Theosis	2017-03-24	22	7	12	34	0.4218
Dark Eden Origin	2017-08-18	52	31	48	100	0.42119999999999996
Impact Winter	2017-05-22	105	172	252	357	0.42090000000000005
Iron Wings	2017-05-31	11	35	54	65	0.4208
Snow Games VR	2017-02-01	5	5	9	14	0.4204
Syndrome VR	2017-10-06	5	5	9	14	0.4204
Space Scumbags	2017-08-14	13	5	9	22	0.4204
Ameline and the Ultimate Burger	2017-08-02	3	5	9	12	0.4204
Piece of Memory	2017-07-26	3	5	9	12	0.4204
NanoScape	2017-09-14	3	5	9	12	0.4204
JigsawMania	2017-11-14	221	5	9	230	0.4204
Space Hotel	2017-01-04	11	22	35	46	0.41960000000000003
HARP	2017-10-06	5	12	20	25	0.4186
Labyrinth Escape	2017-07-10	7	12	20	27	0.4186
Megaton: Total Destruction	2017-10-13	6	12	20	26	0.4186
Fairy of the treasures	2017-12-27	7	52	80	87	0.4183
Infernales	2017-11-11	8	25	40	48	0.4173
Orc Hunter VR	2017-07-24	7	8	14	21	0.4167
Battle for Enlor	2017-04-19	709	8	14	723	0.4167
Megacity Builder	2017-07-19	285	8	14	299	0.4167
Australian Football Coach	2017-09-01	6	3	6	12	0.4167
Dunk It (VR Basketball)	2017-01-17	2	3	6	8	0.4167
The Ancient Remains	2017-03-13	2	3	6	8	0.4167
Mahjong Challenge	2017-08-22	2	3	6	8	0.4167
Tactics 2: War	2017-09-22	3	3	6	9	0.4167
Dead Noir the Heart	2017-10-20	1	3	6	7	0.4167
Rift Coaster HD Remastered VR	2017-08-09	7	32	51	58	0.4157
Isolation	2017-01-31	27	13	22	49	0.41509999999999997
Breach of Contract Online	2017-07-21	7	13	22	29	0.41509999999999997
MARS SIMULATOR - RED PLANET	2017-02-03	4	6	11	15	0.41450000000000004
Extra Terrestrial Perception	2017-06-13	2	6	11	13	0.41450000000000004
Prelude	2017-11-20	3	6	11	14	0.41450000000000004
Nash Racing 2: Muscle cars	2017-10-16	3	23	38	41	0.41250000000000003
Panzer Panic VR	2017-03-15	15	9	16	31	0.41250000000000003
KungFu Town VR	2017-11-29	4	9	16	20	0.41250000000000003
Atlantis VR	2017-11-03	3	21	35	38	0.41200000000000003
Hide and Seek	2017-08-31	88	145	223	311	0.4119
Bang Bang Fruit 2	2017-10-25	4	37	60	64	0.41130000000000005
FPS - Fun Puzzle Shooter	2017-11-17	5	24	40	45	0.4106
Battleship Bishojo	2017-03-29	14	4	8	22	0.4103
VRtender	2017-05-03	3	4	8	11	0.4103
Qajary Cat	2017-11-14	2	4	8	10	0.4103
Knights of the Drowned Table	2017-12-25	5	4	8	13	0.4103
The Fog	2017-12-01	3	4	8	11	0.4103
StarSmashers	2017-05-26	6	7	13	19	0.41000000000000003
Defcon VR	2017-02-15	6	7	13	19	0.41000000000000003
Desert Strait: Operation Online	2017-08-17	6	7	13	19	0.41000000000000003
Domino	2017-10-19	5	7	13	18	0.41000000000000003
Ragnarok Re:Start	2017-07-18	510	73	116	626	0.4097
Pro Farm Manager	2017-11-20	31	10	18	49	0.409
Plague Road	2017-05-23	18	10	18	36	0.409
NeoBoom	2017-09-14	70	25	42	112	0.40880000000000005
Hooligan Vasja: Christmas	2017-07-19	3	23	39	42	0.408
Grav Blazer Squared	2017-09-08	5	23	39	44	0.408
The Land of Dasthir	2017-01-10	2783	38	63	2846	0.40700000000000003
House of Evil	2017-12-20	8	38	63	71	0.40700000000000003
Delude - Succubus Prison	2017-08-04	5	8	15	20	0.40630000000000005
Magic Pixel Picross	2017-08-16	4	8	15	19	0.40630000000000005
German Fortress 3D	2017-07-15	4	19	33	37	0.4061
Wizards Home	2017-09-08	1	0	1	2	0.4058
Unreal Heroes	2017-02-03	3	0	1	4	0.4058
SPACE DVRTS	2017-06-22	2	0	1	3	0.4058
Dead Hand Drive	2017-09-03	1	0	1	2	0.4058
Tier 1	2017-03-16	3	0	1	4	0.4058
Mekside VR	2017-03-27	3	0	1	4	0.4058
Island Getaway	2017-01-16	3	0	1	4	0.4058
Pleasure in Dream	2017-01-12	2	0	1	3	0.4058
Home Tech VR	2017-01-19	1	0	1	2	0.4058
GridVR	2017-01-17	1	0	1	2	0.4058
The source of evil	2017-02-23	2	0	1	3	0.4058
Cut Cut Buffet	2017-02-24	2	0	1	3	0.4058
Brutal Warrior	2017-01-26	1	0	1	2	0.4058
Play with Balloon	2017-03-24	2	0	1	3	0.4058
Paper Quest	2017-03-24	2	0	1	3	0.4058
Violet's Dream VR	2017-03-07	4	0	1	5	0.4058
Zombie in my city	2017-02-24	1	0	1	2	0.4058
Light Strike Array	2017-12-22	8	0	1	9	0.4058
Jungle Dino VR	2017-02-28	2	0	1	3	0.4058
VR Audio Visualizer	2017-02-25	2	0	1	3	0.4058
Rota Craze	2017-03-09	1	0	1	2	0.4058
Desert Battle	2017-04-11	1	0	1	2	0.4058
Shoot Loop VR	2017-09-28	2	0	1	3	0.4058
City Rush	2017-03-22	2	0	1	3	0.4058
Flame of Mirrors	2017-07-19	2	0	1	3	0.4058
Xtrike	2017-08-27	2	0	1	3	0.4058
Tunnel Runner VR	2017-07-11	2	0	1	3	0.4058
Pine Seekers	2017-08-14	3	0	1	4	0.4058
Retro Block VR	2017-07-11	1	0	1	2	0.4058
The Unclogging: An Unsanitary Saga	2017-07-25	1	0	1	2	0.4058
Turn your Destiny	2017-06-29	1	0	1	2	0.4058
Fire Fighter	2017-07-19	1	0	1	2	0.4058
Snake Charmer - TPS Snek	2017-12-30	1	0	1	2	0.4058
Orb Flo	2017-10-06	1	0	1	2	0.4058
VR Fitness	2017-08-07	1	0	1	2	0.4058
VR2Space	2017-08-16	1	0	1	2	0.4058
Dark Empire	2017-12-04	2	0	1	3	0.4058
Slingshot Cowboy VR	2017-07-28	1	0	1	2	0.4058
Solmec: Among Stars	2017-09-05	1	0	1	2	0.4058
Tower And Guardian 塔与守卫者	2017-08-15	1	0	1	2	0.4058
VR Dart Zone	2017-09-15	2	0	1	3	0.4058
Castle Demolition VR	2017-09-01	2	0	1	3	0.4058
沙漠飞车	2017-09-22	2	0	1	3	0.4058
Landon	2017-10-13	2	0	1	3	0.4058
Bees Knees	2017-09-04	1	0	1	2	0.4058
DungeonGOGO	2017-10-08	2	0	1	3	0.4058
Ninja Goemon and Immortal Jewels	2017-10-19	1	0	1	2	0.4058
Pixel Killers - The Showdown	2017-09-15	2	0	1	3	0.4058
Haul Asteroid	2017-10-12	2	0	1	3	0.4058
VIRUS OF SURVIVORS:LIFE SIMULATOR	2017-09-16	2	0	1	3	0.4058
Conquest of Gerazania	2017-12-15	3	0	1	4	0.4058
Reprogram	2017-11-09	1	0	1	2	0.4058
KENDAMVR - Virtual Reality Kendama	2017-09-25	1	0	1	2	0.4058
SPIIIDERS	2017-09-21	2	0	1	3	0.4058
No God for Us	2017-12-23	2	0	1	3	0.4058
Halloween Knight	2017-10-31	2	0	1	3	0.4058
Tales of Inca - Lost Land	2017-10-03	3	0	1	4	0.4058
Yerah	2017-10-12	3	0	1	4	0.4058
Mind Sweeper VR	2017-10-24	2	0	1	3	0.4058
Dance Studio VR	2017-11-08	1	0	1	2	0.4058
AMON	2017-11-29	1	0	1	2	0.4058
Sable Maze: Norwich Caves Collector's Edition	2017-11-13	3	0	1	4	0.4058
Ninja in Training	2017-11-02	1	0	1	2	0.4058
NO ONE	2017-11-17	2	0	1	3	0.4058
WAR Pig - Big Bang	2017-10-27	2	0	1	3	0.4058
Pterodalien	2017-12-05	2	0	1	3	0.4058
Water Density	2017-12-14	2	0	1	3	0.4058
TEEN DATE SIMULATOR	2017-11-14	1	0	1	2	0.4058
Refinish Network - Paintboss VR	2017-11-28	2	0	1	3	0.4058
The Plague	2017-12-25	1	0	1	2	0.4058
Apperception	2017-12-27	2	0	1	3	0.4058
Go! Go! Radio : 8-Bit Edition	2017-11-29	3	5	10	13	0.4057
Daddy's gone a-hunting	2017-12-12	2	5	10	12	0.4057
SMACKHEAD	2017-12-13	33	32	54	87	0.4054
Cyborg Arena	2017-11-28	2	14	25	27	0.4054
Travel VR	2017-11-02	12	14	25	37	0.4054
Cavern Escape	2017-02-20	2229	156	249	2478	0.40399999999999997
4x4 Offroad Racing Nitro	2017-03-10	1	1	3	4	0.40399999999999997
Tribal Siege	2017-06-13	6	1	3	9	0.40399999999999997
Tower Ascent	2017-09-08	3	1	3	6	0.40399999999999997
Songs of Araiah: Re-Mastered Edition	2017-10-13	183	1	3	186	0.40399999999999997
High Templar VR	2017-05-22	3	1	3	6	0.40399999999999997
Fort Awesome	2017-04-04	3	1	3	6	0.40399999999999997
TimeToDie	2017-08-08	2	1	3	5	0.40399999999999997
Spirit Guide Crucible	2017-04-24	2	1	3	5	0.40399999999999997
RXE	2017-07-21	3	1	3	6	0.40399999999999997
PHAT STACKS 2	2017-08-15	2	1	3	5	0.40399999999999997
Keep It Safe 2	2017-06-22	3	1	3	6	0.40399999999999997
Cutlass	2017-07-20	2	1	3	5	0.40399999999999997
Brave	2017-08-18	2	1	3	5	0.40399999999999997
Poseidon - Project Dark Sky	2017-07-19	1	1	3	4	0.40399999999999997
Taking Valhalla VR	2017-10-31	1	1	3	4	0.40399999999999997
GRIM - Mystery of Wasules	2017-10-24	4	1	3	7	0.40399999999999997
Captain vs Sky Pirates	2017-10-10	2	1	3	5	0.40399999999999997
Chicken with Chainguns	2017-11-03	2	1	3	5	0.40399999999999997
DROP VR Audiovisualizer	2017-11-02	2	1	3	5	0.40399999999999997
Olympics VR	2017-11-28	2	1	3	5	0.40399999999999997
Soul Survival	2017-12-09	1	1	3	4	0.40399999999999997
Rasty Pelican	2017-11-15	1	1	3	4	0.40399999999999997
Slice the Ice	2017-12-08	1	1	3	4	0.40399999999999997
In the thrall of darkness: The gift of dreams	2017-12-01	1	1	3	4	0.40399999999999997
The Day They Landed	2017-12-29	3	1	3	6	0.40399999999999997
Rokh	2017-05-16	281	168	268	549	0.4037
Equalizer	2017-08-11	7	36	61	68	0.4035
Atom Universe	2017-12-25	423	167	267	690	0.4033
Glasswinged Ascension	2017-07-21	2	9	17	19	0.4032
Bombastic Cars	2017-11-03	7	9	17	24	0.4032
Justice League VR	2017-12-05	6	9	17	23	0.4032
Global Adventures	2017-12-29	217	66	109	326	0.4031
Sense of The Devil	2017-09-22	8	49	82	90	0.40299999999999997
Survive	2017-08-10	5	21	37	42	0.4025
Hollow	2017-11-17	48	110	179	227	0.4023
Beached	2017-06-29	10	6	12	22	0.402
SK8	2017-11-29	4	6	12	16	0.402
Troll and I™	2017-03-21	7	13	24	31	0.4011
Survivor VR	2017-07-11	3	2	5	8	0.40030000000000004
House Dating VR: Cute Korean Girl, Sehyun	2017-10-25	3	2	5	8	0.40030000000000004
InGame.exe	2017-09-25	1	2	5	6	0.40030000000000004
AgeOfDarkness	2017-11-21	4	2	5	9	0.40030000000000004
VR DREAM MATCH BASEBALL	2017-12-07	4	2	5	9	0.40030000000000004
B A S E M E N T	2017-10-11	1	2	5	6	0.40030000000000004
Camper Jumper Simulator	2017-01-02	10	31	54	64	0.4001
Dark Maze	2017-12-01	4	17	31	35	0.3994
Gold Rush In The Oort Cloud	2017-07-05	2	7	14	16	0.39909999999999995
JUMPER : SPEEDRUN	2017-08-28	7	7	14	21	0.39909999999999995
Super Meat Shooter	2017-11-22	6	32	56	62	0.39890000000000003
Lumber King	2017-08-16	84	54	92	176	0.39880000000000004
Monkey Land 3D: Reaper Rush	2017-02-14	2	3	7	9	0.3972
Redfoot Bluefoot Dancing	2017-06-20	3	3	7	10	0.3972
bead	2017-07-17	6	3	7	13	0.3972
SuperLuminauts	2017-09-01	4	3	7	11	0.3972
Bombinator	2017-05-05	23	37	65	88	0.3968
Pixel Space Battles	2017-11-14	3	25	45	48	0.39670000000000005
Archangel	2017-07-22	3	8	16	19	0.39659999999999995
❂ Heroes of Hexaluga ❂	2017-11-20	4	8	16	20	0.39659999999999995
Coaster of Carnage VR	2017-12-05	3	8	16	19	0.39659999999999995
Insectophobia : Episode 1	2017-07-04	3	12	23	26	0.39630000000000004
Vengeance: Lost Love	2017-06-29	5	19	35	40	0.3962
Road Rage	2017-11-14	6	20	37	43	0.3948
Absent Mind	2017-02-24	2	4	9	11	0.3946
No Mans Land	2017-09-15	3	4	9	12	0.3946
Fish's Trip	2017-09-28	2	4	9	11	0.3946
New Frontier Days ~Founding Pioneers~	2017-06-08	40	9	18	58	0.3945
You, With Me - A Kinetic Novel	2017-02-24	929	9	18	947	0.3945
PRO DRIFT RELOADED	2017-10-11	137	9	18	155	0.3945
Dead Alliance™	2017-08-29	37	46	81	118	0.39420000000000005
News Tycoon	2017-03-24	17	50	88	105	0.3935
Dark Egypt	2017-02-08	1288	35	63	1351	0.39299999999999996
Survival Is Not Enough	2017-07-14	2051	18	34	2085	0.39270000000000005
tick-hunter	2017-07-13	2	5	11	13	0.3924
Project X	2017-09-24	4	5	11	15	0.3924
A Mazeing Tower Defense	2017-08-29	4	5	11	15	0.3924
Telepathy Zero	2017-07-21	14	19	36	50	0.3915
Space Epic Untitled - Season 1	2017-10-28	21	11	22	43	0.391
Man of Law | Judge simulator	2017-12-22	4	6	13	17	0.39049999999999996
Ragnarok Journey	2017-06-12	453	118	204	657	0.3899
Kamikaze Cube	2017-09-15	3	29	54	57	0.3891
Animal Herding	2017-08-01	83	7	15	98	0.3889
VR Triber	2017-10-27	10	7	15	25	0.3889
Snake Party	2017-02-17	1629	13	26	1655	0.3882
The Frost	2017-05-16	3	8	17	20	0.3875
Forgotten Land	2017-10-09	7	39	72	79	0.3873
Sad City 42	2017-12-28	3	14	28	31	0.3871
NightZ	2017-02-15	1499	45	83	1582	0.3859
Crazy Buggy Racing	2017-04-12	1159	42	78	1237	0.3854
OR	2017-02-08	2754	58	106	2860	0.3851
Triple Otakus Puzzle	2017-09-05	13	26	50	63	0.3848
Caveman Alive	2017-10-07	5	35	66	71	0.3847
Wasted Pizza	2017-10-16	32	45	84	116	0.38380000000000003
The Spirit Underneath	2017-01-02	2921	37	70	2991	0.3835
The Adventures of Capitano Navarro	2017-08-04	3	18	36	39	0.3832
Age of Heroes (VR)	2017-07-20	15	12	25	40	0.38310000000000005
Seed Of The Arcane , Episode 1	2017-05-12	4	12	25	29	0.38310000000000005
A Shawn Story	2017-10-05	3	12	25	28	0.38310000000000005
Polterheist	2017-02-22	7985	84	154	8139	0.3812
The Thirst of Hearts	2017-08-26	19	47	89	108	0.38070000000000004
Hide vs. Seek	2017-08-08	119	222	394	513	0.38060000000000005
BrotherZ	2017-06-03	4	4	10	14	0.3805
Gamers Unknown Survival	2017-09-10	4	4	10	14	0.3805
The Promethium Effect - The Idle Clicker MMO	2017-11-27	10	4	10	20	0.3805
Wild Downtown	2017-12-28	2	4	10	12	0.3805
Bravery: Rise of The Last Hero	2017-05-25	59	5	12	71	0.3804
Ancient Worlds: Jaguar's Fate	2017-08-16	2	5	12	14	0.3804
Jewels of the Mysterious Woodland	2017-08-10	6	3	8	14	0.3803
Vacant	2017-08-19	3	3	8	11	0.3803
Hydroactive	2017-12-04	66	3	8	74	0.3803
Backgammon	2017-08-28	6	6	14	20	0.38
Hardcore ZBoy	2017-09-22	3	23	46	49	0.3797
Dyana Moto	2017-11-01	2	7	16	18	0.37950000000000006
Lab 03 Yrinth	2017-11-17	2	7	16	18	0.37950000000000006
Lux umbra	2017-09-17	2	2	6	8	0.379
Ishin no Arashi	2017-03-21	11	2	6	17	0.379
CRAFT BATTLE SIMULATOR	2017-06-13	4	2	6	10	0.379
Be Quiet!	2017-07-31	4	2	6	10	0.379
Squadron: Sky Guardians	2017-07-14	2	2	6	8	0.379
Around the Words	2017-08-08	3	2	6	9	0.379
Nightmare at the lighthouse	2017-08-15	2	2	6	8	0.379
Guitar Hardness	2017-09-13	3	2	6	9	0.379
The Flight Of Dowran	2017-10-24	1	2	6	7	0.379
NOLA is Burning	2017-11-17	3	2	6	9	0.379
Old School FOTD	2017-10-26	4	25	50	54	0.3786
Crazy Scientist	2017-09-19	3	38	74	77	0.378
Ruin City Gasolina	2017-08-16	47	29	58	105	0.3766
Beachhead 2000	2017-05-02	4	14	30	34	0.376
Undead Blackout: Reanimated Edition	2017-02-03	3	1	4	7	0.3749
Super Toaster X: Learn Japanese RPG	2017-01-22	3	1	4	7	0.3749
Trickshot	2017-04-07	4	1	4	8	0.3749
Enigma Sphere: Enhanced Edition	2017-03-31	7	1	4	11	0.3749
Star Hunter VR	2017-03-18	2	1	4	6	0.3749
Escape The Gray	2017-06-01	2	1	4	6	0.3749
Yama	2017-08-28	1	1	4	5	0.3749
Sellsword VR	2017-09-30	2	1	4	6	0.3749
Elly The Jelly	2017-08-04	4	1	4	8	0.3749
Pooper Scooper	2017-10-13	3	1	4	7	0.3749
鉄道運転士VR	2017-11-14	3	1	4	7	0.3749
Yago, the Coquerrestrial	2017-11-01	2	1	4	6	0.3749
Phantom	2017-05-27	51	58	113	164	0.37329999999999997
Heavy Gear Assault	2017-02-10	472	83	159	631	0.373
Hooligan Vasja: Halloween	2017-07-08	4	23	48	52	0.3725
Northern Regime	2017-02-17	14	9	21	35	0.3711
69 Ways to Kill a Zombie	2017-06-09	431	9	21	452	0.3711
Survivalizm The Animal Survival Simulator	2017-04-05	6	9	21	27	0.3711
Harald	2017-09-28	11	7	17	28	0.37070000000000003
Bullyparade - DER Spiel	2017-08-10	4	6	15	19	0.37020000000000003
龙魂时刻	2017-06-28	921	472	864	1785	0.3701
Filthy, Stinking, Orcs!	2017-04-21	4	5	13	17	0.3694
Please	2017-06-24	2	5	13	15	0.3694
Football Mogul 18	2017-09-19	13	5	13	26	0.3694
Project Remedium	2017-08-29	136	46	93	229	0.3691
Delphinia Chronicle	2017-06-15	10	4	11	21	0.3679
Dark Rising	2017-10-20	4	4	11	15	0.3679
Lost in the Forest	2017-09-30	3	21	46	49	0.3658
Holy Avenger	2017-11-15	5	15	34	39	0.3658
Pixel Shooter	2017-07-03	6	56	114	120	0.3657
Candy Machine	2017-04-24	2222	14	32	2254	0.3657
Super ComboMan: Smash Edition	2017-08-22	4	3	9	13	0.3655
THOSE DAMN ALIENS VR	2017-02-15	15	3	9	24	0.3655
Where is my Brain!?	2017-03-10	22	3	9	31	0.3655
Wisdom of War	2017-06-06	3	3	9	12	0.3655
Nightork Adventures 2 - Legacy of Chaos	2017-09-04	2	12	28	30	0.3654
StockUp	2017-09-18	3	10	24	27	0.36469999999999997
On Board Game	2017-12-07	2	7	18	20	0.3625
位面穿越者-三国传(A Bit Crosser-Three Kingdoms)	2017-07-26	54	31	67	121	0.3624
Immortal Heroes	2017-11-24	7	33	71	78	0.36229999999999996
The Slopes	2017-05-19	2	2	7	9	0.3611
Sea Battle VR	2017-11-24	4	2	7	11	0.3611
Crawl Space: The Mansion	2017-10-26	4	2	7	11	0.3611
Last Hope	2017-12-31	2	2	7	9	0.3611
Virtual Reality Girls 2	2017-12-25	5	2	7	12	0.3611
Ancient Siberia	2017-12-11	24	82	168	192	0.36060000000000003
Heavily Armed	2017-06-16	791	12	29	820	0.36
Merri Puzzle	2017-06-22	13	12	29	42	0.36
CrazyCar	2017-07-27	3	27	60	63	0.35960000000000003
Forest Guardian	2017-09-04	4	27	60	64	0.35960000000000003
Santa Run	2017-12-12	2	11	27	29	0.3594
ProtoMasons	2017-10-03	5	0	2	7	0.3592
Daydream Blue	2017-01-25	2	0	2	4	0.3592
Shadow Circuit	2017-03-21	2	0	2	4	0.3592
30th Century Post Office	2017-04-27	1	0	2	3	0.3592
Caelum: Into the Sky	2017-06-08	2	0	2	4	0.3592
Treasure Bolt	2017-12-18	1	0	2	3	0.3592
Bullet Dodge	2017-06-15	2	0	2	4	0.3592
HOCKEY SPACE	2017-07-20	1	0	2	3	0.3592
Rain of Pumpkins	2017-10-23	2	0	2	4	0.3592
Bottle_Shooter	2017-09-12	1	0	2	3	0.3592
Memories of Home	2017-07-31	2	0	2	4	0.3592
Derelict Fleet	2017-07-11	2	0	2	4	0.3592
Princess Sahirah is a Spoiled Brat!	2017-07-23	2	0	2	4	0.3592
Loneliness Early Acess	2017-10-09	3	0	2	5	0.3592
Darts VR	2017-08-07	2	0	2	4	0.3592
Solmec: Colony Adrift	2017-09-05	2	0	2	4	0.3592
CanBoom VR	2017-08-22	2	0	2	4	0.3592
Zombies Berserk	2017-09-20	1	0	2	3	0.3592
Tooth and Claw	2017-12-19	11	0	2	13	0.3592
The market trader	2017-09-12	1	0	2	3	0.3592
Blast	2017-09-12	1	0	2	3	0.3592
麻将VR	2017-09-23	3	0	2	5	0.3592
Duel Survival	2017-10-06	1	0	2	3	0.3592
Bubble Rush	2017-09-30	2	0	2	4	0.3592
Drone Infiltrator	2017-12-18	1	0	2	3	0.3592
Gems	2017-11-01	1	0	2	3	0.3592
AF-ZERO	2017-11-28	1	0	2	3	0.3592
Barrimean Jungle	2017-11-21	1	0	2	3	0.3592
Code Name: Origin	2017-12-28	2	0	2	4	0.3592
A Plot Story	2017-09-21	9	20	46	55	0.3586
Horse Racing 2016	2017-07-14	3	10	25	28	0.3586
idleBeer	2017-08-31	3027	16	38	3065	0.35729999999999995
Dragon Perception	2017-10-27	5	15	36	41	0.3568
RoadkillerZ	2017-05-30	3	4	12	15	0.3565
Numberline 2	2017-07-14	7	8	21	28	0.3564
akda	2017-12-27	7	23	53	60	0.35600000000000004
Home Darkness - Escape	2017-12-15	3	13	32	35	0.3556
Deformers	2017-04-21	98	56	121	219	0.355
Hot Pool	2017-11-20	3	7	19	22	0.35479999999999995
Retro Miami	2017-12-14	3	18	43	46	0.3542
Urban Empire	2017-01-20	5840	820	1602	7442	0.354
Save Our Souls: Episode I - The Absurd Hopes Of Blessed Children	2017-03-13	10	11	28	38	0.35380000000000006
BoxMaker	2017-08-08	8	32	73	81	0.3527
Armored Freedom	2017-07-21	37	6	17	54	0.3527
NOBUNAGA'S AMBITION: Sengoku Gunyuuden	2017-02-22	18	1	5	23	0.3522
Chaos Edge	2017-04-05	2	1	5	7	0.3522
Samhain World	2017-04-27	2043	1	5	2048	0.3522
The 37th Week	2017-12-08	1	1	5	6	0.3522
Survivor of Eschewal	2017-11-03	3	1	5	8	0.3522
The Silence Outside	2017-11-27	2	1	5	7	0.3522
VEHICLES_FURY	2017-12-19	4	1	5	9	0.3522
Air Dash	2017-12-15	2	1	5	7	0.3522
OutBreak: The Escape	2017-12-28	3	1	5	8	0.3522
Bunker 58	2017-06-07	1725	42	95	1820	0.3505
Ethereal Legends	2017-02-21	13	5	15	28	0.35000000000000003
Super Mr. Kake	2017-09-12	3	5	15	18	0.35000000000000003
The Lost Wizard	2017-10-19	3	11	29	32	0.3486
Station 228	2017-11-23	3	11	29	32	0.3486
VR Chair Games	2017-04-04	637	7	20	657	0.34750000000000003
Restaurant Tycoon	2017-12-05	2	4	13	15	0.3462
O'Fox life	2017-10-31	24	39	91	115	0.3461
Store Manager: Cellular Edition	2017-03-31	11	21	52	63	0.3458
Skills Hockey VR	2017-02-23	3	2	8	11	0.3458
Community Garden	2017-10-10	1106	2	8	1114	0.3458
Learn (Japanese) Kana The Fun Way!	2017-09-29	2	2	8	10	0.3458
Super Bomb Rush!	2017-04-20	2	6	18	20	0.34490000000000004
The Doorbreaker	2017-10-17	10	11	30	40	0.3435
ChefU	2017-08-28	8	17	44	52	0.34259999999999996
Son Korsan	2017-06-28	30	34	82	112	0.34240000000000004
MineFight	2017-09-23	35	44	104	139	0.3422
Clicker bAdventure	2017-12-27	28	24	60	88	0.342
Taken Souls: Blood Ritual Collector's Edition	2017-02-03	9	16	42	51	0.34149999999999997
Awakening: The Golden Age Collector's Edition	2017-02-01	4	5	16	20	0.34140000000000004
Crash Test Billy	2017-08-19	3	3	11	14	0.3407
Daemonsgate	2017-10-25	3	3	11	14	0.3407
Save the Halloween	2017-11-10	3	12	33	36	0.3404
Employee Recycling Center	2017-05-15	708	38	92	800	0.34020000000000006
Sullen: Light is Your Friend	2017-07-22	1782	14	38	1820	0.33909999999999996
Inferno Puzzle	2017-07-01	4	11	31	35	0.3386
Phobia	2017-06-09	3	16	43	46	0.3379
MEG 9: Lost Echoes	2017-09-21	3	4	14	17	0.3367
Heroes of Civilizations	2017-08-12	14	14	39	53	0.3351
Woodlands	2017-09-27	96	92	216	312	0.3345
symeCu8e	2017-07-04	2	1	6	8	0.33380000000000004
Distant Nightmare	2017-06-30	2	1	6	8	0.33380000000000004
DarkMaze	2017-07-08	2	1	6	8	0.33380000000000004
Dawn of the killer zombies	2017-07-08	2	1	6	8	0.33380000000000004
Police Adventure	2017-08-08	2	1	6	8	0.33380000000000004
Gnome Light	2017-07-31	1	5	17	18	0.33340000000000003
President Evil	2017-09-30	4	5	17	21	0.33340000000000003
Fight desserts	2017-12-02	2	5	17	19	0.33340000000000003
Eared Hero	2017-09-29	4	42	105	109	0.3333
Airport Master	2017-02-17	7	15	42	49	0.3329
One Sole Purpose	2017-05-16	7	2	9	16	0.33240000000000003
Elevator VR	2017-05-15	2	2	9	11	0.33240000000000003
AHTS Ship Simulator	2017-07-25	1	2	9	10	0.33240000000000003
DrumSim	2017-09-25	3	2	9	12	0.33240000000000003
Micro Machines World Series	2017-06-29	248	164	378	626	0.3322
Premier Buggy Racing Tour	2017-10-10	3	10	30	33	0.33170000000000005
Kommissar	2017-04-06	7	8	25	32	0.3315
TAIKU MANSION	2017-02-14	1483	102	243	1726	0.3308
EEP Train Simulator Mission	2017-04-05	4	3	12	16	0.33020000000000005
Heroes Never Die	2017-07-07	3	3	12	15	0.33020000000000005
Basketball Court VR	2017-04-04	2	0	3	5	0.32939999999999997
Free Towns	2017-03-24	3	0	3	6	0.32939999999999997
RetroFighter VR	2017-05-06	1	0	3	4	0.32939999999999997
Bleeding Kansas	2017-07-23	2	0	3	5	0.32939999999999997
伝創記IV ~if~	2017-08-10	2	0	3	5	0.32939999999999997
Dormant World	2017-09-04	2	0	3	5	0.32939999999999997
Tales of Glacier (VR)	2017-09-04	2	0	3	5	0.32939999999999997
Tetsoidea Eternal	2017-08-07	3	0	3	6	0.32939999999999997
Infinity Assassin (VR)	2017-09-02	2	0	3	5	0.32939999999999997
Pirate Jump 2	2017-08-23	1	0	3	4	0.32939999999999997
The Legendary Player - Make Your Reputation	2017-11-10	1	0	3	4	0.32939999999999997
Captive of Fortune	2017-12-19	6	0	3	9	0.32939999999999997
Crazy Toad	2017-10-03	2	0	3	5	0.32939999999999997
Virality	2017-10-30	2	0	3	5	0.32939999999999997
Chopper Battle New Horizon	2017-11-25	1	0	3	4	0.32939999999999997
Escape Room	2017-12-12	9	7	23	32	0.3282
Draw Your Game	2017-08-10	15	18	52	67	0.3245
Hidden Object - Sweet Home	2017-10-16	8	35	95	103	0.3224
3D Tower	2017-11-15	9	36	98	107	0.3215
The Sorceress	2017-02-01	6	3	13	19	0.3207
Forgotten Faces	2017-07-25	20	3	13	33	0.3207
Red Barton and The Sky Pirates	2017-03-14	3	2	10	13	0.3207
Shattered God - Quest for the Divine Relic	2017-06-26	3	2	10	13	0.3207
VR Drivers	2017-10-05	6	2	10	16	0.3207
Trolley Gold	2017-03-17	1600	66	172	1772	0.3201
Deer Hunter: Reloaded	2017-10-24	7	4	16	23	0.32
Terrorist Elimination	2017-11-07	2	4	16	18	0.32
Singularity Roller	2017-08-13	6	9	30	36	0.3195
Fortune's Tavern - Fantasy Tavern Simulation, Remastered	2017-08-18	6	1	7	13	0.3185
Alimardan Meets Merlin	2017-08-24	3	1	7	10	0.3185
DinosaurIsland	2017-09-04	3	1	7	10	0.3185
Call of Nightmare	2017-10-14	3	1	7	10	0.3185
★ Fallalypse ★	2017-09-12	5	13	41	46	0.31829999999999997
NaziShoot	2017-10-12	3	10	33	36	0.3182
Bystander	2017-12-15	13	9	31	44	0.3149
SnipZ	2017-03-24	3	7	26	29	0.31170000000000003
Little Adventurer II	2017-09-21	2	2	11	13	0.3103
Tactics: Bludgeons Blessing	2017-07-04	2	0	4	6	0.308
Hack Time	2017-07-18	5	0	4	9	0.308
Paper Toss VR	2017-03-10	3	0	4	7	0.308
Encounter of Galaxies	2017-04-17	2	0	4	6	0.308
Beetlejuice: Bad as Can	2017-09-25	1	0	4	5	0.308
The Legend of Slime	2017-10-13	2	0	4	6	0.308
Armed Warrior VR	2017-11-01	2	0	4	6	0.308
Cyber Arena	2017-10-27	2	0	4	6	0.308
RageBall	2017-09-30	3	4	18	21	0.3056
Medusa's Labyrinth VR	2017-05-24	3	1	8	11	0.3056
Lemuria: Lost in Space - VR Edition	2017-08-04	2	1	8	10	0.3056
Wheel Riders Online OBT	2017-12-27	77	66	189	266	0.3043
Tearstone	2017-06-19	5	3	15	20	0.3041
Signs Of Darkness	2017-12-15	6	12	43	49	0.30210000000000004
TennisVR	2017-04-19	2	2	12	14	0.3009
Dream Pets VR	2017-11-01	9	5	22	31	0.3006
You Are God	2017-05-19	9	8	32	41	0.2981
HJ: Sacrifice	2017-12-13	2	8	32	34	0.2981
Heroes of Myths - Warriors of Gods	2017-12-07	3	3	16	19	0.2967
Fallen Cube	2017-07-14	4	6	26	30	0.29660000000000003
Megatronic Void	2017-09-20	2	6	26	28	0.29660000000000003
Buildanauts	2017-05-04	19	13	49	68	0.29309999999999997
Soldiers Of Freedom	2017-09-08	3	2	13	16	0.2925
The Breeding: The Fog	2017-12-01	3	6	27	30	0.2919
The Darkness	2017-12-29	3	6	27	30	0.2919
Hollow Halls	2017-01-19	9	0	5	14	0.2916
Block Robot Mini Survival Game	2017-07-07	3	0	5	8	0.2916
Distorted Reality	2017-08-05	6	14	53	59	0.2907
Killer Elite – Time to Die	2017-04-28	3964	4	21	3985	0.28750000000000003
Spirit of the Ancient Forest	2017-07-20	6	7	32	38	0.2851
Deadly Animal Duel	2017-09-12	28967	9	39	29006	0.2843
Street of Sanctuary VR	2017-01-15	4	0	6	10	0.2783
Virtual Robots - Robot programming simulator	2017-11-01	2	0	6	8	0.2783
Mahjong Match	2017-09-19	2	0	6	8	0.2783
Tevris	2017-11-24	2	0	6	8	0.2783
HUNGER	2017-06-21	16	1	11	27	0.2758
CAR THIEF SIMULATOR 2017	2017-10-18	2	1	11	13	0.2758
Dragon of Legends	2017-12-16	11	5	28	39	0.2721
Super Death Arena	2017-01-11	14	15	66	80	0.2687
CloudCity VR	2017-07-13	4	1	12	16	0.2681
Relic Keepers	2017-09-12	2	1	12	14	0.2681
Hidden Object - Food	2017-09-25	3	1	12	15	0.2681
Galaxy of Drones	2017-08-01	2	0	7	9	0.26739999999999997
Space Wrangler	2017-09-29	2	0	7	9	0.26739999999999997
Red Planet: Survive	2017-09-14	6	8	41	47	0.267
Bomb Defense	2017-07-05	15	20	89	104	0.2604
Star Dust: The Book of Earth (VR)	2017-05-12	3	0	8	11	0.2581
Valknut	2017-12-22	8	5	32	40	0.2572
Rise of Man	2017-09-15	19	26	114	133	0.2566
Seduction	2017-07-22	9	11	59	68	0.2522
A New World: Kingdoms	2017-10-05	5	0	9	14	0.25
Death penalty: Beginning 	2017-01-23	33	31	140	173	0.249
Crafting Tycoon	2017-12-15	3	0	10	13	0.2429
Vickinachi	2017-07-18	34	35	173	207	0.2347
Chess	2017-09-19	5	1	18	23	0.23420000000000002
F.E.X (Forced Evolution Experiment)	2017-08-24	11	6	50	61	0.22350000000000003
Pro Gamer Manager 2	2017-10-05	90	24	142	232	0.2207
Storm Riders	2017-04-25	44	60	307	351	0.22030000000000002
Urban War Defense	2017-07-08	137	3	78	215	0.15990000000000001
Stardew Valley	2016-02-26	94879	547823	9918	104797	0.9732
OneShot	2016-12-09	824	34234	619	1443	0.9615000000000001
VA-11 Hall-A: Cyberpunk Bartender Action	2016-06-21	1574	30686	739	2313	0.9554
American Truck Simulator	2016-02-02	19153	121033	4212	23365	0.9528
Iron Snout	2016-01-27	1373	16627	372	1745	0.9526000000000001
The Room Two	2016-07-05	401	15738	355	756	0.9521
Don't Starve Together	2016-04-21	68418	369233	15241	83659	0.9508
STEINS;GATE	2016-09-09	1238	14065	360	1598	0.9485
INSIDE	2016-07-07	4170	44760	1572	5742	0.9477
Hot Dogs, Horseshoes & Hand Grenades	2016-04-05	992	17268	532	1524	0.9454000000000001
Sally Face - Episode One	2016-12-14	2107	14350	437	2544	0.9443000000000001
Enter the Gungeon	2016-04-05	15792	69355	2919	18711	0.9438
NEKOPARA Vol. 2	2016-02-20	1228	11967	356	1584	0.9435
Shadow Tactics: Blades of the Shogun	2016-12-06	5037	32263	1285	6322	0.9417
Danganronpa 2: Goodbye Despair	2016-04-19	1869	21261	793	2662	0.9412
DOOM	2016-05-13	44271	169008	8349	52620	0.941
Danganronpa: Trigger Happy Havoc	2016-02-18	3392	24441	965	4357	0.9401999999999999
Ultimate Chicken Horse	2016-03-04	2744	31790	1321	4065	0.9400000000000001
Rabi-Ribi	2016-01-28	693	10299	335	1028	0.9398000000000001
Ori and the Blind Forest: Definitive Edition	2016-04-27	9079	54867	2497	11576	0.9396
Glass Masquerade	2016-11-18	29689	5651	169	29858	0.9363
Human: Fall Flat	2016-07-22	127517	172793	9628	137145	0.9356
Kingdom Rush Frontiers	2016-07-25	981	6706	222	1203	0.9353
The Jackbox Party Pack 3	2016-10-18	10972	5081	153	11125	0.935
TY the Tasmanian Tiger	2016-12-12	230	2329	45	275	0.9347
Princess Remedy in a World of Hurt	2016-01-01	177	2701	64	241	0.9329999999999999
klocki	2016-07-13	438	4383	135	573	0.9328000000000001
Bit Blaster XL	2016-01-22	1501	5902	206	1707	0.9325
Mad Father	2016-09-23	233	3862	117	350	0.9318000000000001
Blood and Bacon	2016-02-01	762	28963	1474	2236	0.9314
DARK SOULS™ III	2016-04-11	129975	327524	20628	150603	0.9313
Day of the Tentacle Remastered	2016-03-22	1097	3737	116	1213	0.9308
Rusty Lake: Roots	2016-10-20	394	5518	201	595	0.9305
Pony Island	2016-01-04	374	13139	641	1015	0.9277
Plague Inc: Evolved	2016-02-18	17889	44481	2600	20489	0.9273
Montaro	2016-07-26	1001	11588	566	1567	0.9267000000000001
Rise of the Tomb Raider	2016-01-28	44588	109913	7053	51641	0.9266
Rusty Lake Hotel	2016-01-29	5038	6457	283	5321	0.9258
Songs for a Hero - Definitive Edition	2016-03-25	616	3115	112	728	0.9244
Devil Daggers	2016-02-18	358	7660	364	722	0.9243000000000001
My Summer Car	2016-10-24	5509	49035	3091	8600	0.9239
Zup! 2	2016-12-05	376	6098	279	655	0.9236
DEADBOLT	2016-03-14	501	4476	188	689	0.9235
LiEat	2016-02-26	155	3953	163	318	0.9228000000000001
Grim Dawn	2016-02-25	61458	77751	5339	66797	0.9213
EARTH DEFENSE FORCE 4.1 The Shadow of New Despair	2016-07-19	5940	8158	426	6366	0.9209
Lucy -The Eternity She Wished For-	2016-02-29	193	7171	367	560	0.9206000000000001
SpeedRunners	2016-04-19	17212	32433	2095	19307	0.9204000000000001
Crazy Machines 3	2016-10-18	1114	8791	488	1602	0.9188
Trick & Treat	2016-09-26	637	2103	78	715	0.9184000000000001
Epic Battle Fantasy 3	2016-09-01	403	1739	59	462	0.9181999999999999
The Lab	2016-04-05	927	5395	277	1204	0.9177
Epistory - Typing Chronicles	2016-03-30	400	5765	308	708	0.9167000000000001
Kindred Spirits on the Roof	2016-02-12	228	1135	32	260	0.9162
Hello Charlotte	2016-11-21	27	1105	31	58	0.9159
Scrap Mechanic	2016-01-20	46643	89999	6854	53497	0.9157
Transmissions: Element 120	2016-06-16	790	8853	526	1316	0.9156000000000001
Mandagon	2016-08-03	257	5213	279	536	0.9156000000000001
Starbound	2016-07-22	88709	148564	11723	100432	0.9153
Sven Co-op	2016-01-22	6572	25247	1742	8314	0.9153
The House in Fata Morgana	2016-05-13	105	3147	150	255	0.9148000000000001
FINAL FANTASY IX	2016-04-14	8229	8671	525	8754	0.9145000000000001
Brick Rigs	2016-11-07	2460	29621	2122	4582	0.914
Shakes and Fidget	2016-02-25	9495	27910	1993	11488	0.9139
Farming Simulator 17	2016-10-24	32313	20775	1448	33761	0.9135
SHENZHEN I/O	2016-11-17	1170	3428	173	1343	0.9135
Higurashi When They Cry Hou - Ch.3 Tatarigoroshi	2016-06-17	65	646	12	77	0.9135
Zup!	2016-10-04	1029	7854	480	1509	0.9131999999999999
Wuppo - Definitive Edition	2016-09-29	2273	4744	263	2536	0.913
Google Earth VR	2016-11-16	791	3316	168	959	0.913
Hyper Light Drifter	2016-03-31	4954	15085	1038	5992	0.912
Momodora: Reverie Under the Moonlight	2016-03-04	693	9402	606	1299	0.912
Brigador: Up-Armored Edition	2016-06-02	616	4543	257	873	0.9117000000000001
Tayutama 2 -you're the only one-	2016-12-09	155	2213	102	257	0.9117000000000001
GUILTY GEAR Xrd REV 2	2016-12-14	3455	8339	531	3986	0.9116
Eleven Table Tennis	2016-09-22	147	2868	148	295	0.9105
Zenge	2016-04-12	847	2798	145	992	0.91
PRICE	2016-09-16	660	4657	275	935	0.9098999999999999
Samorost 3	2016-03-24	468	3804	215	683	0.9098
Waltz of the Wizard (Legacy demo)	2016-05-31	406	1376	55	461	0.9098
SENRAN KAGURA SHINOVI VERSUS	2016-06-01	1048	3513	195	1243	0.9097
Master of Orion 2	2016-02-25	283	1171	44	327	0.9091
Hearts of Iron IV	2016-06-06	70997	207480	18316	89313	0.9086
ABZÛ	2016-08-02	1329	21513	1635	2964	0.9085
SteamWorld Heist	2016-06-07	1120	4589	279	1399	0.9083
Megadimension Neptunia VII	2016-07-05	1161	2945	164	1325	0.9075
Clustertruck	2016-09-27	2658	12581	919	3577	0.9073000000000001
Zeus + Poseidon	2016-12-15	337	1308	55	392	0.9073000000000001
SEUM: Speedrunners from Hell	2016-07-28	852	2688	147	999	0.9072
The Elder Scrolls V: Skyrim Special Edition	2016-10-28	69906	228217	20845	90751	0.9064
Angels of Death	2016-12-20	245	3852	236	481	0.9061
Highway Blossoms	2016-06-17	146	2333	126	272	0.9059999999999999
Umineko When They Cry - Question Arcs	2016-07-08	145	1502	70	215	0.9058
Flowers -Le volume sur printemps-	2016-08-17	65	1434	67	132	0.905
Khimera: Destroy All Monster Girls	2016-05-09	99	1261	57	156	0.9042
Creeper World Anniversary Edition	2016-11-16	168	654	20	188	0.9042
Ara Fell: Enhanced Edition	2016-06-02	226	1653	85	311	0.9034000000000001
Narcissu 10th Anniversary Anthology Project	2016-01-27	70	512	13	83	0.9032
BLUE REVOLVER	2016-10-11	49	393	7	56	0.9031
Turmoil	2016-06-02	5055	10476	807	5862	0.9027
Stephen's Sausage Roll	2016-04-18	90	1272	61	151	0.9022
Darkest Dungeon®	2016-01-19	19357	112489	10554	29911	0.9020999999999999
ACE Academy	2016-08-22	132	1387	69	201	0.9020999999999999
Brief Karate Foolish	2016-11-18	314	2485	149	463	0.902
Recursed	2016-09-30	24	419	9	33	0.9017000000000001
Death Road to Canada	2016-07-22	491	6775	510	1001	0.9004000000000001
N++	2016-08-25	522	2627	167	689	0.8998
The Count Lucanor	2016-03-03	89	2020	121	210	0.8994
Higurashi When They Cry Hou - Ch.4 Himatsubushi	2016-10-14	68	450	12	80	0.8993000000000001
Oxenfree	2016-01-15	733	9786	789	1522	0.8992
Melody's Escape	2016-05-20	370	4489	334	704	0.8972
FORTIFY	2016-08-10	374	1806	110	484	0.8971
Lazerbait	2016-10-14	15	474	15	30	0.8966
NARUTO SHIPPUDEN: Ultimate Ninja STORM 4	2016-02-04	7185	69067	6813	13998	0.8963
Planet Coaster	2016-11-17	21971	53675	5221	27192	0.8963
Hue	2016-08-30	59	1844	115	174	0.8962000000000001
Beholder	2016-11-09	7817	21387	1967	9784	0.8956000000000001
Tattletail	2016-12-28	155	2991	212	367	0.8956000000000001
DoDonPachi Resurrection	2016-10-14	328	770	36	364	0.8946
Season of 12 Colors	2016-03-14	91	1852	121	212	0.8940000000000001
Titan Quest Anniversary Edition	2016-08-31	19497	27723	2691	22188	0.8931
MELTY BLOOD Actress Again Current Code	2016-04-20	2068	3509	268	2336	0.8931
Motorsport Manager	2016-11-10	6251	11290	1017	7268	0.8929
Poly Bridge	2016-07-12	4134	14330	1325	5459	0.8926999999999999
Deathsmiles	2016-03-10	191	461	17	208	0.892
Accounting	2016-10-18	244	2292	164	408	0.8919
Supipara - Chapter 1 Spring Has Come!	2016-07-29	26	224	3	29	0.8918
Slayaway Camp	2016-10-25	186	728	36	222	0.8915000000000001
Picross Touch	2016-08-24	239	1289	80	319	0.8914
Zombie Night Terror	2016-07-20	480	2860	217	697	0.8912000000000001
Chicken Invaders 2	2016-03-04	103	369	12	115	0.8903
Harmonia	2016-09-23	70	533	24	94	0.8887999999999999
POSTAL Redux	2016-05-20	628	3855	322	950	0.8885
Kathy Rain	2016-05-05	348015	3291	268	348283	0.8885
SUPERHOT	2016-02-25	5584	30579	3183	8767	0.8881
Wild Animal Racing	2016-03-07	74	2369	184	258	0.8876000000000001
Tilt Brush	2016-04-05	233	1098	70	303	0.8876000000000001
Bloons TD Battles	2016-04-20	2634	24639	2551	5185	0.8874
Orwell	2016-10-27	154375	12771	1254	155629	0.8874
ICEY	2016-11-17	3240	21610	2225	5465	0.8871
Bot Vice	2016-07-11	47	1154	76	123	0.8868
Lara Croft GO	2016-12-04	397	2945	242	639	0.8867
Valley	2016-08-24	483	5820	533	1016	0.8863
Five Nights at Freddy's: Sister Location	2016-10-07	3549	8865	857	4406	0.8859
KNIGHTS	2016-05-30	653	660	36	689	0.8858
The Lion's Song	2016-07-07	272	1959	151	423	0.8856999999999999
GAROU: MARK OF THE WOLVES	2016-12-07	95	746	43	138	0.8856999999999999
Lost Lands: Mahjong	2016-03-14	443	4532	406	849	0.8855
UnReal World	2016-02-26	249	1063	70	319	0.8855
FINAL FANTASY X/X-2 HD Remaster	2016-05-12	13263	14249	1455	14718	0.8851000000000001
Downfall	2016-02-15	98	1070	72	170	0.8845000000000001
Overcooked	2016-08-03	1195	12013	1223	2418	0.8842
Thumper	2016-10-10	246	3408	298	544	0.8842
IMSCARED	2016-02-03	158	1673	128	286	0.8840000000000001
Hyperdimension Neptunia U: Action Unleashed	2016-03-21	1249	2721	232	1481	0.8834000000000001
Furi	2016-07-05	640	9603	969	1609	0.8832
Crush Crush	2016-10-19	4512	20817	2246	6758	0.883
VR The Diner Duo	2016-11-03	53	398	18	71	0.8824
Tricky Towers	2016-08-02	1002	11984	1250	2252	0.8823000000000001
The Last Door: Season 2 - Collector's Edition	2016-03-29	64	751	47	111	0.8821
We Know the Devil	2016-02-15	32	750	47	79	0.882
Quern - Undying Thoughts	2016-11-28	437	2794	245	682	0.8819
Dragon's Dogma: Dark Arisen	2016-01-15	27368	29329	3292	30660	0.8815999999999999
Allumette	2016-10-13	25	553	31	56	0.8813
Heart's Medicine - Time to Heal	2016-09-20	216	784	51	267	0.881
Princess Maker 2 Refine	2016-09-28	245	1261	95	340	0.8809
Move or Die	2016-01-21	2038	19672	2175	4213	0.8806999999999999
Tower Unite	2016-04-08	1603	16228	1770	3373	0.8806
Salt and Sanctuary	2016-05-17	2430	15948	1751	4181	0.88
PAC-MAN 256	2016-06-21	245	1642	135	380	0.8795000000000001
I and Me	2016-05-05	21	339	15	36	0.8795000000000001
STAR WARS™ Galactic Battlegrounds Saga	2016-03-01	485	3277	306	791	0.8793000000000001
The Herbalist	2016-11-15	216	588	36	252	0.8786
DRAGON BALL XENOVERSE 2	2016-10-27	19416	36121	4255	23671	0.8784000000000001
Curious Expedition	2016-09-02	1038	3525	338	1376	0.8782
Corinne Cross's Dead & Breakfast	2016-08-18	8	127	1	9	0.8782
Aragami	2016-10-04	1713	10291	1115	2828	0.8781
Overload Playable Teaser	2016-03-08	74	628	40	114	0.878
Disturbed	2016-10-03	110	1536	128	238	0.8776999999999999
Mimpi Dreams	2016-03-22	52	746	51	103	0.8776999999999999
VOI	2016-11-07	1342	687	46	1388	0.8773000000000001
SHENZHEN SOLITAIRE	2016-12-15	22	174	4	26	0.8773000000000001
Corona Blossom Vol.1 Gift From the Galaxy	2016-07-28	87	272	11	98	0.8769
The Sea Will Claim Everything	2016-03-24	16	202	6	22	0.8768000000000001
Soda Drinker Pro	2016-04-14	21	560	35	56	0.8767
Hustle Cat	2016-03-16	111	1118	88	199	0.8765999999999999
IS Defense	2016-04-19	172	1345	111	283	0.8765000000000001
Eventide: Slavic Fable	2016-01-28	166	687	47	213	0.8762000000000001
Polandball: Can into Space!	2016-06-15	47	476	28	75	0.8762000000000001
NEKOPALIVE	2016-05-31	94	1334	111	205	0.8758
Tadpole Treble	2016-09-02	201	266	11	212	0.8756999999999999
Oh...Sir! The Insult Simulator	2016-10-25	1193	3203	314	1507	0.8756
Particle Fleet: Emergence	2016-09-29	932	979	76	1008	0.8753000000000001
Lost Lands: The Golden Curse	2016-03-24	41	443	26	67	0.8748
Learn Japanese To Survive - Hiragana Battle	2016-02-17	495	1767	159	654	0.8745999999999999
Mad Games Tycoon	2016-09-13	1434	3957	405	1839	0.8745
Caesar 3	2016-08-29	434	1386	119	553	0.8744
Chicken Assassin: Reloaded	2016-06-28	80	784	58	138	0.8744
Predynastic Egypt	2016-10-10	295	1574	139	434	0.8743000000000001
Gnomes & Goblins (preview)	2016-09-08	18	483	30	48	0.8741
Firewatch	2016-02-09	17568	53455	6733	24301	0.8740000000000001
Orbox C	2016-12-28	4782	177	5	4787	0.8740000000000001
Stellaris	2016-05-09	68602	129186	16879	85481	0.8737
Adam Wolfe	2016-10-07	116	918	72	188	0.8737
Champions of Breakfast	2016-06-23	12	130	2	14	0.8736
Sisyphus Reborn	2016-09-05	42	865	67	109	0.8734999999999999
Sakura Dungeon	2016-06-03	551	1667	151	702	0.8734000000000001
Red Comrades Save the Galaxy: Reloaded	2016-02-18	227	628	44	271	0.8733
BlazBlue: Chronophantasma Extend	2016-03-02	1107	2492	243	1350	0.8732
Panzermadels: Tank Dating Simulator	2016-03-09	80	1344	117	197	0.8731
Coffin of Ashes	2016-12-08	538	657	47	585	0.8731
SENRAN KAGURA Bon Appetit!	2016-11-10	78	838	65	143	0.8729000000000001
Anarcute	2016-07-12	125	529	35	160	0.8729000000000001
Enigmatis 3: The Shadow of Karkhala	2016-08-11	228	767	58	286	0.8728
Job Simulator	2016-04-05	611	3649	379	990	0.8726
Ghost 1.0	2016-06-07	422	1793	167	589	0.8725
Memory Oblivion Box	2016-06-14	90	883	70	160	0.8725
Floppy Heroes	2016-09-13	80	336	18	98	0.8725
Anyland	2016-10-06	31	359	20	51	0.8724
Corona Blossom Vol.2 The Truth From Beyond	2016-10-27	92	157	4	96	0.8724
Layers of Fear (2016)	2016-02-15	145384	22315	2747	148131	0.8719
Quest for Glory Collection	2016-08-29	127	341	19	146	0.8713
Toonstruck	2016-11-15	17	195	7	24	0.8713
Super Blue Boy Planet	2016-12-16	255	2386	239	494	0.8706999999999999
Mansions of Madness	2016-08-01	545	872	71	616	0.8706999999999999
Palinurus	2016-12-09	8	243	11	19	0.8706
The Night Cafe	2016-06-03	13	243	11	24	0.8706
WolfQuest: Classic	2016-03-25	245	1449	134	379	0.8701000000000001
Helen's Mysterious Castle	2016-03-18	39	709	55	94	0.87
Grow Up	2016-08-16	558	1445	134	692	0.8699
Nurse Love Addiction	2016-07-08	67	664	51	118	0.8694
Kick Ass Commandos	2016-11-18	169	394	25	194	0.8689
Evo Explores	2016-05-16	28	317	18	46	0.8688
KARAKARA	2016-06-27	314	1640	159	473	0.8684999999999999
Neon Chrome	2016-04-28	313	1013	89	402	0.8684000000000001
Lucius Demake	2016-08-09	49	432	29	78	0.8682
Pharaoh + Cleopatra	2016-12-15	662	1879	188	850	0.868
The Dweller	2016-05-19	313	543	40	353	0.868
Grim Legends 3: The Dark City	2016-06-02	105	630	49	154	0.8678
Mr. Massagy	2016-12-05	41	195	8	49	0.8677
Seven Kingdoms: Ancient Adversaries	2016-03-22	26	169	6	32	0.8675
Mecha Ritz: Steel Rondo	2016-06-10	20	112	2	22	0.8668000000000001
Nelly Cootalot: The Fowl Fleet	2016-03-22	164	250	13	177	0.8665
Killing Floor 2	2016-11-18	69987	99637	13947	83934	0.8659
Meadow	2016-10-26	15036	5115	600	15636	0.8658
Shantae: Half-Genie Hero	2016-12-20	964	2081	220	1184	0.8651000000000001
The Last Time	2016-09-09	13	149	5	18	0.8651000000000001
Xanadu Next	2016-11-03	149	432	31	180	0.8648
Final Approach	2016-04-05	34	330	21	55	0.8648
Earn to Die 2	2016-05-05	179	698	59	238	0.8647
Battlezone 98 Redux	2016-04-18	304	833	74	378	0.8645999999999999
Cosmic Sugar VR	2016-11-27	16	348	23	39	0.8643000000000001
The Banner Saga 2	2016-04-19	1924	2934	329	2253	0.8642000000000001
Cats are Liquid - A Light in the Shadows	2016-07-25	81	580	47	128	0.8639
Save Jesus	2016-08-04	3855	1886	201	4056	0.8633
Quadrilateral Cowboy	2016-07-25	311	770	69	380	0.8627
It's Spring Again	2016-02-02	1611	725	64	1675	0.8627
Happy Room	2016-12-19	1530	2298	255	1785	0.8623999999999999
ENIGMA:	2016-11-15	21	116	3	24	0.8623999999999999
Dog Sled Saga	2016-09-22	86	607	52	138	0.8614
Fibbage XL	2016-03-24	700	252	15	715	0.8614
RefRain - prism memories -	2016-05-12	25	100	2	27	0.8614
Lost Castle	2016-09-01	4701	19366	2639	7340	0.8613
Trick and Treat - Visual Novel	2016-12-31	185	3179	373	558	0.8613
Red Trigger	2016-07-08	298	1820	198	496	0.8612000000000001
Cobalt	2016-02-02	321	613	53	374	0.8611
Zombo Buster Rising	2016-10-03	647	420	32	679	0.8611
Void Pyramid	2016-12-05	14	125	4	18	0.8606
Beat Da Beat	2016-03-10	77	425	33	110	0.8603000000000001
Near Death	2016-08-02	44	866	83	127	0.8602
Tasty Planet: Back for Seconds	2016-03-29	139	422	33	172	0.8598
Carrie's Order Up	2016-09-13	116	123	4	120	0.8598
Automobilista	2016-08-24	497	1951	219	716	0.8595999999999999
ZeGame	2016-05-27	23	82	1	24	0.8593999999999999
Grandpa's Table	2016-05-24	55	82	1	56	0.8593999999999999
Surge	2016-05-24	12	244	15	27	0.8592000000000001
Duskers	2016-05-18	411	2088	238	649	0.8591
That Dragon, Cancer	2016-01-12	165	1222	128	293	0.8589
The Price of Freedom	2016-12-22	178	361	27	205	0.8589
House of the Dying Sun	2016-11-01	207	1494	163	370	0.8584999999999999
Seduce Me 2: The Demon War	2016-05-23	211	349	26	237	0.8584
Senza Peso	2016-10-11	20	281	19	39	0.8583
Party Jousting	2016-03-02	5438	651	60	5498	0.8581000000000001
Switch 'N' Shoot	2016-10-17	199	119	4	203	0.8579000000000001
Frosty Kiss	2016-01-08	619	1292	139	758	0.8577
8Bit Fiesta	2016-09-30	142	517	45	187	0.8575
Rage Wars	2016-11-18	207	1639	184	391	0.8573999999999999
True Fear: Forsaken Souls Part 1	2016-10-19	90	729	70	160	0.8573000000000001
WORLD END ECONOMiCA episode.03	2016-12-21	264	206	12	276	0.8571
Shadow Warrior 2	2016-10-13	12634	20379	2912	15546	0.8568000000000001
Wand Wars	2016-04-13	16	194	11	27	0.8566
Plantera	2016-01-28	1937	4585	594	2531	0.856
Headlander	2016-07-27	176	873	89	265	0.856
The Bug Butcher	2016-01-19	139	1055	112	251	0.8558
Conan the mighty pig	2016-07-07	2460	989	104	2564	0.8556
Out of the Park Baseball 17	2016-03-22	973	590	55	1028	0.8556
Lucid9	2016-04-14	189	924	96	285	0.8555
Screeps: World	2016-11-16	359	1497	170	529	0.8554
Stories: The Path of Destinies	2016-04-12	81664	5557	738	82402	0.8553000000000001
INFRA	2016-01-15	145	2158	259	404	0.8552
Ratz Instagib 2.0	2016-07-27	2102	3263	413	2515	0.8549
Starlight Vega	2016-04-14	77	219	14	91	0.8548
Resident Evil 7 Teaser: Beginning Hour	2016-12-18	3910	3828	494	4404	0.8547
Corpse Party	2016-04-25	151	1033	111	262	0.8545999999999999
Siralim 2	2016-08-12	307	412	35	342	0.8545999999999999
Prison Run and Gun	2016-03-16	920	455	40	960	0.8545
Dark Fear	2016-06-22	41	188	11	52	0.8545
LEGO® MARVEL's Avengers	2016-01-26	2112	5380	719	2831	0.8544
There's Poop In My Soup	2016-03-14	2826	3811	493	3319	0.8544
Tomoyo After ~It's a Wonderful Life~ English Edition	2016-07-01	31	488	44	75	0.8543000000000001
Reigns	2016-08-11	1612	6573	896	2508	0.8541
UNDER NIGHT IN-BIRTH Exe:Late	2016-07-13	621	847	88	709	0.8541
Nitroplus Blasterz: Heroines Infinite Duel	2016-12-08	250	711	71	321	0.8541
Aveyond 4: Shadow of the Mist	2016-02-01	41	145	7	48	0.8541
Detective Hayseed - Hollywood	2016-10-07	45	111	4	49	0.8540000000000001
simian.interface++	2016-06-26	7	99	3	10	0.8540000000000001
Dead Rising	2016-09-13	993	4160	547	1540	0.8537
Buried: An Interactive Story	2016-01-22	78	144	7	85	0.8537
BLARP!	2016-04-05	9	165	9	18	0.8536
The Sad Story of Emmeline Burns	2016-01-05	35	680	68	103	0.8533
Starward Rogue	2016-01-22	140	430	38	178	0.8531000000000001
Smashbox Arena	2016-12-07	134	413	36	170	0.8531000000000001
Paws	2016-03-24	79	571	55	134	0.8529000000000001
Crashlands	2016-01-21	1761	3482	454	2215	0.8528
Pharaoh Rebirth+	2016-03-17	39	288	22	61	0.8528
Princess Remedy In A Heap of Trouble	2016-09-09	234	543	52	286	0.8523000000000001
Moonlight	2016-02-05	141	221	15	156	0.8523000000000001
Calm Down, Stalin	2016-09-08	89	896	97	186	0.8519
Doom & Destiny Advanced	2016-11-16	31	352	30	61	0.8511
The Descendant	2016-03-24	18862	5269	729	19591	0.8509000000000001
Kelvin and the Infamous Machine	2016-07-21	101	777	83	184	0.8506999999999999
Darksiders Warmastered Edition	2016-11-29	2904	11361	1667	4571	0.8506
The Afterglow of Grisaia	2016-07-20	35	93	3	38	0.8505
The Turing Test	2016-08-30	536	6584	932	1468	0.8504
Pitfall Planet	2016-05-02	9	54	0	9	0.8504
Abode	2016-12-01	16	338	29	45	0.8499
Rivalry	2016-01-22	25	277	22	47	0.8498000000000001
Sora	2016-01-05	113	371	33	146	0.8497
Zombie Training Simulator	2016-04-16	199	510	50	249	0.8495999999999999
Redirection	2016-10-24	34	135	7	41	0.8495
Drop Alive	2016-12-06	255	1297	155	410	0.8493
You Have 10 Seconds	2016-08-02	153	1158	136	289	0.8492000000000001
A Little Lily Princess	2016-05-19	42	256	20	62	0.8489
Shardlight	2016-03-08	98	560	57	155	0.8487
Wheely	2016-11-09	42	112	5	47	0.8484999999999999
The Tale of a Common Man	2016-09-02	954	121	6	960	0.8477
You Have 10 Seconds 2	2016-08-25	338	597	63	401	0.8473
Matris	2016-06-02	28	64	1	29	0.8473
One Thousand Lies	2016-04-25	90	915	106	196	0.8470000000000001
Slavistan	2016-07-29	1861	633	68	1929	0.8470000000000001
Quell Zen	2016-07-14	8	50	0	8	0.8469
Guns of Infinity	2016-03-29	76	98	4	80	0.8466
Tyranny	2016-11-10	15792	9973	1512	17304	0.8462999999999999
Mad Bullets	2016-06-10	31	288	25	56	0.8456999999999999
Disgaea PC	2016-02-24	2937	3643	515	3452	0.8455
Trouble Witches Origin - Episode1 Daughters of Amalgam -	2016-11-21	41	174	12	53	0.8453
The Body VR: Journey Inside a Cell	2016-10-03	150	234	19	169	0.8447
Children of a Dead Earth	2016-09-23	117	594	65	182	0.8445
The Leisure of Grisaia	2016-05-18	61	258	22	83	0.8442000000000001
HunieCam Studio	2016-04-04	2675	5253	778	3453	0.8440000000000001
Sonicomi	2016-07-02	90	477	50	140	0.8437000000000001
Root Double -Before Crime * After Days- Xtend Edition	2016-04-27	214	377	37	251	0.8437000000000001
Creeper World 2 Anniversary Edition	2016-11-16	88	321	30	118	0.8436
Intralism	2016-11-04	1854	4334	636	2490	0.8433
Street Legal Racing: Redline v2.3.1	2016-08-05	853	3027	432	1285	0.8428
Kingdom: New Lands	2016-08-09	3518	8550	1327	4845	0.8427
Giants: Citizen Kabuto	2016-12-03	14	131	8	22	0.8425
WayOut	2016-11-04	1003	948	117	1120	0.8423
Holopoint	2016-04-05	67	630	72	139	0.8422000000000001
Along the Edge	2016-10-12	42	315	30	72	0.8420000000000001
The Final Station	2016-08-30	1284	6413	984	2268	0.8419
The Deadly Tower of Monsters	2016-01-19	140	1146	147	287	0.8416
Space Impossible	2016-03-01	81	120	7	88	0.8416
Mother Russia Bleeds	2016-09-05	1250	4062	605	1855	0.8412999999999999
ARCADE GAME SERIES: GALAGA	2016-04-19	66	609	70	136	0.8412000000000001
Camp Sunshine	2016-10-28	54	248	22	76	0.841
Angry Video Game Nerd II: ASSimilation	2016-03-29	296	671	79	375	0.8409000000000001
Bastard Bonds	2016-06-15	376	643	75	451	0.8409000000000001
Gun Done	2016-06-14	555	542	61	616	0.8408
Sid Meier's Civilization VI	2016-10-21	162657	222893	39771	202428	0.8404
Masquerada: Songs and Shadows	2016-09-30	65	457	50	115	0.8399
Sabres of Infinity	2016-03-29	96	126	8	104	0.8397
Istrolid	2016-05-06	1331	2274	326	1657	0.8395
Cubicolor	2016-03-18	26	178	14	40	0.8395
Delicious - Emily's Message in a Bottle	2016-12-10	32	116	7	39	0.8393
Magical Otoge Ciel	2016-08-27	356	210	18	374	0.8390000000000001
Codename: Panzers, Phase One	2016-02-18	61	319	32	93	0.8389
Old Friend	2016-12-22	8	133	9	17	0.8386
Quantum Break	2016-09-29	2719	20454	3456	6175	0.8384
Riptide GP: Renegade	2016-07-26	30	277	27	57	0.8377
New York Mysteries: The Lantern of Souls	2016-08-24	57	206	18	75	0.8375
Arcanum	2016-08-29	150	1255	171	321	0.8373999999999999
Water Bears VR	2016-01-27	114	165	13	127	0.8373999999999999
Rose of Winter	2016-10-17	33	173	14	47	0.8372
Off-Peak	2016-10-21	66	1300	179	245	0.8369
Pocket Kingdom	2016-12-08	44	147	11	55	0.8368000000000001
Mibibli's Quest	2016-08-04	12	74	3	15	0.8368000000000001
Sepia Tears	2016-01-08	102	788	101	203	0.8364
Alone in the Dark 1	2016-12-13	33	227	21	54	0.8364
Twilight Struggle	2016-04-13	672	2086	306	978	0.8362999999999999
STAR WARS™ Rebellion	2016-03-01	238	958	127	365	0.8362999999999999
One Night Stand	2016-11-07	70	565	68	138	0.8362999999999999
Zasa - An AI Story	2016-04-11	159	129	9	168	0.8362999999999999
MegaTagmension Blanc + Neptune VS Zombies	2016-10-03	466	1196	165	631	0.8356
Mad Nords: Probably an Epic Quest	2016-12-02	1238	110	7	1245	0.8355
A-10 VR	2016-04-05	20	136	10	30	0.8354
Ragdoll Runners	2016-07-13	64	262	26	90	0.8353
Monsters' Den: Book of Dread	2016-07-19	42	177	15	57	0.8353
My Little Kitties	2016-06-21	10	62	2	12	0.8353
The Melody of Grisaia	2016-12-16	19	72	3	22	0.8351000000000001
Himawari - The Sunflower -	2016-12-10	28	135	10	38	0.8349
Master of Orion 1	2016-02-25	97	275	28	125	0.8347
Suits: A Business RPG	2016-01-06	655	786	103	758	0.8344
Replica	2016-07-11	286	2825	436	722	0.8342
Ace of Seafood	2016-04-08	169	485	58	227	0.8342
Choice of Alexandria	2016-06-10	48	71	3	51	0.8342
SWARMRIDERS	2016-06-15	14	409	47	61	0.8341
Christmas Adventure: Candy Storm	2016-04-01	850	324	35	885	0.8341
Half-Life: A Place in the West	2016-09-29	42	619	78	120	0.8340000000000001
12 Labours of Hercules V: Kids of Hellas	2016-06-17	199	338	37	236	0.8340000000000001
Halloween Forever	2016-10-25	12	150	12	24	0.8340000000000001
New York Mysteries: High Voltage	2016-01-12	31	235	23	54	0.8337000000000001
Alicemare	2016-11-22	28	805	107	135	0.8334999999999999
Endless Fables: The Minotaur's Curse	2016-12-15	362	234	23	385	0.8334
Quanero	2016-08-12	16	307	33	49	0.8333
Disney Infinity 2.0: Gold Edition	2016-12-10	51	285	30	81	0.8331999999999999
Security Hole	2016-09-28	43	132	10	53	0.8331000000000001
The Witness	2016-01-26	6185	12876	2231	8416	0.8329000000000001
Volleyball Unbound	2016-12-16	19	148	12	31	0.8329000000000001
Graviteam Tactics: Mius-Front	2016-03-05	161	729	96	257	0.8328
Maze: Subject 360 Collector's Edition	2016-04-28	5	37	0	5	0.8327
Idling to Rule the Gods	2016-05-27	2783	1266	182	2965	0.8325
Ride 2	2016-10-07	638	2377	368	1006	0.8322
Deponia Doomsday	2016-03-01	2644	2975	471	3115	0.8320000000000001
Handsome Mr. Frog	2016-08-08	446	193	18	464	0.8320000000000001
Birdsketball	2016-11-17	8	48	1	9	0.8319
ARCADE GAME SERIES: PAC-MAN	2016-04-19	62	674	89	151	0.8314
Stormworm+	2016-05-20	11	58	2	13	0.8312999999999999
Gal*Gun: Double Peace	2016-09-27	218	1713	259	477	0.8311000000000001
Straimium Immortaly	2016-10-10	79	144	12	91	0.8307
Bad Caterpillar	2016-10-19	562	103	7	569	0.8306
Hade	2016-12-03	176	255	27	203	0.8304
Astro Duel	2016-02-22	7	67	3	10	0.8304
BARRIER X	2016-05-27	9640	1948	301	9941	0.8303
Slash It	2016-12-17	2196	1008	144	2340	0.8301000000000001
The Little Acre	2016-12-13	31	697	94	125	0.8301000000000001
Aim Hero	2016-09-05	524	5161	869	1393	0.8300000000000001
HoloBall	2016-04-25	50	412	50	100	0.8300000000000001
Punch Bomb	2016-12-13	4	35	0	4	0.8300000000000001
Gnomes Garden 2	2016-05-18	2651	158	14	2665	0.8299
Far Cry Primal	2016-03-01	14783	22282	4060	18843	0.8297
XCOM 2	2016-02-05	133022	72895	13865	146887	0.8291
Descent: Road to Legend	2016-06-01	112	314	36	148	0.8291
Bear With Me	2016-08-08	1216	808	113	1329	0.8290000000000001
Tales of Symphonia	2016-02-01	1414	3723	618	2032	0.8289
Rock 'N' Roll Defense	2016-08-10	2801	1875	293	3094	0.8287000000000001
The VR Museum of Fine Art	2016-08-20	23	264	29	52	0.8286
Meow-Jong Solitaire	2016-11-04	25	34	0	25	0.8285
Ghostlords	2016-11-18	1294	65	3	1297	0.8284
Button Tales	2016-12-22	874	74	4	878	0.8283
Dream Quest	2016-12-09	34	242	26	60	0.8281999999999999
peakvox Mew Mew Chamber for Steam	2016-12-16	172	45	1	173	0.8281999999999999
Prominence Poker	2016-12-13	912	5667	978	1890	0.8279000000000001
Sorcery! Parts 1 & 2	2016-02-02	182	532	70	252	0.8279000000000001
Codename: Panzers, Phase Two	2016-02-18	36	184	18	54	0.8279000000000001
Make America Great Again: The Trump Presidency	2016-09-26	732	1554	240	972	0.8278
A Date in the Park	2016-07-19	88	1359	207	295	0.8277
OPUS: The Day We Found Earth	2016-04-22	71	1164	174	245	0.8276000000000001
F1 2016	2016-09-07	5658	3816	644	6302	0.8273
Radiator 2: Anniversary Edition	2016-06-16	137	2439	398	535	0.8269
LaserCat	2016-12-08	620	81	5	625	0.8267
LEGO® STAR WARS™: The Force Awakens	2016-06-28	2586	5091	884	3470	0.8264
Redout: Enhanced Edition	2016-09-02	1118	3718	633	1751	0.8261000000000001
CUPID - A free to play Visual Novel	2016-03-04	212	1081	163	375	0.8258
Delicious - Emily's Home Sweet Home	2016-12-15	26	80	5	31	0.8258
Space Pilgrim Episode IV: Sol	2016-03-05	2402	309	37	2439	0.8255
Gabriel Knight 2: The Beast Within	2016-08-29	20	179	18	38	0.8255
Spacejacked	2016-02-26	122	43	1	123	0.8255
Worms W.M.D	2016-08-23	4767	8132	1466	6233	0.8253
Deadhunt	2016-01-12	14	127	11	25	0.8251000000000001
Home Behind	2016-06-03	3083	4774	835	3918	0.8250000000000001
Razortron 2000	2016-10-13	3801	1402	221	4022	0.8245
Haydee	2016-09-26	381	5127	906	1287	0.8244
Star Realms	2016-03-08	233	1468	233	466	0.8244
Delicious! Pretty Girls Mahjong Solitaire	2016-10-14	330	1468	233	563	0.8244
Bigscreen Beta	2016-04-28	315	2398	402	717	0.8238
DROD: Gunthro and the Epic Blunder	2016-09-23	50	125	11	61	0.8238
Abduction Bit	2016-11-15	2971	182	19	2990	0.8234
Disney Infinity 3.0: Gold Edition	2016-12-10	148	808	120	268	0.8233
Soundboxing	2016-09-29	41	497	68	109	0.8233
Nemesis of the Roman Empire	2016-01-28	16	77	5	21	0.8229000000000001
Delicious - Emily's New Beginning	2016-11-24	17	77	5	22	0.8229000000000001
Stronghold Legends	2016-09-15	313	1610	262	575	0.8228
Clock Simulator	2016-07-20	192	358	46	238	0.8228
Darkness and Flame: Born of Fire	2016-12-08	21	116	10	31	0.8228
Batman - The Telltale Series	2016-08-02	4001	10881	2033	6034	0.8227
Lost in Secular Love	2016-10-28	42	382	50	92	0.8225
Xmas Shooting - Scramble!!	2016-12-16	26	108	9	35	0.8224
METAL SLUG 2	2016-04-15	42	672	98	140	0.8223
INVERSUS Deluxe	2016-08-16	65	299	37	102	0.8223
Choice of the Pirate	2016-05-20	97	92	7	104	0.8220000000000001
Hyper Bounce Blast	2016-05-27	431	76	5	436	0.8220000000000001
Attack on Titan / A.O.T. Wings of Freedom	2016-08-26	2191	3165	552	2743	0.8219
Zero Escape: Zero Time Dilemma	2016-06-29	1914	2901	504	2418	0.8216
Linea, the Game	2016-01-04	5592	847	129	5721	0.8215000000000001
On Rusty Trails	2016-06-13	30	212	24	54	0.8215000000000001
The Silver Case	2016-10-06	83	542	77	160	0.8214
The Cubicle.	2016-04-05	36	535	76	112	0.8212
The Tale of Doris and the Dragon - Episode 1	2016-09-08	16	67	4	20	0.8212
ChuSingura46+1 S	2016-06-22	227	849	130	357	0.821
[the Sequence]	2016-03-30	124	149	15	139	0.8207
Northern Tale	2016-02-09	21	49	2	23	0.8205
Gremlins, Inc.	2016-03-11	1716	6277	1163	2879	0.8201999999999999
Beglitched	2016-10-07	32	105	9	41	0.8201
Jesus Christ RPG Trilogy	2016-03-18	210	1305	213	423	0.8200000000000001
UBERMOSH Vol.3	2016-08-15	12	246	30	42	0.8193000000000001
BUTCHER	2016-10-05	61	913	144	205	0.8190999999999999
Owlboy	2016-11-01	1317	4567	839	2156	0.8189000000000001
Leap of Fate	2016-03-30	155	392	54	209	0.8186
Nature And Life - Drunk On Nectar	2016-11-16	14	186	21	35	0.8186
Otem's Defiance	2016-04-25	124	28	0	124	0.8186
Able Black	2016-12-21	4	28	0	4	0.8186
SHINRAI - Broken Beyond Despair	2016-08-26	8	103	9	17	0.8185
CASE: Animatronics	2016-08-03	798	2812	502	1300	0.8181999999999999
One Troll Army	2016-05-19	1498	1180	194	1692	0.8181
Cue Club 2: Pool & Snooker	2016-03-08	55	479	69	124	0.8181
CLANNAD Side Stories	2016-06-02	15	249	31	46	0.818
Road to Ballhalla	2016-08-05	64	347	47	111	0.8178000000000001
Wish Project	2016-03-22	25	47	2	27	0.8178000000000001
Stikbold!	2016-04-01	159	371	51	210	0.8177
Cat President ~A More Purrfect Union~	2016-08-23	25	130	13	38	0.8175
Hot Squat	2016-11-22	6	130	13	19	0.8175
Sickness	2016-01-20	376	116	11	387	0.8174
Yu-Gi-Oh! Legacy of the Duelist	2016-12-07	1627	3703	680	2307	0.8172
Blind Love	2016-12-28	7	71	5	12	0.8168000000000001
HITMAN™	2016-03-11	51650	30442	6222	57872	0.8163
Project Highrise	2016-09-08	2515	3320	610	3125	0.8162
NSFW ~ Not a Simulator For Working	2016-10-28	229	93	8	237	0.8162
Kismet	2016-05-02	9	128	13	22	0.8161
Disney Infinity 1.0: Gold Edition	2016-12-10	88	293	39	127	0.816
Decisive Campaigns: Barbarossa	2016-04-29	129	168	19	148	0.816
Typoman	2016-08-15	54	623	96	150	0.8159000000000001
Animated Puzzles	2016-12-16	14	70	5	19	0.8157
Pierhead Arcade	2016-09-22	16	237	30	46	0.8156
Ice Lakes	2016-04-19	2595	1260	214	2809	0.8154000000000001
Atlantic Fleet	2016-02-25	400	1137	191	591	0.8153
Demon Hunter 3: Revelation	2016-12-01	212	211	26	238	0.8151
Hero and Daughter+	2016-02-18	113	192	23	136	0.8151
King Oddball	2016-09-09	17	77	6	23	0.8150000000000001
Frost	2016-07-05	100	126	13	113	0.8146
Santa's Christmas Solitaire	2016-12-05	7	26	0	7	0.8146
Cube Runner	2016-12-13	1871	878	144	2015	0.8145
Hitman GO: Definitive Edition	2016-02-23	183	1662	293	476	0.8144
Delicious - Emilys Christmas Carol	2016-11-04	48	152	17	65	0.8143000000000001
WITCH-BOT MEGLILO	2016-07-15	15	98	9	24	0.8143000000000001
Amaranthine	2016-04-06	193	98	9	202	0.8143000000000001
The Brookhaven Experiment	2016-07-05	263	740	119	382	0.8142
Mythic Wonders: The Philosopher's Stone	2016-04-21	255	282	38	293	0.8142
The Deed: Dynasty	2016-05-10	1478	422	62	1540	0.8140999999999999
Creepy Castle	2016-10-31	25	171	20	45	0.8140999999999999
Blameless	2016-10-13	639	3843	728	1367	0.8138
Sorcery! Part 3	2016-04-05	29	90	8	37	0.8135
Trip to Vinelands	2016-10-21	217	182	22	239	0.8131999999999999
GunGirl 2	2016-09-01	26	124	13	39	0.8131999999999999
Phantom Brave PC	2016-07-25	219	452	68	287	0.8131
Take Command - 2nd Manassas	2016-10-28	13	60	4	17	0.813
RHEM IV: The Golden Fragments Special Edition	2016-02-03	8	35	1	9	0.813
Portal Stories: VR	2016-05-16	134	1224	212	346	0.8129000000000001
Once in Yaissor	2016-11-09	5073	966	163	5236	0.8128000000000001
Welcome to the Game	2016-06-15	190	1879	340	530	0.8127
The Preposterous Awesomeness of Everything	2016-02-09	19	82	7	26	0.8126000000000001
Steep	2016-12-02	2113	19950	4137	6250	0.8125
Transport Fever	2016-11-08	12615	8650	1734	14349	0.8124
12 Labours of Hercules VI: Race for Olympus	2016-12-21	90	193	24	114	0.8124
Kopanito All-Stars Soccer	2016-11-16	422	2225	411	833	0.812
真恋～寄语枫秋～	2016-10-05	96	1205	210	306	0.812
Mu Cartographer	2016-08-24	43	186	23	66	0.812
Backstage Pass	2016-08-23	85	234	31	116	0.8117000000000001
Avadon 3: The Warborn	2016-09-14	132	102	10	142	0.8117000000000001
Cockroach VR	2016-09-08	8	43	2	10	0.8117000000000001
Akin	2016-06-07	2826	390	58	2884	0.8116
Resident Evil 0	2016-01-19	3128	7849	1577	4705	0.8115000000000001
Silence	2016-11-15	373	1891	346	719	0.8115000000000001
Cube Destroyer	2016-02-15	927	982	168	1095	0.8115000000000001
SculptrVR	2016-04-04	10	88	8	18	0.8115000000000001
Hiiro	2016-07-12	1892	257	35	1927	0.8114
Kokurase	2016-11-11	586	115	12	598	0.8114
Deranged Rabbits	2016-07-29	66	34	1	67	0.8111
Counter Agents	2016-12-01	17	134	15	32	0.8109999999999999
Hexoscope	2016-08-10	1650	190	24	1674	0.8108
Murasaki	2016-05-13	105	94	9	114	0.8107
Wayward	2016-04-22	140	964	166	306	0.8106
NO THING	2016-04-07	69	255	35	104	0.8106
Dark Parables: The Final Cinderella Collector's Edition	2016-06-17	9	24	0	9	0.8103
Rescuties! VR	2016-10-19	5	24	0	5	0.8103
Duke Nukem 3D: 20th Anniversary World Tour	2016-10-11	329	3424	663	992	0.8101
The Secret Order 3: Ancient Times	2016-03-10	68	283	40	108	0.8101
Highrise Heroes: Word Challenge	2016-01-09	132	100	10	142	0.81
Homeworld: Deserts of Kharak	2016-01-20	7326	5890	1181	8507	0.8099
Space Pilgrim Episode II: Epsilon Indi	2016-01-08	3278	423	65	3343	0.8099
Ahnayro: The Dream World	2016-12-02	542	224	30	572	0.8099
This Is the Police	2016-08-02	3093	8042	1639	4732	0.8098000000000001
Eon Altar	2016-06-22	152	633	104	256	0.8097
Planes, Bullets and Vodka	2016-12-13	3843	1324	238	4081	0.8096
State of Anarchy	2016-04-27	6944	894	154	7098	0.8096
theBlu: Season 1	2016-04-05	100	1088	192	292	0.8094
SAMOLIOTIK	2016-03-25	6074	2258	429	6503	0.8088
Sally's Law	2016-08-24	25	186	24	49	0.8087000000000001
12 orbits	2016-10-24	65	221	30	95	0.8085
Metal Tales: Fury of the Guitar Gods	2016-11-18	15	71	6	21	0.8084
Heirs And Graces	2016-09-02	9	71	6	15	0.8084
Mahjong World Contest	2016-10-07	2288	161	20	2308	0.8081999999999999
Diamond Joyce and the Secrets of Crystal Cave	2016-09-16	38	23	0	38	0.8079000000000001
Street Champ VR	2016-12-08	4	23	0	4	0.8079000000000001
Spacecats with Lasers VR	2016-12-20	4	23	0	4	0.8079000000000001
Doorways: Old Prototype	2016-10-05	71	549	90	161	0.8078000000000001
Bear Simulator	2016-02-26	89	512	83	172	0.8078000000000001
Night Blights	2016-04-15	37	91	9	46	0.8078000000000001
Forgotten, Not Lost - A Kinetic Novel	2016-04-02	1120	196	26	1146	0.8077
Pan-Pan	2016-08-25	29	190	25	54	0.8076000000000001
Clean'Em Up	2016-08-18	111	56	4	115	0.8076000000000001
One Small Fire At A Time	2016-06-10	45	56	4	49	0.8076000000000001
ARCADE GAME SERIES: DIG DUG	2016-04-19	37	392	61	98	0.8074
Mosaic: Game of Gods	2016-10-31	30	70	6	36	0.8072
Kittypocalypse	2016-08-15	16	177	23	39	0.807
L U N E	2016-06-20	6	48	3	9	0.8069
Zombie Party	2016-06-10	999	560	93	1092	0.8068000000000001
Optika	2016-08-26	165	291	43	208	0.8068000000000001
Lethe - Episode One	2016-08-01	31	306	46	77	0.8062
Soda Girls	2016-11-07	28	267	39	67	0.8061
Beautiful Japanese Scenery - Animated Jigsaws	2016-09-15	109	187	25	134	0.8059999999999999
RunGunJumpGun	2016-08-31	87	255	37	124	0.8058
Abbot's Book Demo	2016-04-05	8	175	23	31	0.8058
Shooting Stars!	2016-01-19	544	750	131	675	0.8057
The Rose and I	2016-04-05	9	157	20	29	0.8057
Save the Dodos	2016-04-22	266	151	19	285	0.8057
Unseen Diplomacy	2016-04-05	9	139	17	26	0.8057
 神明的一天世界-God's One Day World	2016-07-01	128	611	104	232	0.8055
RIVE	2016-09-13	258	773	136	394	0.8053
Shmups Skill Test	2016-06-10	32	47	3	35	0.8053
Atlas Reactor	2016-10-04	3613	4372	895	4508	0.8051
Virtual Escape: The Play Room	2016-11-01	4	31	1	5	0.8051
Gahkthun of the Golden Lightning Steam Edition	2016-04-15	22	75	7	29	0.805
Moékuri: Adorable + Tactical SRPG	2016-12-17	64	335	52	116	0.8049
Cursed Castilla (Maldita Castilla EX)	2016-10-20	264	478	79	343	0.8048000000000001
EXIT	2016-12-16	936	39	2	938	0.8048000000000001
Total Extreme Wrestling 2013	2016-12-02	43	68	6	49	0.8047
Demons with Shotguns	2016-04-25	233	54	4	237	0.8047
Verdict Guilty - 유죄 평결	2016-06-13	1507	632	109	1616	0.8046
Phantasmagoria	2016-08-29	56	318	49	105	0.8046
Nemesis Perspective	2016-12-21	8	106	12	20	0.8038
Archibald's Adventures	2016-06-10	14	74	7	21	0.8038
Oh My Gore!	2016-10-20	833	374	60	893	0.8037000000000001
Ghost Town Mine Ride & Shootin' Gallery	2016-10-28	32	342	54	86	0.8036
Blitz Breaker	2016-02-02	505	118	14	519	0.8036
Chef Solitaire: USA	2016-01-15	258	130	16	274	0.8035
Dead Island Definitive Edition	2016-05-31	2324	14964	3282	5606	0.8034
My Name is Mayo	2016-02-15	357	2274	452	809	0.8033
Vintage VR	2016-05-03	431	80	8	439	0.8031999999999999
Bad Sector HDD	2016-10-15	426	53	4	430	0.8031999999999999
Ittle Dew 2+	2016-11-15	55	308	48	103	0.8029000000000001
Zombie Defense	2016-09-30	2369	1672	326	2695	0.8027
Neon Drive	2016-05-12	138	1699	332	470	0.8026000000000001
Sakura Nova	2016-10-20	73	339	54	127	0.8026000000000001
Critical Annihilation	2016-02-12	60	180	25	85	0.802
INVASION!	2016-10-12	13	157	21	34	0.8019
City Car Driving	2016-11-03	2399	16595	3697	6096	0.8018000000000001
Riff Racer	2016-05-12	95	1730	341	436	0.8017000000000001
Space Pilgrim Episode III: Delta Pavonis	2016-02-04	3186	310	49	3235	0.8017000000000001
Mr. Pumpkin Adventure	2016-07-08	33	207	30	63	0.8015000000000001
Secret Santa	2016-12-01	8	72	7	15	0.8014
Hadean Lands	2016-06-20	92	37	2	94	0.8009000000000001
Lifestream - A Haunting Text Adventure	2016-09-19	87	29	1	88	0.8007
The Way	2016-05-20	115	986	186	301	0.8006000000000001
Halcyon 6: Starbase Commander (CLASSIC)	2016-09-09	2988	1095	209	3197	0.8005
Pixel Puzzles 2: Space	2016-02-19	1753	291	46	1799	0.8005
Paddle Up	2016-08-24	45	205	30	75	0.8005
SPLIT BULLET	2016-10-31	26	58	5	31	0.8004000000000001
Zaccaria Pinball	2016-06-16	64	1060	202	266	0.8003
MOAI 3: Trade Mission Collector's Edition	2016-01-29	85	44	3	88	0.8002
Trials of Azra	2016-09-15	12	108	13	25	0.8001
Dig 4 Destruction	2016-08-15	44	102	12	56	0.8001
Turner	2016-07-15	35	51	4	39	0.8001
Song of the Deep	2016-07-11	148	672	122	270	0.8
Star Rogue	2016-02-01	2	20	0	2	0.8
Please, Don't Touch Anything 3D	2016-12-07	168	764	141	309	0.7998999999999999
Ne no Kami - The Two Princess Knights of Kyoto	2016-10-26	22	137	18	40	0.7998999999999999
One day in London	2016-08-10	63	77	8	71	0.7997
Duelyst	2016-08-23	2372	3968	842	3214	0.7996
Six Sides of the World	2016-01-20	442	83	9	451	0.7994
Escape the Game	2016-10-13	107	1601	320	427	0.7992
Polygon Attack	2016-12-28	962	208	31	993	0.7992
Dead by Daylight	2016-06-14	105093	529610	128677	233770	0.7991
The Gallery - Episode 1: Call of the Starseed	2016-04-05	73	1265	248	321	0.799
HEBEREKE!: March! Red Army Girls' Brigade	2016-09-30	29	180	26	55	0.7987000000000001
Dashy Square	2016-04-26	146	141	19	165	0.7987000000000001
World's Fastest Pizza	2016-03-15	4	43	3	7	0.7983
Meld	2016-05-11	11	28	1	12	0.7983
Lil Big Invasion	2016-08-04	843	28	1	844	0.7983
Gebub's Adventure	2016-08-16	7	28	1	8	0.7983
Slay	2016-11-30	211	129	17	228	0.7981999999999999
Sins Of The Demon RPG	2016-05-13	1299	801	151	1450	0.7981
Slash or Die	2016-06-03	791	210	32	823	0.7974
Super Night Riders	2016-02-22	7	172	25	32	0.7972
Modbox	2016-04-05	30	188	28	58	0.797
Manual Samuel - Anniversary Edition	2016-10-14	9036	2305	483	9519	0.7968000000000001
Shadow Complex Remastered	2016-05-03	389	717	135	524	0.7968000000000001
The Bottom of the Well	2016-03-04	124	457	81	205	0.7968000000000001
Little Walker	2016-04-06	1836	35	2	1838	0.7968000000000001
SportsBar VR 	2016-06-01	161	697	131	292	0.7966
Tower of Archeos	2016-09-07	9	42	3	12	0.7965000000000001
Snowball!	2016-12-16	172	138	19	191	0.7964
Dead Age	2016-11-04	888	4250	929	1817	0.7962
Kingspray Graffiti	2016-12-07	39	685	129	168	0.7961
Guards	2016-08-19	43	385	67	110	0.7959999999999999
Equin: The Lantern	2016-10-27	7	55	5	12	0.7958
Root Of Evil: The Tailor	2016-12-08	19	418	74	93	0.7955
Dead End Road	2016-07-08	16	232	37	53	0.7953
Conga Master	2016-09-14	13	61	6	19	0.7952
The Order of the Thorne - The King's Challenge	2016-01-26	14	114	15	29	0.7951
Pills4Skills	2016-01-25	128	48	4	132	0.795
Cubotrox	2016-11-11	6	48	4	10	0.795
Dead Hungry	2016-12-06	8	48	4	12	0.795
Don't Disturb	2016-09-01	47	522	96	143	0.7948999999999999
The Eyes of Ara	2016-07-19	81	531	98	179	0.7948000000000001
Hero Zero	2016-07-06	1447	2740	591	2038	0.7945000000000001
Hunting Unlimited 2009	2016-11-03	9	41	3	12	0.7945000000000001
Stellar Tactics	2016-09-23	149	972	193	342	0.7944
Even the Ocean	2016-11-16	19	199	31	50	0.7943000000000001
World of Tanks Blitz	2016-11-09	56669	102123	25049	81718	0.7942
Cossacks 3	2016-09-20	5797	9387	2162	7959	0.7941
GoNNER	2016-10-12	267	1047	210	477	0.7941
Toadled	2016-09-22	1973	330	57	2030	0.7941
The Metronomicon: Slay The Dance Floor	2016-09-29	85	315	54	139	0.794
Candice DeBébé's Incredibly Trick Lifestyle	2016-03-22	7	151	22	29	0.7939
Blue Rider	2016-03-03	45	90	11	56	0.7939
ComixPlay #1: The Endless Incident	2016-02-24	143	18	0	143	0.7939
XorceD - Sashiro's Laedrum	2016-04-14	5	18	0	5	0.7939
The Men of Yoshiwara: Ohgiya	2016-04-20	71	177	27	98	0.7936
Super Mega Neo Pug	2016-05-11	3131	620	118	3249	0.7935
VIDEOBALL	2016-07-12	63	161	24	87	0.7935
The Labyrinth of Grisaia	2016-06-22	76	112	15	91	0.7933
18 Wheels of Steel: Across America	2016-08-26	13	123	17	30	0.7931999999999999
Blockships	2016-09-02	4	26	1	5	0.7931999999999999
Bitslap	2016-09-23	5	26	1	6	0.7931999999999999
ARCADE GAME SERIES: Ms. PAC-MAN	2016-04-19	18	197	31	49	0.7931
Virtual-O	2016-12-07	21	95	12	33	0.7931
Strawberry Vinegar	2016-01-05	14	128	18	32	0.7928000000000001
The Walking Dead: A New Frontier	2016-12-20	8278	10877	2548	10826	0.7925
Indie Game Sim	2016-12-08	22	53	5	27	0.7925
Hydra Slayer	2016-03-24	8	40	3	11	0.7925
Tumbleweed Express	2016-05-31	70	100	13	83	0.7924
RWBY: Grimm Eclipse	2016-07-05	3298	9319	2173	5471	0.7923
ChromaGun	2016-02-16	22	431	79	101	0.7923
My Night Job	2016-04-21	49	77	9	58	0.7923
Requiescence	2016-09-23	5	33	2	7	0.7923
Pinball FX2 VR	2016-11-29	19	300	52	71	0.792
Gnomes Garden 3: The thief of castles	2016-12-22	2737	105	14	2751	0.7919
The Pirate: Caribbean Hunt	2016-08-24	1968	3320	740	2708	0.7917000000000001
Gabriel Knight: Sins of the Fathers	2016-08-29	32	121	17	49	0.7915000000000001
Found	2016-09-15	7	121	17	24	0.7915000000000001
Don't open the doors!	2016-11-11	1042	254	43	1085	0.7913
The Emerald Maiden: Symphony of Dreams	2016-02-18	97	375	68	165	0.7912
Goblin and Coins	2016-11-09	7	76	9	16	0.7909999999999999
Wild Animals - Animated Jigsaws	2016-11-07	210	131	19	229	0.7909
Fly O'Clock	2016-07-08	942	458	86	1028	0.7906000000000001
Corpo Tale	2016-08-06	6	17	0	6	0.7905
Vermillion Watch: Moorgate Accord Collector's Edition	2016-06-23	7	17	0	7	0.7905
Red Comrades 2: For the Great Justice. Reloaded	2016-10-14	109	251	43	152	0.7898999999999999
Cubikolor	2016-05-20	43	32	2	45	0.7898999999999999
A Matter of Murder	2016-09-01	8	32	2	10	0.7898999999999999
Slashy Hero	2016-10-18	10	32	2	12	0.7898999999999999
Irrational Exuberance: Prologue	2016-04-05	15	299	53	68	0.7897
A Chair in a Room: Greenwater	2016-03-31	48	505	97	145	0.7895000000000001
Xenoraid	2016-09-30	12	108	15	27	0.7895000000000001
Sunrider: Liberation Day - Captain's Edition	2016-03-04	270	659	131	401	0.7894
FORCED SHOWDOWN	2016-03-29	427	541	105	532	0.7894
Tokyo Babel	2016-03-31	40	69	8	48	0.7894
Rot Gut	2016-07-12	22	240	41	63	0.7893000000000001
Sheltered	2016-03-15	1413	4659	1077	2490	0.7892
8-Bit Armies	2016-04-22	600	1834	401	1001	0.7891
Binaries	2016-04-04	1998	63	7	2005	0.7891
Punch Club	2016-01-08	4305	9485	2264	6569	0.789
The Bellows	2016-09-13	76	200	33	109	0.789
Star Vikings Forever	2016-10-06	190	80	10	200	0.7889
Intensive Exposure	2016-09-06	851	154	24	875	0.7886
Sunset's Ashes	2016-11-18	643	123	18	661	0.7886
Koihime Enbu	2016-05-19	240	248	43	283	0.7885
Atari Vault	2016-03-24	122	720	146	268	0.7881999999999999
Flat Path	2016-08-24	1757	68	8	1765	0.788
Broken Armor	2016-08-01	2839	494	96	2935	0.7879
Zombie Exodus: Safe Haven	2016-10-28	101	158	25	126	0.7878000000000001
Madrobot X	2016-09-21	7601	106	15	7616	0.7875
Tornuffalo	2016-12-13	4	44	4	8	0.7875
VR Battle Grid	2016-11-09	65	56	6	71	0.7874
Cyberpong	2016-04-28	11	95	13	24	0.7872
Mystery Castle	2016-05-06	7	16	0	7	0.7869
Otherworld: Spring of Shadows Collector's Edition	2016-06-03	4	16	0	4	0.7869
The Agency of Anomalies: Mystic Hospital Collector's Edition	2016-07-18	5	16	0	5	0.7869
Unruly Ghouls	2016-10-19	4	16	0	4	0.7869
The Abbey of Crime Extensum	2016-05-19	175	201	34	209	0.7867000000000001
Skautfold: Shrouded in Sanity	2016-05-27	13	392	75	88	0.7861
Bounce	2016-11-30	7	37	3	10	0.7859999999999999
Duke Grabowski, Mighty Swashbuckler	2016-10-06	15	165	27	42	0.7857
SUPER IMPOSSIBLE ROAD	2016-05-11	17	83	11	28	0.7857
Agatha Christie - The ABC Murders	2016-02-04	222	1976	446	668	0.7856000000000001
Apocalypse: Party's Over	2016-05-30	132	140	22	154	0.7856000000000001
House of Hell	2016-01-19	11	43	4	15	0.7855
Light Repair Team #4	2016-04-05	5	43	4	9	0.7855
Secrets of Magic: The Book of Spells	2016-10-21	21	43	4	25	0.7855
Doodler	2016-07-15	23	43	4	27	0.7855
The Castles of Dr. Creep	2016-09-03	5	43	4	9	0.7855
Smash Party VR	2016-12-19	9	43	4	13	0.7855
OZMAFIA!!	2016-04-29	246	502	100	346	0.7853
MYTH	2016-10-28	14	88	12	26	0.7853
Heroes of the West	2016-03-23	39	407	79	118	0.7851
Chicku	2016-05-05	10	66	8	18	0.7851
Echoes of Aetheria	2016-01-15	67	129	20	87	0.7848
Super Mutant Alien Assault	2016-07-11	32	129	20	52	0.7848
DROD: The Second Sky	2016-11-19	8	30	2	10	0.7848
Pub Encounter	2016-04-13	42	212	37	79	0.7847
BLEAK: Welcome to Glimmer	2016-04-08	50	60	7	57	0.7845000000000001
GraveRun	2016-09-21	162	23	1	163	0.7844
Pozzo Jello Crusade	2016-09-01	25	23	1	26	0.7844
Queendoom	2016-11-10	4	23	1	5	0.7844
Lost Grimoires: Stolen Kingdom	2016-11-10	39	192	33	72	0.7842
Warlords Battlecry III	2016-01-22	148	616	127	275	0.7841
The FOO Show	2016-04-05	22	133	21	43	0.784
Out of Ammo	2016-09-15	57	592	122	179	0.7836
Worlds	2016-03-01	6	48	5	11	0.7836
C. Kane	2016-01-26	224	42	4	228	0.7834000000000001
ConflictCraft	2016-12-08	10025	525	107	10132	0.7833
Sophie's Curse	2016-03-16	1011	379	74	1085	0.7833
HordeZ	2016-04-29	118	334	64	182	0.7833
Who's Your Daddy?!	2016-05-13	1209	21168	5391	6600	0.7831999999999999
Last Hope - Tower Defense	2016-04-13	154	356	69	223	0.7831
Recourse	2016-03-01	11	15	0	11	0.783
Drawful 2	2016-06-21	5430	2455	573	6003	0.7829
NotCoD™	2016-05-19	25	70	9	34	0.7829
Super Rad Raygun	2016-11-08	13	59	7	20	0.7828
BioShock Remastered	2016-09-15	5245	37513	9721	14966	0.7827
THOTH	2016-10-07	306	364	71	377	0.7827
Unbox	2016-09-05	66	487	99	165	0.7825
Aurora Nights	2016-05-26	19	254	47	66	0.7822
Fabric	2016-08-12	22	106	16	38	0.7822
Legend of Merchant	2016-12-16	320	529	109	429	0.7820999999999999
Upwards, Lonely Robot	2016-03-10	6	29	2	8	0.7820999999999999
Project Starship	2016-04-05	4300	374	74	4374	0.7816
Dots eXtreme	2016-09-13	1181	85	12	1193	0.7816
Worm.is: The Game	2016-05-04	3498	3640	878	4376	0.7814
Age of Conquest IV	2016-04-06	1023	2012	469	1492	0.7814
UBERMOSH:BLACK	2016-02-17	7	275	52	59	0.7814
VR: Vacate the Room	2016-07-15	25	206	37	62	0.7813
Time Tenshi 2: Special Edition	2016-11-21	15	22	1	16	0.7811
Apollo 11 VR	2016-04-01	30	499	103	133	0.7809999999999999
Blueprint Tycoon	2016-05-13	978	867	190	1168	0.7809
Hard Reset Redux	2016-06-03	485	1599	369	854	0.7806000000000001
Glittermitten Grove	2016-12-13	391	406	82	473	0.7805
Extreme Forklifting 2	2016-08-05	12	167	29	41	0.7803
Cockroach Simulator	2016-09-17	871	2292	544	1415	0.78
Seasons after Fall	2016-09-02	304	2235	530	834	0.7798999999999999
Worlds Adrift Island Creator	2016-04-28	174	426	87	261	0.7798999999999999
Gal-X-E	2016-05-14	4582	68	9	4591	0.7798999999999999
Winter Novel	2016-08-10	1205	447	92	1297	0.7798
Yesterday Origins	2016-11-10	202	498	104	306	0.7796
Lost Socks: Naughty Brothers	2016-10-17	2289	46	5	2294	0.7796
Ayakashigami	2016-12-21	232	46	5	237	0.7796
Planet Centauri	2016-06-03	369	1498	347	716	0.7795000000000001
One Man Is Not No Man	2016-03-18	17	57	7	24	0.7794
The Real Texas	2016-07-12	8	28	2	10	0.7792
Minimal	2016-12-16	120	28	2	122	0.7792
Space Scaven	2016-04-08	140	28	2	142	0.7792
Soft Body	2016-05-17	9	40	4	13	0.779
GRAVEN The Purple Moon Prophecy	2016-09-29	9	40	4	13	0.779
Ultimate Arena	2016-08-22	1878	759	167	2045	0.7787999999999999
Hide & Spook: The Haunted Alchemist	2016-10-29	6	34	3	9	0.7787999999999999
NEON Ultra	2016-09-30	6	34	3	9	0.7787999999999999
Fire in the Goal	2016-10-27	49	34	3	52	0.7787999999999999
Factotum 90	2016-06-20	4	14	0	4	0.7787000000000001
Gunnihilation	2016-09-14	5	14	0	5	0.7787000000000001
Artisan: Going Home Again	2016-09-14	14	14	0	14	0.7787000000000001
Evil Orbs	2016-10-27	3	14	0	3	0.7787000000000001
Audioshield	2016-04-05	226	2217	531	757	0.7785
Viking Squad	2016-10-04	115	206	38	153	0.7785
C14 Dating	2016-04-22	21	51	6	27	0.7785
Cloudlands : VR Minigolf	2016-04-05	44	255	49	93	0.7783
Demetrios - The BIG Cynical Adventure	2016-05-31	118	290	57	175	0.7781
Sherlock Holmes: The Devil's Daughter	2016-06-10	2968	10014	2580	5548	0.7779
Arizona Sunshine	2016-12-06	658	6642	1686	2344	0.7779
Karma. Incarnation 1	2016-10-19	245	294	58	303	0.7779
Regeria Hope Episode 1	2016-07-25	83	294	58	141	0.7779
D: The Game	2016-10-28	80	87	13	93	0.7778
Fast Action Hero	2016-10-03	9	87	13	22	0.7778
Crush Your Enemies	2016-07-13	207	324	65	272	0.7777
CRANGA!: Harbor Frenzy	2016-12-06	3	21	1	4	0.7777
A Day in the Woods	2016-10-26	12	21	1	13	0.7777
Chunky Orbits	2016-12-21	15	21	1	16	0.7777
Lost girl`s [diary]	2016-03-24	88	843	189	277	0.7776000000000001
Roguelands	2016-06-13	1150	2941	721	1871	0.7775
Z-Exemplar	2016-11-25	5	45	5	10	0.7775
The Underground Man	2016-09-01	350	1109	255	605	0.7774
The Average Everyday Adventures of Samantha Browne	2016-04-19	69	866	195	264	0.7774
Awkward Dimensions Redux	2016-10-21	261	2351	570	831	0.7773000000000001
Mustache in Hell	2016-07-28	286	61	8	294	0.7772
Rad Rodgers: World One	2016-12-01	21	144	25	46	0.777
Super Destronaut	2016-08-26	5	39	4	9	0.7767000000000001
WOLFLAME	2016-04-21	10	81	12	22	0.7765000000000001
Mr.President!	2016-10-10	385	2982	737	1122	0.7764
5089: The Action RPG	2016-02-03	71	264	52	123	0.7762000000000001
PRiO	2016-03-18	6	27	2	8	0.7762000000000001
Defunct	2016-01-29	139	527	114	253	0.7761
Planet R-12	2016-05-05	3932	202	38	3970	0.7761
Clouds & Sheep 2	2016-10-24	88	124	21	109	0.7759
Green Game: TimeSwapper	2016-04-04	982	55	7	989	0.7759
Good Robot	2016-04-05	85	206	39	124	0.7758
Falcon 4.0	2016-01-08	8	151	27	35	0.7752
Betrayal Collection	2016-12-15	20	80	12	32	0.7751000000000001
Empty Horizons	2016-07-19	55	75	11	66	0.7751000000000001
ONE PIECE BURNING BLOOD	2016-09-01	857	3074	769	1626	0.7748999999999999
Snow Fortress	2016-12-16	19	49	6	25	0.7745000000000001
Egg Time	2016-09-19	5	49	6	11	0.7745000000000001
Cat on a Diet	2016-02-29	927	663	149	1076	0.7744
TOKYO WARFARE	2016-07-29	22	269	54	76	0.7744
Skyhook	2016-05-17	465	113	19	484	0.7744
Discovering Colors - Animals	2016-04-13	5	38	4	9	0.7743000000000001
The Incredible Baron	2016-05-27	19	38	4	23	0.7743000000000001
Patterna	2016-10-03	9	38	4	13	0.7743000000000001
Maize	2016-12-01	266	1530	369	635	0.7742
BOTOLO	2016-12-15	3	13	0	3	0.7741
Star Crusade CCG	2016-09-08	343	1513	365	708	0.774
Tomato Jones	2016-07-11	994	203	39	1033	0.774
Space Cat	2016-12-02	4	20	1	5	0.774
Warka Flarka Flim Flam	2016-12-22	4	20	1	5	0.774
CAGE	2016-11-15	13	103	17	30	0.7737
Mervils: A VR Adventure	2016-10-25	11	59	8	19	0.7737
Dispersio	2016-12-02	9	59	8	17	0.7737
Disoriented	2016-11-21	740	293	60	800	0.7736000000000001
8-Bit Invaders!	2016-12-16	192	335	70	262	0.7735
Castle Battles	2016-12-16	11	32	3	14	0.7734000000000001
Obduction	2016-08-24	1915	2801	705	2620	0.7733
Legionwood: Tale of the Two Swords	2016-05-10	94	144	26	120	0.7732
Kyoto Colorful Days	2016-06-15	101	144	26	127	0.7732
Sydney's World	2016-02-01	8	43	5	13	0.7732
Carpe Lucem - Seize The Light	2016-04-05	4	43	5	9	0.7732
SPACE MOUSE	2016-11-08	14	26	2	16	0.773
Space Codex	2016-05-17	1917	308	64	1981	0.7728
TurnOn	2016-06-01	26	287	59	85	0.7728
Airport Madness 3D	2016-05-25	77	270	55	132	0.7728
Alice's Patchwork	2016-03-03	1690	201	39	1729	0.7728
House of Snark 6-in-1 Bundle	2016-07-20	33	83	13	46	0.7726000000000001
Retro Parking	2016-12-20	14	48	6	20	0.7725
LostWinds 2: Winter of the Melodias	2016-03-24	36	226	45	81	0.7722
Little Briar Rose	2016-12-02	9	160	30	39	0.7717
Pro Pinball Ultra	2016-07-21	34	199	39	73	0.7715000000000001
Thorne - Son of Slaves (Ep.2)	2016-08-26	1387	96	16	1403	0.7711
Conception II: Children of the Seven Stars	2016-08-15	454	507	114	568	0.7708
Acan's Call: Act 1	2016-08-11	16	295	62	78	0.7708
Event[0]	2016-09-14	396	1699	423	819	0.7706999999999999
Stellar Interface	2016-11-21	63	163	31	94	0.7706000000000001
Cubixx HD	2016-01-28	6	31	3	9	0.7706000000000001
Atlas Reactor VR Character Viewer	2016-04-05	6	31	3	9	0.7706000000000001
BLADE ARCUS from Shining: Battle Arena	2016-07-28	55	180	35	90	0.7704000000000001
Duckpocalypse	2016-08-22	5	47	6	11	0.7704000000000001
Avalon Legends Solitaire 2	2016-10-04	15	47	6	21	0.7704000000000001
No Man's Sky	2016-08-12	212613	203604	58510	271123	0.7703
10 Second Ninja X	2016-07-19	1215	2238	568	1783	0.7703
Total War: WARHAMMER	2016-05-24	113019	39421	11053	124072	0.7702
The Solus Project	2016-06-07	652	2024	511	1163	0.7702
Campus Notes - forget me not.	2016-04-06	26	62	9	35	0.7702
Quar: Battle for Gate 18	2016-04-04	9	52	7	16	0.7702
illumine	2016-09-29	280	52	7	287	0.7702
The Walking Dead: Michonne	2016-02-23	2435	5089	1346	3781	0.7701000000000001
RYB	2016-11-17	11	57	8	19	0.7701000000000001
LostWinds	2016-03-24	79	508	115	194	0.77
Hover Cubes: Arena	2016-05-02	14	19	1	15	0.77
Passage 4	2016-12-13	15	19	1	16	0.77
Fantasy Mosaics 14: Fourth Color	2016-06-04	9	25	2	11	0.7697
Black Moon Chronicles	2016-08-25	3	25	2	5	0.7697
She Wants Me Dead	2016-05-13	112	113	20	132	0.7696
Evochron Legacy SE	2016-01-18	198	317	68	266	0.7695000000000001
Raining Blobs	2016-01-15	92	76	12	104	0.7695000000000001
Front Office Football Eight	2016-11-23	172	217	44	216	0.7694
Pretty Girls Panic!	2016-12-20	231	341	74	305	0.7693000000000001
Inbound	2016-07-05	6	36	4	10	0.7692
Cyber Sentinel	2016-07-29	5	36	4	9	0.7692
Mystic Destinies: Serendipity of Aeons	2016-02-11	69	316	68	137	0.7691
LightWalk	2016-05-18	6	12	0	6	0.7690000000000001
Star-Twine	2016-11-30	4	12	0	4	0.7690000000000001
ORCS	2016-05-20	1445	319	69	1514	0.7687
Brushwood Buddies	2016-02-18	732	121	22	754	0.7686000000000001
Rocket Fist	2016-05-12	17	61	9	26	0.7685
Disastr_Blastr	2016-11-21	518	41	5	523	0.7685
LoveKami -Divinity Stage-	2016-12-16	128	466	106	234	0.7682
Gem Forge	2016-11-01	381	51	7	388	0.7682
Feed and Grow: Fish	2016-01-08	1056	9904	2717	3773	0.7681
Heaven's Hope	2016-02-25	47	98	17	64	0.768
Moon Hunters	2016-03-10	324	3626	960	1284	0.7676999999999999
War of the Human Tanks - Limited Operations	2016-06-13	30	30	3	33	0.7676000000000001
Way of the Red	2016-11-16	7	30	3	10	0.7676000000000001
Dark Parables: Rise of the Snow Queen Collector's Edition	2016-08-09	6	30	3	9	0.7676000000000001
Settled	2016-02-29	42	111	20	62	0.7675000000000001
Art of War: Red Tides	2016-12-22	4031	5284	1425	5456	0.7673000000000001
EggK47	2016-09-30	4	167	33	37	0.7671
The Slaughter: Act One	2016-01-28	23	110	20	43	0.7664
Bamboo EP	2016-12-15	7	55	8	15	0.7664
Chiptune Champion	2016-01-08	52	170	34	86	0.7662000000000001
BladeShield	2016-11-28	12	24	2	14	0.7662000000000001
Wobbly Jungle	2016-04-14	338	40	5	343	0.7661
Christmas Stories: Nutcracker Collector's Edition	2016-12-16	23	40	5	28	0.7661
REDCON	2016-04-22	670	455	105	775	0.766
Treasure of a Blizzard	2016-10-06	38	140	27	65	0.766
Endless Night - Alpha	2016-12-06	8	45	6	14	0.766
Frederic: Resurrection of Music Director's Cut	2016-04-21	654	260	56	710	0.7658
Board Defenders	2016-09-06	1307	18	1	1308	0.7658
Ballistic Tanks	2016-09-20	14	194	40	54	0.7655
Red Rope: Don't Fall Behind	2016-07-21	14	87	15	29	0.7655
Dead Secret	2016-03-28	32	444	103	135	0.765
Kitty Cat: Jigsaw Puzzles	2016-07-18	649	218	46	695	0.765
The Town of Light	2016-02-26	155	1861	485	640	0.7648999999999999
System Crash	2016-08-01	52	234	50	102	0.7648999999999999
Cowbots and Aliens	2016-11-07	52	82	14	66	0.7648
Hyperdevotion Noire: Goddess Black Heart	2016-04-26	499	729	178	677	0.7647
ISLANDS: Non-Places	2016-11-17	13	282	62	75	0.7647
123 Slaughter Me Street 2	2016-11-01	10	147	29	39	0.7647
9th Dawn II	2016-10-17	61	130	25	86	0.7646
Spooky Night	2016-12-31	6	29	3	9	0.7645000000000001
Recursion Deluxe	2016-02-12	295	68	11	306	0.7643000000000001
Merlin adventurer store	2016-12-02	2875	108	20	2895	0.7642
OmniBus	2016-05-26	57	387	89	146	0.7641
Flobe	2016-02-22	4039	49	7	4046	0.7640000000000001
Black Rose	2016-03-15	49	732	180	229	0.7637999999999999
Artificial Defense	2016-06-01	212	171	35	247	0.7637999999999999
Ortus Regni	2016-06-21	41	146	29	70	0.7637999999999999
Magnetized	2016-10-16	78	44	6	84	0.7637
Get The Gems	2016-11-11	879	34	4	883	0.7637
Gun Bombers	2016-09-21	26	39	5	31	0.7635
Samurai of Hyuga Book 2	2016-09-16	36	39	5	41	0.7635
Redemption Cemetery: Salvation of the Lost Collector's Edition	2016-07-12	5	11	0	5	0.7634000000000001
Ayumi: Enhanced Edition	2016-07-07	7	11	0	7	0.7634000000000001
Mystery Trackers: The Void Collector's Edition	2016-10-12	4	11	0	4	0.7634000000000001
Flock VR	2016-12-25	3	11	0	3	0.7634000000000001
Bad Rats Show	2016-07-20	346	685	168	514	0.7633
BoomTown! Deluxe	2016-10-14	2680	149	30	2710	0.7628
panGEMic	2016-12-28	7	85	15	22	0.7628
Fragments of Him	2016-05-03	12	111	21	33	0.7626999999999999
TRIZEAL Remix	2016-07-08	7	23	2	9	0.7625000000000001
Valentino Rossi The Game	2016-06-16	322	332	76	398	0.7624
Four Sided Fantasy	2016-08-30	14	312	71	85	0.7622
Space Moth DX	2016-01-22	230	102	19	249	0.7622
Doorways: Holy Mountains of Flesh	2016-08-10	467	358	83	550	0.762
Pharaonic	2016-04-28	42	209	45	87	0.7619
Barrow Hill: Curse of the Ancient Circle	2016-09-22	10	123	24	34	0.7619
18 Wheels of Steel: Haulin’	2016-09-09	11	71	12	23	0.7618
Karaski: What Goes Up...	2016-03-02	61	48	7	68	0.7618
Heart&Slash	2016-08-09	110	441	105	215	0.7615999999999999
Killing Time at Lightspeed: Enhanced Edition	2016-07-06	18	114	22	40	0.7613
Lavapools	2016-05-04	3	17	1	4	0.7613
Domino Sky	2016-04-05	22	267	60	82	0.7612000000000001
Dynetzzle Extended	2016-03-15	12	28	3	15	0.7612000000000001
Shiver: Vanishing Hitchhiker Collector's Edition	2016-06-11	6	28	3	9	0.7612000000000001
Ghost Sweeper	2016-07-22	584	28	3	587	0.7612000000000001
Frog Climbers	2016-10-06	40	143	29	69	0.7611
The Land of Eyas	2016-07-21	278	57	9	287	0.7611
Defense Zone 3 Ultra HD	2016-12-14	85	332	77	162	0.7608
Black Hole Hazard	2016-08-29	68	33	4	72	0.7608
Trials on Tatooine	2016-07-18	617	1053	273	890	0.7604000000000001
Fruit Ninja VR	2016-12-15	122	649	162	284	0.7603
Lance A Lot: Classic Edition	2016-10-18	13	52	8	21	0.7603
Awareness Rooms	2016-06-16	122	342	80	202	0.7602
The Dark Legions	2016-07-09	334	113	22	356	0.7602
Access Denied	2016-12-16	45	261	59	104	0.7601000000000001
Disgraced	2016-11-18	44	70	12	56	0.7601000000000001
Cursed	2016-06-17	211	507	124	335	0.7599
Capitalism Plus	2016-03-22	34	83	15	49	0.7599
Mystery Case Files ®: 13th Skull ™ Collector's Edition	2016-08-18	14	83	15	29	0.7599
World's Dawn	2016-01-25	265	668	168	433	0.7595999999999999
The Cat! Porfirio's Adventure	2016-08-04	267	264	60	327	0.7595999999999999
Cally's Caves 3	2016-01-05	188	416	100	288	0.7595000000000001
Legacy of the Elder Star	2016-06-07	427	47	7	434	0.7595000000000001
Sweet Escape VR	2016-04-20	31	47	7	38	0.7595000000000001
Dark Parables: The Exiled Prince Collector's Edition	2016-08-09	9	47	7	16	0.7595000000000001
Yomawari: Night Alone	2016-10-25	134	1439	384	518	0.7592
Captain Forever Remix	2016-06-03	118	294	68	186	0.7592
Japanese School Life	2016-11-22	319	236	53	372	0.7592
Flying Pengy	2016-10-26	879	65	11	890	0.7592
Just Dance 2017	2016-10-27	174	1551	416	590	0.7591
Battlevoid: Harbinger	2016-02-24	579	753	192	771	0.7591
Zenodyne R	2016-05-29	5	56	9	14	0.7591
Thorne - Death Merchants	2016-03-25	1399	216	48	1447	0.7589
PolyDome	2016-08-09	9	42	6	15	0.7587999999999999
GOD EATER 2 Rage Burst	2016-08-29	1491	3210	897	2388	0.7586
Ember Kaboom	2016-06-03	15	99	19	34	0.7586
Super Intergalactic Gang	2016-01-15	4	22	2	6	0.7586
Polyology	2016-03-28	50	22	2	52	0.7586
Power Link VR	2016-09-09	8	22	2	10	0.7586
100 nya	2016-11-12	14	22	2	16	0.7586
DarkMaus	2016-01-26	96	338	80	176	0.7585
Super Star	2016-08-11	479	3215	900	1379	0.7583
Atlantis: Pearls of the Deep	2016-09-06	20	60	10	30	0.7582
Orbital X	2016-08-18	438	37	5	443	0.7582
We Are Stars	2016-12-16	8	37	5	13	0.7582
Polynomial 2	2016-05-31	14	119	24	38	0.7578
VRchaeology: Prologue	2016-12-01	9	32	4	13	0.7576999999999999
Beyond Reality	2016-01-08	884	127	26	910	0.7576
8-Bit Hordes	2016-08-12	424	399	97	521	0.7575000000000001
Boid	2016-07-08	525	581	147	672	0.7571
Slap Village - Reality Slap	2016-07-21	10	102	20	30	0.7571
Dr. Spacezoo	2016-05-09	3	10	0	3	0.7571
Grave Mania: Undead Fever	2016-04-28	3	10	0	3	0.7571
Off the Record: The Linden Shades Collector's Edition	2016-05-24	6	10	0	6	0.7571
Alchemist Penguin	2016-07-01	4	10	0	4	0.7571
Brick Stack VR	2016-07-26	3	10	0	3	0.7571
The Agency of Anomalies: Cinderstone Orphanage Collector's Edition	2016-11-21	4	10	0	4	0.7571
Christmas Eve: Midnight's Call Collector's Edition	2016-12-19	20	10	0	20	0.7571
Ember Strike	2016-05-26	209	814	212	421	0.757
Eternal Destiny	2016-04-21	115	182	40	155	0.757
Dungeon Escape	2016-05-27	1238	631	161	1399	0.7569
Counter Fight	2016-11-15	19	174	38	57	0.7569
Intrude	2016-08-01	11	158	34	45	0.7567
Potato Thriller Steamed Potato Edition	2016-06-22	10	437	108	118	0.7565999999999999
CHKN	2016-04-01	289	1023	272	561	0.7564000000000001
Kinacoustic	2016-05-04	9	16	1	10	0.7564000000000001
Ghost Croquet	2016-08-31	7	16	1	8	0.7564000000000001
Jumper Jape	2016-11-17	4	16	1	5	0.7564000000000001
Half dead	2016-08-01	242	2552	716	958	0.7563
Lightblade VR	2016-05-31	32	516	130	162	0.7562000000000001
Auro: A Monster-Bumping Adventure	2016-04-13	9	59	10	19	0.7562000000000001
Laser Disco Defenders	2016-10-06	167	41	6	173	0.7562000000000001
Dark Parables: The Little Mermaid and the Purple Tide Collector's Edition	2016-03-21	9	41	6	15	0.7562000000000001
Phrase Shift	2016-11-30	10	41	6	16	0.7562000000000001
Through Abandoned: The Forest	2016-08-09	2132	227	52	2184	0.7561
UTOPIA 9 - A Volatile Vacation	2016-05-05	21	113	23	44	0.7556
DreadOut: Keepers of The Dark	2016-03-24	558	770	202	760	0.7554000000000001
Iron Sea Defenders	2016-09-09	3087	241	56	3143	0.7554000000000001
MechoEcho	2016-05-18	9	36	5	14	0.7553000000000001
Innoquous 5	2016-05-13	2524	36	5	2529	0.7553000000000001
Runbow	2016-11-18	21	88	17	38	0.755
Melon Simulator	2016-11-04	7	67	12	19	0.755
The Uncertain: Last Quiet Day	2016-09-22	2058	4200	1216	3274	0.7548
ROD: Revolt Of Defense	2016-08-13	152	439	110	262	0.7548
Redie	2016-12-01	22	175	39	61	0.7547
Waddle Home	2016-07-07	5	31	4	9	0.7545999999999999
Negligee	2016-10-19	218	571	147	365	0.7545000000000001
Dual Core	2016-05-26	10	21	2	12	0.7544
Sceal	2016-10-27	3	21	2	5	0.7544
Sarab: Duji Tower	2016-11-18	3	21	2	5	0.7544
BalanCity	2016-09-21	289	609	158	447	0.7542
Casey Powell Lacrosse 16	2016-03-09	48	79	15	63	0.7540000000000001
Super Jagua	2016-09-16	203	79	15	218	0.7540000000000001
Vertigo	2016-12-22	49	204	47	96	0.7536
The Shape Of Heart	2016-10-25	42	181	41	83	0.7534000000000001
Axes and Acres	2016-04-07	31	111	23	54	0.7534000000000001
NVIDIA® VR Funhouse	2016-07-14	197	637	167	364	0.7533
it's always monday	2016-11-23	1305	230	54	1359	0.7533
Projector Face	2016-06-02	14	66	12	26	0.7533
Safety First!	2016-09-08	194	267	64	258	0.7532
Versus Squad	2016-10-26	500	444	113	613	0.7529000000000001
Blacksea Odyssey	2016-06-01	38	165	37	75	0.7528
99Vidas	2016-12-23	76	446	114	190	0.7523000000000001
Seraph	2016-09-20	156	428	109	265	0.7523000000000001
Spikit	2016-08-09	2771	320	79	2850	0.7523000000000001
Cellar	2016-03-23	953	149	33	986	0.7523000000000001
Colosse	2016-04-21	7	118	25	32	0.7523000000000001
TASTEE: Lethal Tactics	2016-05-10	86	187	43	129	0.7522
Psychocat: The Answer	2016-01-11	41	183	42	83	0.752
Gravity Den	2016-04-15	5014	61	11	5025	0.7518000000000001
Space Hole 2016	2016-09-03	41	61	11	52	0.7518000000000001
Balrum	2016-03-01	313	475	123	436	0.7514000000000001
Plenty: Skyhearth	2016-10-20	8	48	8	16	0.7514000000000001
Tomato Way	2016-12-07	12550	432	111	12661	0.7512000000000001
Battle Crust	2016-02-26	6	30	4	10	0.7512000000000001
Interstellar Logistics Inc	2016-08-15	783	30	4	787	0.7512000000000001
Solitairica	2016-05-31	67	328	82	149	0.751
Vairon's Wrath	2016-05-27	66	15	1	67	0.751
Salmon Ninja	2016-09-30	5	15	1	6	0.751
Farm Tribe 2	2016-09-22	8	15	1	9	0.751
Azurea Juncture	2016-11-16	4	15	1	5	0.751
Chimeras: Tune of Revenge Collector's Edition	2016-12-14	5	15	1	6	0.751
Lost Crew	2016-09-15	2681	39	6	2687	0.7509
TOXIKK	2016-09-13	1646	4240	1259	2905	0.7508
Bloody Walls	2016-09-28	134	970	267	401	0.7508
StarBreak	2016-05-10	810	956	263	1073	0.7508
Livelock	2016-08-30	229	550	145	374	0.7506999999999999
Gravity Cat	2016-07-13	666	381	97	763	0.7506999999999999
Ley Lines	2016-12-06	16	120	26	42	0.7503000000000001
Operation Hardcore	2016-12-28	15	25	3	18	0.7503000000000001
HELP: THE GAME	2016-07-26	2	9	0	2	0.75
Hat Trick Header	2016-10-04	3	9	0	3	0.75
Valkyrius Prime	2016-08-08	3	9	0	3	0.75
AquaNimble	2016-09-30	4	9	0	4	0.75
Edge Guardian	2016-09-21	3	9	0	3	0.75
League of Light: Dark Omens Collector's Edition	2016-10-07	4	9	0	4	0.75
MOORHUHN | CRAZY CHICKEN strikes back	2016-12-02	6	9	0	6	0.75
Riddles of Fate: Wild Hunt Collector's Edition	2016-11-16	4	9	0	4	0.75
Lazors	2016-09-26	21	20	2	23	0.7499
Flip	2016-02-16	7	20	2	9	0.7499
T-Kara Puzzles	2016-06-01	23	20	2	25	0.7499
Turbo Pug DX	2016-09-26	40590	1356	384	40974	0.7498
Kim	2016-10-24	7	60	11	18	0.7498
Pang Adventures	2016-04-19	229	289	72	301	0.7495
Age of Gladiators	2016-02-26	378	552	147	525	0.7494
A dragon girl looks up at the endless sky	2016-10-27	13	34	5	18	0.7493000000000001
My Lil' Donut	2016-08-31	7	34	5	12	0.7493000000000001
Alchemic Jousts	2016-12-16	7	34	5	12	0.7493000000000001
La Peri	2016-08-19	11	168	39	50	0.7491
No One But You	2016-01-19	69	138	31	100	0.7491
Lichtspeer	2016-09-27	19	119	26	45	0.7491
Bomb U!	2016-09-18	9	47	8	17	0.7490000000000001
The Dope Game	2016-05-31	99	164	38	137	0.7489
Radiation Island	2016-11-29	53	425	111	164	0.7488
Tenrow	2016-04-08	1327	130	29	1356	0.7487
NewRetroArcade: Neon	2016-08-01	51	480	127	178	0.7486
Carmageddon: Max Damage	2016-10-27	593	2244	658	1251	0.7484999999999999
What The Box?	2016-09-12	161	590	159	320	0.7484999999999999
A Fear Of Heights, And Other Things	2016-10-17	99	51	9	108	0.7484999999999999
The Revenge of Johnny Bonasera: Episode 1	2016-11-01	27	51	9	36	0.7484999999999999
Way of the Samurai 3	2016-03-23	235	417	109	344	0.7484000000000001
Curvatron	2016-01-29	1124	137	31	1155	0.7481
Memory's Dogma CODE:01	2016-11-04	181	275	69	250	0.7479000000000001
Byte Family	2016-10-26	1936	59	11	1947	0.7478
Diib's Dilemma	2016-05-27	609	29	4	613	0.7478
VERSUS: The Elite Trials	2016-12-16	47	29	4	51	0.7478
Max, an Autistic Journey	2016-08-19	154	79	16	170	0.7477
Offworld Trading Company	2016-04-28	2698	4083	1237	3935	0.7473000000000001
Aozora Meikyuu	2016-01-27	1498	417	110	1608	0.7471
CAFE 0 ~The Sleeping Beast~	2016-11-11	5	42	7	12	0.7471
Magi Trials	2016-11-17	42	98	21	63	0.747
Super Kaiju	2016-12-06	10	24	3	13	0.7463
Holo Impact : Prologue	2016-11-11	7	24	3	10	0.7463
UNLOVED	2016-09-29	115	864	244	359	0.7459
Age of Barbarian Extended Cut	2016-06-03	45	573	157	202	0.7458
Witch & Hero（魔女と勇者）	2016-04-22	38	70	14	52	0.7458
Jet Set Knights	2016-04-07	66	62	12	78	0.7456999999999999
Surfingers	2016-01-27	977	464	125	1102	0.7456
Candle	2016-11-11	58	776	218	276	0.7454999999999999
Sixtieth Kilometer	2016-08-25	1976	1218	353	2329	0.7453000000000001
Jockey Rush	2016-07-15	8	14	1	9	0.7453000000000001
LooWarVR	2016-08-11	4	14	1	5	0.7453000000000001
Goblet of Maya	2016-12-16	3829	14	1	3830	0.7453000000000001
Magnificent Ships: Volume 1	2016-11-29	3	14	1	4	0.7453000000000001
Demolish & Build 2017	2016-10-18	212	473	128	340	0.7452
Astroloco: Worst Contact	2016-03-11	26	19	2	28	0.7451000000000001
Grimsfield	2016-05-12	4	19	2	6	0.7451000000000001
Gemini: Heroes Reborn	2016-01-19	45	394	105	150	0.745
Medusa's Labyrinth	2016-02-15	107	848	241	348	0.7448
A Healer Only Lives Twice	2016-06-03	33	152	36	69	0.7448
#KILLALLZOMBIES	2016-08-10	3879	241	61	3940	0.7445999999999999
Tiny Guardians	2016-03-24	102	126	29	131	0.7445
My Lady	2016-03-28	6	126	29	35	0.7445
Bear Haven Nights	2016-01-29	1802	41	7	1809	0.7444
Millia -The ending-	2016-01-08	4	28	4	8	0.7441
Kiya	2016-12-12	7	28	4	11	0.7441
Escape: Close Call	2016-03-24	9	28	4	13	0.7441
Overdriven Reloaded	2016-10-08	6	28	4	10	0.7441
Oh No! Bugs!	2016-08-14	913	92	20	933	0.7440000000000001
Uprising: Join or Die	2016-05-19	16	69	14	30	0.7440000000000001
Nary	2016-08-02	781	45	8	789	0.7440000000000001
Midvinter	2016-05-05	192	61	12	204	0.7438
Gnomoria	2016-02-23	2050	2663	812	2862	0.7434999999999999
Her Majesty's SPIFFING	2016-12-07	39	225	57	96	0.7434000000000001
Caravan	2016-09-30	588	684	194	782	0.7428
Blueshift	2016-12-21	19	157	38	57	0.7428
Puppy Dog: Jigsaw Puzzles	2016-07-19	85	117	27	112	0.7426
TRON RUN/r	2016-02-17	67	289	76	143	0.7424
Totally Unbalanced	2016-07-29	2079	124	29	2108	0.7423000000000001
Super Duper Party Pooper	2016-06-06	1893	343	92	1985	0.7422
Star Sky 2	2016-03-02	51	68	14	65	0.7422
Requiem: Avenging Angel	2016-07-07	4	68	14	18	0.7422
Soulcaster: Part I & II	2016-05-24	84	36	6	90	0.742
Into the Belly of the Beast	2016-06-22	3	8	0	3	0.7419
Dawn of the Robot Empire	2016-04-12	2	8	0	2	0.7419
Fly to KUMA MAKER	2016-09-13	5	8	0	5	0.7419
Fierce Tales: The Dog's Heart Collector's Edition	2016-12-07	4	8	0	4	0.7419
Crea	2016-06-09	1662	1039	305	1967	0.7418000000000001
Jelly Killer	2016-03-24	182	260	68	250	0.7415999999999999
Tick's Tales	2016-06-09	29	56	11	40	0.7415
YANKAI'S TRIANGLE	2016-11-02	11	56	11	22	0.7415
Subterrain	2016-01-21	567	956	280	847	0.7414000000000001
Archimedes	2016-10-06	1341	166	41	1382	0.7414000000000001
Onechanbara Z2: Chaos	2016-06-03	245	638	182	427	0.7412000000000001
Masky	2016-12-16	1753	123	29	1782	0.7412000000000001
Super Switch	2016-08-25	2950	90	20	2970	0.7411
OutDrive	2016-02-22	1391	3491	1092	2483	0.741
The Flame in the Flood	2016-02-24	6158	5168	1640	7798	0.7409
Elisa: The Innkeeper - Prequel	2016-06-14	52	571	162	214	0.7406999999999999
Firefight	2016-07-12	11	71	15	26	0.7406999999999999
Master of Orion	2016-08-25	4852	5429	1729	6581	0.7406
Crypt of the Serpent King	2016-12-27	407	151	37	444	0.7406
Distant Space	2016-12-20	7052	302	81	7133	0.7404000000000001
Break Chance Memento	2016-02-13	7	27	4	11	0.7403000000000001
Babel: Tower to the Gods	2016-04-05	5	27	4	9	0.7403000000000001
Deus Ex Machina, Game of the Year, 30th Anniversary Collector’s Edition	2016-09-29	60	27	4	64	0.7403000000000001
Cosmos Crash VR	2016-12-23	9	27	4	13	0.7403000000000001
Duo	2016-12-19	3818	27	4	3822	0.7403000000000001
Deus Ex: Mankind Divided™	2016-08-23	52485	28452	9447	61932	0.7402
Caretaker Sacrifice	2016-08-17	5	18	2	7	0.74
Grenade Madness	2016-04-15	6	18	2	8	0.74
K Station	2016-06-15	2	18	2	4	0.74
Nightmare Adventures: The Witch's Prison	2016-08-29	6	18	2	8	0.74
Twixel	2016-11-18	658	18	2	660	0.74
A Legend of Luca	2016-04-05	21	164	41	62	0.7397
Game Royale 2 - The Secret of Jannis Island	2016-12-22	128	89	20	148	0.7395999999999999
OESE	2016-06-14	10	59	12	22	0.7395999999999999
Riddles Of The Past	2016-07-22	251	191	49	300	0.7391
Okhlos: Omega	2016-08-18	507	642	186	693	0.7389
Talent Not Included	2016-08-30	30	35	6	36	0.7389
Dead TrailZ	2016-01-08	4	13	1	5	0.7389
Mutant Mudds Super Challenge	2016-07-26	4	13	1	5	0.7389
Super Grav	2016-11-07	4	13	1	5	0.7389
Ship It	2016-10-14	4	13	1	5	0.7389
A-Gents	2016-04-20	1216	103	24	1240	0.7388
Hypersensitive Bob	2016-03-29	58	47	9	67	0.7388
Force of Nature	2016-12-13	814	3029	956	1770	0.7387
Tales of Cosmos	2016-10-20	5	43	8	13	0.7387
AIPD - Artificial Intelligence Police Department	2016-01-29	10	39	7	17	0.7387
Defend Your Crypt	2016-07-21	630	39	7	637	0.7387
Time Tenshi 2	2016-06-14	45	39	7	52	0.7387
Dawn's Light	2016-09-01	798	39	7	805	0.7387
Estiman	2016-11-23	191	39	7	198	0.7387
Super Markup Man	2016-08-16	96	81	18	114	0.7386
Crown Champion: Legends of the Arena	2016-10-21	700	159	40	740	0.7383
Windlands	2016-04-05	77	655	191	268	0.7382
Stellar Monarch	2016-12-05	50	176	45	95	0.7381000000000001
侠客风云传(Tale of Wuxia)	2016-04-28	963	4812	1551	2514	0.7379000000000001
Haven Moon	2016-07-08	86	412	116	202	0.7379000000000001
Donuts'n'Justice	2016-11-22	274	113	27	301	0.7379000000000001
Phantasmagoria 2	2016-08-29	19	134	33	52	0.7377
1 Moment Of Time: Silentville	2016-07-22	1124	508	146	1270	0.7375
Club Life	2016-04-13	60	102	24	84	0.7375
The Narrator is a DICK	2016-06-14	139	102	24	163	0.7375
Flute Master	2016-06-16	32	22	3	35	0.7375
Mallow Drops	2016-11-03	16	22	3	19	0.7375
ecotone	2016-05-06	6	22	3	9	0.7375
Bird of Light	2016-07-15	165	22	3	168	0.7375
Basketball Babe VR	2016-10-03	4	22	3	7	0.7375
Nanuleu	2016-11-17	10	54	11	21	0.7371
The Adventures of Tree	2016-03-01	1891	373	105	1996	0.7366
Gnomes Vs. Fairies	2016-07-02	107	50	10	117	0.7366
Quell 4D	2016-10-14	9	76	17	26	0.7364
Mind Spheres	2016-07-08	7870	552	161	8031	0.7363
Muddy Heights 2	2016-04-19	28	231	62	90	0.7363
The Beggar's Ride	2016-05-05	18	143	36	54	0.7363
Fabulous - Angela's Fashion Fever	2016-10-19	16	101	24	40	0.7362000000000001
Goetia	2016-04-14	111	519	151	262	0.7359
Mushroom Wars	2016-04-07	78	410	117	195	0.7359
Star Tactics	2016-09-07	825	42	8	833	0.7359
Samurai of Hyuga	2016-09-16	50	42	8	58	0.7359
Tumblestone	2016-07-12	13239	1389	431	13670	0.7356999999999999
Mr. Nibbles Forever	2016-04-29	9	38	7	16	0.7356999999999999
Dungelot : Shattered Lands	2016-02-18	390	419	120	510	0.7356
DARTHY	2016-02-16	3535	34	6	3541	0.7356
Antiflux	2016-05-19	4	34	6	10	0.7356
LUMBERMANCER	2016-06-29	9	34	6	15	0.7356
Hidden Object 6-in-1 bundle	2016-03-17	180	183	48	228	0.7354999999999999
Junk Jack	2016-12-01	75	344	97	172	0.7353000000000001
Shadowverse	2016-10-28	24167	10252	3428	27595	0.7352
Sorcery! Part 4	2016-09-22	31	68	15	46	0.7352
SPINGUN	2016-11-11	379	68	15	394	0.7352
1979 Revolution: Black Friday	2016-04-05	40	808	244	284	0.7351000000000001
NeuroVoider	2016-08-31	205	526	154	359	0.7351000000000001
Gunjack	2016-04-05	24	179	47	71	0.735
Duke of Alpha Centauri	2016-12-28	1351	356	101	1452	0.7349
Exoplanet: First Contact	2016-12-09	22	232	63	85	0.7348
Gurgamoth	2016-02-16	56	75	17	73	0.7347
Carnivore Land	2016-03-09	4	17	2	6	0.7345
Dark Tales: Edgar Allan Poe's The Gold Bug Collector's Edition	2016-06-09	5	17	2	7	0.7345
Claws & Feathers 2	2016-12-13	6	17	2	8	0.7345
hackmud	2016-09-22	436	520	153	589	0.7343000000000001
Unveil	2016-04-19	23	49	10	33	0.7341
MachineCraft	2016-03-25	510	683	206	716	0.7334999999999999
Dead Island Riptide Definitive Edition	2016-05-31	439	3554	1164	1603	0.7334
BlackSmith HIT	2016-08-05	1593	378	109	1702	0.7333
A Blind Legend	2016-04-07	98	190	51	149	0.7331000000000001
Square's Route	2016-03-18	4	41	8	12	0.733
BUTTS	2016-02-03	4	74	17	21	0.7329000000000001
Table Top Racing: World Tour	2016-05-26	76	493	146	222	0.7327
Pumpkin SculptrVR	2016-10-21	8	21	3	11	0.7327
Emily: Displaced	2016-07-26	3	7	0	3	0.7326
Glory by Example	2016-08-24	9	7	0	9	0.7326
TwinForce	2016-09-20	2	7	0	2	0.7326
The Electric Shocktopus	2016-11-30	2	7	0	2	0.7326
Chilie	2016-11-23	79	7	0	79	0.7326
Myths of the World: Chinese Healer Collector's Edition	2016-11-07	3	7	0	3	0.7326
Danse Macabre: The Last Adagio Collector's Edition	2016-11-09	3	7	0	3	0.7326
Magic Hour	2016-12-20	3	7	0	3	0.7326
CloudBound	2016-09-08	6	37	7	13	0.7325
Magical Eyes - Red is for Anguish	2016-03-30	20	52	11	31	0.7323999999999999
Spectrum	2016-09-22	622	52	11	633	0.7323999999999999
Design it, Drive it : Speedboats	2016-07-26	12	52	11	23	0.7323999999999999
Run Rabbit Run	2016-03-31	118	70	16	134	0.7321
TV Trouble	2016-10-24	11	33	6	17	0.7321
Next Stop 2	2016-11-06	58	33	6	64	0.7321
The Strike	2016-01-07	12	25	4	16	0.7320000000000001
Spaceman Sparkles 3	2016-03-21	46	25	4	50	0.7320000000000001
AcidPunk : Echoes of Doll City	2016-08-04	5	25	4	9	0.7320000000000001
Anicon - Animal Complex - Cat's Path	2016-08-02	6	25	4	10	0.7320000000000001
In Extremis	2016-11-17	55	25	4	59	0.7320000000000001
The Aquatic Adventure of the Last Human	2016-01-19	55	327	94	149	0.7319
NeonXSZ	2016-02-22	53	84	20	73	0.7319
Color Chaos	2016-05-02	2452	29	5	2457	0.7319
Stereo Aereo	2016-12-14	21	29	5	26	0.7319
Awakening: The Redleaf Forest Collector's Edition	2016-03-28	5	12	1	6	0.7319
Relativity	2016-08-24	3	12	1	4	0.7319
BASMENT DWELLERS	2016-11-22	2	12	1	3	0.7319
Alice's Patchworks 2	2016-10-07	1661	208	57	1718	0.7318000000000001
Dungeon of Zolthan	2016-05-11	6356	393	115	6471	0.7317
Royal Heroes	2016-03-17	1195	237	66	1261	0.7317
Neon Shadow	2016-08-26	6	59	13	19	0.7316
Blade Ballet	2016-08-09	53	59	13	66	0.7316
WASTED	2016-06-07	596	856	266	862	0.7312000000000001
SHOCK TROOPERS	2016-05-18	11	128	33	44	0.7312000000000001
Toy Soldiers: Complete	2016-02-17	212	743	229	441	0.7311
Wake Up	2016-08-09	168	73	17	185	0.7311
Time Leap Paradise SUPER LIVE!	2016-12-16	39	184	50	89	0.731
Shadwen	2016-05-17	121	927	290	411	0.7309
Dungeon Journey	2016-06-04	1033	197	54	1087	0.7309
Lethal VR	2016-11-08	14	151	40	54	0.7309
Shu	2016-10-04	68	131	34	102	0.7309
Santa Rockstar Steam Edition	2016-12-13	343	104	26	369	0.7309
Aselia the Eternal -The Spirit of Eternity Sword-	2016-04-29	55	55	12	67	0.7308
Anomalies	2016-10-28	733	44	9	742	0.7308
Ashes of the Singularity: Escalation	2016-11-10	3831	3298	1096	4927	0.7305
Grand Pigeon's Duty	2016-08-05	2292	449	134	2426	0.7304
Hidden Dimensions 3	2016-10-12	26	62	14	40	0.7304
Wind Child	2016-03-18	354	76	18	372	0.7302
Wilson Chronicles - Beta	2016-01-14	114	1156	368	482	0.7301000000000001
Between Me and The Night	2016-01-22	1681	617	189	1870	0.7301000000000001
Voodoo Garden	2016-08-04	158	565	172	330	0.7301000000000001
GI Racing 2.0	2016-07-23	136	40	8	144	0.73
Pandarama: The Lost Toys	2016-12-15	1736	51	11	1747	0.7299
The Interactive Adventures of Dog Mendonça and Pizzaboy	2016-03-03	34	189	52	86	0.7298
Onion Force	2016-03-02	842	58	13	855	0.7293999999999999
Colours of Magic: Aqua Teeter	2016-04-25	428	72	17	445	0.7293000000000001
Drive on Moscow	2016-10-27	26	65	15	41	0.7293000000000001
Overpower	2016-04-20	26	36	7	33	0.7293000000000001
Scrap Garden	2016-05-06	334	834	262	596	0.7292000000000001
Antenna	2016-04-08	232	1853	607	839	0.7291
Major\Minor	2016-10-11	61	436	131	192	0.7291
RePete	2016-03-09	699	32	6	705	0.7286
Memoir En Code: Reissue	2016-09-21	20	16	2	22	0.7286
Red Spider2: Exiled	2016-12-09	4	16	2	6	0.7286
Last Mage Standing	2016-12-15	4	16	2	6	0.7286
Dexodonex	2016-12-08	838	75	18	856	0.7284
Warden: Melody of the Undergrowth	2016-04-08	40	61	14	54	0.7283
From Earth	2016-03-10	25	187	52	77	0.7282
Forge of Gods (RPG)	2016-05-06	5445	2013	666	6111	0.728
DubWars	2016-07-19	490	225	64	554	0.728
Notruf 112	2016-11-10	1332	2751	922	2254	0.7279000000000001
Runes	2016-11-24	5	28	5	10	0.7279000000000001
Fortified	2016-02-03	138627	1261	409	139036	0.7278
Risky Rescue	2016-02-19	915	284	83	998	0.7276
Red Baron Pack	2016-01-07	11	78	19	30	0.7276
Reagan Gorbachev	2016-02-24	623	20	3	626	0.7276
Spunk and Moxie	2016-05-06	5	20	3	8	0.7276
Framed Wings	2016-08-06	61	20	3	64	0.7276
Asteroids Minesweeper	2016-07-08	10	50	11	21	0.7273999999999999
Bunnyrama	2016-12-20	1515	50	11	1526	0.7273999999999999
Dark Parables: Curse of Briar Rose Collector's Edition	2016-09-09	7	57	13	20	0.7272
Fantastic Contraption	2016-04-05	91	211	60	151	0.7271
Maze Lord	2016-06-17	1057	176	49	1106	0.7270000000000001
Dungeon Rats	2016-11-04	278	430	131	409	0.7269
Special Tactics Online	2016-04-26	20	81	20	40	0.7269
Boulder Dash 30th Anniversary	2016-09-14	24	81	20	44	0.7269
Roll'd	2016-04-14	302	220	63	365	0.7267
Big Action Mega Fight!	2016-01-12	622	201	57	679	0.7267
EscapeVR: The Basement	2016-11-07	11	74	18	29	0.7266
EvilMaze	2016-06-17	1304	888	285	1589	0.7264
Spin Rush	2016-09-16	1658	395	120	1778	0.7263
Starters Orders 6	2016-06-29	77	84	21	98	0.7263
Satellite Rush	2016-11-16	192	46	10	202	0.7263
Ember	2016-09-09	399	697	221	620	0.726
DROD RPG: Tendry's Tale	2016-02-12	11	35	7	18	0.7259000000000001
Weather Lord: Following the Princess Collector's Edition	2016-04-20	34	35	7	41	0.7259000000000001
Armed Against the Undead	2016-06-17	8	35	7	15	0.7259000000000001
Demon Truck	2016-09-26	8	35	7	15	0.7259000000000001
Lost in the Rift - Reborn	2016-11-21	7	35	7	14	0.7259000000000001
TableTop Soccer	2016-04-22	71	87	22	93	0.7256999999999999
Legends of the Universe - StarCore	2016-07-26	960	87	22	982	0.7256999999999999
Atom Fishing II	2016-11-30	944	1155	378	1322	0.7256
Mugen Souls Z	2016-08-25	73	70	17	90	0.7255
Pocket Rumble	2016-02-01	45	155	43	88	0.7254
Tales [PC]	2016-11-14	122	63	15	137	0.7251000000000001
CALENDULA	2016-02-02	29	270	80	109	0.7249
Tales Across Time	2016-04-18	50	56	13	63	0.7249
Poly Runner VR	2016-04-18	8	56	13	21	0.7249
Party Golf	2016-10-27	23	49	11	34	0.7248
WildStar	2016-06-09	5060	3725	1286	6346	0.7245999999999999
The Way of Life Free Edition	2016-05-31	316	4753	1655	1971	0.7245
Pankapu	2016-09-21	31	263	78	109	0.7244
Triennale Game Collection	2016-12-07	11	66	16	27	0.7243
The Political Machine 2016	2016-02-04	193	545	172	365	0.7242000000000001
Sakura Space	2016-10-10	63	238	70	133	0.7242000000000001
Auralux: Constellations	2016-06-01	30	109	29	59	0.7242000000000001
Hyper Gods	2016-10-07	7	11	1	8	0.7242000000000001
Rising Runner	2016-06-10	3596	11	1	3597	0.7242000000000001
Atomic Butcher: Homo Metabolicus	2016-10-21	3	11	1	4	0.7242000000000001
Nevertales: Shattered Image Collector's Edition	2016-09-16	7	11	1	8	0.7242000000000001
Super Ninja Hero VR	2016-12-24	5	11	1	6	0.7242000000000001
Hoverboards VR	2016-10-26	4	11	1	5	0.7242000000000001
Tyto Online	2016-11-26	13	11	1	14	0.7242000000000001
Domino Craft VR	2016-12-22	3	11	1	4	0.7242000000000001
The Storm Guard: Darkness is Coming	2016-08-25	78	128	35	113	0.7238
Powargrid	2016-10-05	47	27	5	52	0.7238
Dark Parables: The Red Riding Hood Sisters Collector's Edition	2016-08-09	8	27	5	13	0.7238
DashBored	2016-06-14	279	197	57	336	0.7236
Dragonpath	2016-07-07	16	79	20	36	0.7234999999999999
Genius Greedy Mouse	2016-08-12	923	69	17	940	0.7234999999999999
Ultimate Booster Experience	2016-07-15	35	252	75	110	0.7232999999999999
boxlife	2016-01-14	20	105	28	48	0.7232
Wailing Heights	2016-04-27	15	92	24	39	0.7232
Rogue Wizards	2016-09-27	175	187	54	229	0.7231000000000001
Madness Cubed	2016-05-12	1601	708	229	1830	0.723
Castle of no Escape 2	2016-12-21	671	294	89	760	0.723
VR Ping Pong	2016-09-13	26	108	29	55	0.7229000000000001
Trump Simulator VR	2016-10-27	4	72	18	22	0.7228
Ricerca VR	2016-05-03	4	23	4	8	0.7228
Scrap Garden - The Day Before	2016-10-07	254	711	231	485	0.7223999999999999
Super Dungeon Tactics	2016-12-14	135	114	31	166	0.7223999999999999
Sprinter	2016-02-25	8	34	7	15	0.7223999999999999
Tank Universal 2	2016-10-13	4	34	7	11	0.7223999999999999
LoveBeat	2016-01-14	406	1030	342	748	0.7222
Beeftacular	2016-08-26	40	75	19	59	0.7222
Queen At Arms	2016-02-03	23	15	2	25	0.7222
Log Drive Runner	2016-09-08	91	15	2	93	0.7222
Super Mixtape	2016-10-24	213	15	2	215	0.7222
The Crystal Nebula	2016-07-28	5	15	2	7	0.7222
Citadel 1986	2016-08-17	9	15	2	11	0.7222
Juno's Darkest Hour	2016-12-19	182	15	2	184	0.7222
Pong It! VR	2016-09-20	5	15	2	7	0.7222
Bubble Jungle	2016-09-27	2777	15	2	2779	0.7222
Rogue Continuum 	2016-10-04	10	19	3	13	0.7221
The Beard in the Mirror	2016-10-25	11	19	3	14	0.7221
Run Turn Die	2016-05-09	6	19	3	9	0.7221
Adventure Lamp	2016-07-15	4	19	3	7	0.7221
Wondershot	2016-02-19	25	19	3	28	0.7221
Steno Arcade	2016-03-30	13	139	39	52	0.7220000000000001
Mr. Shadow	2016-11-17	100	41	9	109	0.7220000000000001
ARAYA	2016-11-23	179	596	192	371	0.7219
Leave Me Alone: A Trip To Hell	2016-04-21	1662	78	20	1682	0.7217
Legend of Moros	2016-03-03	3	6	0	3	0.7217
Snakes on an Extradimensional Plane	2016-12-05	3	6	0	3	0.7217
BitShift: BattleGrid	2016-09-28	3	6	0	3	0.7217
Spirits of Mystery: Amber Maiden Collector's Edition	2016-08-19	4	6	0	4	0.7217
zTime (Danger Noodles!)	2016-10-24	3	6	0	3	0.7217
Scary Humans	2016-10-26	2	6	0	2	0.7217
Naughty Or Nice	2016-12-29	4	6	0	4	0.7217
Space Grunts	2016-01-12	17	58	14	31	0.7216
Last Will	2016-08-29	48	237	71	119	0.7215
Radial-G : Racing Revolved	2016-03-28	15	113	31	46	0.7211
iOMoon	2016-04-27	4	30	6	10	0.7209000000000001
Pixelscape: Oceans	2016-09-09	36	37	8	44	0.7205
Pixel Puzzles Ultimate	2016-09-09	4048	1776	612	4660	0.7203
The Guest	2016-03-10	116	573	187	303	0.7195
Sentry Knight Tactics	2016-10-04	49	96	26	75	0.7195
Starship Titanic	2016-10-27	9	67	17	26	0.7195
League of Evil	2016-10-25	205	47	11	216	0.7194
Subsistence	2016-10-25	1527	8299	3018	4545	0.7193
Dungeon Souls	2016-12-02	327	1644	569	896	0.7190000000000001
SoulHunt	2016-12-23	20	70	18	38	0.7190000000000001
Shift	2016-08-16	813	233	71	884	0.7188
1917 - The Alien Invasion DX	2016-06-10	70	105	29	99	0.7188
Tavernier	2016-08-25	40	136	39	79	0.7187
Cranks and Goggles	2016-12-21	16	139	40	56	0.7186
FreeHolder	2016-07-05	14	73	19	33	0.7184999999999999
LASTFIGHT	2016-05-19	32	60	15	47	0.7184999999999999
Starr Mazer: DSP	2016-08-26	24	190	57	81	0.718
Victory and Glory: Napoleon	2016-03-17	111	98	27	138	0.7178
A Midsummer Night's Choice	2016-08-25	29	22	4	33	0.7178
Asteroid Blaster VR	2016-09-28	4	22	4	8	0.7178
Death Goat	2016-06-07	207	258	80	287	0.7177
Dimensional	2016-12-14	10	43	10	20	0.7176
Spellweaver	2016-02-01	721	1002	342	1063	0.7175
Control Craft 2	2016-02-15	1247	237	73	1320	0.7175
BattleTime	2016-09-29	583	147	43	626	0.7173999999999999
Rogue Port - Red Nightmare	2016-05-09	3906	82	22	3928	0.7173999999999999
Alien Attack	2016-06-21	932	168	50	982	0.7172
Kombine	2016-10-14	805	85	23	828	0.7171
Planet Stronghold: Colonial Defense	2016-03-09	13	29	6	19	0.7169
Infinite Air with Mark McMorris	2016-10-25	77	221	68	145	0.7167
Fernbus Simulator	2016-08-25	865	6345	2327	3192	0.7166
Guided Meditation VR	2016-10-03	10	91	25	35	0.7166
Marble Void	2016-04-12	7	18	3	10	0.7162999999999999
The Concourse	2016-06-01	12	18	3	15	0.7162999999999999
SwingStar VR	2016-12-20	5	18	3	8	0.7162999999999999
The Warlock of Firetop Mountain	2016-08-31	264	484	160	424	0.7156999999999999
Jerry Rice & Nitus' Dog Football	2016-02-11	40	39	9	49	0.7156999999999999
Tribal Pass	2016-08-26	1106	298	95	1201	0.7155
Land It!	2016-08-01	4	10	1	5	0.7155
Orange Adventure	2016-08-04	3	10	1	4	0.7155
Omega Reaction	2016-10-18	4	10	1	5	0.7155
Take the Dream IX	2016-04-01	28	130	38	66	0.7154
Gobernators (Parodia política peruana)	2016-10-01	12	65	17	29	0.7153
Think To Die	2016-09-22	37	283	90	127	0.7152
Rayon Riddles - Rise of the Goblin King	2016-11-11	3	14	2	5	0.7152
StreetCraft	2016-09-30	6	14	2	8	0.7152
Nevertales: The Beauty Within Collector's Edition	2016-05-17	4	14	2	6	0.7152
PlanetFate	2016-06-07	4	14	2	6	0.7152
Red is Dead	2016-07-22	5	14	2	7	0.7152
Zissi's Island	2016-08-29	6	14	2	8	0.7152
Spinning Maze	2016-10-17	8	14	2	10	0.7152
Proxy - Ultimate Hacker	2016-10-14	18	14	2	20	0.7152
ShapeRockets	2016-10-28	10	14	2	12	0.7152
Dawn's Light 2	2016-11-09	35	14	2	37	0.7152
Shady Brook - A Dark Mystery Text Adventure	2016-10-24	23	14	2	25	0.7152
The Whisperer in Darkness	2016-10-18	5	32	7	12	0.7149
Clover Tale	2016-06-15	111	591	199	310	0.7148000000000001
Trial by Viking	2016-03-29	10	25	5	15	0.7148000000000001
Void 21	2016-04-04	7	25	5	12	0.7148000000000001
New Yankee in King Arthur's Court	2016-04-28	730	25	5	735	0.7148000000000001
MOAI 4: Terra Incognita Collector’s Edition	2016-06-07	85	25	5	90	0.7148000000000001
Tennis Elbow Manager	2016-10-14	27	25	5	32	0.7148000000000001
Left Alone	2016-04-28	75	453	150	225	0.7147
SMASHING THE BATTLE	2016-05-16	221	433	143	364	0.7145999999999999
Tyto Ecology	2016-04-14	143	316	102	245	0.7144
Simutrans	2016-05-24	199	367	120	319	0.7143
Where's My Mommy?	2016-03-02	40	129	38	78	0.7142000000000001
Drunkn Bar Fight	2016-11-28	39	716	245	284	0.7141
The Dwarves	2016-12-01	972	1362	482	1454	0.7138
Eventide 2: The Sorcerers Mirror	2016-10-13	143	220	69	212	0.7138
President Erect VR	2016-12-21	7	92	26	33	0.7133
Destiny's Princess: A War Story, A Love Story	2016-04-06	44	198	62	106	0.7126
Control Craft 3	2016-12-30	700	163	50	750	0.7125
AWA	2016-06-16	4039	73	20	4059	0.7123999999999999
Raptor Valley	2016-09-09	5	38	9	14	0.7123
Thirst	2016-08-10	13	94	27	40	0.7117
Final Soccer VR	2016-11-18	22	94	27	49	0.7117
Feesh	2016-02-02	40	103	30	70	0.7116
Stratego® Single Player	2016-12-10	14	41	10	24	0.7114
Zolg	2016-12-02	649	144	44	693	0.7111
Kitten Cannon	2016-11-01	5	31	7	12	0.711
Atomic Reconstruction	2016-12-18	935	31	7	942	0.711
Legends of Callasia	2016-06-10	284	207	66	350	0.7106
BossConstructor	2016-10-24	118	158	49	167	0.7105
Sumeru	2016-09-21	39	123	37	76	0.7105
Winged Sakura: Demon Civil War	2016-12-08	29	69	19	48	0.7105
Blue Solar: Chaos War	2016-07-21	33	111	33	66	0.7103
Lovely Planet Arcade	2016-07-22	36	105	31	67	0.7101999999999999
Tahira: Echoes of the Astral Empire	2016-08-31	33	87	25	58	0.7101000000000001
HeartZ: Co-Hope Puzzles	2016-06-07	61	17	3	64	0.71
Dungeon Punks	2016-08-24	7	17	3	10	0.71
MAGICAL×SPIRAL	2016-12-20	11	17	3	14	0.71
Ninja Smasher!	2016-11-24	4	17	3	7	0.71
Rescue Team 6 Collector's Edition	2016-12-13	12	17	3	15	0.71
StarsOne	2016-04-08	199	388	131	330	0.7099
Axe, Bow & Staff	2016-09-29	12	24	5	17	0.7099
Crystal Quest Classic	2016-11-23	4	24	5	9	0.7099
Blanco	2016-12-24	4	24	5	9	0.7099
Dyna Bomb	2016-05-13	446	34	8	454	0.7098000000000001
BellyBots	2016-07-26	4	34	8	12	0.7098000000000001
MineSweeper VR	2016-08-25	6	34	8	14	0.7098000000000001
Mekazoo	2016-11-15	14	50	13	27	0.7097
Directionless	2016-06-01	5	50	13	18	0.7097
Gochi-Show!	2016-09-02	80	50	13	93	0.7097
Dragon Rage	2016-07-22	21	128	39	60	0.7095
Bullshot	2016-11-22	2658	228	74	2732	0.7093
Never give up!	2016-12-30	284	107	32	316	0.7088
Squareface	2016-09-12	58	59	16	74	0.7088
Elena	2016-12-16	18	37	9	27	0.7088
Fright Light	2016-08-26	18	37	9	27	0.7088
Think To Die 2	2016-10-14	90	86	25	115	0.7084
Armed and Gelatinous	2016-03-01	4	5	0	4	0.7084
Bipolar Game	2016-04-20	1	5	0	1	0.7084
Baskhead	2016-07-19	8	5	0	8	0.7084
Heroes from the Past: Joan of Arc	2016-07-21	5	5	0	5	0.7084
Hero Boy	2016-10-31	8	5	0	8	0.7084
Hidden Expedition: Dawn of Prosperity Collector's Edition	2016-09-07	4	5	0	4	0.7084
Grave Mania: Pandemic Pandemonium	2016-08-30	3	5	0	3	0.7084
Oniris Basket VR	2016-09-17	2	5	0	2	0.7084
Damned Cold	2016-10-25	3	5	0	3	0.7084
Amaranthine Voyage: The Tree of Life Collector's Edition	2016-11-14	3	5	0	3	0.7084
Little Kingdom 2	2016-12-16	3	5	0	3	0.7084
Ghostlight Manor	2016-12-11	10	5	0	10	0.7084
Subliminal Realms: The Masterpiece Collector's Edition	2016-12-12	4	5	0	4	0.7084
Smithy	2016-06-03	1627	74	21	1648	0.7083
Riding Club Championships	2016-09-27	200	471	163	363	0.7081000000000001
Robot Legions Reborn	2016-07-19	2206	40	10	2216	0.7081000000000001
Mazement	2016-02-19	229	27	6	235	0.7081000000000001
Puzzle Box	2016-04-22	13	27	6	19	0.7081000000000001
Battles of Norghan	2016-09-27	12	27	6	18	0.7081000000000001
Win Big Or Die	2016-10-13	10	27	6	16	0.7081000000000001
Alcatraz: VR Escape Room	2016-12-27	11	27	6	17	0.7081000000000001
Freebie	2016-06-16	5623	1012	366	5989	0.7078
Adorables	2016-03-31	4973	634	224	5197	0.7077
Sakura Shrine Girls	2016-08-26	60	192	62	122	0.7076000000000001
FIRMA	2016-11-18	5	13	2	7	0.7075
Blockpocalypse	2016-10-06	7	13	2	9	0.7075
XO-Planets	2016-04-21	21	13	2	23	0.7075
PataNoir	2016-06-01	4	13	2	6	0.7075
Button Frenzy	2016-07-08	6	13	2	8	0.7075
Tetradecagon	2016-07-11	6	13	2	8	0.7075
KOTH	2016-09-01	2	13	2	4	0.7075
Weather Lord: Legendary Hero Collector's Edition	2016-08-04	74	13	2	76	0.7075
VilleTown	2016-09-23	9	13	2	11	0.7075
PuppetShow™: Mystery of Joyville	2016-10-14	4	13	2	6	0.7075
Sullen	2016-12-21	1211	13	2	1213	0.7075
Zombie Town VR	2016-12-09	6	13	2	8	0.7075
Arkshot	2016-05-19	29	106	32	61	0.7073999999999999
Day D: Tower Rush	2016-07-08	1632	183	59	1691	0.7072
Zombasite	2016-08-23	64	146	46	110	0.7070000000000001
Slybots: Frantic Zone	2016-01-18	7	30	7	14	0.7068000000000001
Sengoku Jidai: Shadow of the Shogun	2016-05-19	60	120	37	97	0.7067
Timore 5	2016-08-25	121	82	24	145	0.7066
Ludu	2016-12-04	8	55	15	23	0.7065
Sethian	2016-11-09	18	70	20	38	0.7062999999999999
STAR WARS™: Rogue Squadron 3D	2016-03-29	157	816	295	452	0.7061000000000001
The Mims Beginning	2016-05-18	90	193	63	153	0.7061000000000001
Candy Kingdom	2016-09-20	5	33	8	13	0.7059000000000001
The Puppet Master	2016-10-22	16	33	8	24	0.7059000000000001
VR Invaders	2016-12-15	5	33	8	13	0.7059000000000001
Strike.is: The Game	2016-07-14	482	933	340	822	0.7058
Skeet: VR Target Shooting	2016-04-05	14	125	39	53	0.7058
Huenison	2016-02-26	13	9	1	14	0.7057
Shadow Of Nebula	2016-03-01	3	9	1	4	0.7057
Awakening: The Sunhook Spire Collector's Edition	2016-06-08	5	9	1	6	0.7057
Epic Flail	2016-11-01	5	9	1	6	0.7057
SOS: SPECIAL OPERATIVE STORIES	2016-12-20	3	9	1	4	0.7057
Off the Record: The Italian Affair Collector's Edition	2016-08-04	6	9	1	7	0.7057
Duck Force	2016-11-17	7	9	1	8	0.7057
The Mine	2016-12-20	3	9	1	4	0.7057
Wicce	2016-05-05	11	96	29	40	0.7055
The Visitor	2016-03-30	10	153	49	59	0.7054
Qasir al-Wasat: International Edition	2016-01-19	29	36	9	38	0.7051999999999999
Crawlers and Brawlers	2016-08-22	115	36	9	124	0.7051999999999999
Super Blue Fighter	2016-05-06	1447	87	26	1473	0.705
拯救大魔王2 Rescue the Great Demon 2	2016-11-18	287	336	116	403	0.7048000000000001
Antihorror	2016-07-27	1024	144	46	1070	0.7048000000000001
Historium VR - Relive the history of Bruges	2016-12-02	4	23	5	9	0.7048000000000001
Kittypocalypse - Ungoggled	2016-11-03	13	42	11	24	0.7044
Dofus	2016-11-15	399	410	144	543	0.7042
Megamagic: Wizards of the Neon Age	2016-04-20	534	69	20	554	0.7042
Pythagoria	2016-01-22	85	174	57	142	0.7041
Neon Warp	2016-07-29	778	63	18	796	0.7041
Space Rift - Episode 1	2016-08-02	14	57	16	30	0.7040000000000001
Affairs of the Court: Choice of Romance	2016-06-23	37	51	14	51	0.7040000000000001
Dead Effect 2	2016-05-06	264	1544	583	847	0.7034
Super Flippin' Phones	2016-02-18	8	26	6	14	0.7034
I am Setsuna	2016-07-19	1493	1121	418	1911	0.7033
GemBreak	2016-06-14	106	86	26	132	0.7033
Proton Pulse	2016-04-05	3	16	3	6	0.7033
XNemesis	2016-06-07	591	16	3	594	0.7033
Nekuia	2016-12-16	35	16	3	38	0.7033
Survival VR	2016-11-27	6	16	3	9	0.7033
Heroes of the Monkey Tavern	2016-09-22	29	263	90	119	0.7031999999999999
Patchwork	2016-12-06	162	173	57	219	0.7031999999999999
Crime Secrets: Crimson Lily	2016-07-14	227	327	114	341	0.7029000000000001
Bezier	2016-03-03	18	80	24	42	0.7029000000000001
Monsters and Monocles	2016-08-16	65	77	23	88	0.7027
MXGP2 - The Official Motocross Videogame	2016-04-07	437	435	155	592	0.7025
The Song of Seven : Overture	2016-05-17	13	32	8	21	0.7019
Just a Cleric	2016-05-19	45	32	8	53	0.7019
Locked In VR	2016-12-01	11	32	8	19	0.7019
Impossible Quest	2016-06-03	976	239	82	1058	0.7016
Hunger Dungeon	2016-12-06	770	1657	634	1404	0.7015000000000001
Demon's Crystals	2016-04-21	80	53	15	95	0.7012999999999999
Alone in the Dark 3	2016-12-13	6	53	15	21	0.7012999999999999
Dreamcage Escape	2016-11-16	9	53	15	24	0.7012999999999999
LUXIS	2016-10-26	254	38	10	264	0.7012999999999999
A Magical High School Girl	2016-11-22	50	138	45	95	0.7012
Xuan-Yuan Sword: The Gate of Firmament	2016-02-25	352	1017	383	735	0.7009000000000001
Solstice	2016-03-23	32	135	44	76	0.7009000000000001
Rising Angels: Hope	2016-03-18	11	19	4	15	0.7008
Wish -tale of the sixteenth night of lunar month-	2016-08-19	60	19	4	64	0.7008
Echoes of the Fey - The Fox's Trail	2016-08-16	43	19	4	47	0.7008
PITCH-HIT ARCADE	2016-09-23	4	19	4	8	0.7008
Catch a Falling Star	2016-03-30	3013	431	156	3169	0.6999
Happy Maze	2016-12-21	5109	64	19	5128	0.6997
Puzzle Cube	2016-10-12	1205	95	30	1235	0.6994
Fatehaven	2016-09-16	40	61	18	58	0.6994
Falcon Gold	2016-01-08	46	22	5	51	0.6994
Stargazer Christmas	2016-12-01	138	22	5	143	0.6994
PLANNES	2016-12-08	4	22	5	9	0.6994
Townsmen	2016-11-30	158	166	56	214	0.6990999999999999
Paper Train: Traffic	2016-03-04	124	78	24	148	0.6990999999999999
Monsters!	2016-10-25	3	12	2	5	0.6990999999999999
Astral Gun	2016-02-02	5	12	2	7	0.6990999999999999
Quip Anomaly	2016-08-09	11	12	2	13	0.6990999999999999
Arizona Rose and the Pirates' Riddles	2016-10-19	8	12	2	10	0.6990999999999999
Emerland Solitaire: Endless Journey	2016-07-18	32	75	23	55	0.6988
Diaries of a Spaceport Janitor	2016-09-16	153	628	234	387	0.6987000000000001
Zavix Tower	2016-07-21	152	253	89	241	0.6984
Soulless: Ray Of Hope	2016-10-18	475	229	80	555	0.6981999999999999
Ragnarok Clicker	2016-08-03	3402	815	309	3711	0.6979000000000001
How To Make Your Grandpa Happy	2016-10-25	5	43	12	17	0.6979000000000001
Last Days of Spring 2	2016-11-18	515	43	12	527	0.6979000000000001
Resette's Prescription ~Book of memory, Swaying scale~	2016-05-30	19	40	11	30	0.6978
Democracy 3 Africa	2016-04-12	264	286	102	366	0.6977
Plates	2016-08-19	9	37	10	19	0.6977
The Fastest Fist	2016-11-10	7	37	10	17	0.6977
ASCII Attack	2016-03-17	42	31	8	50	0.6977
Just Deserts	2016-07-25	116	241	85	201	0.6973999999999999
Romopolis	2016-05-18	499	91	29	528	0.6973999999999999
35MM	2016-05-28	230	2833	1129	1359	0.6973
Surgeon Simulator VR: Meet The Medic	2016-04-05	30	324	117	147	0.6972
Card of spirits	2016-06-21	1418	77	24	1442	0.6972
EARTH'S DAWN	2016-12-07	60	169	58	118	0.6968000000000001
Glitchspace	2016-05-05	26	253	90	116	0.6967
Sky To Fly: Soulless Leviathan	2016-07-22	23	57	17	40	0.6966
Adventure Time: Magic Man's Head Games	2016-04-05	7	158	54	61	0.6964
Slain: Back from Hell	2016-03-24	252	1502	590	842	0.6962
Neon Space	2016-05-12	1726	386	142	1868	0.6961
Bitardia Cards: Memes of 2ch	2016-05-19	28	139	47	75	0.6961
Barrow Hill: The Dark Path	2016-09-22	43	93	30	73	0.6961
Super Mustache	2016-01-27	11227	452	168	11395	0.696
ORBITAL	2016-07-27	11882	205	72	11954	0.696
Alone in the Dark 2	2016-12-13	8	68	21	29	0.6959000000000001
Deadweight	2016-04-22	8	15	3	11	0.6959000000000001
Rewind	2016-03-31	5	15	3	8	0.6959000000000001
EXZEAL	2016-07-15	6	15	3	9	0.6959000000000001
Romance of the Three Kingdoms	2016-12-14	35	15	3	38	0.6959000000000001
Dark Parables: The Thief and the Tinderbox Collector's Edition	2016-09-22	6	15	3	9	0.6959000000000001
Hope Lake	2016-06-03	38	347	127	165	0.6958
Draw Rider	2016-04-01	1200	128	43	1243	0.6958
#SelfieTennis	2016-04-01	17	79	25	42	0.6957
Death by Game Show	2016-01-22	59	90	29	88	0.6956
The Away Team	2016-07-22	54	65	20	74	0.6955
Rocket Riot	2016-10-19	203	48	14	217	0.6954000000000001
The Hive	2016-08-25	61	251	90	151	0.6953
VRMultigames	2016-07-25	15	62	19	34	0.6950000000000001
Hyper Box	2016-03-17	1087	42	12	1099	0.6946
Systematic Immunity	2016-05-20	37	18	4	41	0.6944
Observatory: A VR Variety Pack	2016-05-12	3	8	1	4	0.6944
VR-Xterminator	2016-12-20	2	8	1	3	0.6944
MachRace	2016-06-30	3	8	1	4	0.6944
Human, we have a problem	2016-07-05	2	8	1	3	0.6944
Tails	2016-08-08	3	8	1	4	0.6944
Tesla's Tower: The Wardenclyffe Mystery	2016-07-29	8	8	1	9	0.6944
Siege Hammer	2016-11-02	3	8	1	4	0.6944
Head It!: VR Soccer Heading Game	2016-10-20	3	8	1	4	0.6944
NOBUNAGA'S AMBITION	2016-12-14	7	8	1	8	0.6944
Boo Breakers: The Ghostening	2016-10-25	3	8	1	4	0.6944
Astervoid 2000	2016-12-01	213	39	11	224	0.6943
Through the Woods	2016-10-27	149	976	382	531	0.6938
Shattered Throne	2016-11-28	64	33	9	73	0.6936
Action Legion	2016-04-19	7	21	5	12	0.6936
Blamdown Udder Fury	2016-08-30	215	21	5	220	0.6936
Malazard: The Master of Magic	2016-11-17	4	21	5	9	0.6936
The Hateful Dead	2016-10-28	5	21	5	10	0.6936
Rescue Bear Operation	2016-09-29	7	53	16	23	0.6935
Drift Into Eternity	2016-12-13	29	30	8	37	0.6934
Plight of the Zombie	2016-02-22	6	30	8	14	0.6934
Loot or Die	2016-09-13	129	30	8	137	0.6934
Empty Soul - S&S Edition	2016-06-30	246	27	7	253	0.6933
One More Night	2016-11-18	18	27	7	25	0.6933
VR Monster Awakens	2016-12-23	6	24	6	12	0.6933
Rubek	2016-10-14	123	75	24	147	0.6931999999999999
Dark Train	2016-10-25	29	131	45	74	0.6929000000000001
Police Quest Collection	2016-08-29	89	83	27	116	0.6929000000000001
Storm of Spears	2016-06-17	637	401	151	788	0.6926000000000001
Megapolis	2016-06-15	443	99	33	476	0.6926000000000001
Pixel Puzzles 2: RADical ROACH	2016-08-12	6981	69	22	7003	0.6920000000000001
LYDIA: SWEET DREAMS	2016-10-04	2	4	0	2	0.6920000000000001
Rally Copters	2016-08-10	109	4	0	109	0.6920000000000001
Nebula	2016-06-02	3	4	0	3	0.6920000000000001
Old School 8-in-1 bundle	2016-06-02	5	4	0	5	0.6920000000000001
Final Cut: Death on the Silver Screen Collector's Edition	2016-08-25	5	4	0	5	0.6920000000000001
Royal Detective: The Lord of Statues Collector's Edition	2016-11-23	3	4	0	3	0.6920000000000001
Fear Equation	2016-01-15	46	66	21	67	0.6914
Killing Time	2016-12-15	4	55	17	21	0.6914
Omega Agent	2016-05-04	5	41	12	17	0.6912
The Survey	2016-10-27	33	548	212	245	0.6911
Prehistoric Tales	2016-05-26	635	74	24	659	0.6911
Runeous: Part One	2016-05-31	184	82	27	211	0.691
One Night Two Crazies	2016-08-10	5	38	11	16	0.6907
King of Booze: Drinking Game	2016-09-09	45	38	11	56	0.6907
Realities	2016-04-05	84	183	66	150	0.6904000000000001
Flat Kingdom Paper's Cut Edition	2016-04-15	2509	142	50	2559	0.6904000000000001
Trigger Runners	2016-03-03	199	49	15	214	0.6900000000000001
Pipejob	2016-10-15	10	35	10	20	0.6900000000000001
Perfect Universe	2016-02-26	220	92	31	251	0.6899
Playthings: VR Music Vacation	2016-08-24	5	11	2	7	0.6897
Duckie Dash	2016-07-14	6	11	2	8	0.6897
Brick Battalion	2016-08-15	5	11	2	7	0.6897
TankYou!	2016-09-16	9	11	2	11	0.6897
PANIC at Multiverse High!	2016-08-17	9	11	2	11	0.6897
Santa's Special Delivery	2016-12-12	172	11	2	174	0.6897
Streamline	2016-09-30	10513	1441	586	11099	0.6896
Angel Express [Tokkyu Tenshi]	2016-07-15	38	32	9	47	0.6894
Vision of Aurora Borealis	2016-08-22	5	32	9	14	0.6894
Governor of Poker 3	2016-02-19	2720	8186	3492	6212	0.6890000000000001
Daily Chthonicle: Editor's Edition	2016-09-30	3557	102	35	3592	0.6890000000000001
GO AWAY, THERE'S KUMIS OVER THERE!	2016-10-28	2240	143	51	2291	0.6886
MEMENTO	2016-07-08	11	43	13	24	0.6885
Flesh Eaters	2016-05-03	3127	955	385	3512	0.6883
LineDash	2016-07-11	391	26	7	398	0.6883
Construct: Escape the System	2016-12-02	20	91	31	51	0.6881
Selenon Rising	2016-04-29	4	14	3	7	0.688
Operation KREEP	2016-06-10	193	14	3	196	0.688
Simple Spy	2016-07-06	5	14	3	8	0.688
Square Arena	2016-06-19	5	14	3	8	0.688
Shiperoids	2016-08-10	5	14	3	8	0.688
画境(Picturesque) VR	2016-12-20	3	14	3	6	0.688
I Hate Santa	2016-12-02	3	14	3	6	0.688
SHOWTIME 2073	2016-02-12	11	213	79	90	0.6879000000000001
Super Robot Jump Jump	2016-03-31	52	23	6	58	0.6878000000000001
EPΘCH	2016-05-17	25	40	12	37	0.6877
BUSTED!	2016-10-11	10	59	19	29	0.6876000000000001
Lew Pulsipher's Doomstar	2016-09-16	48	20	5	53	0.6875
Spell Casting: Meowgically Enhanced Edition	2016-09-02	36	20	5	41	0.6875
Natural - Beyond Nature -	2016-12-12	32	20	5	37	0.6875
ARK BOX Unlimited	2016-11-29	51	20	5	56	0.6875
Cloudphobia	2016-12-07	3	17	4	7	0.6875
Atlantic Quest 2 - New Adventure -	2016-04-05	23	17	4	27	0.6875
Fairies vs. Darklings: Arcane Edition	2016-02-29	129	17	4	133	0.6875
Minds Eyes	2016-08-31	192	1132	462	654	0.6873
Masked Shooters 2	2016-01-14	2215	1135	464	2679	0.6870999999999999
POPixel	2016-06-04	1233	48	15	1248	0.687
Mars Odyssey	2016-09-09	10	37	11	21	0.6869
Obliteracers	2016-02-24	75	169	62	137	0.6867
March of the Living	2016-04-20	304	378	147	451	0.6866
Deadlight Director’s Cut	2016-06-21	104	884	359	463	0.6865000000000001
XBlaze Code: Embryo	2016-03-01	16	69	23	39	0.6861
FourChords Guitar Karaoke	2016-09-29	11	69	23	34	0.6861
The Lost Heir: The Fall of Daria	2016-01-29	70	45	14	84	0.6861
Simple Ball: Extended Edition	2016-07-26	1758	82	28	1786	0.6859999999999999
Broken Bots	2016-06-08	70	34	10	80	0.6859999999999999
Secrets of Me	2016-10-05	11	34	10	21	0.6859999999999999
DEXED	2016-09-26	10	34	10	20	0.6859999999999999
Metrico+	2016-08-23	122	153	56	178	0.6857
WARSHIFT	2016-10-13	206	479	190	396	0.6855
God of Word	2016-09-28	38	92	32	70	0.6854000000000001
Leap Up no jutsu	2016-12-31	1748	92	32	1780	0.6854000000000001
Showdown Adventure	2016-09-23	320	42	13	333	0.6851999999999999
Giant Machines 2017	2016-09-29	211	350	137	348	0.6848000000000001
Fortify	2016-04-08	110	71	24	134	0.6848000000000001
Gunmetal Arcadia Zero	2016-11-15	13	89	31	44	0.6846
Incredible Dracula: Chasing Love Collector's Edition	2016-01-28	196	63	21	217	0.6844
Gulman 4: Still alive	2016-12-20	11	99	35	46	0.6843000000000001
String Theory	2016-02-17	21	39	12	33	0.6840999999999999
Tick Tock Bang Bang	2016-06-09	21	39	12	33	0.6840999999999999
Timelapse	2016-01-21	5	28	8	13	0.6840999999999999
Tentacult!	2016-09-23	13	28	8	21	0.6840999999999999
Autumn Park Mini Golf	2016-09-17	4	28	8	12	0.6840999999999999
How to Survive 2	2016-09-08	2823	7363	3215	6038	0.684
Chimpact 1 - Chuck's Adventure	2016-11-11	35	149	55	90	0.684
htoL#NiQ: The Firefly Diary	2016-05-18	72	393	156	228	0.6835
Share	2016-05-03	637	205	78	715	0.6834
Ghoul Kid	2016-04-26	27	106	38	65	0.6833
Crazy Stone Deep Learning -The First Edition-	2016-05-26	15	25	7	22	0.6831
Seven Seas Solitaire	2016-11-29	12	25	7	19	0.6831
Momento Temporis: Light from the Deep	2016-10-27	7	36	11	18	0.6829999999999999
Tharsis	2016-01-12	694	1682	713	1407	0.6829000000000001
AltspaceVR	2016-04-01	736	427	171	907	0.6828000000000001
Demon Hunter 2: New Chapter	2016-07-21	337	170	64	401	0.6827
Mind Games	2016-03-04	367	123	45	412	0.6826000000000001
Guardian's Oath	2016-09-28	20	108	39	59	0.6826000000000001
Hover 2030	2016-06-14	986	70	24	1010	0.6826000000000001
Rencounter	2016-11-04	625	235	91	716	0.6822
Tempest	2016-08-22	1109	1671	711	1820	0.6820999999999999
Princess Edge - Dragonstone	2016-05-20	3	22	6	9	0.682
The Chosen RPG	2016-02-04	656	842	350	1006	0.6819
Asdivine Hearts	2016-02-01	23	62	21	44	0.6819
Wonder Boy Returns	2016-10-13	7	62	21	28	0.6819
Hoops VR	2016-06-21	20	49	16	36	0.6819
Octave	2016-10-18	6083	110	40	6123	0.6818000000000001
Arcade Saga	2016-12-08	18	33	10	28	0.6818000000000001
Baseball Mogul Diamond	2016-08-09	43	33	10	53	0.6818000000000001
Honey Rose: Underdog Fighter Extraordinaire	2016-09-30	29	33	10	39	0.6818000000000001
Alicia Griffith – Lakeside Murder	2016-12-16	96	67	23	119	0.6816
Quantum Lock	2016-01-08	10	7	1	11	0.6815000000000001
Save the Universe, Please!	2016-08-31	3	7	1	4	0.6815000000000001
Soul Axiom	2016-02-29	174	176	67	241	0.6814
Legend of Numbers	2016-06-02	62	72	25	87	0.6813
Welkin Road	2016-04-13	14	54	18	32	0.6813
Bus Simulator 16	2016-03-02	1280	2400	1038	2318	0.6809999999999999
Axis Football 2016	2016-07-29	25	92	33	58	0.6809999999999999
Evil Robot Traffic Jam HD	2016-08-26	5	19	5	10	0.6809999999999999
Audio Arena	2016-07-25	81	19	5	86	0.6809999999999999
Spellbound	2016-09-06	5	19	5	10	0.6809999999999999
Orbital Strike: Arena	2016-07-12	15	19	5	20	0.6809999999999999
ShotForge	2016-11-02	15	59	20	35	0.6808
Fatal Fight	2016-06-10	19	46	15	34	0.6807
Skull Ball Heroes	2016-09-15	75	46	15	90	0.6807
Onward	2016-08-30	423	5942	2629	3052	0.6806
The Huntsman: Winter's Curse	2016-04-22	110	204	79	189	0.6805
Mobile Astro	2016-12-16	1018	119	44	1062	0.6805
101 Ways to Die	2016-03-18	7	30	9	16	0.6805
XBlaze Lost: Memories	2016-08-11	9	30	9	18	0.6805
Talisman: The Horus Heresy	2016-02-22	316	206	80	396	0.6802
MSI Electric City	2016-08-10	15	94	34	49	0.6801
Mantis Burn Racing	2016-10-12	25	89	32	57	0.6801
Baezult	2016-08-03	33	51	17	50	0.6801
ChaosTower	2016-02-23	12	16	4	16	0.68
Robo's World: The Zarnok Fortress	2016-03-07	93	16	4	97	0.68
Endless Labyrinth	2016-08-08	3	16	4	7	0.68
Sorcery Is for Saps	2016-10-14	40	16	4	44	0.68
Pure Chess	2016-09-09	30	167	64	94	0.6797
Sacred Almanac Traces of Greed	2016-12-07	301	56	19	320	0.6797
Path to the Sky	2016-02-02	29	43	14	43	0.6795
Mausoleum of the Medusa: Speedrun Edition	2016-10-28	8	61	21	29	0.6794
Gods and Idols	2016-12-12	353	516	213	566	0.6793000000000001
Space Food Truck	2016-03-25	157	193	75	232	0.6793000000000001
Abyss Cave	2016-07-18	2930	13	3	2933	0.6793000000000001
Lost Bros	2016-02-25	59	13	3	62	0.6793000000000001
Wanderjahr	2016-02-18	9	13	3	12	0.6793000000000001
Eclipsed	2016-02-17	3	13	3	6	0.6793000000000001
Mitch: Berry Challenge	2016-08-25	35	13	3	38	0.6793000000000001
Battle Knights	2016-08-31	4	13	3	7	0.6793000000000001
Uprising 2: Lead and Destroy	2016-08-19	4	13	3	7	0.6793000000000001
Snowday	2016-11-30	7	13	3	10	0.6793000000000001
Planet Smasher	2016-09-16	323	13	3	326	0.6793000000000001
The Rosefinch Curse（Ning's Wing 1）	2016-09-20	4	13	3	7	0.6793000000000001
prog.1	2016-06-23	38	10	2	40	0.6793000000000001
Gooblins	2016-12-21	3	10	2	5	0.6793000000000001
JUST BAT (VR CRICKET)	2016-09-13	5	10	2	7	0.6793000000000001
The Bits That Saved The Universe	2016-12-30	3	10	2	5	0.6793000000000001
POLYWAR	2016-12-30	21240	365	148	21388	0.6792
TWINKLE STAR SPRITES	2016-05-26	24	140	53	77	0.6792
The Lost Heir 2: Forging a Kingdom	2016-01-29	41	27	8	49	0.6790999999999999
Monster Maze VR	2016-10-19	7	27	8	15	0.6790999999999999
Comit the Astrodian	2016-11-15	550	27	8	558	0.6790999999999999
The Bunker	2016-09-20	70	1002	426	496	0.679
GentleMoon 2	2016-06-08	737	35	11	748	0.679
Escape Bloody Mary	2016-10-25	9	48	16	25	0.6788
PICO PARK:Classic Edition	2016-04-27	438	715	301	739	0.6784
Xenus 2. White gold.	2016-12-01	18	187	73	91	0.6781999999999999
Fracture the Flag	2016-12-07	31	83	30	61	0.6781999999999999
Black Hat Cooperative	2016-07-29	11	58	20	31	0.6781999999999999
Sparkle Unleashed	2016-12-02	13	58	20	33	0.6781999999999999
Polaris Sector	2016-03-22	548	300	121	669	0.6781
Beasts Battle	2016-06-15	342	63	22	364	0.6781
A Wizard's Lizard: Soul Thief	2016-04-05	10	40	13	23	0.6781
Deer Man	2016-04-16	11	227	90	101	0.6779999999999999
PooShooter: Toilet Invaders	2016-10-04	11	68	24	35	0.6779999999999999
You Deserve	2016-08-19	177	184	72	249	0.6776000000000001
VR Baseball - Home Run Competition	2016-04-04	7	24	7	14	0.6776000000000001
Glow	2016-10-14	40	24	7	47	0.6776000000000001
QUACK ATTACK 1985	2016-12-20	270	24	7	277	0.6776000000000001
God Of Arrows VR	2016-11-03	5	32	10	15	0.6775
Dub Dash	2016-02-16	19	198	78	97	0.6774
Filthy Lucre	2016-12-11	47	55	19	66	0.6769
BomberZone	2016-06-10	1125	97	36	1161	0.6768000000000001
ABRACA - Imagic Games	2016-03-31	9	37	12	21	0.6765000000000001
Super Ubie Island REMIX	2016-01-15	229	37	12	241	0.6765000000000001
Rush for gold: Alaska	2016-01-14	714	37	12	726	0.6765000000000001
Heroes Must Die	2016-07-15	26	37	12	38	0.6765000000000001
Aplowcalypse	2016-12-15	6	37	12	18	0.6765000000000001
Klang	2016-09-22	16	87	32	48	0.6764
Moustache Mountain	2016-03-31	636	99	37	673	0.6761
Faceted Flight	2016-10-05	8	21	6	14	0.6759000000000001
Crudelis	2016-01-20	26	21	6	32	0.6759000000000001
Nil-Ninjahtic: Ronin	2016-03-16	308	21	6	314	0.6759000000000001
Frantic Freighter	2016-08-29	60	21	6	66	0.6759000000000001
HAUNTED: Halloween '85	2016-10-30	5	21	6	11	0.6759000000000001
Will of the Gods	2016-08-29	242	29	9	251	0.6758
THE LAST BLADE	2016-08-31	20	118	45	65	0.6757
18 Wheels of Steel: Convoy	2016-09-02	7	57	20	27	0.6755
In Case of Emergency, Release Raptor	2016-08-29	14	52	18	32	0.6755
PRINCIPIA: Master of Science	2016-09-09	170	198	79	249	0.6753
Gladiator Trainer	2016-11-26	1695	172	68	1763	0.6751
Cubway	2016-08-12	3441	91	34	3475	0.6748000000000001
Dead End Junction	2016-09-23	14	34	11	25	0.6748000000000001
Zombie Parking	2016-04-14	926	69	25	951	0.6746
Tiltagon	2016-03-29	810	86	32	842	0.6745
Everybody's Gone to the Rapture	2016-04-14	191	1024	447	638	0.6743000000000001
Energy Hook	2016-07-05	4	39	13	17	0.6743000000000001
Evolution Planet: Gold Edition	2016-07-08	25	39	13	38	0.6743000000000001
PAC-MAN™ CHAMPIONSHIP EDITION 2	2016-09-13	972	1427	630	1602	0.6742
Broken Dreams	2016-02-19	10797	330	137	10934	0.6742
Slap The Fly	2016-11-02	20	206	83	103	0.6742
Cthulhu Realms	2016-07-01	164	150	59	223	0.6742
Farabel	2016-10-14	50	81	30	80	0.6742
Assassins vs Pirates	2016-05-10	45	59	21	66	0.6742
Zeus vs Monsters - Math Game for kids	2016-02-18	8	44	15	23	0.6741
10 Minute Barbarian	2016-01-27	11	18	5	16	0.674
Dyadic	2016-02-25	5	18	5	10	0.674
Candlelight	2016-03-15	4	18	5	9	0.674
THE GREY MAN	2016-12-20	8	18	5	13	0.674
Fated Souls 2	2016-12-02	502	18	5	507	0.674
Killing Zombies	2016-10-27	11	18	5	16	0.674
Tatsu	2016-08-29	6	26	8	14	0.6739
Tank Battle: North Africa	2016-07-12	26	26	8	34	0.6739
Funfair	2016-08-20	10	26	8	18	0.6739
Killing Room	2016-10-20	270	923	403	673	0.6736
Caesar 4	2016-08-29	147	433	183	330	0.6736
CyberThreat	2016-08-18	8	71	26	34	0.6736
Book Series - Alice in Wonderland	2016-11-16	226	71	26	252	0.6736
Californium	2016-02-17	57	235	96	153	0.6734
Small Radios Big Televisions	2016-11-08	37	246	101	138	0.6729999999999999
Origin Of Destiny: Crimson Awakening	2016-04-01	29	90	34	63	0.6729999999999999
Bumper	2016-09-12	810	78	29	839	0.6729999999999999
Gardenarium	2016-02-25	7	31	10	17	0.6729999999999999
Fist of Physics	2016-12-15	7	31	10	17	0.6729999999999999
I Know a Tale	2016-09-20	15	31	10	25	0.6729999999999999
Diesel Guns	2016-09-22	12	211	86	98	0.6726000000000001
Investigator	2016-06-02	603	673	292	895	0.6725
Brick Inventions	2016-03-23	33	36	12	45	0.6725
Serafina's Crown	2016-03-15	123	36	12	135	0.6725
BioShock 2 Remastered	2016-09-15	1315	14250	6665	7980	0.6723
Fancy Skiing VR	2016-08-09	83	169	68	151	0.672
Zombie Gotchi	2016-03-23	214	15	4	218	0.672
Chalo Chalo	2016-10-24	6	15	4	10	0.672
Fly, Glowfly!	2016-07-08	45	15	4	49	0.672
FORGOTTEN BALL	2016-03-03	9	15	4	13	0.672
Ant-gravity: Tiny's Adventure	2016-12-15	205	15	4	209	0.672
Cannonfire Concerto	2016-12-08	34	15	4	38	0.672
Astroflux	2016-09-27	242	201	82	324	0.6718999999999999
Magical Brickout	2016-10-17	224	23	7	231	0.6718000000000001
VirZOOM Arcade	2016-06-30	17	23	7	24	0.6718000000000001
Acorn Assault: Rodent Revolution	2016-03-02	150	58	21	171	0.6716
Neon Space 2	2016-07-26	1798	271	113	1911	0.6715000000000001
Allods Online	2016-06-03	370	459	197	567	0.6714
Zombie City Defense 2	2016-08-19	146	136	54	200	0.6714
The Technomancer	2016-06-28	2366	1777	803	3169	0.6709999999999999
Atonement 2: Ruptured by Despair	2016-10-18	3516	110	43	3559	0.6709
Farnham Fables	2016-06-20	1202	261	109	1311	0.6708
Battlefleet Gothic: Armada	2016-04-21	9253	3756	1731	10984	0.6707
Walk The Light	2016-01-05	3	3	0	3	0.6706000000000001
LILT	2016-01-28	3	3	0	3	0.6706000000000001
Second Death	2016-08-17	5	3	0	5	0.6706000000000001
Meteor Crush VR	2016-08-16	1	3	0	1	0.6706000000000001
Candy Thieves - Tale of Gnomes	2016-10-25	3	3	0	3	0.6706000000000001
The Garden	2016-09-06	2	3	0	2	0.6706000000000001
Fish Lake	2016-12-16	2	3	0	2	0.6706000000000001
The Miners	2016-10-04	7	3	0	7	0.6706000000000001
Landmine Larry	2016-12-17	2	3	0	2	0.6706000000000001
Dante's Forest	2016-11-15	1	3	0	1	0.6706000000000001
The Frontier	2016-10-24	2	3	0	2	0.6706000000000001
Redemption Cemetery: Bitter Frost Collector's Edition	2016-10-26	4	3	0	4	0.6706000000000001
Spirit of Revenge: Cursed Castle Collector's Edition	2016-11-02	4	3	0	4	0.6706000000000001
peakvox Route Candle for Steam	2016-12-16	129	3	0	129	0.6706000000000001
GemWars	2016-11-30	2	3	0	2	0.6706000000000001
Celestial Crossing	2016-12-30	20	91	35	55	0.6705
"Project ""Fire"""	2016-10-01	26	72	27	53	0.6705
The Collider 2	2016-04-19	16	33	11	27	0.6705
Catch Canvas	2016-10-14	87	67	25	112	0.6698999999999999
Wayward Terran Frontier: Zero Falls	2016-02-11	104	282	119	223	0.6698000000000001
Torgar's Quest	2016-05-31	5	12	3	8	0.6698000000000001
Bazaar	2016-03-28	4	12	3	7	0.6698000000000001
Deios II // DEIDIA	2016-12-08	6	12	3	9	0.6698000000000001
Nother	2016-12-14	8	12	3	11	0.6698000000000001
Zenith	2016-09-20	113	402	173	286	0.6697
The Temporal Invasion	2016-07-04	2280	74	28	2308	0.6696
Sword Master VR	2016-09-23	28	146	59	87	0.6695000000000001
To Ash	2016-03-29	272	20	6	278	0.6694
Reptilian Rebellion	2016-08-07	754	45	16	770	0.6691
Please State Your Name : A VR Animated Film	2016-11-07	7	45	16	23	0.6691
Cally's Trials	2016-06-14	16	118	47	63	0.669
Child Phobia: Nightcoming Fears	2016-12-21	2135	40	14	2149	0.6687000000000001
The Orchard of Stray Sheep	2016-06-20	54	35	12	66	0.6684
Sol 0: Mars Colonization	2016-01-15	619	275	117	736	0.6681999999999999
Rescue your chickens	2016-11-04	1469	99	39	1508	0.6681999999999999
The Next World	2016-03-07	73	78	30	103	0.6681
Stellar Overload	2016-10-11	245	426	186	431	0.6677
Fall of Gyes	2016-03-18	2	9	2	4	0.6676000000000001
Space Ranger ASK	2016-08-26	3	9	2	5	0.6676000000000001
Witches' Legacy: The Ties That Bind Collector's Edition	2016-06-20	6	9	2	8	0.6676000000000001
Strike Squadron: Caracará	2016-12-27	138	9	2	140	0.6676000000000001
Friday Night Bullet Arena	2016-09-30	22	9	2	24	0.6676000000000001
Redactem	2016-08-01	1563	216	91	1654	0.6673
Zombillie	2016-04-29	1017	178	74	1091	0.6673
Chime Sharp	2016-07-19	90	103	41	131	0.6672
Chopper: Lethal darkness	2016-09-26	374	42	15	389	0.6670999999999999
BASEBALL STARS 2	2016-04-28	16	61	23	39	0.6668000000000001
Kitty Kitty Boing Boing: the Happy Adventure in Puzzle Garden!	2016-09-08	41	17	5	46	0.6666
The Rise of Captain Longbeard	2016-10-20	8	17	5	13	0.6666
Selma and the Wisp	2016-08-04	7	114	46	53	0.6665000000000001
Fantasy Tales Online	2016-05-05	321	316	137	458	0.6662
BlockAid	2016-07-26	4	6	1	5	0.6662
Puzzle Cross	2016-07-23	3	6	1	4	0.6662
Wills and Wonders	2016-08-22	3	6	1	4	0.6662
Dark Tales: Edgar Allan Poe's The Masque of the Red Death Collector's Edition	2016-12-02	4	6	1	5	0.6662
Rebound	2016-11-23	927	6	1	928	0.6662
Slymes	2016-11-25	9	6	1	10	0.6662
Company of Heroes: Far East War	2016-12-12	56	444	196	252	0.6661
Gems of the Aztecs	2016-04-22	1563	125	51	1614	0.6659999999999999
FullBlast	2016-01-28	55	56	21	76	0.6659999999999999
This World Unknown	2016-09-02	25	32	11	36	0.6659999999999999
Heroes of Loot 2	2016-06-07	14	27	9	23	0.6657
Fireworks Desert Blast	2016-12-22	6	22	7	13	0.6657
Ryzom	2016-05-06	281	304	132	413	0.6656000000000001
Farming 6-in-1 bundle	2016-06-02	31	39	14	45	0.6648999999999999
Rogue Stormers	2016-04-21	533	659	298	831	0.6647
Rexodus: A VR Story Experience	2016-06-08	18	81	32	50	0.6647
Sig.Null	2016-09-27	1334	81	32	1366	0.6647
Digimon Masters Online	2016-11-03	3830	5468	2617	6447	0.6646
HALP!	2016-08-02	18	74	29	47	0.6645000000000001
Caveman World: Mountains of Unga Boonga	2016-04-26	2445	440	196	2641	0.6644
IKEA VR Experience	2016-04-05	241	241	104	345	0.6644
Insanity Clicker	2016-06-07	6819	1880	881	7700	0.6643000000000001
Steamroll	2016-02-19	25	46	17	42	0.6643000000000001
Kill to Collect	2016-04-06	66	190	81	147	0.6639
Gunscape	2016-03-02	181	845	388	569	0.6636
Where's My Helmet?	2016-05-20	1753	69	27	1780	0.6636
Cosmic Leap	2016-03-17	2198	94	38	2236	0.6635
Cherry Tree High Girls' Fight	2016-06-13	60	41	15	75	0.6634000000000001
DUCATI - 90th Anniversary	2016-06-09	33	163	69	102	0.6633
ARSLAN: THE WARRIORS OF LEGEND	2016-02-09	101	132	55	156	0.6633
Hidden Mysteries: Titanic	2016-03-21	6	29	10	16	0.6633
Slam	2016-07-11	4	14	4	8	0.6633
Grass Max	2016-06-22	10	14	4	14	0.6633
Kyurinaga's Revenge	2016-10-25	16	14	4	20	0.6633
Empire of the Gods	2016-01-27	1200	48	18	1218	0.6631999999999999
Last Heroes 3	2016-04-01	1156	48	18	1174	0.6631999999999999
Heroes & Generals	2016-10-18	21026	95073	47305	68331	0.663
GEO Master	2016-05-06	14	24	8	22	0.6627
The Wire	2016-07-31	9	24	8	17	0.6627
Bladestar	2016-01-15	850	64	25	875	0.6626000000000001
Catacombs of the Undercity	2016-01-19	56	19	6	62	0.6625
Survive in Space	2016-05-20	7386	221	96	7482	0.6624
Political Animals	2016-11-02	53	129	54	107	0.6623
Machine Learning: Episode I	2016-09-10	2706	57	22	2728	0.6623
Energy Cycle	2016-01-13	2585	188	81	2666	0.662
Perraw - FPS Clone War	2016-01-29	1961	84	34	1995	0.6616
Of Carrots And Blood	2016-03-25	11	75	30	41	0.6616
Generic Space Shooter	2016-03-11	5	31	11	16	0.6614
ZHEROS	2016-02-15	10	31	11	21	0.6614
A dead world's dream	2016-09-20	9	31	11	20	0.6614
Mad Combat Marines	2016-07-13	548	275	122	670	0.6609
Cashtronauts	2016-08-31	71	45	17	88	0.6609
Marble Mountain	2016-04-05	241	45	17	258	0.6609
NOBUNAGA'S AMBITION: Sphere of Influence - Ascension	2016-03-24	7488	635	293	7781	0.6607
Astral Heroes	2016-10-20	264	210	92	356	0.6604000000000001
The Cows Are Watching	2016-12-08	3	26	9	12	0.6603
Weird Hero	2016-11-18	1044	127	54	1098	0.6596
Heroes of the Seven Seas	2016-10-14	7	33	12	19	0.6596
Urban Pirate	2016-06-18	36	33	12	48	0.6596
Grave Danger	2016-12-19	9	33	12	21	0.6596
Rogue Operatives	2016-09-30	106	94	39	145	0.6594
The Torus Syndicate	2016-11-22	5	21	7	12	0.6593000000000001
Gravity Island	2016-09-21	5	11	3	8	0.6593000000000001
VR Disc Golf	2016-07-19	5	11	3	8	0.6593000000000001
Pro Strategy Football 2016	2016-09-06	9	11	3	12	0.6593000000000001
Detective Hank and the Golden Sneeze	2016-07-29	21	11	3	24	0.6593000000000001
Drop Out 0	2016-09-16	415	11	3	418	0.6593000000000001
DANGEROUS DUELS	2016-10-26	4	11	3	7	0.6593000000000001
Marblize	2016-11-25	34	11	3	37	0.6593000000000001
Bric	2016-10-07	4	11	3	7	0.6593000000000001
Jewel Quest Seven Seas Collector's Edition	2016-11-02	13	11	3	16	0.6593000000000001
Robot City Stadium	2016-12-21	4	11	3	7	0.6593000000000001
5-in-1 Pack - Monument Builders: Destination USA	2016-12-20	14	11	3	17	0.6593000000000001
The Turkey of Christmas Past	2016-12-19	3	11	3	6	0.6593000000000001
Ninja Stealth	2016-09-29	1015	906	427	1442	0.6591
Strategy & Tactics: Wargame Collection	2016-04-22	516	174	76	592	0.6589
Mesel	2016-02-23	7	49	19	26	0.6589
Won't You Be My Laser?	2016-09-02	2664	49	19	2683	0.6589
Men of Valor	2016-02-09	47	354	161	208	0.6587999999999999
Shop Heroes	2016-08-15	4222	2454	1191	5413	0.6586
Jeklynn Heights	2016-05-25	17	16	5	22	0.6586
New Yankee in Santa's Service	2016-05-12	720	16	5	725	0.6586
Dark Parables: The Swan Princess and The Dire Tree Collector's Edition	2016-07-07	7	16	5	12	0.6586
EEP 13	2016-12-19	26	16	5	31	0.6586
Zombie Vikings: Stab-a-thon	2016-12-22	13	42	16	29	0.6585
Atulos Online	2016-04-30	138	182	80	218	0.6583
SVRVIVE: The Deus Helix	2016-11-17	15	69	28	43	0.6581999999999999
Green Ranch	2016-10-21	91	28	10	101	0.6581999999999999
The Westport Independent	2016-01-21	137	156	68	205	0.658
Home Improvisation: Furniture Sandbox	2016-07-28	58	156	68	126	0.658
Race.a.bit	2016-03-10	102	60	24	126	0.658
Age of Steel: Recharge	2016-01-06	1593	173	76	1669	0.6578
8infinity	2016-09-23	1778	249	112	1890	0.6575
Cards of Cthulhu	2016-10-11	2197	162	71	2268	0.6575
The Assembly	2016-07-19	57	106	45	102	0.6575
I am weapon: Revival	2016-07-27	100	196	87	187	0.6574
TRESPASS - Episode 1	2016-08-04	11	44	17	28	0.6574
A Detective's Novel	2016-07-28	4826	587	275	5101	0.6573000000000001
Street Fighter V	2016-02-16	14783	27374	13858	28641	0.6572
Aqua Moto Racing Utopia	2016-11-30	11	73	30	41	0.6572
Temple of the Apsara	2016-09-07	7	37	14	21	0.6569
Black Sand Drift	2016-09-08	1989	157	69	2058	0.6567000000000001
Chill the Piro	2016-04-29	2261	23	8	2269	0.6567000000000001
The Seeker	2016-09-02	815	23	8	823	0.6567000000000001
GUILTY GEAR 2 -OVERTURE-	2016-03-31	135	195	87	222	0.6565000000000001
Collider	2016-03-01	6	46	18	24	0.6565000000000001
Drawn®: Dark Flight™ Collector's Edition	2016-03-08	5	30	11	16	0.6565000000000001
GE Neuro	2016-09-06	10	30	11	21	0.6565000000000001
FootRock	2016-10-14	500	66	27	527	0.6563
Solitaire Beach Season	2016-10-10	1110	66	27	1137	0.6563
Infectonator : Survivors	2016-08-08	193	679	322	515	0.6559999999999999
Dicetiny	2016-07-21	33	167	74	107	0.6559999999999999
Automata Empire	2016-04-08	36	39	15	51	0.6557
CABAL Online	2016-02-18	1439	750	358	1797	0.6555
Deputy Dangle	2016-07-30	11	18	6	17	0.6551
Catyph: The Kunci Experiment	2016-05-11	8	18	6	14	0.6551
The Ables: Freepoint High	2016-04-07	4	18	6	10	0.6551
Beyond Dimensions	2016-03-11	119	18	6	125	0.6551
Alien Blitz	2016-05-10	45	18	6	51	0.6551
Running Gods	2016-09-13	4993	18	6	4999	0.6551
Goo Saga - HD Edition	2016-09-26	145	18	6	151	0.6551
SkyBoats	2016-08-23	35	18	6	41	0.6551
Red Spider: Vengeance	2016-11-25	28	18	6	34	0.6551
vrAMP	2016-05-27	5	32	12	17	0.655
Lop Nor Zombie VR	2016-10-01	7	41	16	23	0.6547
M.EXE	2016-07-29	9	25	9	18	0.6546
Unearthed Inc: The Lost Temple	2016-12-16	16	25	9	25	0.6546
Stranger of Sword City	2016-06-06	638	397	186	824	0.6544
Smash Pixel Racing	2016-06-20	3	8	2	5	0.6542
Slightly Magic - 8bit Legacy Edition	2016-09-29	8	8	2	10	0.6542
Desperate Times	2016-09-30	3	8	2	5	0.6542
Awesome Obstacle Challenge	2016-09-22	4	8	2	6	0.6542
Crystal Shard Adventure Bundle	2016-12-15	3	8	2	5	0.6542
[R.U.M.A]	2016-11-05	2	8	2	4	0.6542
The Night Christmas Ended	2016-12-04	3	8	2	5	0.6542
The Wizards Who Fell In A Hole	2016-12-10	80	8	2	82	0.6542
Lumo	2016-05-24	21	76	32	53	0.6541
Turbo Pug 3D	2016-09-20	3889	238	109	3998	0.654
Big Bang Empire	2016-08-24	629	748	360	989	0.6539
Tom vs. The Armies of Hell	2016-07-27	5	13	4	9	0.6537999999999999
Rynn's Adventure: Trouble in the Enchanted Forest	2016-03-31	4	13	4	8	0.6537999999999999
Mech Anarchy	2016-03-15	59	13	4	63	0.6537999999999999
Silhouette	2016-11-13	2	13	4	6	0.6537999999999999
Whack a Vote: Hammering the Polls	2016-11-02	4	13	4	8	0.6537999999999999
Hunter's Legacy	2016-07-19	17	34	13	30	0.6537000000000001
Spell Fighter VR	2016-03-23	32	254	117	149	0.6536
Void Raiders	2016-06-14	203	54	22	225	0.6536
Typefighters (Steam Edition)	2016-04-18	81	97	42	123	0.6531
Zero-G VR	2016-06-16	18	97	42	60	0.6531
Goliath	2016-05-12	187	185	84	271	0.6529
Crystal Cosmos	2016-07-22	273	27	10	283	0.6529
Malus Code	2016-05-06	40	71	30	70	0.6525
Snow Horse	2016-08-04	5	20	7	12	0.6525
Quatros Origins	2016-07-29	78	20	7	85	0.6525
Just Bones	2016-06-09	8	20	7	15	0.6525
Spareware	2016-10-10	211	20	7	218	0.6525
Gem Monster	2016-12-18	1123	20	7	1130	0.6525
A Boy and His Blob	2016-01-19	319	330	155	474	0.6524
moto RKD dash	2016-06-03	140	47	19	159	0.6523000000000001
XenoShyft	2016-03-29	23	73	31	54	0.6522
Ninja Senki DX	2016-02-23	34	62	26	60	0.6516
Riders of Icarus	2016-07-06	17162	6914	3539	20701	0.6515000000000001
1993 Space Machine	2016-03-28	337	204	94	431	0.6514
Perfect Fit - Totemland	2016-11-11	3261	29	11	3272	0.6514
Cargo Cult: Shoot'n'Loot VR	2016-12-09	604	29	11	615	0.6514
Holiday Bonus GOLD	2016-12-27	461	29	11	472	0.6514
We Are The Dwarves	2016-02-26	1464	760	371	1835	0.6513
Anima Gate of Memories	2016-06-03	145	455	218	363	0.6513
Amigdala	2016-03-28	2813	79	34	2847	0.6513
Small Town Terrors: Livingston	2016-01-18	8	51	21	29	0.6511
Line of Sight: Vietnam	2016-12-01	6	51	21	27	0.6511
True or False	2016-09-16	334	879	432	766	0.6508
Trillion	2016-11-07	246	303	143	389	0.6508
Defect	2016-07-28	32	40	16	48	0.6508
Last Heroes 2	2016-01-22	1225	40	16	1241	0.6508
Galaxy Reavers	2016-09-19	139	131	59	198	0.6505
Vaccine War	2016-03-21	4	22	8	12	0.6503
The Enlightened League of Bone Builders and the Osseous Enigma Content	2016-08-29	10	22	8	18	0.6503
The Lords of the Earth Flame	2016-09-02	965	174	80	1045	0.6501
Liquid Pinball	2016-11-24	913	70	30	943	0.6501
Chesster	2016-03-17	80	15	5	85	0.65
Adventure Apes and the Mayan Mystery	2016-07-15	307	15	5	312	0.65
Arcane	2016-12-19	5	15	5	10	0.65
DemonicGuestVR	2016-10-17	3	15	5	8	0.65
Summer times Afternoon	2016-12-24	4	15	5	9	0.65
Far Beyond: A space odyssey VR	2016-10-28	19	118	53	72	0.6497
FATED: The Silent Oath	2016-04-28	15	93	41	56	0.6497
Death Stair	2016-08-16	130	198	92	222	0.6496
Silver Bullet: Prometheus	2016-04-08	32	44	18	50	0.6494
Epic Clicker Journey	2016-04-21	1087	456	221	1308	0.6492
Push Me Pull You	2016-07-14	9	24	9	18	0.6487
Soko Match	2016-09-16	20	24	9	29	0.6487
Midnight	2016-01-28	30	48	20	50	0.6483
Dark Days	2016-06-03	7	35	14	21	0.6483
Pick a Hero	2016-06-10	21	35	14	35	0.6483
Until I Have You	2016-04-04	12	119	54	66	0.6481
My Secret Pets!	2016-05-11	36	88	39	75	0.6481
Pavilion	2016-09-23	11	90	40	51	0.648
Color By	2016-01-22	4	5	1	5	0.6478
Swift	2016-06-02	6	5	1	7	0.6478
Hubert's Island Adventure: Mouse o' War	2016-02-03	3	5	1	4	0.6478
One Clone Left	2016-08-14	6	5	1	7	0.6478
VReakout	2016-07-14	2	5	1	3	0.6478
Car Car Crash Hands On Edition	2016-07-06	3	5	1	4	0.6478
BoX -containment-	2016-05-26	96	5	1	97	0.6478
Thunder Gun: Revenge of the Mutants	2016-09-22	2	5	1	3	0.6478
Crate Punks	2016-12-02	2	5	1	3	0.6478
Kapsul Infinite	2016-08-25	2	5	1	3	0.6478
Blind Blades	2016-09-01	3	5	1	4	0.6478
Happy Birthday, Bernard	2016-12-14	2	5	1	3	0.6478
WRC 6	2016-10-07	233	678	336	569	0.6476999999999999
ABC Coloring Town	2016-05-30	192	198	93	285	0.6476999999999999
Hyspherical 2	2016-02-16	69	10	3	72	0.6476000000000001
Magic Flute	2016-02-17	4	10	3	7	0.6476000000000001
MC Lars: The Video Game	2016-10-15	3	10	3	6	0.6476000000000001
Banzai Escape	2016-03-01	141	98	44	185	0.6475
Ground Breakers	2016-06-15	173	37	15	188	0.6475
Underground Keeper	2016-08-15	15	37	15	30	0.6475
Silver Creek Falls - Chapter 3	2016-03-31	4	26	10	14	0.6473000000000001
Pertinence	2016-03-25	249	26	10	259	0.6473000000000001
ASRECorp	2016-07-22	201	26	10	211	0.6473000000000001
DUO	2016-07-08	3	26	10	13	0.6473000000000001
Ultimate Solid	2016-10-26	188	26	10	198	0.6473000000000001
World VR Competition	2016-12-06	5	17	6	11	0.6473000000000001
DEADLOCK	2016-08-15	4	17	6	10	0.6473000000000001
Too Angry to Space	2016-08-08	23	39	16	39	0.6468
A Tale of Caos: Overture	2016-12-21	58	39	16	74	0.6468
Sweet Volley High	2016-10-26	516	56	24	540	0.6467
The Lost Mythologies	2016-01-28	96	1107	560	656	0.6465000000000001
INTERSHELTER	2016-11-21	1330	697	348	1678	0.6464
Jeeboman	2016-04-05	8	28	11	19	0.6462000000000001
Where are my Internets?	2016-12-16	534	60	26	560	0.6461
Ascent - The Space Game	2016-04-12	168	230	110	278	0.6459999999999999
Zezenia Online	2016-07-07	132	194	92	224	0.6459
Lantern	2016-11-15	33	43	18	51	0.6458
Into The Unknown	2016-11-09	17	64	28	45	0.6456999999999999
AdVenture Communist	2016-08-23	2871	2943	1528	4399	0.6456000000000001
Emerge: Cities of the Apocalypse	2016-04-27	97	103	47	144	0.6454000000000001
The Treasures of Montezuma 5	2016-03-10	100	109	50	150	0.6453
Mini Metal	2016-04-22	18	19	7	25	0.6452
Trackmania Turbo	2016-03-24	2085	945	480	2565	0.6448
Epic Manager	2016-12-12	158	157	74	232	0.6448
Envy the Dead	2016-09-12	924	147	69	993	0.6448
Pigmentone	2016-07-08	100	32	13	113	0.6444
Alteric	2016-07-13	153	82	37	190	0.6443000000000001
METAGAL	2016-05-23	16	94	43	59	0.6439
Trimmer Tycoon	2016-11-04	184	463	231	415	0.6437999999999999
Tales from the Void	2016-05-20	1704	34	14	1718	0.6437999999999999
Cursed West	2016-09-09	2322	55	24	2346	0.6437
EmergeNYC	2016-11-03	479	2419	1264	1743	0.6436000000000001
Agent Walker: Secret Journey	2016-09-01	36	156	74	110	0.6436000000000001
RollerForce	2016-09-14	9	21	8	17	0.6436000000000001
Falcon	2016-01-08	2	12	4	6	0.6435
Diorama No.3 : The Marchland	2016-04-05	4	12	4	8	0.6435
Imhotep, Pyramid Builder	2016-05-06	8	12	4	12	0.6435
Farm Tribe	2016-05-27	5	12	4	9	0.6435
Castle Invasion: Throne Out	2016-07-27	11	12	4	15	0.6435
Forgotten Tales: Day of the Dead	2016-05-27	93	36	15	108	0.6432
Super Button Soccer	2016-07-20	42	67	30	72	0.6428
Mount Wingsuit	2016-08-25	8	67	30	38	0.6428
Aurion: Legacy of the Kori-Odan	2016-04-14	226	216	105	331	0.6425
Brain Booster	2016-12-26	201	23	9	210	0.6424
Dear RED - Extended	2016-04-12	2130	235	115	2245	0.6421
Defense of Egypt: Cleopatra Mission	2016-09-30	1520	97	45	1565	0.642
The Girl and the Robot	2016-08-18	18	46	20	38	0.6414
Cube Samurai: RUN!	2016-06-15	3	2	0	3	0.6408
Space Junk Patrol	2016-12-01	2	2	0	2	0.6408
Spheria	2016-04-01	3	2	0	3	0.6408
Battleships At Dawn!	2016-07-05	2	2	0	2	0.6408
Campgrounds: The Endorus Expedition Collector's Edition	2016-03-03	4	2	0	4	0.6408
Four Realms	2016-10-24	4	2	0	4	0.6408
Alveari	2016-10-10	2	2	0	2	0.6408
Malkia	2016-07-26	7	2	0	7	0.6408
Captain Curve's Intergalactic Space Adventure	2016-07-26	2	2	0	2	0.6408
Geo-Fall	2016-07-23	1	2	0	1	0.6408
Puzzling Rooms VR	2016-08-26	2	2	0	2	0.6408
Garden Wars	2016-11-09	5	2	0	5	0.6408
DOPAMINE	2016-10-17	1	2	0	1	0.6408
ROBUST ROAD ROLLER	2016-12-12	5	2	0	5	0.6408
Shrouded Tales: The Spellbound Land Collector's Edition	2016-11-28	3	2	0	3	0.6408
Holiday Simulator : Wacky Sleigh Ride	2016-12-22	1	2	0	1	0.6408
The Minims	2016-04-01	6	14	5	11	0.6406999999999999
King Lucas	2016-12-01	1194	98	46	1240	0.6402
Santa's Big Adventures	2016-12-19	1195	66	30	1225	0.6402
Vanguards	2016-10-28	18	64	29	47	0.6402
Pesadelo - Regressão	2016-02-11	101	92	43	144	0.6401000000000001
Mahjong Deluxe 3	2016-04-22	157	78	36	193	0.6401000000000001
Dimensional Intersection	2016-10-05	3	29	12	15	0.64
Painted Legend	2016-07-29	363	29	12	375	0.64
Pixel Survivors	2016-05-05	3617	184	90	3707	0.6399
Purino Party	2016-06-23	177	184	90	267	0.6399
Hybrid Wars	2016-09-29	197	147	71	268	0.6399
The Agency: Chapter 1	2016-07-13	926	31	13	939	0.6395000000000001
Masked Forces	2016-11-23	573	300	151	724	0.639
The Amazing Adventures of Ash - Afterparty	2016-01-21	4	7	2	6	0.6389
Base Raid	2016-11-17	40	7	2	42	0.6389
OCCHIO	2016-08-11	3	7	2	5	0.6389
DragonBlast VR	2016-09-01	4	7	2	6	0.6389
Shop-n-Spree: Shopping Paradise	2016-09-12	4	7	2	6	0.6389
Destroyer	2016-10-20	3	7	2	5	0.6389
Rogues or Heroes	2016-10-18	5	7	2	7	0.6389
Vulture Island	2016-10-31	5	7	2	7	0.6389
VR Apocalypse	2016-12-17	4	7	2	6	0.6389
Futuridium EP Deluxe	2016-01-08	5	16	6	11	0.6388
Giga Girl	2016-08-17	4	16	6	10	0.6388
Music Inside: A VR Rhythm Game	2016-09-06	10	37	16	26	0.6385000000000001
Archipelago	2016-08-18	3422	39	17	3439	0.6383
ToyOdyssey	2016-09-20	102	215	107	209	0.6382
Allods Online RU	2016-01-27	2563	1032	544	3107	0.6379
Labyrinth	2016-03-08	79	184	91	170	0.6379
Nomad Fleet	2016-04-19	683	128	62	745	0.6379
Necropolis	2016-07-12	5148	2958	1595	6743	0.6378
Emporea	2016-06-08	606	313	159	765	0.6376
N.E.R.O.: Nothing Ever Remains Obscure	2016-04-29	31	120	58	89	0.6376
One Last Chance	2016-04-07	609	57	26	635	0.6375000000000001
Skedaddle	2016-06-17	110	18	7	117	0.6375000000000001
Amihailu in Dreamland	2016-08-24	5	18	7	12	0.6375000000000001
Kubz VR	2016-09-05	3	18	7	10	0.6375000000000001
CrazyCars3D	2016-06-14	1933	143	70	2003	0.6373
Trials of the Blood Dragon	2016-06-13	126	133	65	191	0.6368
Tree of Savior (English Ver.)	2016-03-28	53554	12765	7061	60615	0.6365
Felt Tip Circus	2016-04-05	5	20	8	13	0.6365
Infinity Saga	2016-02-29	54	20	8	62	0.6365
Might & Magic Heroes VII – Trial by Fire	2016-08-04	558	847	449	1007	0.6358
Perfect Golf	2016-05-03	198	573	301	499	0.6354
Zamarian	2016-01-22	20	24	10	30	0.6353
Kill The Plumber	2016-01-01	72	70	33	105	0.6352000000000001
The NADI Project	2016-06-01	42	279	143	185	0.635
Janken Cards	2016-10-17	216	26	11	227	0.6349
Florensia	2016-11-29	385	420	219	604	0.6348
That's Mahjong!	2016-10-27	1309	97	47	1356	0.6348
Krautscape	2016-02-24	23	158	79	102	0.6346
Carton	2016-10-02	2452	54	25	2477	0.6345000000000001
planktOs	2016-02-03	2	9	3	5	0.6345000000000001
Slime Jumper	2016-04-07	3	9	3	6	0.6345000000000001
Watson's Watch	2016-06-06	279	9	3	282	0.6345000000000001
Hidden Expedition: The Crown of Solomon Collector's Edition	2016-05-20	5	9	3	8	0.6345000000000001
Toxic Terror	2016-06-03	191	9	3	194	0.6345000000000001
FARIA: Ghosts of the Stream	2016-08-04	6	9	3	9	0.6345000000000001
Phantasmat: Crucible Peak Collector's Edition	2016-10-19	4	9	3	7	0.6345000000000001
Shiver: Poltergeist Collector's Edition	2016-10-28	5	9	3	8	0.6345000000000001
Oblivion's Edge	2016-11-10	314	9	3	317	0.6345000000000001
SolForge	2016-07-25	2103	779	415	2518	0.6344
Mysteries of the Past: Shadow of the Daemon Collector's Edition	2016-02-19	15	30	13	28	0.6344
Diorama Battle of NINJA	2016-09-20	29	30	13	42	0.6344
Inexistence	2016-02-17	1542	235	120	1662	0.6343
Death's Life	2016-10-26	2904	50	23	2927	0.6343
Quantum Chess	2016-12-12	16	34	15	31	0.6342
Psycho on the loose	2016-12-21	2759	34	15	2774	0.6342
Toro	2016-01-26	4	38	17	21	0.6341
I Am Caligula	2016-03-25	18	38	17	35	0.6341
Virginia	2016-09-22	240	2028	1107	1347	0.6339
WWE 2K16	2016-03-10	2520	1825	995	3515	0.6337
Soccer Manager 2017	2016-09-16	847	414	217	1064	0.6337
Sky Break	2016-10-21	306	353	184	490	0.6337
Ace of Words	2016-05-13	2234	539	286	2520	0.633
Football Club Simulator - FCS #21	2016-03-04	35	179	91	126	0.6328
Squirbs	2016-01-06	449	277	144	593	0.6324000000000001
Falling Stars: War of Empires	2016-04-27	7	11	4	11	0.6321
ChessVR	2016-07-07	3	11	4	7	0.6321
The Multidimensional Underwear Drawer	2016-08-31	8	11	4	12	0.6321
RunningJoe	2016-11-01	4	11	4	8	0.6321
Lord Darydikilkil	2016-11-04	2	11	4	6	0.6321
Kingdom of Aurelia: Mystery of the Poisoned Dagger	2016-11-17	10	59	28	38	0.6319
Death Dojo	2016-11-09	9	57	27	36	0.6317
Goblins and Grottos	2016-07-07	44	55	26	70	0.6315
Sudoku Quest	2016-06-03	139	55	26	165	0.6315
BuildMoreCubes	2016-11-21	2490	55	26	2516	0.6315
Pro Cycling Manager 2016	2016-06-16	2377	251	131	2508	0.6309
Neon Prism	2016-11-18	3272	227	118	3390	0.6308
FIVE: Champions of Canaan	2016-09-27	20	47	22	42	0.6307
Asteroid Bounty Hunter	2016-02-24	3999	480	257	4256	0.6306
RollerGirls From Beyond	2016-09-09	3	13	5	8	0.6306
Cosmic Cavern 3671　　宇宙最大の地底最大の作戦	2016-07-14	39	13	5	44	0.6306
Tales of the Elements	2016-10-13	958	13	5	963	0.6306
Hunting Unlimited 4	2016-11-03	6	13	5	11	0.6306
Sol Trader	2016-06-06	47	45	21	68	0.6305
VR GirlFriend	2016-12-13	14	89	44	58	0.6304
BitMaster	2016-10-12	1713	128	65	1778	0.6298
Bathory - The Bloody Countess	2016-07-07	45	37	17	62	0.6298
Rebel Wings	2016-07-08	8	15	6	14	0.6298
RAM BOE	2016-04-04	918	15	6	924	0.6298
The Last Look	2016-10-28	7	15	6	13	0.6298
Behold!	2016-10-26	6	15	6	12	0.6298
Starfighter Arduxim	2016-10-19	3	15	6	9	0.6298
Solar Division	2016-04-20	1077	35	16	1093	0.6296
The Spookening	2016-11-01	14	35	16	30	0.6296
Crazy Sapper 3D	2016-10-26	2742	62	30	2772	0.6295000000000001
DeathMetal	2016-11-18	1482	33	15	1497	0.6294
Space Merchants: Arena	2016-11-04	1280	17	7	1287	0.6293
Emergency 2017	2016-10-27	601	258	136	737	0.6292
A Quiver of Crows	2016-10-19	10	31	14	24	0.6292
Rush for gold: California	2016-03-10	824	31	14	838	0.6292
Extravaganza Rising	2016-07-21	780	31	14	794	0.6292
Candy Smash VR	2016-07-26	3062	29	13	3075	0.6291
Assassin’s Creed® Chronicles: India	2016-01-12	140	530	287	427	0.629
Space Drifters 2D	2016-03-28	506	27	12	518	0.629
Neptune Flux	2016-11-15	6	27	12	18	0.629
Planet in the Shadows	2016-04-15	8	19	8	16	0.629
Fiber Twig: Midnight Puzzle	2016-10-26	9	19	8	17	0.629
ArsonVille	2016-11-24	4	19	8	12	0.629
GalaxIverse	2016-08-16	850	25	11	861	0.6289
Rabbit Island	2016-07-14	937	21	9	946	0.6289
Redswood VR	2016-08-18	5	21	9	14	0.6289
Back in 1995	2016-04-28	18	75	37	55	0.6288
WizardCraft	2016-05-27	9	23	10	19	0.6288
Babel: Choice	2016-02-12	16	73	36	52	0.6285000000000001
Heroine Anthem Zero	2016-12-23	209	439	237	446	0.6284000000000001
SWORDY	2016-07-21	9	69	34	43	0.6279
Warriors' Wrath	2016-05-26	561	50	24	585	0.6278
Marooners	2016-09-15	182	430	233	415	0.6276
Adam's Venture Origins	2016-04-01	59	263	140	199	0.6275000000000001
Jonah's Path	2016-07-07	19	46	22	41	0.6271
Project CARS - Pagani Edition	2016-10-28	646	947	526	1172	0.627
ICARUS.1	2016-11-17	9	44	21	30	0.6268
A grande bagunça espacial - The big space mess	2016-04-05	6242	693	383	6625	0.6264000000000001
The Infinite Black	2016-10-19	139	133	69	208	0.6264000000000001
Escape The Past	2016-09-14	104	42	20	124	0.6264000000000001
Space Run Galaxy	2016-06-17	720	608	335	1055	0.6263000000000001
Warhammer 40,000: Armageddon - Da Orks	2016-08-18	46	57	28	74	0.626
Sky To Fly: Faster Than Wind	2016-03-25	59	70	35	94	0.6257
Drive!Drive!Drive!	2016-12-13	5	38	18	23	0.6257
Karma Miwa	2016-08-12	621	38	18	639	0.6257
Trulon: The Shadow Engine	2016-03-01	21	55	27	48	0.6256
The Secret Order 4: Beyond Time	2016-09-22	39	136	71	110	0.6255
Jump Tanks	2016-03-08	8	4	1	9	0.6251
P-3 Biotic	2016-05-10	2	4	1	3	0.6251
Bugspeed Collider	2016-10-06	4	4	1	5	0.6251
Mosaic Maze	2016-02-12	2	4	1	3	0.6251
Paintey	2016-04-18	3	4	1	4	0.6251
Echoes of the Past: The Revenge of the Witch Collector's Edition	2016-05-31	4	4	1	5	0.6251
Subterrarium	2016-05-26	3	4	1	4	0.6251
ikenie	2016-08-09	11	4	1	12	0.6251
Gravity Shot	2016-11-09	137	4	1	138	0.6251
AcrossFlash	2016-09-01	2	4	1	3	0.6251
Supa Kila Monsta Hunta	2016-10-07	2	4	1	3	0.6251
Skyway	2016-12-02	3	4	1	4	0.6251
TacoFace	2016-12-21	3	4	1	4	0.6251
Baru and the Spirit Prince	2016-12-30	2	4	1	3	0.6251
Winning Putt: Golf Online	2016-10-25	450	371	203	653	0.6247
Broomball	2016-07-26	8	32	15	23	0.6245
Space Rogue	2016-09-15	58	289	157	215	0.6244
天使帝國四《Empire of Angels IV》	2016-12-15	108	257	139	247	0.6244
Metal Assault - Gigaslave - Europe	2016-11-04	292	75	38	330	0.6244
Discouraged Workers TEEN	2016-03-22	198	49	24	222	0.6244
P·O·L·L·E·N	2016-04-20	100	126	66	166	0.6242
Anime Studio Simulator	2016-11-03	57	47	23	80	0.6239
Meridian: Squad 22	2016-08-11	32	82	42	74	0.6236
Asemblance	2016-06-21	30	82	42	72	0.6236
The Haunting of Billy Classic	2016-02-26	1886	28	13	1899	0.6235
Broken Blue	2016-12-09	8	28	13	21	0.6235
Townopolis	2016-04-27	1010	69	35	1045	0.6232
Hero Defense	2016-05-31	203	445	247	450	0.6231
Reset 1-1	2016-08-30	5657	154	82	5739	0.6231
DOGOS	2016-09-06	210	43	21	231	0.623
Metamorphic	2016-07-06	6	24	11	17	0.6226
REALITY	2016-11-30	8	65	33	41	0.6223
Mindless Running	2016-02-18	633	254	139	772	0.6221
Diorama No.1 - Blocked In	2016-04-05	5	22	10	15	0.6221
IACTURA	2016-08-25	2296	22	10	2306	0.6221
PolyRace	2016-03-24	11	39	19	30	0.6219
Aegis of Earth: Protonovus Assault	2016-07-19	31	39	19	50	0.6219
The Last Leviathan	2016-06-22	266	360	200	466	0.6215999999999999
Burly Men at Sea	2016-09-29	32	283	156	188	0.6215
MiniGolf Mania	2016-03-25	16	72	37	53	0.6215
Concealed Intent	2016-08-02	8	20	9	17	0.6215
FrightShow Fighter	2016-11-15	3	20	9	12	0.6215
Octoshield VR	2016-06-15	5	20	9	14	0.6215
The Orphan Dreams	2016-04-27	3	37	18	21	0.6213000000000001
Crown and Council	2016-04-22	725	479	269	994	0.6212
Puzzles Under The Hill	2016-06-11	90	70	36	126	0.6211
Zombie Camp	2016-08-01	60	18	8	68	0.621
InterSection	2016-07-12	2	6	2	4	0.621
Terrarium Land	2016-03-29	4	6	2	6	0.621
Mini's Magic World	2016-05-12	38	6	2	40	0.621
Trap House	2016-06-14	6	6	2	8	0.621
.EXE	2016-06-16	3	6	2	5	0.621
Reverence: The Ultimate Combat Experience	2016-09-13	6	6	2	8	0.621
ThrounnelVR	2016-09-15	1001	6	2	1003	0.621
Live In Color	2016-09-12	2	6	2	4	0.621
Solitaire 220 Plus	2016-11-04	8	6	2	10	0.621
Chicken Chase	2016-10-06	5	6	2	7	0.621
VR Laser Harp	2016-11-16	2	6	2	4	0.621
A Number's life	2016-12-13	3	6	2	5	0.621
MXGP2 - The Official Motocross Videogame Compact	2016-09-08	11	59	30	41	0.6209
Magma Tsunami	2016-06-01	2628	198	108	2736	0.6208
The Minotaur	2016-01-21	657	35	17	674	0.6207
Tropical Fish Shop 2	2016-03-10	845	16	7	852	0.6204999999999999
Momentum	2016-08-12	31	16	7	38	0.6204999999999999
Rocket Ski Racing	2016-10-13	18	16	7	25	0.6204999999999999
Shuttle Siege	2016-12-30	4	16	7	11	0.6204999999999999
Six Feet Under	2016-09-20	4	16	7	11	0.6204999999999999
Tank Battle: Blitzkrieg	2016-12-07	7	16	7	14	0.6204999999999999
Charm Tale Quest	2016-10-27	8	16	7	15	0.6204999999999999
The Odyssey	2016-09-05	48	14	6	54	0.62
Polywings	2016-10-04	3	14	6	9	0.62
Pawn	2016-12-09	62	14	6	68	0.62
Don't Let Go!	2016-09-13	9	44	22	31	0.6197
Break Through: Artificial Maze	2016-07-12	23	8	3	26	0.6197
Super Cube Smash	2016-08-16	3	8	3	6	0.6197
Inklings	2016-10-06	3	8	3	6	0.6197
Saving Harmony	2016-09-26	4	8	3	7	0.6197
Armor Clash VR	2016-08-09	4	8	3	7	0.6197
TRI.DEFENDER	2016-11-02	361	8	3	364	0.6197
Rocket Craze 3D	2016-11-18	4	8	3	7	0.6197
Orbit - Playing with Gravity	2016-11-10	5	8	3	8	0.6197
Fancy Trangram VR	2016-11-04	2	8	3	5	0.6197
OneManVurgeR	2016-12-16	9	8	3	12	0.6197
Dreii	2016-02-02	7	12	5	12	0.6196
Zombie Hunter, Inc.	2016-01-18	5	12	5	10	0.6196
WinKings	2016-10-28	36	12	5	41	0.6196
Pong Champion VR	2016-07-26	3	10	4	7	0.6195
Gochi-Show! for Girls	2016-09-07	3	10	4	7	0.6195
Lord of the Seal	2016-09-16	10	10	4	14	0.6195
Saga of the North Wind	2016-11-17	35	10	4	39	0.6195
Thirty Years' War	2016-06-09	16	31	15	31	0.6193
Score a goal (Physical football)	2016-12-28	807	163	89	896	0.6191
Thrills & Chills - Roller Coasters	2016-09-20	13	42	21	34	0.619
Unforgiving Trials: The Darkest Crusade	2016-06-15	7692	405	229	7921	0.6189
Steam Squad	2016-07-28	156	60	31	187	0.6185
Bears Can't Drift!?	2016-08-08	5	40	20	25	0.6183
Cricket Captain 2016	2016-07-05	231	40	20	251	0.6183
Blight of the Immortals	2016-10-25	35	40	20	55	0.6183
Frozen State	2016-08-05	120	345	195	315	0.618
Bohemian Killing	2016-07-21	32	127	69	101	0.6178
Imprisoned Light	2016-10-28	21	132	72	93	0.6174000000000001
Spellstone	2016-11-14	2072	265	149	2221	0.6173
Western Press	2016-04-21	248	156	86	334	0.617
Vanilla Bagel: The Roguelike	2016-06-15	120	25	12	132	0.6169
Crewsaders	2016-11-17	6	25	12	18	0.6169
RoShamBo Arena	2016-07-14	315	278	157	472	0.6168
Planet Explorers	2016-11-08	2125	4174	2498	4623	0.6167
Werewolves Within	2016-12-06	203	93	50	253	0.6167
Eclipse: New Dawn for the Galaxy	2016-09-16	102	77	41	143	0.6164000000000001
HEX: Shards of Fate	2016-04-19	2118	1099	646	2764	0.6161
My Tower, My Home	2016-03-16	15	23	11	26	0.616
Fairy Tale Mysteries: The Puppet Thief	2016-01-07	249	205	115	364	0.6159
Satellite Command	2016-12-16	40	52	27	67	0.6159
Children of Orc	2016-12-20	28	52	27	55	0.6159
Kingdom Wars 2: Battles	2016-03-04	547	603	351	898	0.6153000000000001
Dungeons & Darkness	2016-09-30	27	66	35	62	0.6153000000000001
Techwars Online	2016-03-17	9	80	43	52	0.6152000000000001
ViveSpray	2016-11-25	15	50	26	41	0.6152000000000001
Copter and Sky	2016-07-22	8	41	21	29	0.615
To The Capital	2016-12-28	1595	41	21	1616	0.615
Party Saboteurs	2016-10-20	402	32	16	418	0.615
Marrow	2016-11-26	3	21	10	13	0.6149
ASTROKILL	2016-05-27	8	48	25	33	0.6144
Tabletopia	2016-12-01	1207	957	566	1773	0.6142000000000001
Bottle	2016-04-21	932	271	155	1087	0.6142000000000001
Syndrome	2016-10-06	54	193	109	163	0.6142000000000001
Approaching Blocks	2016-06-04	1501	191	108	1609	0.6139
Galactic Storm	2016-09-17	4	19	9	13	0.6138
Children of Colossus	2016-12-16	880	19	9	889	0.6138
Dungeon Fighter Online	2016-08-09	3469	3105	1878	5347	0.6136
8i	2016-04-26	16	46	24	40	0.6136
Expect The Unexpected	2016-12-09	17	53	28	45	0.6134000000000001
Dungeon Rushers	2016-09-06	263	738	436	699	0.6133
Hover Junkers	2016-04-05	110	514	301	411	0.6133
The Divergent Series: Allegiant VR	2016-03-17	20	67	36	56	0.6133
Time of Dragons	2016-02-01	365	1065	636	1001	0.6127
V ARRR	2016-06-10	12	51	27	39	0.6126
Sky Valley	2016-08-05	38	51	27	65	0.6126
Best Buds	2016-12-07	5	17	8	13	0.6125
Burokku Girls	2016-02-17	24	35	18	42	0.6121
Mahluk:Dark demon	2016-07-19	280	94	52	332	0.6118
NORTH	2016-04-27	1800	267	155	1955	0.6112
Virtual Pool 4 Multiplayer	2016-06-13	25	80	44	69	0.6112
Wolfsong	2016-02-01	6	15	7	13	0.6111
Project G	2016-05-13	50	15	7	57	0.6111
Vex	2016-09-13	3	15	7	10	0.6111
Space Jones VR	2016-08-11	9	15	7	16	0.6111
Beat Boxer	2016-11-22	4	15	7	11	0.6111
7D Game （VR for VIVE）	2016-10-27	5	15	7	12	0.6111
Hero Battle	2016-04-28	1338	97	54	1392	0.611
Level 22: Gary’s Misadventures	2016-02-11	255	33	17	272	0.611
Ball of Wonder	2016-10-28	3329	54	29	3358	0.6109
Eve of Destruction - REDUX VIETNAM	2016-09-30	8	40	21	29	0.6108
Tibetan Quest: Beyond the World's End	2016-04-07	274	134	76	350	0.6104999999999999
MilitAnt	2016-07-12	9	24	12	21	0.6104999999999999
Hieroglyphika	2016-02-03	11	95	53	64	0.6104
Shoppe Keep	2016-05-20	683	1730	1054	1737	0.6103000000000001
Stay Close	2016-10-14	71	1017	614	685	0.6102000000000001
Battleborn	2016-05-03	12101	5965	3699	15800	0.6098
Fallen	2016-12-20	1149	45	24	1173	0.6098
Shadows of Kurgansk	2016-12-15	72	135	77	149	0.6096
Dino Eggs: Rebirth	2016-06-09	5	13	6	11	0.6095
MAGATAMA Earrings	2016-06-14	4	13	6	10	0.6095
Worldy Cup	2016-08-10	3	13	6	9	0.6095
Finque	2016-11-11	102	13	6	108	0.6095
Obscuritas	2016-03-17	47	118	67	114	0.6093000000000001
Rugby Challenge 3	2016-06-29	50	74	41	91	0.6092000000000001
Lamia's Game Room	2016-02-17	75	133	76	151	0.6091
Machine Gun Train Run	2016-02-26	90	22	11	101	0.609
Zeus Quest Remastered	2016-06-28	412	22	11	423	0.609
UNCORPOREAL - Fluffy!	2016-07-20	7	22	11	18	0.609
Haeven	2016-08-05	301	22	11	312	0.609
Prospekt	2016-02-18	406	944	573	979	0.6088
90 Minute Fever	2016-07-12	129	161	93	222	0.6086
Strange Night	2016-07-27	2299	232	136	2435	0.6084
Unending Galaxy	2016-02-19	141	72	40	181	0.6084
Versus: Battle of the Gladiator	2016-08-26	169	307	182	351	0.608
Parvaneh: Legacy of the Light's Guardians	2016-08-26	907	41	22	929	0.6077
Marvel: Ultimate Alliance	2016-07-26	211	344	205	416	0.6076
The Butterfly Sign	2016-12-14	1650	122	70	1720	0.6076
Castle Torgeath	2016-12-15	207	53	29	236	0.6076
Heroes of Issachar	2016-11-03	7	11	5	12	0.6076
Andromedum	2016-04-19	2	11	5	7	0.6076
Crazy Otto	2016-06-13	93	11	5	98	0.6076
In The Shadow Of The Truth	2016-10-18	2	11	5	7	0.6076
Stars	2016-08-30	5	11	5	10	0.6076
Glaive	2016-07-26	3	11	5	8	0.6076
Cogito	2016-10-15	6	11	5	11	0.6076
Empyrean	2016-12-01	39	11	5	44	0.6076
kunlun fight	2016-12-16	4	11	5	9	0.6076
Tiny Knight	2016-03-17	8	20	10	18	0.6074
The Impossible Travel Agency	2016-09-02	5	27	14	19	0.6071
Snooker Nation Championship	2016-04-27	107	179	105	212	0.6065
Doors	2016-02-12	134	192	113	247	0.6064
Soccer Manager	2016-02-09	382	141	82	464	0.6063000000000001
Phantaruk	2016-08-16	39	131	76	115	0.6062
The Hero Project: Redemption Season	2016-04-08	137	71	40	177	0.6059
Intruder Alert: Ixian Operations	2016-07-21	28	44	24	52	0.6059
WAR CUBE	2016-09-12	1759	44	24	1783	0.6059
Defense Of Greece TD	2016-11-10	2985	44	24	3009	0.6059
Blood Alloy: Reborn	2016-03-02	12	32	17	29	0.6059
Herding Dog	2016-01-15	114	32	17	131	0.6059
Magic Quest	2016-05-07	850	32	17	867	0.6059
Pirate Pop Plus	2016-11-04	91	91	52	143	0.6058
Trawl	2016-05-13	5	25	13	18	0.6055
Concrete and Steel	2016-05-27	11	18	9	20	0.6055
RX squad	2016-07-30	1553	18	9	1562	0.6055
Interfectorem	2016-11-04	4	18	9	13	0.6055
Independence War Deluxe Edition	2016-08-10	2	9	4	6	0.6054
UnderEarth	2016-06-22	74	9	4	78	0.6054
Ego Protocol	2016-02-16	2	9	4	6	0.6054
Leave The Nest	2016-05-28	9	9	4	13	0.6054
Con Amore	2016-07-25	98	9	4	102	0.6054
Crazy Saloon VR	2016-11-30	8	9	4	12	0.6054
Plankton	2016-10-28	794	59	33	827	0.6052000000000001
Smell of Death	2016-07-04	6	37	20	26	0.6052000000000001
Clown2Beat	2016-10-26	6	30	16	22	0.6043999999999999
STAR WARS™: Rebel Assault I + II	2016-03-29	26	133	78	104	0.6043000000000001
Sorcerer King: Rivals	2016-09-22	188	232	139	327	0.6042000000000001
Time Machine VR	2016-05-19	17	72	41	58	0.6042000000000001
Gone In November	2016-08-18	1273	235	141	1414	0.604
After Life - Story of a Father	2016-11-25	3	23	12	15	0.6037
Hooligan Vasja	2016-08-19	1081	108	63	1144	0.6036
Maria the Witch	2016-03-01	147	40	22	169	0.6035
Locked Fears	2016-11-04	22	40	22	44	0.6035
ROM: Extraction	2016-12-07	13	75	43	56	0.6034
Hiragana Pixel Party	2016-03-18	170	16	8	178	0.6034
The Inner Sea	2016-03-30	15	16	8	23	0.6034
Valcarta: Rise of the Demon	2016-07-09	115	16	8	123	0.6034
Radical Heroes: Crimson City Crisis	2016-10-04	3	16	8	11	0.6034
Monsti	2016-09-12	2515	389	238	2753	0.6031000000000001
Ant Queen	2016-06-17	44	158	94	138	0.603
Defragmented	2016-02-12	24	28	15	39	0.6028
Hikikomori No Chuunibyou	2016-07-15	228	28	15	243	0.6028
Fatal Theory	2016-09-14	12	7	3	15	0.6028
Hacked	2016-11-01	2	7	3	5	0.6028
Holodaze	2016-05-19	3	7	3	6	0.6028
The Wire Loop Game VR	2016-08-08	4	7	3	7	0.6028
Happy Pong	2016-08-22	3	7	3	6	0.6028
Raging Titan	2016-10-16	6	7	3	9	0.6028
Viking Escape	2016-11-10	3	7	3	6	0.6028
Moto Racer 4	2016-11-03	3011	657	408	3419	0.6026
Francisca	2016-07-26	679	209	126	805	0.6024
Alekhine's Gun	2016-03-11	735	252	153	888	0.6022
Boss Monster	2016-04-28	99	223	135	234	0.6020000000000001
Love, Guitars, and the Nashville Skyline	2016-11-22	5	21	11	16	0.6017
Save Halloween: City of Witches	2016-05-10	39	26	14	53	0.601
Bridge Constructor Stunts	2016-02-23	14	87	51	65	0.6009000000000001
Clockwork	2016-10-10	83	46	26	109	0.6007
Panzer Warfare	2016-08-26	1011	46	26	1037	0.6007
Ruckus Ridge VR Party	2016-04-05	8	36	20	28	0.6006
Chamber 19	2016-10-21	8	31	17	25	0.6006
Charlie's Adventure	2016-11-29	4663	218	133	4796	0.6004
Police Tactics: Imperio	2016-09-07	361	254	156	517	0.6
Handball 17	2016-11-15	21	67	39	60	0.5997
DeathCrank	2016-12-15	8	5	2	10	0.5997
Ninja Outbreak	2016-03-30	72	5	2	74	0.5997
Quarterback SNAP	2016-08-26	4	5	2	6	0.5997
Echoes of the Past: Kingdom of Despair Collector's Edition	2016-07-21	3	5	2	5	0.5997
The Food Run	2016-12-10	44	5	2	46	0.5997
Sparky's Hunt	2016-08-18	3	5	2	5	0.5997
Globe Rush	2016-09-02	23	5	2	25	0.5997
Haunted Legends: The Queen of Spades Collector's Edition	2016-10-06	3	5	2	5	0.5997
Mystery Chronicle: One Way Heroics	2016-09-13	223	233	143	366	0.5996
Disposable Heroes	2016-03-22	151	49	28	179	0.5996
Peak Angle: Drift Online	2016-11-25	74	537	337	411	0.5995
Robot Squad Simulator 2017	2016-10-20	17	96	57	74	0.5995
Excubitor	2016-05-26	10	19	10	20	0.5994
Endorlight	2016-04-26	3110	836	530	3640	0.5993
Little King's Story	2016-08-05	94	226	139	233	0.599
The Nest	2016-06-14	136	115	69	205	0.599
Pinball HD Collection	2016-08-03	8	57	33	41	0.599
Valiant	2016-05-02	11	34	19	30	0.5989
Tank Brawl	2016-04-20	7	24	13	20	0.5989
The Cooking Game	2016-10-21	1342	113	68	1410	0.5984
Fossil Echo	2016-07-08	693	81	48	741	0.5984
Starship Annihilator	2016-09-03	17248	89	53	17301	0.5982999999999999
Pointless	2016-02-22	110	162	99	209	0.5981000000000001
Lily´s Epic Quest	2016-08-15	32	12	6	38	0.598
B. Braun Future Operating Room	2016-12-09	6	12	6	12	0.598
Drone Hunter VR	2016-12-21	6	32	18	24	0.5971000000000001
7 Mages	2016-06-23	30	82	49	79	0.5970000000000001
Chasing Dead	2016-03-03	15	139	85	100	0.5969
Planet Driller	2016-07-04	441	45	26	467	0.5969
Adele: Following the Signs	2016-06-02	4	17	9	13	0.5968
Wooden House	2016-09-05	7676	178	110	7786	0.5966
Feelings Adrift	2016-03-01	13	53	31	44	0.5966
mr.President Prologue Episode	2016-09-20	1727	77	46	1773	0.5965
Eyestorm	2016-08-26	2	3	1	3	0.596
Logic Missile	2016-04-29	1	3	1	2	0.596
Dashing Dinos	2016-10-27	3	3	1	4	0.596
Infinite Shooter	2016-04-20	4	3	1	5	0.596
Spa Mania	2016-06-15	5	3	1	6	0.596
Crongdor the Barbarian	2016-07-06	3	3	1	4	0.596
The book of commands : Lost Symbol	2016-06-17	3	3	1	4	0.596
Puzzle Nebula	2016-07-06	2	3	1	3	0.596
Abandoned Hospital VR	2016-08-04	5	3	1	6	0.596
Dungeon of Doom Puzzle	2016-10-28	3	3	1	4	0.596
Septic Savages	2016-11-01	3	3	1	4	0.596
Beneath The Cherry Trees	2016-10-14	8	72	43	51	0.5959000000000001
Summer Fling	2016-06-16	38	64	38	76	0.5959000000000001
Kung Fu Panda Showdown of Legendary Legends	2016-01-06	10	56	33	43	0.5959000000000001
Tank Battle: 1944	2016-03-01	22	35	20	42	0.5958
CURSE	2016-09-02	9	43	25	34	0.5954
SUPERFIGHT	2016-07-21	3124	228	143	3267	0.5953
SkyTime	2016-12-02	1600	122	75	1675	0.595
Outrage	2016-04-06	3345	89	54	3399	0.595
Love in the Glen	2016-06-09	525	38	22	547	0.5947
Domain Defense	2016-07-14	49	25	14	63	0.5946
A Long Way Home	2016-05-27	23	25	14	37	0.5946
Infinitesimal Point	2016-02-03	4	10	5	9	0.5943
Nanobots	2016-03-15	2759	10	5	2764	0.5943
Medieval Battlefields	2016-06-02	6	10	5	11	0.5943
Galaxy Cannon Rider	2016-05-10	98	10	5	103	0.5943
KYOTO TANOJI QUEST	2016-12-24	3	10	5	8	0.5943
Happy Critters	2016-10-20	2	1	0	2	0.5942000000000001
Capria: Magic of the Elements	2016-04-05	2	1	0	2	0.5942000000000001
Octamari Rescue	2016-07-26	4	1	0	4	0.5942000000000001
NeverMine	2016-07-26	2	1	0	2	0.5942000000000001
GravPool	2016-08-30	2	1	0	2	0.5942000000000001
ATV Quadracer Ultimate	2016-11-18	2	1	0	2	0.5942000000000001
Unfazed	2016-09-17	2	1	0	2	0.5942000000000001
NDE Rescue	2016-09-01	1	1	0	1	0.5942000000000001
Aleph Null	2016-08-15	1	1	0	1	0.5942000000000001
Why is the Princess in a Magic Forest?!	2016-11-11	2	1	0	2	0.5942000000000001
Wondee	2016-12-06	2	1	0	2	0.5942000000000001
Invaders!	2016-11-09	2	1	0	2	0.5942000000000001
FIGHTING SPACE	2016-12-20	40	1	0	40	0.5942000000000001
REVIVAL RESET	2016-12-23	2	1	0	2	0.5942000000000001
DinoFense	2016-12-24	3	1	0	3	0.5942000000000001
Borstal	2016-03-22	125	20	11	136	0.594
Lithium: Inmate 39	2016-10-25	7	20	11	18	0.594
Felis: Cat Saving Platformer	2016-12-28	5	20	11	16	0.594
Highland Warriors	2016-03-04	9	33	19	28	0.5939
Project Graviton	2016-02-15	57	15	8	65	0.5937
Ascension VR	2016-08-01	8	15	8	16	0.5937
Wave Magic VR	2016-12-29	14	15	8	22	0.5937
Unforgiving Trials: The Space Crusade	2016-10-07	5175	181	114	5289	0.5931000000000001
Tangled Up!	2016-09-02	51	28	16	67	0.593
Virtual Warfighter	2016-09-02	11	44	26	37	0.5929
CRACKHEAD	2016-11-11	3066	650	423	3489	0.5928
On My Own	2016-02-26	28	91	56	84	0.5926
Ian's Eyes	2016-09-01	136	66	40	176	0.5926
Abrix the robot	2016-04-29	736	55	33	769	0.5926
Puzzle Galaxies	2016-04-29	6223	94	58	6281	0.5924
Assault Suit Leynos	2016-08-30	18	111	69	87	0.5922999999999999
Operation: Matriarchy	2016-01-29	1028	58	35	1063	0.5922
TAIKER	2016-12-01	7	23	13	20	0.5921000000000001
PHAT PHROG	2016-10-27	16	39	23	39	0.5920000000000001
Amulet of Dreams	2016-06-03	105	103	64	169	0.5918
NAL Is Alive	2016-12-17	2356	18	10	2366	0.5910000000000001
CasinoXR	2016-08-04	6	18	10	16	0.5910000000000001
The Night The Carsons Disappeared	2016-10-24	6	18	10	16	0.5910000000000001
ABE VR	2016-06-23	34	182	116	150	0.5908
Ortus Arena, online strategy board game	2016-09-28	6	26	15	21	0.5906
ALONE? - VR	2016-10-07	19	26	15	34	0.5906
BIOS	2016-12-13	22	113	71	93	0.5904
Echo Tokyo: An Intro	2016-01-27	5	96	60	65	0.5902000000000001
Graveyard Shift	2016-10-20	3	37	22	25	0.5901
ReBoot	2016-10-20	138	13	7	145	0.59
Sky Tower	2016-04-26	3	8	4	7	0.5897
Side Quest	2016-02-15	4	8	4	8	0.5897
Fancy Slingshot VR	2016-08-19	3	8	4	7	0.5897
Guardian war VR	2016-08-24	3	8	4	7	0.5897
Sonic Hunter VR	2016-11-23	4	8	4	8	0.5897
Island Racer	2016-12-15	3	8	4	7	0.5897
Life in Bunker	2016-02-25	283	196	126	409	0.5896
Lost Sea	2016-07-05	30	40	24	54	0.5894
Crush Online	2016-10-10	725	307	200	925	0.5893
Edgar	2016-03-29	6	21	12	18	0.5892000000000001
Football Mogul 15	2016-09-06	10	21	12	22	0.5892000000000001
Civil War: 1862	2016-10-06	11	21	12	23	0.5892000000000001
Our Wonderful World	2016-11-29	3002	21	12	3014	0.5892000000000001
3DRPG	2016-01-12	929	135	86	1015	0.5891
Homefront: The Revolution	2016-05-17	4365	9036	6175	10540	0.5889
Purgatory	2016-06-22	4242	150	96	4338	0.5889
Skater 2D	2016-11-02	1316	49	30	1346	0.5881000000000001
The Secret Monster Society	2016-07-28	69	24	14	83	0.5879
SurvHive	2016-08-01	24	52	32	56	0.5878
The Growth Journey	2016-01-07	1324	38	23	1347	0.5875
Blades of the Righteous	2016-03-07	829	16	9	838	0.5875
Orczz	2016-11-17	955	16	9	964	0.5875
Bicyclism EP	2016-11-14	33	16	9	42	0.5875
Don't Die Dateless, Dummy!	2016-03-22	15	41	25	40	0.5870000000000001
A Game of Changes	2016-06-02	2711	67	42	2753	0.5868
Football Manager 2017	2016-11-03	72824	6539	4503	77327	0.5866
Super Helmets on Fire DX Ultra Edition Plus Alpha	2016-02-15	59	30	18	77	0.5863
Wanderland	2016-12-20	60	194	127	187	0.5860000000000001
Ace of Protectors	2016-06-27	388	53	33	421	0.5860000000000001
Milford Heaven - Luken's Chronicles	2016-06-10	1176	33	20	1196	0.5857
It's Killing Time	2016-04-22	13	11	6	19	0.5855
Doritos VR Battle	2016-11-04	6	11	6	12	0.5855
The Life Of Greather	2016-08-25	2684	74	47	2731	0.5853
MacGuffin	2016-02-18	8	22	13	21	0.5849000000000001
Yrminsul	2016-03-02	42	22	13	55	0.5849000000000001
Spooky Heroes	2016-06-24	579	22	13	592	0.5849000000000001
Ironclads 2: War of the Pacific	2016-11-15	3	22	13	16	0.5849000000000001
Timore Inferno	2016-06-02	1230	200	132	1362	0.5846
Stop Online - Battle of Words	2016-01-15	117	102	66	183	0.5843
3D Chess	2016-12-06	58	81	52	110	0.5841
Spellbind	2016-03-04	1340	25	15	1355	0.5841
King's Guard TD	2016-06-08	1576	208	138	1714	0.5838
Wanda	2016-06-03	1693	109	71	1764	0.5835
A Princess' Tale	2016-05-20	1186	31	19	1205	0.5833
Malavision: The Origin	2016-10-18	1608	31	19	1627	0.5833
Cyborg Rage	2016-02-19	3	14	8	11	0.5833
Witan	2016-07-12	3	14	8	11	0.5833
Highway to the Moon	2016-08-26	700	14	8	708	0.5833
Combat Racers	2016-04-16	38	6	3	41	0.5833
Anthelion	2016-07-26	8	6	3	11	0.5833
Night Vigil	2016-08-10	167	6	3	170	0.5833
Wasps!	2016-08-31	2	6	3	5	0.5833
The Final Days: I'm Still Alive	2016-09-02	2	6	3	5	0.5833
Brumm	2016-11-01	4	6	3	7	0.5833
Nanomedix Inc	2016-10-27	5	6	3	8	0.5833
Lonelyland VR	2016-11-09	4	6	3	7	0.5833
Fly and Destroy	2016-07-29	1629	156	103	1732	0.5831000000000001
Cmoar VR Cinema UHD	2016-09-30	19	125	82	101	0.583
VR Escape the space station	2016-08-25	11	37	23	34	0.5828
Eagle Flight	2016-12-20	118	220	147	265	0.5827
Mystic Saga	2016-01-27	1233	141	93	1326	0.5827
Sunny Hillride	2016-02-01	12	58	37	49	0.5826
The Construct	2016-09-12	2292	58	37	2329	0.5826
Little Jack's Adventures	2016-12-28	1971	43	27	1998	0.5826
Krai Mira: Extended Cut	2016-07-11	63	145	96	159	0.5822
Virtual Rogue	2016-04-08	152	17	10	162	0.5821000000000001
Moonshot Galaxy™	2016-08-24	51	17	10	61	0.5821000000000001
Elysium: Blood Games	2016-01-05	1681	80	52	1733	0.5817
Barnyard Mahjong 3	2016-07-29	120	71	46	166	0.5814
Let Hawaii Happen VR	2016-10-22	9	20	12	21	0.5814
Infinity Wings - Scout & Grunt	2016-03-11	734	26	16	750	0.5807
Survival Kingdom	2016-10-13	1445	26	16	1461	0.5807
3D Arcade Fishing	2016-12-20	39	26	16	55	0.5807
Dance Magic	2016-02-16	184	32	20	204	0.5805
Mystica: The Ninth Society	2016-03-07	44	29	18	62	0.5805
Ghostdream	2016-10-24	207	29	18	225	0.5805
NightCry	2016-03-29	90	159	107	197	0.5796
Alphabeats: Master Edition	2016-03-07	5	9	5	10	0.5796
Castle Heist: Chapter 1	2016-05-05	4	9	5	9	0.5796
Space Bit Attack	2016-04-05	3	9	5	8	0.5796
Pulse Shift	2016-08-29	172	9	5	177	0.5796
Toon Ocean VR	2016-08-27	4	9	5	9	0.5796
Block Wave	2016-09-09	3	9	5	8	0.5796
VR Fun World	2016-11-21	16	9	5	21	0.5796
Doomsday Survival:Training	2016-11-30	4	9	5	9	0.5796
Nodiatis	2016-11-15	63	48	31	94	0.5788000000000001
Summer Sale	2016-06-02	170	547	380	550	0.5786
Shining Plume	2016-10-14	779	39	25	804	0.5782
Redemption	2016-08-11	36	12	7	43	0.5782
Lolly Joe	2016-08-06	52	12	7	59	0.5782
The Fifth Expedition	2016-04-07	16	12	7	23	0.5782
Save Home	2016-10-01	1791	30	19	1810	0.5777
Final Approach: Pilot Edition	2016-06-23	10	27	17	27	0.5775
Escape from Pleasure Planet	2016-12-16	8	27	17	25	0.5775
And So It Was	2016-02-29	4	24	15	19	0.5774
Galactic Landing	2016-12-09	1653	24	15	1668	0.5774
Pane In The Glass	2016-08-08	11	21	13	24	0.5773
Russian VR Coasters	2016-07-27	16	21	13	29	0.5773
Blackfaun	2016-10-26	8	18	11	19	0.5773
Blood Ties	2016-10-21	1345	46	30	1375	0.5768
Codename: Rogue Fleet	2016-01-15	86	185	127	213	0.5765
Hero's Song	2016-11-07	338	112	76	414	0.5760000000000001
Star Trek: Starfleet Command Gold Edition	2016-11-22	14	102	69	83	0.5760000000000001
Soviet City	2016-03-31	12	66	44	56	0.5758
Darkness Ahead	2016-11-02	2814	37	24	2838	0.5758
Take Thy Throne	2016-07-05	2071	136	93	2164	0.5756
Last Days of Old Earth	2016-06-07	13	34	22	35	0.5754
GROOVY	2016-05-27	694	73	49	743	0.5753
Smash Up	2016-10-12	96	137	94	190	0.5750000000000001
Elemental Heroes	2016-03-04	171	100	68	239	0.5749000000000001
Immune	2016-12-09	511	839	597	1108	0.5748
Planar Conquest	2016-05-30	212	272	190	402	0.5748
XCavalypse	2016-06-06	13	28	18	31	0.5746
Crystal Rift	2016-03-30	8	77	52	60	0.5745
Red Risk	2016-03-04	9996	503	356	10352	0.5744
UFO Online: Invasion	2016-06-08	570	344	242	812	0.5743
TERROR LAB	2016-03-16	5	54	36	41	0.5743
Warhammer: Vermintide VR - Hero Trials	2016-12-20	42	118	81	123	0.5740999999999999
Caretaker Retribution	2016-12-15	3	4	2	5	0.5739
Rescue From Goblin Deep	2016-01-26	4	4	2	6	0.5739
Minigame Party VR	2016-04-05	2	4	2	4	0.5739
Savana	2016-07-26	3	4	2	5	0.5739
PROJECT XINATRA	2016-08-08	2	4	2	4	0.5739
Mythic Victory Arena	2016-10-03	5	4	2	7	0.5739
Robot Incursion	2016-11-21	2	4	2	4	0.5739
Merchants & Mercenaries	2016-11-11	8	4	2	10	0.5739
Kamio Recoil	2016-12-21	5	4	2	7	0.5739
Hover Hazard	2016-10-21	4002	38	25	4027	0.5737
Zone4	2016-11-21	807	354	250	1057	0.5736
Marcus Level	2016-01-20	93	22	14	107	0.5736
Miaou Moon	2016-08-19	104	22	14	118	0.5736
Tyler	2016-01-14	306	19	12	318	0.5731
CRAPPY ZOMBIE GAME	2016-10-28	4	19	12	16	0.5731
Rising Islands	2016-08-02	144	65	44	188	0.5729
Racecar.io	2016-10-19	41	194	136	177	0.5726
Spectrubes	2016-03-25	284	13	8	292	0.5721
World Boxing Manager	2016-12-10	24	76	52	76	0.5720000000000001
Civil War: 1863	2016-06-21	40	29	19	59	0.5719
Soup	2016-03-19	95	29	19	114	0.5719
S.O.R.S	2016-03-04	6	7	4	10	0.5718
Spells 'n' Stuff	2016-04-05	4	7	4	8	0.5718
Wincars Racer	2016-11-18	7	7	4	11	0.5718
JOLT: Super Robot Racer	2016-11-15	20	7	4	24	0.5718
Watching Grass Grow In VR - The Game	2016-08-22	6	7	4	10	0.5718
Draconic Order VR	2016-10-31	4	7	4	8	0.5718
The Writer: A Change Of Identity	2016-10-14	2	7	4	6	0.5718
Demented Pixie	2016-12-14	116	7	4	120	0.5718
Scapeland	2016-03-31	169	39	26	195	0.5717
Project Abyss	2016-11-18	89	39	26	115	0.5717
Overdosed - A Trip To Hell	2016-05-23	33	10	6	39	0.5717
Planet 1138	2016-02-18	4	10	6	10	0.5717
Nighttime Terror: Dessert Defender	2016-04-04	4	10	6	10	0.5717
Paradox Paradigm	2016-05-23	7	10	6	13	0.5717
Unaided: 1939	2016-09-29	5	10	6	11	0.5717
The Planet of the Vicious Creatures	2016-10-05	2	10	6	8	0.5717
Elements II: Hearts of Light	2016-04-01	3295	80	55	3350	0.5715
Eight Mini Racers	2016-01-12	1260	46	31	1291	0.5712
Crazy Pixel Streaker	2016-06-07	26	53	36	62	0.5709000000000001
SurrealVR	2016-04-16	9	43	29	38	0.5705
Vinyl	2016-07-01	31	167	118	149	0.5703
Hold the door!	2016-09-02	6	23	15	21	0.5703
Mountain Trap 2: Under the Cloak of Fear	2016-12-14	93	23	15	108	0.5703
Operation: New Earth	2016-12-14	473	360	259	732	0.5698
Calcu-Late	2016-03-18	4024	201	143	4167	0.5698
Street Warriors Online	2016-12-16	1436	964	704	2140	0.5696
Desert Ride Coaster	2016-12-08	14	30	20	34	0.5694
Hashtag Dungeon	2016-06-01	128	20	13	141	0.5694
Grim Tales: The Bride Collector's Edition	2016-09-14	16	20	13	29	0.5694
Bombshell	2016-01-29	90	229	164	254	0.569
Industry Manager: Future Technologies	2016-10-06	444	174	124	568	0.5688000000000001
Cornerstone: The Song Of Tyrim	2016-04-26	45	58	40	85	0.5688000000000001
Bizarre Earthquake	2016-05-11	2019	268	193	2212	0.5685
Push For Emor	2016-10-24	11	27	18	29	0.5684
Elems	2016-10-28	12590	17	11	12601	0.5683
Slayer Shock	2016-09-29	28	55	38	66	0.5681
FritzChess 15	2016-02-22	37	48	33	70	0.568
Dead Island Retro Revenge	2016-06-01	28	244	176	204	0.5678
Cosmic Dust & Rust	2016-05-17	5164	256	185	5349	0.5676
Angels & Demigods	2016-09-28	11	59	41	52	0.5676
Power & Revolution	2016-05-26	335	699	514	849	0.5673
Father´s Island	2016-06-21	1706	31	21	1727	0.5671
Bunker Constructor	2016-06-24	6	14	9	15	0.5669
ATOM GRRRL!!	2016-03-01	8	14	9	17	0.5669
Detective Hunt - Crownston City PD	2016-05-23	9	14	9	18	0.5669
Legends of Time	2016-09-27	5	14	9	14	0.5669
Special Delivery	2016-12-16	5	14	9	14	0.5669
Vortex: The Gateway	2016-03-22	54	226	164	218	0.5663
Beerman	2016-08-03	517	35	24	541	0.5660000000000001
So Long Earth	2016-04-29	74	28	19	93	0.5659000000000001
Link	2016-04-22	58	28	19	77	0.5659000000000001
Bacteria	2016-03-23	3666	220	160	3826	0.5658
Congo	2016-03-21	65	113	81	146	0.5656
Zero Gravity	2016-08-28	5	11	7	12	0.5653
Classic Fun Collection 5 in 1	2016-04-29	5	11	7	12	0.5653
Magnetta	2016-08-31	5	11	7	12	0.5653
Hypnorain	2016-07-08	40	11	7	47	0.5653
Gazzel Quest, The Five Magic Stones	2016-07-16	2	11	7	9	0.5653
Yon Paradox	2016-05-06	8	32	22	30	0.5649000000000001
Mafia III: Definitive Edition	2016-10-26	47822	26021	19843	67665	0.5647
Kickoff Legends	2016-12-13	9	18	12	21	0.5644
Crimson Room: Decade	2016-06-10	8	36	25	33	0.5640999999999999
Ginger: Beyond the Crystal	2016-10-25	100	36	25	125	0.5640999999999999
Drizzlepath: Genie	2016-02-23	60	112	81	141	0.5639000000000001
MOBIUS FINAL FANTASY	2016-10-31	2282	66	47	2329	0.5639000000000001
Project: R.E.B.O.O.T	2016-10-26	1405	40	28	1433	0.5636
Return to Krondor	2016-12-15	10	40	28	38	0.5636
The Ship: Remasted	2016-10-31	195	382	284	479	0.5632
Bunny Bash	2016-04-28	7	8	5	12	0.5632
Siege - the card game	2016-09-22	6	8	5	11	0.5632
Duplexer	2016-01-29	3	8	5	8	0.5632
G Prime Into The Rain	2016-08-19	2	8	5	7	0.5632
Super GunWorld 2	2016-08-17	626	8	5	631	0.5632
Suppressed	2016-10-12	4	8	5	9	0.5632
MIGHT	2016-07-13	11	22	15	26	0.5629
Chowderchu	2016-01-05	2651	33	23	2674	0.5628000000000001
Galaxy Control: 3D Strategy	2016-08-10	362	267	198	560	0.5625
Roomscale Tower	2016-07-26	5	15	10	15	0.5625
The Cold War Era	2016-09-09	9	15	10	19	0.5625
The Amazing Shinsengumi: Heroes in Love	2016-07-27	19	60	43	62	0.5621
Lunar Stone: Origin of Blood	2016-11-19	41	26	18	59	0.562
Mathoria: It All Adds Up	2016-03-31	20	53	38	58	0.5613
Retro Football Boss	2016-09-13	11	19	13	24	0.561
Savage Resurrection	2016-08-18	1944	817	620	2564	0.5609000000000001
UnderDread	2016-03-01	203	77	56	259	0.5609000000000001
Autumn	2016-05-14	2752	146	108	2860	0.5607
iGrow Game	2016-06-09	1420	126	93	1513	0.5605
Nebulous	2016-08-30	2	5	3	5	0.5605
Slide Ride Arcade	2016-06-15	1159	5	3	1162	0.5605
Defense of Castle Chilly	2016-12-15	3	5	3	6	0.5605
ShowdownVR	2016-09-19	2	5	3	5	0.5605
Pen Island VR	2016-10-14	4	5	3	7	0.5605
Project Alpha 002	2016-10-28	3	5	3	6	0.5605
Rite of Passage: The Perfect Show Collector's Edition	2016-11-11	3	5	3	6	0.5605
Whispered Secrets: The Story of Tideville Collector's Edition	2016-12-09	3	5	3	6	0.5605
DOOORS VR	2016-12-24	4	5	3	7	0.5605
Rollout	2016-09-15	8	46	33	41	0.5603
Metal Assault	2016-03-18	367	172	128	495	0.5602
Hero Generations: ReGen	2016-08-19	40	50	36	76	0.5602
Annie Amber	2016-06-17	886	50	36	922	0.5602
Rock Paper Scissors Champion	2016-03-02	18	277	208	226	0.5601
The Deep Paths: Labyrinth Of Andokost	2016-10-26	49	70	51	100	0.56
High Fidelity	2016-11-09	164	66	48	212	0.56
Herolike	2016-09-28	114	31	22	136	0.5594
ComPet	2016-11-29	18	43	31	49	0.559
The Great Escape	2016-01-11	570	16	11	581	0.5586
Rogue Contracts: Syndicate	2016-08-27	316	16	11	327	0.5586
Citadel	2016-08-17	210	16	11	221	0.5586
Mind Unleashed	2016-05-05	15	20	14	29	0.5579999999999999
Conflict of Heroes: Awakening the Bear	2016-10-25	12	20	14	26	0.5579999999999999
O3DX	2016-01-22	124	36	26	150	0.5575
Story Of the Survivor	2016-02-17	18	36	26	44	0.5575
Melting Hearts: Our Love Will Grow 2	2016-04-30	189	36	26	215	0.5575
Heartomics: Lost Count	2016-11-27	79	36	26	105	0.5575
Hybrid Animals	2016-08-30	65	229	174	239	0.557
That Dam Level redux	2016-02-25	3	2	1	4	0.5569
Vega Tank	2016-04-29	3	2	1	4	0.5569
Bug N Out	2016-05-03	1	2	1	2	0.5569
Pet Store Panic	2016-05-17	2	2	1	3	0.5569
Surface: The Pantheon Collector's Edition	2016-07-25	5	2	1	6	0.5569
Splash Bash	2016-07-26	3	2	1	4	0.5569
Wrong Dimension - The One Dimensional Platformer	2016-09-09	2	2	1	3	0.5569
House of Alice	2016-07-12	2	2	1	3	0.5569
Domino VR	2016-08-03	2	2	1	3	0.5569
Violet Haunted	2016-10-21	2	2	1	3	0.5569
Groggers!	2016-11-10	2	2	1	3	0.5569
Horizon Of History	2016-11-16	2	2	1	3	0.5569
Aoki Ookami to Shiroki Mejika	2016-12-14	5	2	1	6	0.5569
Arena Master	2016-11-17	2	2	1	3	0.5569
Sea of Lies: Mutiny of the Heart Collector's Edition	2016-11-04	4	2	1	5	0.5569
JETPACK PORTER	2016-12-05	5	2	1	6	0.5569
Vanquish: The Adventures of Lady Exton	2016-06-20	3	9	6	9	0.5566
Ke-Tsu-No-Ana	2016-05-25	16	9	6	22	0.5566
Andoran Skye 1.5	2016-11-26	3	9	6	9	0.5566
Remnants of a Beautiful Day	2016-05-18	903	41	30	933	0.5561
DreamLand	2016-07-07	13	37	27	40	0.5559000000000001
Age of Cavemen	2016-05-24	494	315	242	736	0.5558
Discovr™ Egypt: King Tut's Tomb	2016-04-12	11	29	21	32	0.5555
Backstreets of the Mind	2016-03-04	4	13	9	13	0.5555
Everything is Peachy	2016-08-25	6	13	9	15	0.5555
So Much Blood	2016-06-03	8	25	18	26	0.5553
SuperMoose	2016-11-05	180	21	15	195	0.5552
Earth Liberation	2016-12-15	17	21	15	32	0.5552
TZOMPANTLI	2016-11-10	202	17	12	214	0.5552
Alpine Ski VR	2016-12-16	6	17	12	18	0.5552
Franchise Hockey Manager 3	2016-10-31	155	55	41	196	0.5545
The Lost	2016-08-17	2421	38	28	2449	0.5544
Vernon's Legacy	2016-09-23	27	64	48	75	0.5542
Jade's Journey	2016-12-09	690	34	25	715	0.554
Le Havre: The Inland Port	2016-08-29	30	30	22	52	0.5536
Monster Puzzle	2016-12-08	1320	92	70	1390	0.5532
Big Buck Hunter Arcade	2016-10-25	9	48	36	45	0.5527000000000001
Ludo Supremo	2016-06-08	93	75	57	150	0.5525
Call of Duty: Infinite Warfare	2016-11-05	15417	13748	11025	26442	0.5523
Astral Domine	2016-05-02	4	18	13	17	0.5522
Bowslinger	2016-04-05	5	18	13	18	0.5522
Limberjack	2016-09-01	8	18	13	21	0.5522
CODE OF PRINCESS	2016-04-14	134	164	127	261	0.5521
Find Out	2016-02-16	1813	71	54	1867	0.5521
Luke Sidewalker	2016-12-05	1600	71	54	1654	0.5521
INFERNO CLIMBER	2016-09-09	23	62	47	70	0.5521
Zombie Wars: Invasion	2016-01-14	1022	76	58	1080	0.5518
Candy Blast	2016-06-30	2108	76	58	2166	0.5518
Dorke and Ymp	2016-10-19	128	14	10	138	0.5517000000000001
EURGAVA™ - Fight for Haaria	2016-12-02	26	14	10	36	0.5517000000000001
Dog Fight	2016-01-29	3	6	4	7	0.5514
Sector 724	2016-11-04	1342	6	4	1346	0.5514
Maze Roller	2016-08-23	2	6	4	6	0.5514
Super Hop 'N' Bop ULTRA	2016-10-17	3	6	4	7	0.5514
Starship Survivor	2016-12-24	3	6	4	7	0.5514
The Legend: A University Story	2016-07-27	3	10	7	10	0.5513
Secrets of Deep Earth Shrine	2016-05-04	448	10	7	455	0.5513
Lord Mayor	2016-07-21	5	10	7	12	0.5513
Sky Jac	2016-10-25	5	10	7	12	0.5513
Incursion The Thing	2016-11-10	25	27	20	45	0.5512
Lif	2016-01-21	25	77	59	84	0.5511
Leviathan: The Cargo	2016-07-10	26	36	27	53	0.551
The Secret of Pineview Forest	2016-10-31	29	65	50	79	0.5496
BATTLE PIXELS	2016-01-14	586	37	28	614	0.5496
Genesis of Drones	2016-05-24	10	19	14	24	0.5496
Cursor Challenge	2016-04-05	176	19	14	190	0.5496
Dogfight Elite	2016-06-11	7	19	14	21	0.5496
A Week of Circus Terror	2016-08-05	50	19	14	64	0.5496
High Octane Drift	2016-10-14	524	3273	2641	3165	0.5495
HoCWar	2016-12-29	30	70	54	84	0.5494
Odd||Even	2016-04-06	1083	56	43	1126	0.5492
Kuboom	2016-10-07	3145	1668	1343	4488	0.5491
ADR1FT	2016-03-28	447	961	771	1218	0.549
Boundel	2016-11-14	58	164	129	187	0.5489
The Purge Day	2016-11-25	30	24	18	48	0.5484
Imperia Online	2016-04-15	254	142	112	366	0.5479
Daughter of Shadows: An SCP Breach Event	2016-04-04	45	48	37	82	0.5478000000000001
507研究所	2016-11-30	15	48	37	52	0.5478000000000001
Iron Commando	2016-07-13	128	29	22	150	0.5477000000000001
Breached	2016-06-22	45	73	57	102	0.5474
The Panic Room. House of secrets.	2016-04-27	193	237	189	382	0.5472
Infinium Strike	2016-07-14	69	39	30	99	0.5471
The Warden	2016-03-18	5	11	8	13	0.5468999999999999
Elansar	2016-01-11	4	11	8	12	0.5468999999999999
Marlene Act 1 Betwixt	2016-10-25	4	11	8	12	0.5468999999999999
Pepe Porcupine	2016-06-06	123	69	54	177	0.5467000000000001
Shut Eye	2016-10-01	471	64	50	521	0.5467000000000001
Tap Tap Legions - Epic battles within 5 seconds!	2016-02-09	158	188	150	308	0.5465
Path of War	2016-09-12	283	101	80	363	0.5459
Rebirth of Island	2016-11-04	115	55	43	158	0.5459
Behind the Memory	2016-12-19	6	45	35	41	0.5459
The Mahjong Huntress	2016-05-25	475	117	93	568	0.5457
Dynamite Alex	2016-09-09	2001	16	12	2013	0.5455
Guardian Of December	2016-11-30	42	16	12	54	0.5455
Gabriel Knight 3: Blood of the Sacred, Blood of the Damned	2016-08-29	8	51	40	48	0.5449
BUDDY	2016-05-27	8	46	36	44	0.5449
Gyrodisc Super League	2016-03-04	5	7	5	10	0.5448
Astroderps	2016-06-18	4	7	5	9	0.5448
Across	2016-11-04	2	7	5	7	0.5448
The Shadowland	2016-07-17	1551	36	28	1579	0.5447
A Wild Catgirl Appears!	2016-01-05	644	153	123	767	0.5443
White Mirror	2016-01-27	1555	192	155	1710	0.5442
Pixel-Warfare: Pro	2016-09-20	16	57	45	61	0.5442
The Grandfather	2016-05-03	4	84	67	71	0.5439
Trackday Manager	2016-03-31	168	183	148	316	0.5437
Mahjong Destiny	2016-06-17	220	63	50	270	0.5437
Mystery Case Files®: Escape from Ravenhearst™	2016-02-03	10	32	25	35	0.5433
Beyond Flesh and Blood Episode 1	2016-06-01	6	12	9	15	0.5433
Gumball Drift	2016-04-04	2	12	9	11	0.5433
UNCORPOREAL - Alcatraz Island Lofts	2016-07-20	5	12	9	14	0.5433
Izanami's Dream Battle	2016-10-31	3	12	9	12	0.5433
Escape: Sierra Leone	2016-12-05	8	27	21	29	0.5431
Entschuldigung	2016-12-20	205	22	17	222	0.543
Bloxitivity	2016-01-21	91	17	13	104	0.543
Maneki's Curse	2016-10-26	7	17	13	20	0.543
Khan: Absolute Power	2016-03-19	336	108	87	423	0.5429
Romance of the Three Kingdoms XIII	2016-01-28	11909	3599	2992	14901	0.5428000000000001
Divergence: Online	2016-01-07	67	70	56	123	0.5426
LuckCatchers	2016-11-15	413	440	362	775	0.5421
Help	2016-10-14	1137	82	66	1203	0.5421
The Rise of Chubtan	2016-01-21	37	3	2	39	0.5417000000000001
Heal Them All	2016-03-08	4	3	2	6	0.5417000000000001
Gear Gauntlet	2016-11-01	40	3	2	42	0.5417000000000001
Spellforge	2016-10-05	3	3	2	5	0.5417000000000001
Bloxiq VR	2016-08-30	105	3	2	107	0.5417000000000001
Adventure Of Thieves	2016-08-18	2	3	2	4	0.5417000000000001
The Tower: Last Stand	2016-10-27	2	3	2	4	0.5417000000000001
Green Moon 2	2016-08-14	5	3	2	7	0.5417000000000001
peakvox Escape Virus HD	2016-11-10	23	3	2	25	0.5417000000000001
Si Kancil : The Adventurous Mouse Deer	2016-11-08	3	3	2	5	0.5417000000000001
Lost in Reefs: Antarctic	2016-10-15	9	3	2	11	0.5417000000000001
Space Ghost Pirate Zombie Slayer	2016-11-21	2	3	2	4	0.5417000000000001
Skill Master VR -- Learn Meditation	2016-11-22	2	3	2	4	0.5417000000000001
The Jigsaw Puzzle Garden	2016-12-09	2	3	2	4	0.5417000000000001
Christmas Massacre VR	2016-12-27	3	3	2	5	0.5417000000000001
Princess Isabella: The Rise of an Heir	2016-05-12	44	89	72	116	0.5414
De-Void	2016-09-02	504	61	49	553	0.5413
Talewind	2016-09-23	37	50	40	77	0.5413
Redrum: Dead Diary	2016-10-20	18	39	31	49	0.5413
No Pineapple Left Behind	2016-02-18	14	23	18	32	0.5412
Kaboom Monsters	2016-07-07	1628	67	54	1682	0.5411
Doodle God: 8-bit Mania	2016-11-18	1355	96	78	1433	0.5408
1775: Rebellion	2016-09-29	73	62	50	123	0.5407000000000001
Void	2016-08-16	50	18	14	64	0.5407000000000001
Ray Gigant	2016-08-10	113	57	46	159	0.5402
Mistwood Heroes	2016-12-31	1760	29	23	1783	0.5402
POLYCRUSHER	2016-10-14	6	13	10	16	0.5402
Halloween Mysteries	2016-12-05	1431	13	10	1441	0.5402
Sebastien Loeb Rally EVO	2016-01-29	234	477	397	631	0.5398
CHEXS	2016-09-22	2	8	6	8	0.5398
City VR	2016-09-27	4	8	6	10	0.5398
Ancient Rome 2	2016-11-06	12	8	6	18	0.5398
Cyber City 2157: The Visual Novel	2016-05-04	4413	117	96	4509	0.5395000000000001
Azulgar: Star Commanders	2016-08-19	14	58	47	61	0.5395000000000001
Last Days	2016-10-20	1504	24	19	1523	0.5395000000000001
BlackShot: Mercenary Warfare FPS	2016-06-01	2182	1585	1332	3514	0.5394
FINAL TAKE	2016-06-16	2571	198	164	2735	0.539
ERR - 001	2016-12-13	30	19	15	45	0.5387
Fantastic 4 In A Row 2	2016-08-15	121	54	44	165	0.5382
SOMBRERO: Spaghetti Western Mayhem	2016-10-27	224	25	20	244	0.538
Leviathan Starblade	2016-11-04	110	25	20	130	0.538
Porradaria 2: Pagode of the Night	2016-03-09	544	106	88	632	0.5369
Rugby Union Team Manager 2017	2016-11-25	68	56	46	114	0.5369
Magic Potion Explorer	2016-03-11	39	50	41	80	0.5368
Hunted: One Step too Far	2016-09-02	6	32	26	32	0.5366
Attempt[42]	2016-12-08	2604	114	95	2699	0.5364
Ultimate Arena FPS	2016-09-05	22	127	106	128	0.5363
Clicker Guild	2016-12-16	1761	340	287	2048	0.5362
Bonsai	2016-02-18	611	89	74	685	0.5361
SHOCK TROOPERS 2nd Squad	2016-09-28	6	51	42	48	0.5361
Guardians of Orion (Phase 2)	2016-12-21	691	1967	1681	2372	0.5359
StarFringe: Adversus	2016-04-05	3017	45	37	3054	0.5359
Mimic Arena	2016-05-18	6	9	7	13	0.5359
Divergence: Year Zero	2016-10-21	7	9	7	14	0.5359
21 Steps to Soul	2016-10-25	4	9	7	11	0.5359
RoboSports VR	2016-11-08	5	9	7	12	0.5359
Bullet Life 2010	2016-05-19	233	58	48	281	0.5356000000000001
Piggy Princess	2016-03-19	1181	27	22	1203	0.5353
Space Hulk: Deathwing	2016-12-14	11499	3045	2615	14114	0.5352
Super Space Pug	2016-06-04	5197	151	127	5324	0.5352
Max Stern	2016-10-21	233	21	17	250	0.5352
Shotgun Raiders	2016-09-16	335	15	12	347	0.5352
Hidden Object - 12 in 1 bundle	2016-09-01	44	79	66	110	0.5347999999999999
Kalaban	2016-12-29	208	40	33	241	0.5347999999999999
War Birds: WW2 Air strike 1942	2016-03-18	241	34	28	269	0.5345000000000001
The Black Death	2016-04-19	614	1188	1020	1634	0.5343
Hide & Hold Out - H2o	2016-04-09	540	345	294	834	0.5342
No Turning Back: The Pixel Art Action-Adventure Roguelike	2016-01-15	1151	128	108	1259	0.5342
Terminal Hacker	2016-12-02	649	88	74	723	0.5339
Madness	2016-11-22	1023	48	40	1063	0.5337
Dead Stop	2016-02-29	5	4	3	8	0.5332
DSS	2016-04-12	5	4	3	8	0.5332
Parasite	2016-01-19	4	4	3	7	0.5332
Atriage	2016-04-07	167	4	3	170	0.5332
BowMage	2016-09-26	3	4	3	6	0.5332
A Verdant Hue	2016-07-26	18	4	3	21	0.5332
Maraiyum: Rise of the Setting Sun	2016-08-25	5	4	3	8	0.5332
Hover Havoc	2016-07-28	18	4	3	21	0.5332
Carpe Deal 'Em	2016-11-28	3	4	3	6	0.5332
Archer Guardian VR : The Chapter Zero	2016-11-18	4	4	3	7	0.5332
Infestation: The New Z	2016-11-22	14437	17823	15541	29978	0.5327000000000001
Cogs and Cowboys	2016-08-10	7	10	8	15	0.5327000000000001
World of Golf	2016-12-06	7	10	8	15	0.5327000000000001
Potioneer: The VR Gardening Simulator	2016-10-21	3	10	8	11	0.5327000000000001
NBA 2K17	2016-09-20	14905	4726	4113	19018	0.5324
Arctic alive	2016-01-29	10	30	25	35	0.5319
Germ Wars	2016-11-21	2595	117	100	2695	0.5314
Ohr	2016-12-02	199	17	14	213	0.5313
Wild Romance	2016-10-19	206	67	57	263	0.5309
Contract	2016-01-05	13	31	26	39	0.5309
Caravanserail	2016-03-10	940	31	26	966	0.5309
NASCAR Heat Evolution	2016-09-12	114	166	143	257	0.5306000000000001
Army of Tentacles: (Not) A Cthulhu Dating Sim	2016-02-15	2812	46	39	2851	0.5304
Liveza: Death of the Earth	2016-05-03	1607	84	72	1679	0.5301
Captivity	2016-10-20	2424	54	46	2470	0.53
Winning Post 8 2016	2016-02-19	1646	11	9	1655	0.53
Tank Hero VR	2016-08-25	4	11	9	13	0.53
Pinball Parlor	2016-12-24	6	11	9	15	0.53
Bowling at the Lake	2016-12-08	9	11	9	18	0.53
Tower Dwellers	2016-08-23	41	18	15	56	0.5297
Airstrike HD	2016-03-23	4899	205	178	5077	0.5294
reconquest	2016-12-17	46	134	116	162	0.5292
Trench Run	2016-04-07	219	48	41	260	0.5292
InfinitasDM	2016-11-29	13	26	22	35	0.5288
The Next Door	2016-03-22	4460	435	381	4841	0.5287
OddPlanet	2016-05-11	9	81	70	79	0.5284000000000001
Shonen Idle Z	2016-07-22	1287	285	250	1537	0.5278
Drusilla Dreams	2016-04-22	3	27	23	26	0.5278
Police Quest - SWAT	2016-12-15	9	27	23	32	0.5278
Shepherds of the Abyss	2016-11-18	7	12	10	17	0.5278
Deep Below	2016-09-23	7	12	10	17	0.5278
Defend Felinearth	2016-06-10	10	5	4	14	0.5278
bloxyz	2016-05-20	3	5	4	7	0.5278
Lectrovolt II	2016-08-23	2	5	4	6	0.5278
Zia and the goddesses of magic	2016-09-26	3	5	4	7	0.5278
Princess Kidnapper VR	2016-11-18	3	5	4	7	0.5278
TransOcean 2: Rivals	2016-05-10	990	331	291	1281	0.5275
Hacker Evolution IMMERSION	2016-07-29	4	20	17	21	0.527
Stratus: Battle for the Sky	2016-12-03	8	20	17	25	0.527
Twisted Worlds	2016-06-17	82	69	60	142	0.5268
Cloney	2016-01-20	42	140	123	165	0.5263
Zombies on a Plane	2016-03-26	1242	141	124	1366	0.5261
Ancient VR coaster	2016-07-04	4	13	11	15	0.5259
The Dungeons of Castle Madness	2016-08-08	49	13	11	60	0.5259
Preston Sterling	2016-08-19	5	13	11	16	0.5259
Colt Express	2016-11-17	38	55	48	86	0.5256000000000001
Burst	2016-03-15	1511	22	19	1530	0.5246999999999999
ALONE IN SPACE	2016-02-23	20	85	75	95	0.5245000000000001
Radical Spectrum: Volume 1	2016-07-08	4218	58	51	4269	0.5243
Ridge	2016-07-07	1307	14	12	1319	0.5242
Boxing Saga	2016-10-21	4	14	12	16	0.5242
Dinocide	2016-01-21	204	115	102	306	0.524
Grid Masters	2016-06-01	3	6	5	8	0.5239
WarBirds Dawn of Aces, World War I Air Combat	2016-07-20	5	6	5	10	0.5239
Tribe Of Pok	2016-08-23	10	6	5	15	0.5239
Publisher Tycoon	2016-11-29	3	6	5	8	0.5239
VR Snowballs	2016-12-30	3	6	5	8	0.5239
H1Z1: Test Server	2016-02-24	8554	1326	1194	9748	0.5236999999999999
Marvel: Ultimate Alliance 2	2016-07-26	139	187	167	306	0.5234000000000001
Helmet Heroes	2016-10-03	319	483	434	753	0.5233
Solitaire Royale	2016-09-16	10	24	21	31	0.5228
Dream Catcher Chronicles: Manitou	2016-02-11	6	15	13	19	0.5228
Dream Dealer	2016-10-01	3175	112	100	3275	0.5227
Happy Empire	2016-08-19	6	34	30	36	0.5224
Rumble Fighter: Unleashed	2016-12-16	37	190	171	208	0.5218
Avalon Lords: Dawn Rises	2016-04-28	38	75	67	105	0.5218
Blue Tear	2016-12-16	20	45	40	60	0.5217
Stealth Labyrinth	2016-04-29	37	16	14	51	0.5215
A Land Fit For Heroes	2016-05-04	8	16	14	22	0.5215
Starry Nights : Helix	2016-11-23	81	16	14	95	0.5215
Silver Knight	2016-01-15	1460	46	41	1501	0.5213
The Sun Will Rise	2016-10-04	17	36	32	49	0.5212
Eisenhorn: XENOS	2016-08-09	93	153	138	231	0.5211
Culina: Hands in the Kitchen	2016-11-12	14	7	6	20	0.5211
Geek Resort	2016-01-20	8	7	6	14	0.5211
Worlds of Chaos: Invasion	2016-02-10	3	7	6	9	0.5211
End Of The Mine	2016-10-29	7	7	6	13	0.5211
One Way Flight	2016-04-22	8	7	6	14	0.5211
Escargot Kart	2016-06-17	16	7	6	22	0.5211
Veilia	2016-08-23	64	7	6	70	0.5211
Congresswolf	2016-10-28	25	7	6	31	0.5211
Soldier Sortie: VR Agent 006	2016-12-16	5	7	6	11	0.5211
Story of a Cube	2016-03-04	951	17	15	966	0.5203
Let's Draw	2016-12-31	1540	324	295	1835	0.52
Space Rangers: Quest	2016-09-05	74	49	44	118	0.52
RPG Tycoon	2016-02-12	131	257	234	365	0.5197999999999999
Wars of Napoleon	2016-05-06	55	51	46	101	0.5193
MechaGore	2016-06-15	7	18	16	23	0.5193
Funklift	2016-06-08	28	8	7	35	0.5189
e-River Cabin Journal	2016-07-15	19	31	28	47	0.518
Sparkle ZERO	2016-03-14	361	169	155	516	0.5178
Astral Breakers	2016-02-04	76	9	8	84	0.5171
Miko Mole	2016-05-25	35	9	8	43	0.5171
The Ember Saga: A New Fire	2016-08-27	2049	9	8	2057	0.5171
Sanctuary VR	2016-12-18	331	9	8	339	0.5171
OnTheFrontLine	2016-10-20	1095	21	19	1114	0.5168
Aiball	2016-06-22	1174	75	69	1243	0.5162
Space Trucker	2016-11-23	169	22	20	189	0.5161
Ares Omega	2016-03-11	4653	10	9	4662	0.5156000000000001
Roadworks - The Simulation	2016-11-30	4	10	9	13	0.5156000000000001
Door To Door	2016-08-02	547	23	21	568	0.5155
Xemo : Robot Sim	2016-11-22	19	23	21	40	0.5155
Star Fight	2016-11-11	791	23	21	812	0.5155
Mountain Trap: The Manor of Memories	2016-12-13	100	37	34	134	0.5153
Fastigium	2016-12-19	11	24	22	33	0.5149
Pro Basketball Manager 2016	2016-01-14	51	39	36	87	0.5146000000000001
Villagers	2016-03-25	276	163	152	428	0.5144
The Daring Mermaid Expedition	2016-02-12	25	11	10	35	0.5144
Galaxy Combat Wargames	2016-09-29	11	11	10	21	0.5144
4Team	2016-12-13	103	11	10	113	0.5144
Hyposphere	2016-05-05	2120	101	94	2214	0.5143
Swiftly	2016-01-26	1335	70	65	1400	0.5143
BloodGate	2016-06-02	146	186	174	320	0.5138
Paintball 707	2016-11-30	10	27	25	35	0.5134000000000001
TrumPiñata	2016-07-22	4	12	11	15	0.5134000000000001
My Butler	2016-08-15	22	43	40	62	0.5133
Lion Quest	2016-07-11	197	28	26	223	0.513
Insane Decay of Mind: The Labyrinth	2016-05-06	77	28	26	103	0.513
Space Beret	2016-10-25	5640	339	320	5960	0.5124000000000001
Eisenwald: Blood of November	2016-11-01	194	83	78	272	0.5122
Let's Sing 2016	2016-01-21	9	30	28	37	0.5122
Blind Trust	2016-05-27	162	743	705	867	0.5117
Kivi, Toilet and Shotgun	2016-01-15	8871	252	239	9110	0.5112
Samphi	2016-03-18	45	15	14	59	0.511
Master of Orion 3	2016-02-25	91	73	69	160	0.5109
Grey Phobia	2016-08-23	34	34	32	66	0.5109
Sniper Tactical	2016-01-08	8	16	15	23	0.5104
Sweet Candy Mahjong	2016-09-30	75	36	34	109	0.5103
Plith	2016-06-02	258	17	16	274	0.5099
Blasting Agent: Ultimate Edition	2016-08-18	125	18	17	142	0.5094
The Battle for Sector 219	2016-06-02	193	18	17	210	0.5094
Campfire: One of Us Is the Killer	2016-12-07	2311	41	39	2350	0.5092
Redemption: Saints And Sinners	2016-11-18	2580	137	131	2711	0.5091
Smoots World Cup Tennis	2016-06-01	64	19	18	82	0.509
Piñata	2016-09-01	14	21	20	34	0.5082
Farm Life: Natures Adventure	2016-08-23	1428	21	20	1448	0.5082
Clash of the Monsters	2016-04-14	26	186	179	205	0.508
Mahjong Deluxe 2: Astral Planes	2016-07-20	124	48	46	170	0.5079
Just Hero	2016-09-28	1591	162	156	1747	0.5078
ShapeShifter	2016-07-07	2915	78	75	2990	0.5077
Relaxation balls	2016-11-08	1376	51	49	1425	0.5075000000000001
Twisty's Asylum Escapades	2016-09-28	641	24	23	664	0.5073
Adventures Of Fluzz	2016-09-03	10	24	23	33	0.5073
Earth Space Colonies	2016-07-01	60	83	80	140	0.5072
The East New World	2016-04-27	26	25	24	50	0.5071
Fiery Disaster	2016-11-07	724	25	24	748	0.5071
Destiny of Ancient Kingdoms™	2016-08-30	397	88	85	482	0.5068
Krinkle Krusher	2016-08-04	4	26	25	29	0.5068
Funfair Ride Simulator 3	2016-08-05	527	59	57	584	0.5065999999999999
Everest VR	2016-08-02	86	160	155	241	0.5065
3D Pool	2016-06-17	7	28	27	34	0.5064
Badiya	2016-11-11	38	166	161	199	0.5063000000000001
Unclaimed World	2016-10-04	96	98	95	191	0.5062
Draw Slasher	2016-10-13	1967	420	412	2379	0.5042
Maui	2016-04-26	43	192	189	232	0.5033
Beastiarium	2016-12-05	743	60	59	802	0.5032
Surgeon Simulator: Experience Reality	2016-12-05	61	422	416	477	0.5031
Renoir	2016-11-16	31	63	62	93	0.5031
Fabulous Food Truck	2016-07-21	107	65	64	171	0.503
Music Wars Empire	2016-06-02	25	75	74	99	0.5025999999999999
PulseCharge	2016-01-27	4933	82	81	5014	0.5024000000000001
Citalis	2016-11-03	2331	108	107	2438	0.5019
Game Tycoon 2	2016-04-08	969	124	123	1092	0.5015999999999999
Victory: The Age of Racing	2016-02-12	659	654	650	1309	0.5014000000000001
Lucent Heart	2016-02-11	188	164	164	352	0.5
Wheels of Aurelia	2016-09-20	24	84	84	108	0.5
Wartune	2016-08-15	337	50	50	387	0.5
Fighters Unleashed	2016-12-27	1640	43	43	1683	0.5
Visitors	2016-08-30	5	37	37	42	0.5
Driftwood The Visual Novel	2016-08-08	18	35	35	53	0.5
Close Order	2016-01-21	349	34	34	383	0.5
Demesne	2016-03-12	7	33	33	40	0.5
Eclipse --- Defending the motherland	2016-05-27	21	24	24	45	0.5
Warmada	2016-11-08	15	24	24	39	0.5
Sunken	2016-05-26	11	22	22	33	0.5
Mystic Diary - Quest for Lost Brother	2016-12-08	711	21	21	732	0.5
Footbrawl Playground	2016-09-01	16	21	21	37	0.5
Dropship Down	2016-07-21	9	20	20	29	0.5
Vistascapes VR	2016-07-08	6	18	18	24	0.5
Revolution : Virtual Playspace	2016-10-05	9	17	17	26	0.5
Dragon Fantasy: The Black Tome of Ice	2016-05-26	23	16	16	39	0.5
Ahros: One warrior chronicle	2016-09-29	8	15	15	23	0.5
MechRunner	2016-07-15	23	11	11	34	0.5
C O S M	2016-08-04	4	11	11	15	0.5
Gravity Compass	2016-05-10	4	9	9	13	0.5
VRNinja	2016-09-14	117	9	9	126	0.5
TEOT - The End OF Tomorrow	2016-09-30	2	9	9	11	0.5
PlayFortress	2016-12-07	3	8	8	11	0.5
Doodle WHAT?!	2016-08-03	10	8	8	18	0.5
CoLab	2016-12-15	3	8	8	11	0.5
MagixHome VR	2016-11-04	4	8	8	12	0.5
State of Extinction - Early Access	2016-11-30	4	7	7	11	0.5
Depths of Dread	2016-07-12	13	7	7	20	0.5
What Would You Do?	2016-10-03	2	7	7	9	0.5
Ziggy's Chase	2016-12-29	1731	7	7	1738	0.5
Falcon A.T.	2016-01-08	2	6	6	8	0.5
Revolt	2016-01-26	3	6	6	9	0.5
VR Ultimate Paintball: Heartbreak, Regret & Paintbots	2016-08-09	4	6	6	10	0.5
Beyond Power VR	2016-09-30	4	6	6	10	0.5
Warpin: Creation (VR)	2016-11-02	4	6	6	10	0.5
Magic Tavern	2016-11-23	2	6	6	8	0.5
Cologne	2016-03-10	10	5	5	15	0.5
Ironguard	2016-10-14	5	5	5	10	0.5
Always Higher	2016-07-21	3	5	5	8	0.5
Maximum Archery The Game	2016-10-15	9	5	5	14	0.5
The Cube Hotel（Ning's Wing 2）	2016-09-23	4	5	5	9	0.5
Pirate Defense	2016-11-11	12	5	5	17	0.5
Retaliation: Enemy Mine	2016-01-22	4	4	4	8	0.5
The HinterLands	2016-05-27	4	4	4	8	0.5
Cross Death VR	2016-07-28	3	4	4	7	0.5
Galaxy of Trian Board Game	2016-10-18	68	4	4	72	0.5
Moonlit Mayhem	2016-10-05	100	4	4	104	0.5
Demon Hunter	2016-09-30	4	4	4	8	0.5
Crumbled World	2016-12-01	4	4	4	8	0.5
Void & Nothingness	2016-12-03	2	4	4	6	0.5
Swingin Swiggins	2016-12-16	40	4	4	44	0.5
Work VR Shop	2016-12-08	3	4	4	7	0.5
Stellar Stars	2016-11-10	4	3	3	7	0.5
Dolphin Defense	2016-05-17	2	3	3	5	0.5
10 Minute Tower	2016-07-26	3	3	3	6	0.5
9Grids VR	2016-09-12	2	3	3	5	0.5
Colony	2016-11-30	2	3	3	5	0.5
Tank Defense Division	2016-09-09	5	3	3	8	0.5
WackyMoles	2016-12-12	4	3	3	7	0.5
Pitchfork	2016-09-30	2	3	3	5	0.5
Singing Stones VR	2016-12-16	3	3	3	6	0.5
Fallen Temple	2016-04-06	2	2	2	4	0.5
Tormented 12	2016-07-07	4	2	2	6	0.5
Philia : the Sequel to Elansar	2016-01-12	2	2	2	4	0.5
Zipple World 2: The Sweet Chaos	2016-05-17	2	2	2	4	0.5
The Last	2016-08-18	2	2	2	4	0.5
Chaos Of Hearts	2016-09-16	4	2	2	6	0.5
Very Real Chess	2016-11-12	2	2	2	4	0.5
Thunder Spheres	2016-12-09	2	2	2	4	0.5
New Outbreak	2016-08-22	2	1	1	3	0.5
Shift Orb	2016-11-01	2	1	1	3	0.5
Taxi	2016-10-07	2	1	1	3	0.5
My Own Pet	2016-07-20	1	1	1	2	0.5
50 Years	2016-08-27	2	1	1	3	0.5
Elves vs Goblins Defender	2016-10-27	4	1	1	5	0.5
Isomorph	2016-09-02	2	1	1	3	0.5
Teratini VR	2016-12-21	2	1	1	3	0.5
0 Day	2016-11-16	2	1	1	3	0.5
STAR KINGDOM : The Elements	2016-12-07	1	1	1	2	0.5
Head Shot	2016-06-03	4255	866	868	5123	0.49950000000000006
Pro Gamer Manager	2016-04-28	484	346	347	831	0.4994
Mighty No. 9	2016-06-21	1556	1566	1572	3128	0.4991
Insincere	2016-05-12	5281	126	127	5408	0.49840000000000007
Warhammer 40,000: Eternal Crusade	2016-09-23	5230	6285	6341	11571	0.4979
Oil Enterprise	2016-04-20	115	88	89	204	0.4978
Warriors of Vilvatikta	2016-08-26	5550	73	74	5624	0.4974
Knight Online	2016-01-25	24594	5075	5149	29743	0.4966
Drayt Empire	2016-07-16	2805	119	121	2926	0.4966
Dangerous Relationship	2016-08-24	15	39	40	55	0.4954
Forgotten Myths CCG	2016-03-21	58	38	39	97	0.4953
Moonstone Tavern	2016-05-13	765	67	69	834	0.4943
Trucker	2016-10-21	187	29	30	217	0.494
Pandum online	2016-09-16	24	29	30	54	0.494
Astro Lords: Oort Cloud	2016-01-15	43	27	28	71	0.4936
Miniature - The Story Puzzle	2016-10-28	4	27	28	32	0.4936
Brazed	2016-12-16	96	24	25	121	0.4929
Jumpix Jump	2016-02-15	5	21	22	27	0.49210000000000004
Blue Sheep	2016-03-31	117	20	21	138	0.4918
Forbidden Planet	2016-01-11	4406	146	152	4558	0.4917
PhysDrive	2016-11-15	2052	64	67	2119	0.49119999999999997
Champions of Anteria	2016-08-30	193	77	81	274	0.4901
Sapper's bad dream	2016-07-08	647	15	16	663	0.48960000000000004
The Journey Home	2016-08-22	32	15	16	48	0.48960000000000004
Rescue Love Revenge	2016-10-28	10	32	34	44	0.4891
Massive Cleavage vs Zombies: Awesome Edition	2016-07-08	324	87	92	416	0.489
Wooden Floor 2 - Resurrection	2016-01-11	904	31	33	937	0.4888
The Race for the White House 2016	2016-09-08	9	13	14	23	0.4883
D.N.Age	2016-07-29	97	29	31	128	0.4882
JDM Tuner Racing	2016-06-07	7970	184	195	8165	0.4879
Dark Eden	2016-11-29	143	126	134	277	0.4875
The Sea Eternal	2016-04-22	40	12	13	53	0.4875
Erusal	2016-08-11	2	12	13	15	0.4875
Heroes of Shadow Guard	2016-08-03	47	27	29	76	0.48740000000000006
Mortos	2016-11-14	1446	42	45	1491	0.4872
Mini Golf Mundo	2016-05-10	98	72	77	175	0.4869
Project Genom	2016-10-12	1223	912	968	2191	0.4866
In Fear I Trust	2016-09-22	8	24	26	34	0.48610000000000003
Hardware Engineering	2016-09-29	76	94	101	177	0.4857
Primal Carnage: Onslaught	2016-12-30	5	10	11	16	0.48560000000000003
Fantasy Kingdom Simulator	2016-06-13	1737	62	67	1804	0.4851
Apokalypsis	2016-11-07	2113	22	24	2137	0.4851
The Lost Souls	2016-04-11	1048	86	93	1141	0.48450000000000004
Cyber Chicken	2016-11-23	15	9	10	25	0.4844
VIOLET: Space Mission	2016-01-20	3	9	10	13	0.4844
Airship Asunder	2016-07-21	20	9	10	30	0.4844
Derelict	2016-07-23	11	9	10	21	0.4844
Of Love And Sorrow	2016-08-08	17	9	10	27	0.4844
Best in Show Solitaire	2016-10-06	10	9	10	20	0.4844
Iron Madness	2016-03-02	19	45	49	68	0.4841
Combat Air Patrol 2	2016-06-06	81	148	160	241	0.484
BuriedTown	2016-01-22	11	20	22	33	0.4839
Safety Driving Simulator: Car	2016-05-04	6	30	33	39	0.483
Shiny	2016-08-31	16	30	33	49	0.483
Tactical Craft Online	2016-02-13	345	557	602	947	0.4829
New Yankee in King Arthur's Court 2	2016-08-26	5	8	9	14	0.4829
Rail Adventures - VR Tech Demo	2016-08-25	7	18	20	27	0.48240000000000005
E.T. Armies	2016-03-03	27	142	155	182	0.48210000000000003
MINUS ZERO	2016-06-16	7	7	8	15	0.4811
The Stargazers	2016-11-04	5	7	8	13	0.4811
Wondership Q	2016-07-19	9	7	8	17	0.4811
The Wizard's Lair	2016-08-03	2034	7	8	2042	0.4811
MANIC MINERS	2016-08-09	331	7	8	339	0.4811
Dangerous Golf	2016-06-02	121	301	329	450	0.48100000000000004
Book of Merlin	2016-07-23	7	16	18	25	0.4807
Town of Night	2016-11-17	1997	64	71	2068	0.48
Campaign Clicker	2016-10-05	548	188	207	755	0.47990000000000005
Nokori	2016-03-25	644	24	27	671	0.47950000000000004
Drawn: Dark Flight	2016-01-20	21	6	7	28	0.4789
Izeriya	2016-04-28	8	6	7	15	0.4789
ColecoVision Flashback	2016-10-07	3	6	7	10	0.4789
Constricting Cubes	2016-11-07	2	6	7	9	0.4789
Breaking Bones	2016-11-28	3	6	7	10	0.4789
Escape This	2016-05-05	1755	284	314	2069	0.4786
Russian SuperHero Dead Ivan	2016-10-19	1842	115	128	1970	0.47840000000000005
Autumn Dream	2016-11-05	1644	94	105	1749	0.478
PHAT STACKS	2016-11-29	1080	94	105	1185	0.478
Chess Knight 2	2016-09-12	140	65	73	213	0.47759999999999997
$1 Ride	2016-07-28	3941	413	458	4399	0.47750000000000004
Battle Forever	2016-06-11	190	13	15	205	0.4772
Slingshot people	2016-10-21	3153	643	713	3866	0.4771
Assault on Arnhem	2016-03-11	55	29	33	88	0.47700000000000004
Bierzerkers	2016-02-25	374	248	277	651	0.47659999999999997
Adventure World	2016-08-02	140	28	32	172	0.47630000000000006
Aztecalypse	2016-11-11	2125	28	32	2157	0.47630000000000006
Ghostbusters	2016-07-12	19	20	23	42	0.47630000000000006
Plant Fire Department - The Simulation	2016-08-29	9	20	23	32	0.47630000000000006
Wanted Corp.	2016-12-08	5	5	6	11	0.4761
Megalo Polis	2016-11-01	6	5	6	12	0.4761
CitiesCorp Concept - Build Everything on Your Own	2016-04-29	4	5	6	10	0.4761
Bridge to Nowhere	2016-10-04	6	5	6	12	0.4761
City Z	2016-04-29	920	12	14	934	0.4758
Minigolf VR	2016-03-30	4	12	14	18	0.4758
Zipple World	2016-01-19	88	12	14	102	0.4758
One Tower	2016-11-10	35	43	49	84	0.4757
Spaera	2016-09-13	48	58	66	114	0.4753
Journey to the Center of the Earth	2016-07-22	17	19	22	39	0.4753
DreamBreak	2016-07-21	318	48	55	373	0.4744
Thick Air	2016-09-16	5	11	13	18	0.47409999999999997
Sandstorm	2016-11-13	3082	11	13	3095	0.47409999999999997
Fire With Fire: Online Tower Attack and Defense	2016-03-29	59	108	123	182	0.47380000000000005
Office lovers	2016-08-08	22	53	61	83	0.4733
Perfect	2016-12-16	17	30	35	52	0.47240000000000004
Star Chart	2016-09-05	9	10	12	21	0.4722
Unnamed Fiasco	2016-08-17	157	4	5	162	0.4722
Coffee Pot Terrarium	2016-06-01	2	4	5	7	0.4722
The Caretaker	2016-10-10	14	4	5	19	0.4722
Primitive Road	2016-11-18	2	4	5	7	0.4722
Isyium	2016-12-13	327	4	5	332	0.4722
Grimm: Dark Legacy	2016-11-02	89	36	42	131	0.4719
The Other 99	2016-08-25	19	42	49	68	0.47140000000000004
Whiplash - Crash Valley	2016-12-07	181	111	128	309	0.47130000000000005
Alteil: Horizons	2016-10-27	81	47	55	136	0.4705
Bayla Bunny	2016-06-13	124	60	70	194	0.4704
Day of the Trumplings	2016-09-03	3	9	11	14	0.47000000000000003
Star Drifter	2016-06-01	2932	91	106	3038	0.4697
Mistfal	2016-07-07	82	26	31	113	0.46909999999999996
Evolution	2016-06-06	62	38	45	107	0.46890000000000004
One Dark Night	2016-12-15	5	44	52	57	0.46880000000000005
Sword 'N' Board	2016-01-29	5	14	17	22	0.4687
Exteria	2016-10-26	113	14	17	130	0.4687
Bad birthday	2016-11-11	1621	14	17	1638	0.4687
Where's My What?	2016-09-27	902	55	65	967	0.4682
Plan Z Chapter 1	2016-06-06	3	8	10	13	0.4673
Legend of Miro	2016-08-22	29	24	29	58	0.467
Nightork Adventures - Beyond the Moons of Shadalee	2016-08-23	491	24	29	520	0.467
Occurrence at JCR Outpost	2016-07-18	2	3	4	6	0.4668
Tower Island: Explore, Discover and Disassemble	2016-07-27	3	3	4	7	0.4668
Fairy Maids	2016-07-19	3	3	4	7	0.4668
Birdtual Reality	2016-08-23	4	3	4	8	0.4668
Anguished	2016-11-02	3	3	4	7	0.4668
Heavy Impact	2016-12-21	2	3	4	6	0.4668
The Dolls	2016-05-25	476	127	150	626	0.4661
Overfall	2016-05-17	195	398	467	662	0.46530000000000005
SweatShop	2016-07-22	1694	194	229	1923	0.46530000000000005
Star Fields	2016-08-06	2802	59	71	2873	0.4645
Off-Road Super Racing	2016-12-23	24	37	45	69	0.46409999999999996
Mini Z Racers Turbo	2016-09-06	102	7	9	111	0.46409999999999996
Rainbow Rage Squad	2016-11-08	4	7	9	13	0.46409999999999996
Farm Expert 2017	2016-09-01	234	314	372	606	0.4636
Chunks	2016-04-11	12	21	26	38	0.46340000000000003
Mind Zero	2016-03-08	35	41	50	85	0.4632
Neon Hardcorps	2016-05-30	5886	129	155	6041	0.4626
DAMAGE CONTROL	2016-04-06	198	11	14	212	0.4625
Momonga Pinball Adventures	2016-09-16	37	20	25	62	0.462
Dungeons & Robots	2016-02-29	76	74	90	166	0.4617
I Want To Be Human	2016-04-15	89	34	42	131	0.46159999999999995
Gary the Gull	2016-11-22	6	15	19	25	0.46130000000000004
Shadow Heroes: Vengeance In Flames	2016-11-22	86	6	8	94	0.46020000000000005
Salvaged	2016-11-17	4	6	8	12	0.46020000000000005
The Journey VR	2016-11-01	4	6	8	12	0.46020000000000005
Just Death	2016-02-24	23	14	18	41	0.4593
Dead6hot	2016-02-01	8612	215	261	8873	0.45920000000000005
Full Tilt Poker	2016-01-26	114	40	50	164	0.4587
Puzzle Sages	2016-01-18	3	2	3	6	0.4583
Glory Kingdom	2016-02-19	3	2	3	6	0.4583
Rocket Shooter	2016-03-31	3	2	3	6	0.4583
Push The Crate	2016-07-12	3	2	3	6	0.4583
Wildlife VR	2016-07-16	2	2	3	5	0.4583
Going Up	2016-08-02	2	2	3	5	0.4583
Tank Tread	2016-09-05	4	2	3	7	0.4583
Icity	2016-10-19	3	2	3	6	0.4583
Remind Yourself	2016-10-19	2	2	3	5	0.4583
Sphere Complex	2016-11-18	4	2	3	7	0.4583
Mystic Defense	2016-11-23	3	2	3	6	0.4583
Candy Island	2016-11-28	1	2	3	4	0.4583
Hyper color ball	2016-09-02	2368	140	172	2540	0.45780000000000004
J.U.R : Japan Underground Racing	2016-08-17	7344	70	87	7431	0.45770000000000005
Heart and Seoul	2016-11-01	857	38	48	905	0.457
Safety Driving Simulator: Motorbike	2016-05-04	3	13	17	20	0.457
Doodle Kingdom	2016-06-09	1769	82	102	1871	0.4569
Agenda	2016-09-21	41	21	27	68	0.4569
Dynamic	2016-11-11	3669	55	69	3738	0.45670000000000005
Pinga Ponga	2016-08-02	683	25	32	715	0.45670000000000005
Pandora`s room	2016-03-29	3	9	12	15	0.45670000000000005
Shot Shot Tactic	2016-12-01	2006	203	250	2256	0.45630000000000004
MetaTron	2016-12-19	446	49	62	508	0.4556
Flag N Frag	2016-04-29	49	5	7	56	0.45520000000000005
Stars Simulation	2016-09-09	1753	5	7	1760	0.45520000000000005
MegaRats	2016-11-04	3	5	7	10	0.45520000000000005
PIRATADO 1	2016-10-18	1	5	7	8	0.45520000000000005
The Fleets of Sol	2016-04-01	12	16	21	33	0.455
AsteroidsHD	2016-03-05	8	12	16	24	0.4545
Lup	2016-04-01	8364	158	197	8561	0.45439999999999997
Zombie Playground™	2016-10-31	901	149	186	1087	0.45439999999999997
Mahsung Deluxe	2016-10-17	1074	31	40	1114	0.45409999999999995
Poly Towns	2016-04-22	12	19	25	37	0.4535
Cavernus	2016-07-05	3	8	11	14	0.45310000000000006
Super Puzzle Sisters	2016-10-17	8	8	11	19	0.45310000000000006
R.B.I. Baseball 16	2016-03-29	29	45	58	87	0.4525
Rule Your School	2016-12-16	11	37	48	59	0.4522
Merger 3D	2016-09-29	8051	87	111	8162	0.45170000000000005
Inside: Before Birth	2016-02-12	14	18	24	38	0.4516
Space Survival	2016-06-22	1663	36	47	1710	0.4512
Endica VII The Dream King	2016-01-13	10	25	33	43	0.4512
Cat Simulator	2016-02-13	150	156	198	348	0.4508
It Comes Around - A Kinetic Novel	2016-09-29	1046	14	19	1065	0.4504
Maze Sounds	2016-10-01	6	14	19	25	0.4504
Balloon Blowout	2016-10-28	140	57	74	214	0.45
Phantasmal	2016-04-14	18	141	180	198	0.4499
Zombie Pinball	2016-06-21	49	24	32	81	0.4497
Atomic Space Command	2016-10-13	12	7	10	22	0.4487
Insane	2016-03-31	5	7	10	15	0.4487
Habitus	2016-01-29	3	4	6	9	0.4486
FriendShip	2016-12-16	4	4	6	10	0.4486
Bus Tycoon ND (Night and Day)	2016-09-23	8	10	14	22	0.4483
Noob Squad	2016-10-05	359	215	276	635	0.4475
Rise of the Ancients	2016-05-31	1567	135	175	1742	0.44689999999999996
BattleStick	2016-05-07	203	356	456	659	0.4466
The Hidden Dragon	2016-07-27	91	42	56	147	0.4465
Rabiez: Epidemic	2016-03-04	13814	90	118	13932	0.4462
The Sandbox Evolution	2016-11-15	83	607	777	860	0.4455
Girl Amazon Survival	2016-08-17	1625	101	133	1758	0.4448
IWO: Bloodbath in the Bonins	2016-05-19	28	12	17	45	0.4448
Firefighters - The Simulation	2016-08-31	11	37	50	61	0.4447
Clockwork Empires	2016-10-26	255	347	449	704	0.44450000000000006
Near Midnight	2016-10-13	4	21	29	33	0.44450000000000006
The Slingshot VR	2016-07-06	3	9	13	16	0.44450000000000006
Click Space Miner	2016-08-18	2	9	13	15	0.44450000000000006
The Rebel	2016-07-16	2	24	33	35	0.44430000000000003
AMOK	2016-03-22	1470	86	114	1584	0.44420000000000004
Multimirror	2016-11-15	1333	56	75	1408	0.44420000000000004
SpellKnights	2016-07-13	26	33	45	71	0.4437
Alien Invasion Tower Defense	2016-10-27	4	6	9	13	0.4434
Santa Sling	2016-12-20	7	6	9	16	0.4434
Bubble Blowout	2016-10-24	850	58	78	928	0.44320000000000004
6 Nights	2016-09-08	2	1	2	4	0.44310000000000005
Let's Eat! Seaside Cafe	2016-02-27	5	1	2	7	0.44310000000000005
King Machine	2016-11-02	1	1	2	3	0.44310000000000005
Grave Matters	2016-10-28	2	1	2	4	0.44310000000000005
The Secret of Middle City	2016-11-29	2	1	2	4	0.44310000000000005
Shatter Quest	2016-10-11	1	1	2	3	0.44310000000000005
TURGUL: RAPID FIGHTING	2016-12-20	18	1	2	20	0.44310000000000005
Weird creatures	2016-12-23	1	1	2	3	0.44310000000000005
Our Darkest Night	2016-12-15	2	1	2	4	0.44310000000000005
Danger Room	2016-12-23	2	1	2	4	0.44310000000000005
Wild Game Hunter VR	2016-12-23	3	1	2	5	0.44310000000000005
WipeOut	2016-12-15	2	1	2	4	0.44310000000000005
Smoots Tennis Survival Zombie	2016-12-20	1	1	2	3	0.44310000000000005
Aegis	2016-10-06	488	20	28	516	0.4425
Sinful Eden	2016-05-09	28	14	20	48	0.44200000000000006
Draft Day Sports: Pro Basketball 2017	2016-11-18	26	11	16	42	0.4414
Yore VR	2016-10-25	13	68	92	105	0.4412
'n Verlore Verstand	2016-04-05	2553	49	67	2620	0.44090000000000007
Slime & Friends	2016-03-25	1921	25	35	1956	0.44079999999999997
bit Dungeon+	2016-03-22	21	82	111	132	0.4403
The Space Garden	2016-10-03	227	19	27	254	0.4403
Dyno Adventure	2016-09-26	681	8	12	693	0.44
Dawn of Warriors	2016-10-20	22	8	12	34	0.44
Invasion: Brain Craving	2016-06-22	6446	131	176	6622	0.43979999999999997
Benji Challenges	2016-03-24	3	3	5	8	0.43950000000000006
StarForce: 2193	2016-08-16	4	3	5	9	0.43950000000000006
No1Left	2016-02-19	4	3	5	9	0.43950000000000006
World Of Undead	2016-07-22	4	3	5	9	0.43950000000000006
Beat Ninja	2016-07-13	3	3	5	8	0.43950000000000006
Kuraburo Kai	2016-08-15	23	3	5	28	0.43950000000000006
Airship Commander	2016-10-07	2	3	5	7	0.43950000000000006
Deathwave	2016-06-09	153	13	19	172	0.439
Magdalena	2016-02-22	2459	124	168	2627	0.43829999999999997
Theme Park Studio	2016-12-02	175	201	270	445	0.43820000000000003
Evertown	2016-01-11	18	46	64	82	0.438
Rhino's Rage	2016-03-04	1276	43	60	1336	0.4379
Make America Great Again	2016-09-16	8	26	37	45	0.43770000000000003
Defenders of the Last Colony	2016-06-23	4	10	15	19	0.4375
Super Kitty Boing Boing	2016-03-04	120	10	15	135	0.4375
Haunted Hotel	2016-10-21	3	5	8	11	0.4368
Fatal Gem VR(The First Match-3 VR Game)	2016-11-24	3	5	8	11	0.4368
Hospitalize	2016-09-21	39	70	97	136	0.4364
Drift King: Survival	2016-11-24	11	28	40	51	0.4364
Hide and Secret Treasure of the Ages	2016-06-17	150	25	36	186	0.43590000000000007
The Return Home Remastered	2016-07-29	1981	55	77	2058	0.43579999999999997
The Sentient	2016-02-29	14	33	47	61	0.43579999999999997
Skyreach	2016-04-29	25	71	99	124	0.43520000000000003
a Family of Grave Diggers	2016-01-08	3	7	11	14	0.4347
Bowl VR	2016-06-24	5	7	11	16	0.4347
Super Dungeon Bros	2016-11-01	248	48	68	316	0.4343
Drones, The Human Condition	2016-12-01	80	117	162	242	0.4341
Carnival Games® VR	2016-10-28	20	142	196	216	0.4339
Dessert Storm	2016-10-24	783	39	56	839	0.43320000000000003
Raise Your Own Clone	2016-09-06	2279	9	14	2293	0.43310000000000004
3 Coins At School	2016-04-20	4435	49	70	4505	0.4326
iFactor	2016-12-16	4	11	17	21	0.43170000000000003
Star Rangers XE	2016-07-06	41	63	90	131	0.4311
Soviet Monsters: Ekranoplans	2016-07-14	8	13	20	28	0.43060000000000004
Final Quest II	2016-10-18	2816	67	96	2912	0.4302
MiDZone	2016-07-11	1036	27	40	1076	0.4302
1943 Megami Strike	2016-02-24	20	34	50	70	0.42979999999999996
The SKIES	2016-04-16	1178	1684	2305	3483	0.4286
Final Quest	2016-08-17	2988	70	101	3089	0.4286
Attractio	2016-01-18	16	55	80	96	0.42850000000000005
Vision Runner	2016-10-19	5	4	7	12	0.4282
Arachnophobia	2016-06-02	2	4	7	9	0.4282
ROCK	2016-08-17	3	4	7	10	0.4282
Undead vs Plants	2016-02-26	4	19	29	33	0.42810000000000004
丛林守望者（Ranger of the jungle）	2016-07-19	69	19	29	98	0.42810000000000004
Into the Stars	2016-03-04	258	215	303	561	0.428
Commercium	2016-11-17	6	8	13	19	0.4279
Operation Breakout®	2016-10-28	10734	35	52	10786	0.4277
Dungeons Are Random	2016-01-05	6	10	16	22	0.4274
Cheaters Blackjack 21	2016-06-08	38	10	16	54	0.4274
Skynet Rising : Portal to the Past	2016-10-14	5	10	16	21	0.4274
Forestry 2017 - The Simulation	2016-03-25	36	49	72	108	0.42729999999999996
Fast Detect	2016-10-07	38	288	407	445	0.4263
DATH	2016-11-28	2	2	4	6	0.4261
MetalNoise	2016-11-02	5	2	4	9	0.4261
Golf Pro VR	2016-09-19	3	2	4	7	0.4261
INTRUDER - WAR AREAS	2016-12-13	3	2	4	7	0.4261
Nuts!: The Battle of the Bulge	2016-02-12	131	18	28	159	0.4254
NightmareZ	2016-09-08	523	18	28	551	0.4254
Mystery Of Rivenhallows	2016-07-27	101	47	70	171	0.4251
Paranormal Teens	2016-12-29	7	31	47	54	0.425
Tross	2016-02-25	8	22	34	42	0.42460000000000003
Dark Night	2016-01-11	6	24	37	43	0.4242
Invisible Mind	2016-08-10	1775	64	95	1870	0.42369999999999997
DesertLand 2115	2016-11-18	7	28	43	50	0.42350000000000004
Elite vs. Freedom	2016-05-31	280	32	49	329	0.4229
AL･FINE	2016-11-11	85	17	27	112	0.4225
Horror in the Asylum	2016-02-02	49	19	30	79	0.42229999999999995
Nightfall: Escape	2016-06-28	348	23	36	384	0.42200000000000004
AffordaGolf Online	2016-12-22	401	29	45	446	0.4214
Weapons of Mythology - New Age -	2016-12-15	80	33	51	131	0.42100000000000004
Tower!3D	2016-05-31	53	37	57	110	0.42060000000000003
Awakened	2016-06-30	3	5	9	12	0.4204
PlanCon: Space Conflict	2016-08-08	447	51	78	525	0.41950000000000004
Infection: Humanity's Last Gasp	2016-05-26	134	18	29	163	0.41950000000000004
SCORE 	2016-07-06	14	16	26	40	0.4193
Heroes of Havoc	2016-12-15	426	89	134	560	0.4189
! That Bastard Is Trying To Steal Our Gold !	2016-03-04	1951	44	68	2019	0.41869999999999996
GiAnt	2016-08-02	3	10	17	20	0.4179
The Housewife	2016-08-25	3565	104	157	3722	0.4175
The Dreamlord	2016-12-13	16985	74	113	17098	0.4173
XLR	2016-04-05	11	8	14	25	0.4167
Shiny Gauntlet	2016-08-04	185	8	14	199	0.4167
The Tower - Fantogame	2016-09-20	2	8	14	16	0.4167
R.C. Bot Inc.	2016-07-29	4	3	6	10	0.4167
Zombie Trigger	2016-08-25	4	3	6	10	0.4167
Machinations: Fog of War	2016-08-19	13	3	6	19	0.4167
ALONE?	2016-10-10	119	69	106	225	0.41659999999999997
Otherland	2016-09-12	200	276	409	609	0.4165
NBA 2KVR Experience	2016-11-22	7	6	11	18	0.41450000000000004
Top Floor	2016-09-23	7	11	19	26	0.41409999999999997
Habitat	2016-01-26	76	100	154	230	0.41369999999999996
Grizzly Valley	2016-04-23	1208	92	143	1351	0.41240000000000004
Ultimate Word Search 2: Letter Boxed	2016-08-19	830	32	52	882	0.4122
Final Strike	2016-06-23	6	14	24	30	0.4121
Fall of Civilization	2016-09-19	3288	52	83	3371	0.4114
Drive Megapolis	2016-08-24	3259	115	179	3438	0.4108
One Day : The Sun Disappeared	2016-08-26	92	12	21	113	0.4108
VR Karts SteamVR	2016-05-20	8	17	29	37	0.4105
Flight 787 - Advanced	2016-06-21	6	17	29	35	0.4105
Crystal Chip Collector	2016-03-22	52	4	8	60	0.4103
Revenge of the Spirit: Rite of Resurrection	2016-12-20	19	4	8	27	0.4103
Killer Klownz	2016-12-05	1	4	8	9	0.4103
GOD's DEATH	2016-05-11	1761	7	13	1774	0.41000000000000003
Driftwatch VR	2016-12-01	4	7	13	17	0.41000000000000003
CLASH	2016-11-15	2849	92	145	2994	0.4097
SnookerWorld	2016-09-16	26	47	76	102	0.4097
Unearthing Colossal	2016-10-22	210	10	18	228	0.409
Project Syria	2016-11-01	4	25	42	46	0.40880000000000005
The Challenge	2016-10-07	4992	23	39	5031	0.408
Tropical Girls VR	2016-09-30	4	13	23	27	0.4079
Red Forest	2016-11-16	2488	85	136	2624	0.4073
Ultimate Fight Manager 2016	2016-04-28	9	8	15	24	0.40630000000000005
Inside The Code	2016-01-08	1	0	1	2	0.4058
Free Balling	2016-07-26	1	0	1	2	0.4058
Return Zero VR	2016-09-13	2	0	1	3	0.4058
Pixeloids	2016-07-14	2	0	1	3	0.4058
Evil Robots From N1M	2016-08-05	1	0	1	2	0.4058
Caketomino	2016-09-03	10	0	1	11	0.4058
CrazyFlies	2016-10-14	2	0	1	3	0.4058
Wild Arena	2016-10-23	1	0	1	2	0.4058
HandPass VR	2016-11-25	1	0	1	2	0.4058
Guardian	2016-10-20	2	0	1	3	0.4058
Willi's Haunted Hayride	2016-11-03	1	0	1	2	0.4058
Hand Eye Cubination	2016-12-01	1	0	1	2	0.4058
Juniper Theory	2016-12-19	2	0	1	3	0.4058
AmaranTime Arena	2016-12-15	2	0	1	3	0.4058
Pixel bomb! bomb!!	2016-12-15	1	0	1	2	0.4058
GoWings Safari	2016-12-24	2	0	1	3	0.4058
LOUD on Planet X	2016-04-19	11	5	10	21	0.4057
Drawn Story	2016-02-12	8	5	10	18	0.4057
Z.I.O.N.	2016-05-07	1543	112	180	1723	0.4046
Robot Tsunami	2016-01-07	2	1	3	5	0.40399999999999997
#SOHVR	2016-09-29	2	1	3	5	0.40399999999999997
Pro Basketball Manager 2016 - US Edition	2016-02-18	8	1	3	11	0.40399999999999997
Ad Exitum	2016-05-13	3	1	3	6	0.40399999999999997
Dashy Square VR	2016-07-15	2	1	3	5	0.40399999999999997
VHSoverdose	2016-09-20	5	1	3	8	0.40399999999999997
Spa Mania 2	2016-09-28	4	1	3	7	0.40399999999999997
Battle Tank Armada	2016-09-29	2	1	3	5	0.40399999999999997
The Last Hope	2016-08-29	9417	357	560	9977	0.4035
Blaster Simulator	2016-04-28	14	15	27	41	0.4032
Star Phoenix	2016-11-25	911	9	17	928	0.4032
Painted Memories	2016-11-03	2953	18	32	2985	0.4029
Fantastic Checkers 2	2016-08-19	93	37	63	156	0.40240000000000004
Killbot	2016-07-10	635	40	68	703	0.4019
Above - VR	2016-11-01	1406	13	24	1430	0.4011
Congo Merc	2016-12-12	27	10	19	46	0.4006
No Seat?	2016-12-19	2	2	5	7	0.40030000000000004
Secret of the Pendulum	2016-04-08	6	2	5	11	0.40030000000000004
Rise	2016-07-08	5	2	5	10	0.40030000000000004
Project Hovercraft	2016-10-20	2	2	5	7	0.40030000000000004
FILE 9	2016-09-30	2	2	5	7	0.40030000000000004
Oscar Mike VR	2016-12-01	4	2	5	9	0.40030000000000004
Space Badminton VR	2016-12-30	2	2	5	7	0.40030000000000004
Nordenfelt	2016-01-14	2	7	14	16	0.39909999999999995
ALICE VR	2016-10-27	122	100	166	288	0.399
Age of Farming	2016-11-18	5	11	21	26	0.3983
Cranium Conundrum	2016-09-23	3002	24	43	3045	0.39799999999999996
Feudalism	2016-06-14	19	15	28	47	0.3972
CONTASION 2	2016-04-22	3	3	7	10	0.3972
WarBirds Dogfights	2016-01-14	5	3	7	12	0.3972
Hush Hush - Unlimited Survival Horror	2016-03-25	100	3	7	107	0.3972
MadOut Open City	2016-03-29	28	94	158	186	0.397
Escape Artist: The Trial	2016-12-07	28	8	16	44	0.39659999999999995
AI: Rampage	2016-01-27	14532	180	297	14829	0.3965
At the Mountains of Madness	2016-03-26	22	22	40	62	0.3965
Womb Room	2016-04-04	272	19	35	307	0.3962
Bridge! 2	2016-04-21	46	19	35	81	0.3962
Shard Games	2016-07-29	827	32	57	884	0.3958
Rolling Gauntlet	2016-01-19	2	4	9	11	0.3946
Arkham Nightmares	2016-08-13	113	4	9	122	0.3946
Down To One	2016-01-08	3980	806	1300	5280	0.3944
Apocalypse Hotel - The Post-Apocalyptic Hotel Simulator!	2016-01-26	9	27	49	58	0.3944
Riding Out	2016-05-26	64	64	111	175	0.394
Medieval Defenders	2016-11-11	2214	83	143	2357	0.3932
Midnight Carnival	2016-11-22	2926	115	196	3122	0.3929
WAR7	2016-10-21	8	10	20	28	0.3926
Cyber Team Manager	2016-01-18	46	29	53	99	0.3924
World Defense : Fragmented Reality	2016-03-07	3	5	11	14	0.3924
Acro Storm	2016-12-28	142	11	22	164	0.391
VALENS	2016-02-18	3	6	13	16	0.39049999999999996
Endciv	2016-04-21	46	24	45	91	0.39020000000000005
Airport Fire Department - The Simulation	2016-08-26	17	25	47	64	0.38920000000000005
TRAPPED	2016-09-09	61109	147	254	61363	0.3885
SparkDimension	2016-10-05	254	26	49	303	0.3883
Zombie Apocalypse: Escape The Undead City	2016-06-17	100	26	49	149	0.3883
Ships 2017	2016-10-19	37	64	115	152	0.3874
Beat The Dictators	2016-08-30	9	10	21	30	0.3851
The God's Chain	2016-08-14	17097	132	234	17331	0.38420000000000004
Block Blowout	2016-10-26	121	40	75	196	0.38420000000000004
Drift GEAR Racing Free	2016-10-21	15	76	138	153	0.3839
The Gleam: VR Escape the Room	2016-10-14	896	18	36	932	0.3832
Loading Human	2016-10-15	8	13	27	35	0.3822
Race & Destroy	2016-05-16	25	5	12	37	0.3804
Grave VR	2016-10-31	3	5	12	15	0.3804
Whitetail Challenge	2016-06-21	2	3	8	10	0.3803
The Legions of Rome	2016-09-13	21	16	33	54	0.38
Timber! The Logging Experts	2016-11-18	4	7	16	20	0.37950000000000006
Hacker Series	2016-09-28	9	8	18	27	0.379
Bubonic: OutBreak	2016-02-12	3	2	6	9	0.379
The Contact	2016-04-11	4	2	6	10	0.379
Manor of the Damned!	2016-11-23	2	2	6	8	0.379
Emission VR	2016-11-30	2	2	6	8	0.379
Fleeting Ages	2016-05-02	7	9	20	27	0.3785
ABO MANDO	2016-01-01	1575	26	52	1627	0.37810000000000005
Lone Leader	2016-10-28	9911	122	225	10136	0.3771
Bloonz Toonz	2016-03-11	2	1	4	6	0.3749
Jewel bits	2016-12-21	3	1	4	7	0.3749
Endless Burst	2016-07-26	2	1	4	6	0.3749
Run The Gamut	2016-06-17	27	1	4	31	0.3749
Fall of Freya	2016-09-30	3	1	4	7	0.3749
Pinheads Bowling VR	2016-12-23	5	1	4	9	0.3749
FPV Air Tracks	2016-05-23	13	66	127	140	0.3743
Alone K.W.	2016-02-29	1676	19	40	1716	0.3739
Airline Director 2 - Tycoon Game	2016-04-28	15	19	40	55	0.3739
SLG Remix	2016-06-01	235	13	29	264	0.37090000000000006
Orc Assault	2016-05-10	6	6	15	21	0.37020000000000003
A.I. Space Corps	2016-02-05	4	6	15	19	0.37020000000000003
Absence	2016-02-11	3	6	15	18	0.37020000000000003
Salvage Op	2016-12-13	2	6	15	17	0.37020000000000003
Stern Pinball Arcade	2016-12-24	35	80	156	191	0.37
Club Naughty	2016-11-18	23	44	89	112	0.36960000000000004
Crash Landing	2016-02-04	5	4	11	16	0.3679
Jacob	2016-07-18	15	31	65	80	0.3676
Love is Blind: Mutants	2016-03-15	8906	40	83	8989	0.36619999999999997
Immersion	2016-11-29	553	15	34	587	0.3658
Clickdraw Clicker	2016-10-14	2664	151	293	2957	0.36560000000000004
Military Life: Tank Simulator	2016-06-01	5	13	30	35	0.36560000000000004
The Admin	2016-11-01	869	11	26	895	0.3651
Apartment 666	2016-08-03	2055	147	288	2343	0.3639
Sleeping Valley	2016-10-08	2930	100	200	3130	0.3632
CATS!	2016-06-24	142	29	63	205	0.3624
Plastic Playground	2016-04-18	25	46	97	122	0.3616
Duckles: the Jigsaw Witch	2016-12-20	4991	6	16	5007	0.36119999999999997
Devoured Time	2016-08-09	2	2	7	9	0.3611
Sluggish Morss: Days of the Purple Sun	2016-10-21	2	2	7	9	0.3611
CTU: Counter Terrorism Unit	2016-04-22	13	32	70	83	0.35990000000000005
Beyond The Destiny	2016-04-11	20	5	14	34	0.3593
Damage: Sadistic Butchering of Humanity	2016-12-11	3	5	14	17	0.3593
Lost Cosmonaut	2016-03-25	2	0	2	4	0.3592
MOP Operation Cleanup	2016-05-03	16	0	2	18	0.3592
Master Of Marbles	2016-07-23	1	0	2	3	0.3592
Kisaragi no Hougyoku	2016-10-14	2	0	2	4	0.3592
Brawlderdash	2016-09-14	7	0	2	9	0.3592
 Armies of Riddle CLASSIC	2016-09-30	3	0	2	5	0.3592
Escape Station	2016-09-20	2	0	2	4	0.3592
RuinsCity_VR	2016-10-22	2	0	2	4	0.3592
Elephant Express VR	2016-12-15	1	0	2	3	0.3592
Revolution 60	2016-09-06	12	21	48	60	0.3588
Garbage Day	2016-01-18	44	364	713	757	0.3578
Fill Up!	2016-02-17	10	9	23	33	0.3576
Crazy Belts	2016-01-05	4	21	49	53	0.3554
Professional Farmer 2017	2016-03-23	66	71	151	217	0.3552
Spectre	2016-10-04	6	12	30	36	0.35479999999999995
Professional Construction - The Simulation	2016-08-26	17	7	19	36	0.35479999999999995
Medieval Playground	2016-01-29	3	6	17	20	0.3527
Best of Us	2016-04-22	22	3	10	32	0.35240000000000005
Leveron Space	2016-05-18	7	3	10	17	0.35240000000000005
Blade & Bones	2016-11-30	106	59	129	235	0.3523
Retool	2016-05-19	14	1	5	19	0.3522
Cliff Hanger	2016-09-02	6	1	5	11	0.3522
VR the Anime Girls Method / 全豚に告ぐ！これで痩せなきゃお前は終わりだ！	2016-12-20	2	1	5	7	0.3522
Spider Wars	2016-11-18	23	24	57	80	0.3504
Mind Dead	2016-08-16	4	12	31	35	0.3498
Hunting Unlimited 2011	2016-10-25	5	8	22	27	0.3497
TILE	2016-12-09	11	8	22	33	0.3497
Edge of Twilight – Return To Glory	2016-09-28	41	26	62	103	0.34840000000000004
GAIN	2016-06-14	4	13	34	38	0.34630000000000005
God Simulator	2016-08-03	4	4	13	17	0.3462
Help Me Doctor	2016-10-07	5	4	13	18	0.3462
VR Boxing Workout	2016-07-10	4	2	8	12	0.3458
Ghost Train VR	2016-07-06	2	2	8	10	0.3458
DragonWingsVR	2016-12-11	4	2	8	12	0.3458
Ballistick	2016-10-15	827	69	155	982	0.3456
Initia: Elemental Arena	2016-04-29	10	27	66	76	0.3437
AGP::Epica	2016-12-22	33	18	46	79	0.3435
Jurassic Survival	2016-08-01	3	11	30	33	0.3435
Roadworks Simulator	2016-06-10	4	5	16	20	0.34140000000000004
Road Madness	2016-03-30	2408	141	312	2720	0.3412
So Many Cubes	2016-10-06	13382	45	107	13489	0.34090000000000004
Gun Range VR	2016-07-12	3	3	11	14	0.3407
SOLRAVEN	2016-03-04	17	11	31	48	0.3386
City Play	2016-05-19	21	8	24	45	0.3373
LONE WOLF: Horizon	2016-02-12	118	22	58	176	0.33490000000000003
Racecraft	2016-03-04	15	60	145	160	0.3344
Tyrfing Cycle |Vanilla|	2016-04-15	84	9	27	111	0.3343
Murder Mystery Adventure	2016-10-25	165	21	56	221	0.334
Gunslinger Trainer	2016-04-05	2	1	6	8	0.33380000000000004
Graveyard Smash	2016-09-03	627	1	6	633	0.33380000000000004
Island Simulator 2016	2016-11-28	2	1	6	8	0.33380000000000004
Extreme Skiing VR	2016-10-25	4	1	6	10	0.33380000000000004
Deep Space Dash	2016-07-07	2904	100	235	3139	0.3335
TribeQuest: Red Killer	2016-05-18	1	0	3	4	0.32939999999999997
Ghrian	2016-05-26	1	0	3	4	0.32939999999999997
Ultimate Rock Crawler	2016-01-25	5	7	23	28	0.3282
Hoyle Official Casino Games	2016-10-14	11	4	15	26	0.32799999999999996
Crazy Max VR	2016-12-22	18	4	15	33	0.32799999999999996
Masquerade: The Baubles of Doom	2016-04-20	25	16	46	71	0.3276
The Martian VR Experience	2016-11-15	13	12	36	49	0.3275
Black Swan	2016-11-30	9	18	51	60	0.3274
24 Hours 'til Rescue	2016-02-19	5	22	62	67	0.32439999999999997
Abrix for kids	2016-08-12	320	55	142	462	0.3241
Space Overlords	2016-03-03	21	6	21	42	0.3241
FleetCOMM	2016-05-24	7	7	24	31	0.3224
Hero Quest: Tower Conflict	2016-04-13	4479	87	223	4702	0.3196
Z`code (VR for HTC Vive)	2016-11-09	3	1	7	10	0.3185
New York Taxi Simulator	2016-03-04	3	15	47	50	0.3161
Garlock Online	2016-05-30	24	33	94	118	0.3156
Elves Adventure	2016-08-01	6784	44	123	6907	0.3141
Klepto	2016-06-30	24	59	161	185	0.3138
Umbrella Corps	2016-06-21	428	832	1992	2420	0.3134
Glitchrunners	2016-04-08	5	5	20	25	0.3125
Better Late Than DEAD	2016-03-03	129	256	647	776	0.3114
Robot Arena III	2016-06-20	187	87	234	421	0.3113
Adam and Eve: The Game - Chapter 1	2016-02-26	14	23	71	85	0.3095
Street Posse Showdown	2016-11-21	3	0	4	7	0.308
Night light	2016-07-12	2	0	4	6	0.308
Joana's Life	2016-09-01	83	48	139	222	0.307
Brine	2016-05-07	30	103	281	311	0.3068
Lost Route	2016-06-14	5	5	21	26	0.3064
Hack, Slash & Backstab	2016-08-31	7	1	8	15	0.3056
Insane Insects: The Inception	2016-05-02	1	1	8	9	0.3056
Bank Limit : Advanced Battle Racing	2016-08-16	5	1	8	13	0.3056
GoVenture MICRO BUSINESS	2016-08-10	27	1	8	35	0.3056
HACK_IT	2016-05-05	41	36	110	151	0.303
Mysterious Castle	2016-03-25	7	2	12	19	0.3009
Mechatroniks Attack	2016-12-01	2	2	12	14	0.3009
Guardians of Victoria	2016-04-29	10374	61	180	10554	0.3004
Arctic Trucker Simulator	2016-10-07	10	9	35	45	0.29850000000000004
Vroomist	2016-06-10	6	8	32	38	0.2981
Xmas Zombie Rampage	2016-12-21	3	7	29	32	0.2975
Tales of Destruction	2016-07-14	1458	37	118	1576	0.2958
Streamer Simulator	2016-08-23	14	10	39	53	0.2952
Doctor Watson - The Riddle of the Catacombs	2016-03-04	3	1	9	12	0.2943
Strike Force: Arctic Storm	2016-09-21	3	1	9	12	0.2943
Grim Facade: Mystery of Venice Collector’s Edition	2016-11-18	2	2	13	15	0.2925
RC Racing Off Road 2.0	2016-07-01	4	0	5	9	0.2916
Fair Islands VR	2016-09-14	2	0	5	7	0.2916
Hotel Blind	2016-04-05	2	9	37	39	0.2912
Random Access Murder	2016-08-06	20	38	125	145	0.29059999999999997
Zenza	2016-11-23	152	3	17	169	0.29
New York Bus Simulator	2016-03-04	3	12	47	50	0.2899
The Janitor	2016-07-19	39	27	96	135	0.2852
Pitstop Challenge	2016-02-01	3	4	22	25	0.2822
Bell Ringer	2016-03-18	2242	97	313	2555	0.2796
Doctor Watson - Treasure Island	2016-03-11	3	0	6	9	0.2783
States, Firms, and Households	2016-04-15	2	0	6	8	0.2783
Flying Baron 1916	2016-11-11	2	0	6	8	0.2783
Space Rift Non-VR - Episode 1	2016-12-13	2	0	6	8	0.2783
The Youthdrainers	2016-09-18	251	9	41	292	0.278
C.R.E.E.P.S	2016-03-17	3	3	19	22	0.2779
Secret Of The Royal Throne	2016-04-30	15	2	15	30	0.2778
Strike Force: Desert Thunder	2016-04-25	5	4	23	28	0.2772
Gold Crusader	2016-11-22	40	1	11	51	0.2758
WarFire	2016-11-08	2	0	7	9	0.26739999999999997
Ceggtcher VR	2016-09-27	2	0	7	9	0.26739999999999997
RollerCoaster Tycoon World	2016-11-16	5875	1382	4210	10085	0.266
World Ship Simulator	2016-11-04	56	52	199	255	0.2626
GASP	2016-01-19	48	369	1269	1317	0.2549
Dungeon of Gain	2016-06-23	5000	8	46	5046	0.2535
UnderWater Adventure	2016-06-01	55	2	20	75	0.25010000000000004
Wacky Wheels HD	2016-10-26	5	12	65	70	0.2486
Rail Cargo Simulator	2016-06-07	4	6	41	45	0.2438
C.S.S. CITADEL VR	2016-07-16	3	0	10	13	0.2429
Akuya	2016-12-15	2	1	18	20	0.23420000000000002
Space Universe	2016-06-16	6	2	26	32	0.227
Godus Wars	2016-02-03	143	87	487	630	0.203
Drunk Wizards	2016-06-06	16	5	64	80	0.1915
BeamNG.drive	2015-05-29	20691	166181	5111	25802	0.9577
Undertale	2015-09-15	10484	188493	6467	16951	0.9549
Broforce	2015-10-15	4285	50195	1517	5802	0.9527
The Witcher 3: Wild Hunt	2015-05-18	103329	685661	28911	132240	0.9516
CLANNAD	2015-11-23	312	6865	105	417	0.9511000000000001
Keep Talking and Nobody Explodes	2015-10-08	1767	11748	271	2038	0.9492
Life is Strange™	2015-01-30	18260	153409	6155	24415	0.9489000000000001
Eternal Senia	2015-06-18	645	11480	286	931	0.9474
Duck Game	2015-06-04	5047	33700	1210	6257	0.9454000000000001
Fran Bow	2015-08-27	796	12915	379	1175	0.9444
Dying Light	2015-01-27	45876	356665	18331	64207	0.9416
HuniePop	2015-01-19	3018	28727	1148	4166	0.9408
SOMA	2015-09-22	4072	33718	1417	5489	0.9400000000000001
Hook	2015-07-07	261	8349	255	516	0.9396
Portal Stories: Mel	2015-06-25	3545	18995	736	4281	0.9390999999999999
Universe Sandbox	2015-08-24	727	19194	761	1488	0.9384
Hylics	2015-10-02	80	3510	76	156	0.9381
Nuclear Throne	2015-12-05	1213	15847	612	1825	0.9379000000000001
Mini Metro	2015-11-06	2104	12936	477	2581	0.9379000000000001
Crypt of the NecroDancer	2015-04-23	2282	21960	920	3202	0.9374
Downwell	2015-10-15	405	7093	229	634	0.9365000000000001
Ori and the Blind Forest	2015-03-10	13108	47836	2335	15443	0.9359999999999999
Kerbal Space Program	2015-04-27	19149	108203	5889	25038	0.9349
Refunct	2015-10-16	480	16237	710	1190	0.9337000000000001
The Legend of Heroes: Trails in the Sky SC	2015-10-29	840	2686	62	902	0.9334
GUILTY GEAR XX ACCENT CORE PLUS R	2015-05-27	2383	5424	193	2576	0.9309999999999999
TIS-100	2015-07-20	493	3456	113	606	0.9284
fault - milestone two side: above	2015-09-08	234	2436	72	306	0.9266
Skyrim Script Extender (SKSE)	2015-08-12	33	1143	21	54	0.9244
eden*	2015-01-31	302	3002	109	411	0.9237000000000001
Shower With Your Dad Simulator 2015: Do You Still Shower With Your Dad	2015-09-02	235	9235	466	701	0.9235
Tabletop Simulator	2015-06-05	37198	55044	3607	40805	0.9224
Cities: Skylines	2015-03-10	60386	212031	15281	75667	0.9222
Caves of Qud	2015-07-15	1221	5547	264	1485	0.9211
Hyperdimension Neptunia Re;Birth1	2015-01-29	2281	11064	615	2896	0.9207
GemCraft - Chasing Shadows	2015-04-30	1601	3489	150	1751	0.9198999999999999
Total Annihilation	2015-12-18	608	2737	108	716	0.9198999999999999
Hotline Miami 2: Wrong Number	2015-03-10	18950	44595	3005	21955	0.9198000000000001
Higurashi When They Cry Hou - Ch.1 Onikakushi	2015-05-15	543	3841	171	714	0.9197
NEKOPARA Vol. 0	2015-08-17	960	16136	1030	1990	0.9166
Narcissu 1st & 2nd	2015-04-24	443	3884	189	632	0.9164
Doom & Destiny	2015-03-18	108	2108	84	192	0.9161
Gaokao.Love.100Days	2015-05-31	456	6525	377	833	0.9143000000000001
Hacknet	2015-08-12	127640	21021	1451	129091	0.9141
Cat Goes Fishing	2015-01-19	638	7824	472	1110	0.9138
Contradiction - the all-video murder mystery adventure	2015-07-10	70	2688	130	200	0.9123000000000001
Mushihimesama	2015-11-05	357	1157	40	397	0.9113
Viscera Cleanup Detail	2015-10-23	1526	16765	1191	2717	0.9109
Twinsen's Little Big Adventure 2 Classic	2015-10-20	40	686	16	56	0.9109
The Jackbox Party Pack 2	2015-10-13	4937	1752	76	5013	0.9106000000000001
Dungeon Warfare	2015-11-04	458	1634	69	527	0.9106000000000001
Timberman	2015-09-18	4296	10430	706	5002	0.9102
THE KING OF FIGHTERS 2002 UNLIMITED MATCH	2015-02-27	589	3469	191	780	0.9098999999999999
Hyperdimension Neptunia Re;Birth3 V Generation	2015-10-30	1008	3134	168	1176	0.9098999999999999
Software Inc.	2015-05-01	766	5542	341	1107	0.9096
Higurashi When They Cry Hou - Ch.2 Watanagashi	2015-11-13	163	999	35	198	0.9085
DISTRAINT: Deluxe Edition	2015-10-21	165266	10351	740	166006	0.907
Dr. Langeskov, The Tiger, and The Terribly Cursed Emerald: A Whirlwind Heist	2015-12-04	815	8683	607	1422	0.9069
Chicken Invaders 5	2015-03-13	60	856	29	89	0.9067000000000001
Bullet Heaven 2	2015-12-07	57	409	6	63	0.9065000000000001
Half-Life 2: Update	2015-03-27	3175	6178	415	3590	0.9061
Grim Legends 2: Song of the Dark Swan	2015-03-26	232	1140	47	279	0.9058
Lords of the Realm II	2015-12-03	242	1140	47	289	0.9058
Love at First Sight	2015-05-18	64	1218	52	116	0.9057
Relic Hunters Zero: Remix	2015-08-18	3777	6331	437	4214	0.9048
Paint it Back	2015-10-14	196	473	10	206	0.9048
Spooky's Jump Scare Mansion	2015-07-28	625	12579	964	1589	0.9044
Resident Evil	2015-01-20	4388	18123	1447	5835	0.9043000000000001
Infinifactory	2015-06-30	471	2154	119	590	0.904
Impossible Creatures	2015-11-11	313	1409	68	381	0.9035
Mad Max	2015-10-02	33356	62024	5546	38902	0.9032
The Silent Age	2015-05-29	458	6317	449	907	0.9032
Human Resource Machine	2015-10-15	778	3613	234	1012	0.9026000000000001
Reassembly	2015-02-19	1010	3460	222	1232	0.9026000000000001
Aviary Attorney	2015-12-22	422	1860	102	524	0.9023000000000001
SimplePlanes	2015-12-17	885	8632	654	1539	0.9020999999999999
Kitty Powers' Matchmaker	2015-04-22	204	1178	55	259	0.902
Hero of the Kingdom II	2015-02-20	776	2128	125	901	0.9009999999999999
Turok	2015-12-17	357	2822	179	536	0.9008
Five Nights at Freddy's 4	2015-07-23	1675	10196	814	2489	0.9002
Automation - The Car Company Tycoon Game	2015-03-12	1235	8866	704	1939	0.8994
Car Mechanic Simulator 2015	2015-04-02	4340	13165	1100	5440	0.8991
Tormentum - Dark Sorrow	2015-03-04	129	2311	146	275	0.8986000000000001
WALL E	2015-02-24	71	756	32	103	0.8976999999999999
METAL GEAR SOLID V: THE PHANTOM PAIN	2015-09-01	91195	75594	7424	98619	0.897
Technobabylon	2015-05-21	159	1303	72	231	0.8968
12 Labours of Hercules	2015-03-23	1535	2743	187	1722	0.8967
Chroma Squad	2015-04-30	949	3746	276	1225	0.8959
Assault Android Cactus	2015-09-23	238	1717	106	344	0.8958
Streets of Fury EX	2015-06-25	34	598	24	58	0.8948999999999999
Quell	2015-05-14	24	355	9	33	0.8948
HELLDIVERS™	2015-12-07	6744	21733	2031	8775	0.8946
A Good Snowman Is Hard To Build	2015-02-25	64	777	37	101	0.8941
Lovers in a Dangerous Spacetime	2015-09-09	273	3217	240	513	0.8935
Shantae and the Pirate's Curse	2015-04-23	490	2301	162	652	0.8929
Viridi	2015-08-20	1282	7794	675	1957	0.8926999999999999
Nightmares from the Deep 3: Davy Jones	2015-01-29	170	737	36	206	0.8922
Dropsy	2015-09-10	114	1651	110	224	0.8914
Rampage Knights	2015-09-04	1206	3152	247	1453	0.8904000000000001
Saint Seiya: Soldiers' Soul	2015-11-25	499	2737	210	709	0.89
Endless Sky	2015-10-30	3035	5359	465	3500	0.8893000000000001
Robot Roller-Derby Disco Dodgeball	2015-02-19	373	3567	292	665	0.8890000000000001
Barony	2015-06-23	1447	4255	359	1806	0.8889
Prison Architect	2015-10-06	16211	58945	6383	22594	0.888
Lakeview Cabin Collection	2015-04-10	980	1594	114	1094	0.8872
Jigoku Kisetsukan: Sense of the Seasons	2015-05-12	164	1627	118	282	0.8867
Invisible, Inc.	2015-05-12	2401	4813	431	2832	0.8861
Axiom Verge	2015-05-14	788	4715	424	1212	0.8856
Kingdom: Classic	2015-10-21	64944	18142	1881	66825	0.8855
Hyperdimension Neptunia Re;Birth2 Sisters Generation	2015-05-29	1285	2884	242	1527	0.8851000000000001
Kero Blaster	2015-11-11	211	1137	77	288	0.8851000000000001
Dino Run DX	2015-09-29	1070	1187	82	1152	0.8847
A Kiss For The Petals - Remembering How We Met	2015-09-25	291	1423	104	395	0.8844
Gravity Ghost	2015-01-26	67	283	9	76	0.8843000000000001
Clicker Heroes	2015-05-14	65882	52777	5939	71821	0.8842
LEGO® Jurassic World	2015-06-12	3498	6407	612	4110	0.8841
Grow Home	2015-02-04	712	4666	429	1141	0.8840000000000001
Duet	2015-08-04	273	710	42	315	0.8837
Amnesia™: Memories	2015-08-25	558	2918	251	809	0.8836
Divinity: Original Sin Enhanced Edition	2015-10-27	7565	21176	2293	9858	0.8828
Spooky Bonus	2015-10-15	22	270	9	31	0.882
Nyan Cat: Lost In Space	2015-12-04	88	1587	125	213	0.8815999999999999
Renowned Explorers: International Society	2015-09-02	915	2509	217	1132	0.8815000000000001
Regency Solitaire	2015-05-18	265	658	40	305	0.8811
Sky Force Anniversary	2015-04-29	223	1756	145	368	0.8801000000000001
Templar Battleforce	2015-09-22	106	826	56	162	0.8799
Devil May Cry 4 Special Edition	2015-06-23	4500	11858	1274	5774	0.8798
HyperRogue	2015-01-16	53	379	18	71	0.8797
Blockwick 2	2015-06-25	75	167	3	78	0.8797
The Escapists	2015-02-13	3354	13955	1523	4877	0.8795999999999999
The Fruit of Grisaia	2015-05-30	138	909	64	202	0.8795000000000001
Rocket League	2015-07-07	147632	502036	64231	211863	0.8794
Disney's Treasure Planet: Battle of Procyon	2015-02-24	19	213	6	25	0.8794
Guns, Gore & Cannoli	2015-04-30	263	2810	257	520	0.8791
Voices from the Sea	2015-03-24	52	1147	87	139	0.8791
Snakebird	2015-05-04	199	942	68	267	0.8788
Voidspire Tactics	2015-11-02	22	223	7	29	0.8783
Zoombinis	2015-10-28	188	892	64	252	0.8782
FIM Speedway Grand Prix 15	2015-11-30	132	629	40	172	0.8781
Flywrench	2015-08-24	29	278	11	40	0.8781
Koi-Koi Japan [Hanafuda playing cards]	2015-04-28	126	1012	76	202	0.8776999999999999
Grim Fandango Remastered	2015-01-27	1500	6273	659	2159	0.8767
The Magic Circle	2015-07-09	270	1258	102	372	0.8765999999999999
Farm Frenzy Collection	2015-08-21	116	283	12	128	0.8765000000000001
Pink Hour	2015-10-28	82	907	68	150	0.8761
Secrets of Grindea	2015-07-13	435	5374	560	995	0.876
Snail Bob 2	2015-09-24	316	168	4	320	0.8756999999999999
Monstrum 	2015-05-20	244	2666	257	501	0.8748
Tokyo School Life	2015-02-12	116	625	43	159	0.8742000000000001
Flamebreak	2015-10-16	298	470	29	327	0.8738
SanctuaryRPG: Black Edition	2015-02-13	233	1401	122	355	0.8737
Westerado: Double Barreled	2015-04-16	377	1632	148	525	0.8731
Hand of Fate	2015-02-17	2178	9228	1054	3232	0.8729000000000001
Turbo Pug	2015-11-09	15462	3071	310	15772	0.8729000000000001
Dreaming Sarah	2015-03-12	3038	2350	228	3266	0.8729000000000001
Wolfenstein: The Old Blood 	2015-05-05	3064	14908	1776	4840	0.8725
Tennis Elbow 2013	2015-03-13	143	627	45	188	0.8721
Why Am I Dead At Sea	2015-05-11	27	368	21	48	0.872
SC2VN - The eSports Visual Novel	2015-09-22	228	815	64	292	0.8717
DRAGON BALL XENOVERSE	2015-02-26	22850	15614	1884	24734	0.8715999999999999
ESCHATOS	2015-09-18	37	196	7	44	0.8715999999999999
GUILTY GEAR Xrd -SIGN-	2015-12-10	1971	2158	213	2184	0.8706
Divide by Sheep	2015-07-02	2378	2303	230	2608	0.8704999999999999
Her Story	2015-06-24	663	7517	868	1531	0.8704000000000001
The Consuming Shadow	2015-11-20	67	325	18	85	0.8704000000000001
Tin Star	2015-06-05	116	275	14	130	0.8695999999999999
Kalimba	2015-04-22	90	417	27	117	0.8691
G-senjou no Maou - The Devil on G-String	2015-11-05	46	561	41	87	0.8690000000000001
Emily is Away	2015-11-20	2803	27353	3521	6324	0.8688
Hatoful Boyfriend: Holiday Star	2015-12-15	105	466	32	137	0.8686
Stray Cat Crossing	2015-08-28	57	547	40	97	0.8684999999999999
80 Days	2015-09-29	168	1644	160	328	0.8683
Party Hard	2015-08-25	840	8247	985	1825	0.8681000000000001
Carpe Diem	2015-11-30	101	7435	883	984	0.8678
Morningstar: Descent to Deadrock	2015-02-17	95	481	34	129	0.8678
Deus Ex: Revision	2015-10-13	694	2038	209	903	0.8671
Blue Estate	2015-04-08	142	1352	129	271	0.867
Five Nights at Freddy's 3	2015-03-03	3212	7044	841	4053	0.8669
9 Clues 2: The Ward	2015-07-23	125	773	65	190	0.8668000000000001
AdVenture Capitalist	2015-03-30	22998	47879	6467	29465	0.8667
Echoes+	2015-01-16	193	789	67	260	0.8665
Notch - The Innocent LunA: Eclipsed SinnerS	2015-06-04	48	1288	123	171	0.8663
The Deed	2015-11-23	3976	2463	263	4239	0.8662000000000001
Unium	2015-03-27	148	282	16	164	0.8661
A Study in Steampunk: Choice by Gaslight	2015-11-20	65	163	6	71	0.8654999999999999
Gurumin: A Monstrous Adventure	2015-03-30	352	794	69	421	0.8652
Apotheon	2015-02-03	727	3059	341	1068	0.8651000000000001
Crystal Story II	2015-02-06	123	278	16	139	0.8651000000000001
WORLD END ECONOMiCA episode.02	2015-07-21	58	221	11	69	0.8649
The Old Tree	2015-01-26	91	2936	327	418	0.8648
Homeworld Remastered Collection	2015-02-25	17790	10335	1326	19116	0.8632
Dark Echo	2015-05-11	205	709	62	267	0.8629000000000001
DiRT Rally	2015-12-07	20343	33945	4693	25036	0.8628
Pillars of Eternity	2015-03-26	41906	19307	2602	44508	0.8623999999999999
SquareCells	2015-12-07	136	905	85	221	0.8622
The Book of Unwritten Tales 2	2015-02-19	419	809	74	493	0.8622
Kung Fury: Street Rage - Ultimate Edition	2015-05-28	224	2196	244	468	0.8618000000000001
Stardust Galaxy Warriors	2015-11-10	30	197	10	40	0.8611
12 Labours of Hercules II: The Cretan Bull	2015-06-05	1655	1831	200	1855	0.861
Zombie Kill of the Week - Reborn	2015-03-13	264	909	87	351	0.861
Garfield Kart	2015-10-16	186	11791	1565	1751	0.8609
Train Valley	2015-09-16	1000	2694	311	1311	0.8609
Fairy Fencer F	2015-08-04	1945	2107	236	2181	0.8606999999999999
RUNNING WITH RIFLES	2015-04-02	14149	12521	1674	15823	0.8606
King's Quest	2015-07-28	721	2360	270	991	0.8602
Brilliant Shadows - Part One of the Book of Gray Magic	2015-11-02	37	183	9	46	0.8602
Supercharged Robot VULKAISER	2015-06-04	69	268	17	86	0.8601000000000001
Umihara Kawase	2015-11-02	22	159	7	29	0.8597
LOOP: A Tranquil Puzzle Game	2015-05-22	29	122	4	33	0.8593000000000001
Lost Lands: Dark Overlord	2015-06-26	26	202	11	37	0.8592000000000001
System Shock: Enhanced Edition	2015-10-22	570	1598	175	745	0.8591
Lost Lands: A Hidden Object Adventure	2015-09-24	423	4604	579	1002	0.8587
Tom Clancy's Rainbow Six Siege	2015-12-01	201053	975285	153441	354494	0.8586
Quell Memento	2015-05-14	9	178	9	18	0.8584999999999999
Tallowmere	2015-03-03	567	729	69	636	0.8582
Oh...Sir! Prototype	2015-12-21	223	768	75	298	0.8570000000000001
Militia	2015-12-02	51	129	5	56	0.8570000000000001
hocus	2015-11-18	1033	659	62	1095	0.8569
UBERMOSH	2015-08-13	1545	2469	296	1841	0.8568000000000001
PewDiePie: Legend of the Brofist	2015-12-10	376	1366	150	526	0.8568000000000001
Robbery Bob: Man of Steal	2015-10-21	7	91	2	9	0.8566
Teeworlds	2015-08-24	956	3801	481	1437	0.8564
Lost Lands: The Four Horsemen	2015-07-14	31	244	16	47	0.8563
METAL SLUG	2015-06-25	354	2839	349	703	0.8561
Transformice	2015-01-30	5636	21094	3048	8684	0.8558
Cars	2015-02-24	108	1633	187	295	0.8558
Chicken Invaders 3	2015-06-08	105	261	18	123	0.8556
Gathering Sky	2015-08-13	23	298	22	45	0.8554
Fort Meow	2015-06-25	103	231	15	118	0.8554
The Beginner's Guide	2015-10-01	947	16395	2357	3304	0.8549
Letter Quest: Grimm's Journey Remastered	2015-08-05	1284	431	37	1321	0.8549
Zombie Army Trilogy	2015-03-06	4320	13664	1954	6274	0.8544
Quiplash	2015-06-30	2855	1739	205	3060	0.8542000000000001
Time Clickers	2015-07-23	7003	4360	574	7577	0.8540000000000001
Turtle Odyssey	2015-10-21	8	121	5	13	0.8532
Grand Theft Auto V	2015-04-13	364548	1319655	219551	584099	0.8525
Tcheco in the Castle of Lucio	2015-06-22	1276	878	94	1370	0.8525
Lords of Magic: Special Edition	2015-12-03	70	373	32	102	0.8520000000000001
Quell Reflect	2015-05-14	6	140	7	13	0.8519
Chip's Challenge 1	2015-05-28	259	667	68	327	0.8516
Circa Infinity	2015-09-09	13	247	18	31	0.8516
Portal of Evil: Stolen Runes Collector's Edition	2015-05-26	1141	405	36	1177	0.8515
Leo's Fortune	2015-09-08	55	301	24	79	0.8515
MechaNika	2015-07-16	202	671	69	271	0.8511
Hidden Object Bundle 4 in 1	2015-10-07	140	298	24	164	0.8506999999999999
Please, Don’t Touch Anything	2015-03-26	923	3987	542	1465	0.8502
Super Mega Baseball: Extra Innings	2015-08-21	310	832	91	401	0.85
Boring Man - Online Tactical Stickman Combat	2015-02-20	1032	4764	660	1692	0.8499
Ys VI: The Ark of Napishtim	2015-04-28	222	935	106	328	0.8490000000000001
oO	2015-07-07	67	823	91	158	0.8490000000000001
Tasty Blue	2015-02-11	108	490	48	156	0.8489
TransPlan	2015-06-08	27	247	19	46	0.8489
Ballads of Reemus: When the Bed Bites	2015-04-27	6	66	1	7	0.8489
Absolute Drift	2015-07-29	352	2457	322	674	0.8488
Catlateral Damage	2015-05-27	94	1137	134	228	0.8487
Lowglow	2015-12-03	1826	415	39	1865	0.8484999999999999
Wars and Warriors: Joan of Arc	2015-09-03	16	260	21	37	0.8475
Planet Alcatraz 2	2015-08-12	43	225	17	60	0.8475
rFactor	2015-03-02	179	609	65	244	0.8468000000000001
Underrail	2015-12-18	1981	4541	649	2630	0.8464
Mighty Switch Force! Hyper Drive Edition	2015-06-25	37	230	18	55	0.8462000000000001
New York Mysteries: Secrets of the Mafia	2015-05-22	33	264	22	55	0.8461
Headcrab Frenzy!	2015-08-20	11	314	28	39	0.846
Without Within	2015-01-23	72	1776	231	303	0.8459000000000001
Cars Mater-National	2015-02-24	29	312	28	57	0.8455
Crash Drive 2	2015-05-28	5214	1148	141	5355	0.8454
Black Closet	2015-09-16	63	227	18	81	0.8452
Bulb Boy	2015-10-29	116	904	107	223	0.8451000000000001
TowerClimb	2015-09-22	32	310	28	60	0.8449
Sayonara Umihara Kawase	2015-10-06	59	135	8	67	0.8445999999999999
Port of Call	2015-08-28	106	1040	127	233	0.8445
Game Corp DX	2015-10-02	445	2678	372	817	0.8443
Missing Translation	2015-09-24	388	2710	377	765	0.8442000000000001
Evoland 2	2015-08-25	1043	3294	469	1512	0.8439
Pink Heaven	2015-11-04	47	648	73	120	0.8438
Tinertia	2015-09-03	18	104	5	23	0.8438
Verdun	2015-04-28	4541	31231	5130	9671	0.8437000000000001
Odallus: The Dark Call	2015-07-15	171	1061	132	303	0.8432
SLAMMED!	2015-01-30	32	103	5	37	0.8432
Anna's Quest	2015-07-02	159	1781	240	399	0.8427
Gary Grigsby's War in the East	2015-07-09	150	492	53	203	0.8423
Fortress Forever	2015-03-27	630	1237	160	790	0.8419
Batman™: Arkham Knight	2015-06-23	27406	84802	14663	42069	0.8415
Who Is Mike	2015-09-30	47	398	41	88	0.8415
GRANDIA II HD Remaster	2015-08-24	798	1844	253	1051	0.8414
Heroes of Hellas 3: Athens	2015-03-13	772	165	12	784	0.8414
Catacomb Kids	2015-02-20	119	515	57	176	0.8412000000000001
Waves 2: Notorious	2015-12-16	75	231	20	95	0.8408
Metamorphabet	2015-04-29	10	99	5	15	0.8406
DARK SOULS™ II: Scholar of the First Sin	2015-04-01	12106	75672	13188	25294	0.8402
The Black Watchmen	2015-08-27	206	645	76	282	0.8402
Pathologic Classic HD	2015-10-29	330	2706	396	726	0.8392000000000001
Company of Heroes: Europe at War	2015-05-18	126	973	125	251	0.8392000000000001
Thea: The Awakening	2015-11-20	1742	3155	473	2215	0.8383
Grapple	2015-03-09	462	302	30	492	0.8383
Dex	2015-05-07	217	2730	405	622	0.838
Wolfenstein: The Old Blood German Edition	2015-05-05	742	713	88	830	0.838
Ephemerid: A Musical Adventure	2015-02-04	58	199	17	75	0.8379000000000001
Rubber Ducky and the Rainbow Gun	2015-12-15	523	157	12	535	0.8376000000000001
Shadowrun: Hong Kong - Extended Edition	2015-08-20	7260	3715	570	7830	0.8373999999999999
GOCCO OF WAR	2015-11-18	415	872	113	528	0.8369
The Enchanted Cave 2	2015-06-03	238	595	72	310	0.8367
NotTheNameWeWanted	2015-07-02	383	2307	342	725	0.8362999999999999
Fragile Allegiance	2015-06-30	11	83	4	15	0.8361000000000001
PARTICLE MACE	2015-01-23	569	1206	166	735	0.8359000000000001
Conquest of Elysium 4	2015-11-16	234	494	58	292	0.8359000000000001
Oddworld: New 'n' Tasty	2015-02-25	1457	2758	419	1876	0.8356
Knights of Pen and Paper 2	2015-10-20	661	2139	317	978	0.8356
War for the Overworld	2015-04-02	2227	6139	996	3223	0.8355
Pixel Dungeon	2015-05-29	27	358	39	66	0.8355
Cubot	2015-01-08	71	247	24	95	0.8353
The Knobbly Crook	2015-06-09	85	185	16	101	0.8353
Victor Vran	2015-07-24	2485	5210	840	3325	0.8349
War of the Human Tanks - ALTeR	2015-02-13	56	91	5	61	0.8349
AKIBA'S TRIP: Undead & Undressed	2015-05-26	507	2682	411	918	0.8345
Action Henk	2015-05-11	241	726	94	335	0.8342
Space Pilgrim Episode I: Alpha Centauri	2015-12-21	16445	1037	143	16588	0.8338
SHOGUN: Total War™ - Collection	2015-06-25	195	701	91	286	0.8334999999999999
Super 3-D Noah's Ark	2015-06-23	140	706	92	232	0.8333
Mega Man Legacy Collection	2015-08-25	484	3268	516	1000	0.8331999999999999
Goscurry	2015-01-16	9	37	0	9	0.8327
To Be or Not To Be	2015-02-04	25	232	23	48	0.8326000000000001
Commander Cool 2	2015-12-17	1619	886	121	1740	0.8325
Cosmochoria	2015-04-27	157	415	49	206	0.8323
RFLEX	2015-08-26	18	186	17	35	0.8323
Reverse Crawl	2015-09-24	164	475	58	222	0.8321
The Cat Machine	2015-08-12	30	130	10	40	0.8320000000000001
Angry Arrows	2015-08-13	14	146	12	26	0.8319
Card Hunter	2015-07-13	5800	4261	698	6498	0.8315000000000001
NOT A HERO	2015-05-14	224	1712	258	482	0.8314
KeeperRL	2015-03-31	179	913	127	306	0.8312
The Music Machine	2015-05-06	74	383	45	119	0.8312
Sakura Fantasy Chapter 1	2015-05-29	355	937	131	486	0.8311000000000001
12 Labours of Hercules IV: Mother Nature	2015-12-25	166	452	56	222	0.8301000000000001
BADLAND: Game of the Year Edition	2015-05-26	367	2416	383	750	0.8299
Seduce Me the Otome	2015-06-05	238	1858	287	525	0.8298000000000001
Penumbra: Necrologue	2015-02-02	2385	568	74	2459	0.8298000000000001
Terra Nova: Strike Force Centauri	2015-07-23	44	66	3	47	0.8295
Star Trek™: Judgment Rites	2015-05-08	14	46	1	15	0.8295
Ubinota	2015-03-04	68	202	20	88	0.8294
Assassin's Creed Rogue	2015-03-10	2371	11366	2019	4390	0.8292
Koala Kids	2015-06-22	986	215	22	1008	0.8288
Mind Snares: Alice's Journey	2015-04-23	342	657	89	431	0.8287000000000001
Teddy Floppy Ear - Mountain Adventure	2015-01-09	992	625	84	1076	0.8287000000000001
The Coma	2015-10-19	44	264	29	73	0.8286
Steredenn	2015-10-01	242	761	106	348	0.8285
Over 9000 Zombies!	2015-02-25	784	1266	190	974	0.8283
Transcendence	2015-07-23	29	155	14	43	0.8283
Glorkian Warrior: The Trials Of Glork	2015-03-24	577	304	35	612	0.8281000000000001
Planetary Annihilation: TITANS	2015-08-18	4577	10938	1959	6536	0.828
Princess Evangile	2015-03-27	73	205	21	94	0.8276000000000001
Rebel Galaxy	2015-10-20	5717	6525	1142	6859	0.8273
Bob Was Hungry	2015-08-19	183	529	70	253	0.8273
Subspace Continuum	2015-07-03	208	488	65	273	0.8254000000000001
Swapperoo	2015-12-19	93	62	3	96	0.8253
Age of Fear: The Undead King	2015-06-26	39	313	38	77	0.8247
Dragon's Wake	2015-12-11	85	364	46	131	0.8245
Claws & Feathers	2015-03-26	200	70	4	204	0.8244
JUDGEMENT SILVERSWORD - Resurrection -	2015-09-18	12	61	3	15	0.8242
Super Cyborg	2015-07-08	134	622	88	222	0.8240000000000001
Mortal Kombat X	2015-04-14	15743	40877	7974	23717	0.8237000000000001
Grey Cubes	2015-05-15	28	412	54	82	0.8237000000000001
Sublevel Zero Redux	2015-10-08	144	442	59	203	0.8234
Stalingrad	2015-03-25	26	334	42	68	0.8231999999999999
Bloo Kid 2	2015-10-01	69	236	27	96	0.8231999999999999
ARMED SEVEN	2015-03-06	29	60	3	32	0.823
Rebuild 3: Gangs of Deadsville	2015-05-29	1185	1500	242	1427	0.8229000000000001
Sakura Swim Club	2015-09-11	234	2427	414	648	0.8219
Notrium	2015-12-08	7	59	3	10	0.8219
Sparkle 2	2015-06-01	51	171	18	69	0.8214
BLACKHOLE	2015-02-27	248	867	133	381	0.8211
Concrete Jungle	2015-09-23	130	522	74	204	0.821
60 Seconds!	2015-05-26	1067	9297	1750	2817	0.8209000000000001
Expand	2015-10-01	37	370	49	86	0.8209000000000001
Rescue Team 1	2015-02-19	927	128	12	939	0.8209000000000001
Message Quest	2015-10-22	47	738	111	158	0.8208
Shelter 2	2015-03-09	607	3393	603	1210	0.8203
Roche Fusion	2015-01-23	20	90	7	27	0.8201999999999999
Azure Striker Gunvolt	2015-08-28	132	1281	210	342	0.8194
Close Your Eyes	2015-08-31	92	666	100	192	0.8194
Sakura Clicker	2015-07-30	9127	12423	2402	11529	0.8192
Fine Sweeper	2015-05-25	103	388	53	156	0.8190999999999999
Plug & Play	2015-03-05	104	3955	719	823	0.8190000000000001
The Isle	2015-12-02	11973	51703	10528	22501	0.8189000000000001
Inside My Radio	2015-05-11	67	399	55	122	0.8188
Stock Car Extreme	2015-02-11	166	485	70	236	0.8181
Earthtongue	2015-04-27	1189	178	20	1209	0.8179000000000001
Just Cause 3	2015-12-01	23459	89870	18694	42153	0.8178000000000001
12 is Better Than 6	2015-11-20	4517	4964	926	5443	0.8177
FIREFIGHT RELOADED	2015-11-05	47	454	65	112	0.8177
Executive Assault	2015-07-17	170	1241	206	376	0.8176000000000001
Super Chibi Knight	2015-06-24	35	345	47	82	0.8172
Mute Crimson+	2015-08-13	9	136	14	23	0.8169
12 Labours of Hercules III: Girl Power	2015-08-07	1642	829	132	1774	0.8168000000000001
PANORAMICAL	2015-09-17	24	189	22	46	0.8168000000000001
Avernum 2: Crystal Souls	2015-01-14	308	239	30	338	0.8165000000000001
Mountain Crime: Requital	2015-08-28	496	342	47	543	0.8162
Braveland Pirate	2015-09-14	57	330	45	102	0.8162
The Juicer	2015-09-11	1711	263	34	1745	0.8161
Gnomes Garden	2015-12-18	1639	262	34	1673	0.8158
Draw a Stickman: EPIC 2	2015-11-06	205	605	93	298	0.8157
Sound of Drop - fall into poison -	2015-10-30	75	410	59	134	0.8155
Industry Giant 2	2015-08-14	262	691	109	371	0.8151
Silver Creek Falls - Chapter 1	2015-08-13	107	523	79	186	0.8151
Fallout 4	2015-11-10	472962	250813	54388	527350	0.8146
Area-X	2015-06-24	5	26	0	5	0.8146
ADOM (Ancient Domains Of Mystery)	2015-11-16	312	1141	194	506	0.8140000000000001
Runestone Keeper	2015-03-23	2280	2041	368	2648	0.8139000000000001
MetaHuman Inc.	2015-12-18	170	138	15	185	0.8137000000000001
Shadow Blade: Reload	2015-08-10	53	298	41	94	0.8135
Farm Frenzy: Hurricane Season	2015-07-03	190	90	8	198	0.8135
JumpJet Rex	2015-04-21	66	425	63	129	0.8134
Mystik Belle	2015-05-22	12	176	21	33	0.8133
The Confines Of The Crown	2015-04-03	48	207	26	74	0.8131999999999999
Beeswing	2015-05-08	1054	110	11	1065	0.8128000000000001
Mooch	2015-09-07	13	110	11	24	0.8128000000000001
Crazy Chicken	2015-02-05	41	278	38	79	0.8127
Eastside Hockey Manager	2015-12-01	964	1069	183	1147	0.8125
WE ARE DOOMED	2015-04-21	5	25	0	5	0.8125
The Quest	2015-12-21	83	381	56	139	0.8123
Call of Duty: Black Ops III	2015-11-06	63681	134365	29322	93003	0.8122
404Sight	2015-04-16	255	1383	244	499	0.8122
how do you Do It?	2015-02-27	170	2193	407	577	0.8113
Vox Populi Vox Dei 2	2015-03-17	969	403	61	1030	0.8105
Sunless Sea	2015-02-06	4049	7181	1450	5499	0.8103
Star Trek™: 25th Anniversary	2015-05-07	20	107	11	31	0.8103
Cloudrift	2015-10-30	3	24	0	3	0.8103
Roads of Rome 2	2015-10-16	14	42	2	16	0.81
VRC PRO	2015-03-24	193	586	95	288	0.8099
Iggy's Egg Adventure	2015-08-28	49	206	27	76	0.8098000000000001
Environmental Station Alpha	2015-04-22	66	973	169	235	0.8097
Tick Tock Isle	2015-11-20	344	263	37	381	0.8090999999999999
DinoSystem	2015-06-25	19	228	31	50	0.809
Adventures of Bertram Fiddle: Episode 1: A Dreadly Business	2015-04-02	14	408	63	77	0.8089000000000001
Adventures of Pip	2015-06-04	28	222	30	58	0.8089000000000001
ROOMS: The Toymaker's Mansion	2015-05-01	16	105	11	27	0.8086
Without Within 2	2015-11-09	18	208	28	46	0.8078000000000001
Luxor HD	2015-05-11	25	104	11	36	0.8077
Idol Magical Girl Chiru Chiru Michiru Part 1	2015-07-30	69	154	19	88	0.8076000000000001
Space - The Return Of The Pixxelfrazzer	2015-11-02	15	32	1	16	0.8072
Vampire Legends: The True Story of Kisilova	2015-12-03	203	502	82	285	0.8068000000000001
On A Roll 3D	2015-02-12	921	229	32	953	0.8068000000000001
Rescue Team 2	2015-09-23	66	40	2	68	0.8066
Sakura Santa	2015-12-21	75	543	90	165	0.8065000000000001
Vehicle Simulator	2015-12-09	50	216	30	80	0.8061
Phantom Breaker: Battle Grounds	2015-01-24	424	2485	487	911	0.8059000000000001
AR-K: The Great Escape	2015-07-14	39	102	11	50	0.8059000000000001
Knight Squad	2015-11-16	134	327	50	184	0.8058
The Rainy Port Keelung	2015-03-31	32	332	51	83	0.8057
Crash Dive	2015-07-06	55	151	19	74	0.8057
LOST ORBIT	2015-05-12	66	47	3	69	0.8053
868-HACK	2015-01-27	33	88	9	42	0.8048000000000001
Mayan Death Robots	2015-11-20	21	61	5	26	0.8046
Decisive Campaigns: The Blitzkrieg from Warsaw to Paris	2015-01-22	52	94	10	62	0.8044
Primal Carnage: Extinction	2015-04-04	874	6740	1420	2294	0.8043000000000001
Deathtrap	2015-02-04	948	1652	318	1266	0.8041
Sakura Angels	2015-01-16	309	1851	360	669	0.804
Crusaders of the Lost Idols	2015-10-13	4068	2369	471	4539	0.8037000000000001
Microcosmum: survival of cells	2015-07-24	408	1096	204	612	0.8035
Cardinal Quest 2	2015-11-23	23	93	10	33	0.8034
Magicka 2	2015-05-26	6426	9367	2023	8449	0.8029999999999999
Nubs' Adventure	2015-10-12	5	30	1	6	0.8029999999999999
Ground Control II	2015-07-08	61	192	27	88	0.8024
Karate Master 2 Knock Down Blow	2015-03-20	161	544	94	255	0.8022
Farm Mania: Hot Vacation	2015-10-23	10	52	4	14	0.8017000000000001
Armello	2015-09-01	3614	12201	2691	6305	0.8016
Exanima	2015-04-29	838	7834	1696	2534	0.8016
Reveal The Deep	2015-12-04	140	1207	231	371	0.8013
Chris Sawyer's Locomotion	2015-03-17	61	458	78	139	0.8009999999999999
Dirty Bomb	2015-06-02	13113	47010	10856	23969	0.8009000000000001
Spermination	2015-04-29	153	370	61	214	0.8008
Void Invaders	2015-08-14	864	307	49	913	0.8006000000000001
Ame no Marginal -Rain Marginal-	2015-07-07	177	327	53	230	0.8003
HueBots	2015-08-26	16	44	3	19	0.8002
Adelantado Trilogy. Book one	2015-12-01	14	44	3	17	0.8002
Audiosurf 2	2015-05-26	473	4742	1015	1488	0.7998000000000001
Dead Synchronicity: Tomorrow Comes Today	2015-04-10	108	1062	204	312	0.7994
Frankenstein: Master of Death	2015-03-09	1404	1586	317	1721	0.7991
Total War: ATTILA	2015-02-17	26346	24810	5710	32056	0.7989
The Purring Quest	2015-11-12	90	1231	242	332	0.7984
Wick	2015-12-17	20	522	93	113	0.7983
Siralim	2015-04-24	139	217	33	172	0.7983
Farm Frenzy: Heave Ho	2015-08-26	1188	88	10	1198	0.7981999999999999
The Mean Greens - Plastic Warfare	2015-12-08	2836	8132	1814	4650	0.7977
Ben and Ed	2015-12-08	214	2348	489	703	0.7977
Rats - Time is running out!	2015-08-19	380	247	39	419	0.7974
Canabalt	2015-04-30	33	226	35	68	0.7974
Fire: Ungh’s Quest	2015-04-09	66	498	89	155	0.7973
Below Kryll	2015-09-07	27	93	11	38	0.7970999999999999
Tennis in the Face	2015-11-18	90	93	11	101	0.7970999999999999
Monsterland	2015-12-14	5	35	2	7	0.7968000000000001
Trove	2015-07-09	58949	72087	17349	76298	0.7961
Twinsen's Little Big Adventure Classic	2015-10-20	26	295	49	75	0.7959999999999999
Sacra Terra: Angelic Night	2015-07-02	440	290	48	488	0.7959999999999999
Polychromatic	2015-10-02	19	27	1	20	0.7958
Pixel Galaxy	2015-10-02	512	153	22	534	0.7954000000000001
Sunrider Academy	2015-04-15	234	963	190	424	0.7951
Tales of Zestiria	2015-10-19	9696	6877	1553	11249	0.795
F-19 Stealth Fighter	2015-04-01	7	67	7	14	0.7948999999999999
In Between	2015-08-21	1504	337	58	1562	0.7948000000000001
Masochisia	2015-10-09	20	332	57	77	0.7948000000000001
Another Star	2015-07-28	226	41	3	229	0.7945000000000001
Choice of Kung Fu	2015-12-11	24	41	3	27	0.7945000000000001
The Fall of the Dungeon Guardians	2015-11-06	205	491	90	295	0.7943000000000001
MISSING: An Interactive Thriller - Episode One	2015-05-25	24	533	99	123	0.7941
Square Heroes	2015-04-09	689	214	34	723	0.794
Community College Hero: Trial by Fire	2015-12-04	206	214	34	240	0.794
Hatred	2015-06-01	3085	11760	2739	5824	0.7937000000000001
Unhack	2015-01-09	139	254	42	181	0.7936
Over The Hills And Far Away	2015-09-16	14	177	27	41	0.7936
Machineers	2015-05-15	10	26	1	11	0.7931999999999999
Uncraft World	2015-09-25	29	394	71	100	0.7927
Just Get Through	2015-01-30	74	186	29	103	0.7927
Ultimate Tic-Tac-Toe	2015-04-28	309	1246	257	566	0.7926000000000001
State of Decay: Year-One	2015-04-28	3339	8474	1979	5318	0.7915000000000001
the static speaks my name	2015-08-10	168	4408	1000	1168	0.7914
FINAL FANTASY VI	2015-12-16	577	2010	435	1012	0.7913
DARIUSBURST Chronicle Saviours	2015-12-04	498	576	111	609	0.7911
Penarium	2015-09-22	126	312	55	181	0.7909999999999999
SimpleRockets	2015-06-04	379	302	53	432	0.7909
Brighter Day	2015-07-17	8	70	8	16	0.7908
Manyland	2015-12-07	397	238	40	437	0.7907
Fox & Flock	2015-06-09	768	162	25	793	0.7906000000000001
Let's Explore The Airport (Junior Field Trips)	2015-04-24	16	58	6	22	0.7906000000000001
Anode	2015-10-05	246	87	11	257	0.7905
Moonstrider	2015-09-30	5	17	0	5	0.7905
Deathstate	2015-10-20	144	296	52	196	0.7904000000000001
Gunman Clive 2	2015-09-03	13	98	13	26	0.7904000000000001
Let's Explore The Farm (Junior Field Trips)	2015-04-24	13	39	3	16	0.7904000000000001
ENIGMA : An Illusion Named Family	2015-03-19	6	25	1	7	0.7904000000000001
Champions Of Chaos 2	2015-09-24	6	25	1	7	0.7904000000000001
Legends of Pixelia	2015-09-14	8	25	1	9	0.7904000000000001
Bit Shifter	2015-11-02	4	25	1	5	0.7904000000000001
Raiden IV: OverKill	2015-09-03	47	471	89	136	0.7903
Avalanche 2: Super Avalanche	2015-06-11	969	207	34	1003	0.7902
Airscape: The Fall of Gravity	2015-08-11	925	2184	480	1405	0.7901
Mitos.is: The Game	2015-07-29	5299	9478	2250	7549	0.7898000000000001
Zombie Exodus	2015-10-23	142	135	20	162	0.7898000000000001
The Age of Decadence	2015-10-14	703	2672	597	1300	0.7896
Strania - The Stella Machina -	2015-11-24	23	45	4	27	0.7895000000000001
Nusakana	2015-11-20	17	69	8	25	0.7894
Dungeons 2	2015-04-24	11705	3988	916	12621	0.789
Lumini	2015-09-03	20	134	20	40	0.789
Assassin's Creed Syndicate	2015-11-19	4729	19247	4708	9437	0.7889
Forward to the Sky	2015-01-30	7227	1729	377	7604	0.7889
Swordbreaker The Game	2015-11-06	197	335	61	258	0.7888
Legacy of Dorn: Herald of Oblivion	2015-12-03	57	144	22	79	0.7887000000000001
Psycho Starship Rampage	2015-09-28	91	123	18	109	0.7886
Hollywood Visionary	2015-05-01	43	74	9	52	0.7884000000000001
Virtual Pool 4	2015-05-11	108	495	96	204	0.7881999999999999
Moonshot	2015-12-21	15	85	11	26	0.7881999999999999
SMITE	2015-09-08	31169	86330	21968	53137	0.7881
Apotheon Arena	2015-12-08	363	864	179	542	0.7879
Interloper	2015-05-21	1210	323	59	1269	0.7879
Champion of the Gods	2015-07-17	141	148	23	164	0.7879
Dustoff Heli Rescue	2015-03-06	144	304	55	199	0.7878000000000001
OlliOlli2: Welcome to Olliwood	2015-08-11	118	483	94	212	0.7874
Freaking Meatbags	2015-02-04	61	137	21	82	0.7873000000000001
Fuego!	2015-11-16	10	50	5	15	0.7873000000000001
Ookibloks	2015-10-08	2133	50	5	2138	0.7873000000000001
Trash TV	2015-02-23	17	111	16	33	0.7872
Pushcat	2015-01-12	99	84	11	110	0.787
Astrox: Hostile Space Excavation	2015-12-01	138	362	68	206	0.7868
You Must Build A Boat	2015-06-04	706	816	170	876	0.7865000000000001
Angels Fall First	2015-10-01	1130	2027	456	1586	0.7863
Spooky Cats	2015-06-04	354	354	67	421	0.7856000000000001
Comedy Quest	2015-09-02	125	247	44	169	0.7856000000000001
Marble Age	2015-03-04	259	574	116	375	0.7855
Among the Heavens	2015-11-06	524	242	43	567	0.7855
Burnstar	2015-03-18	142	43	4	146	0.7855
Prompt	2015-07-06	11	43	4	15	0.7855
NOBUNAGA'S AMBITION: Sphere of Influence	2015-09-01	1166	471	93	1259	0.7854000000000001
Mushroom 11	2015-10-15	184	533	107	291	0.7853
Sixth Grade Detective	2015-12-21	31	30	2	33	0.7848
Warhammer: End Times - Vermintide	2015-10-23	24700	16170	4049	28749	0.7846
Forget Me Not: My Organic Garden	2015-08-21	46	333	63	109	0.7846
Goosebumps	2015-10-13	21	202	35	56	0.7845000000000001
Legends of Solitaire: Curse of the Dragons	2015-09-28	68	103	15	83	0.7844
Reverse x Reverse	2015-12-10	8	23	1	9	0.7844
Immortal Defense	2015-08-31	24	158	26	50	0.7842
PixelJunk™ Shooter Ultimate	2015-10-21	195	153	25	220	0.7841
Planet of the Eyes	2015-08-24	120	444	88	208	0.784
Zero Punctuation: Hatfall - Hatters Gonna Hat Edition	2015-11-20	43	239	43	86	0.784
rFactor 2	2015-11-12	1769	5497	1330	3099	0.7837999999999999
Breezeblox	2015-05-15	8	76	10	18	0.7837000000000001
Making History: The Calm and the Storm Gold Edition	2015-05-19	99	142	23	122	0.7831999999999999
Prominence	2015-11-07	32	122	19	51	0.7831
Word Wonders: The Tower of Babel	2015-05-08	6	15	0	6	0.783
Gilbert Goodmate and the Mushroom of Phungoria	2015-06-23	4	15	0	4	0.783
Ostrich Island	2015-01-09	417	217	39	456	0.7822
Splendor	2015-09-17	329	811	175	504	0.782
STAR WARS™: X-Wing Alliance™	2015-04-28	120	348	68	188	0.7818
ONE PIECE PIRATE WARRIORS 3	2015-08-27	4274	7177	1781	6055	0.7817000000000001
Ancient Planet	2015-02-03	158	778	168	326	0.7814
Replay - VHS is not dead	2015-07-09	91	41	4	95	0.7813
Scarab Tales	2015-07-01	2031	41	4	2035	0.7813
Ossuary	2015-05-27	9	35	3	12	0.7813
Fahrenheit: Indigo Prophecy Remastered	2015-01-29	417	4318	1052	1469	0.7812000000000001
STASIS	2015-08-31	284	1402	319	603	0.7812000000000001
Fractured Soul	2015-02-06	6	22	1	7	0.7811
Super Galaxy Squadron EX Turbo	2015-01-23	59	359	71	130	0.7809999999999999
Gridworld	2015-12-24	309	182	32	341	0.7809
Kings of Israel	2015-12-21	43	74	10	53	0.7809
Blockstorm	2015-05-21	1411	5180	1278	2689	0.7806000000000001
Ground Control Anthology	2015-07-08	40	129	21	61	0.7805
Casino Inc	2015-04-17	38	209	38	76	0.7803
Red Game Without A Great Name	2015-12-09	874	68	9	883	0.7798999999999999
Cultures - 8th Wonder of the World	2015-03-26	45	338	67	112	0.7797000000000001
Cultures - Northland	2015-03-26	726	433	89	815	0.7794
Mighty Switch Force! Hose It Down!	2015-06-04	10	57	7	17	0.7794
Enemy	2015-03-17	49	137	23	72	0.7791
Pixel Star	2015-05-22	284	103	16	300	0.779
Gun Wings	2015-12-08	58	237	45	103	0.7782
Girlfriend Rescue	2015-07-10	914	178	32	946	0.7782
BAD END	2015-11-25	293	303	60	353	0.778
Lemma	2015-05-12	189	196	36	225	0.778
INK	2015-08-05	184	1274	295	479	0.7779
DungeonUp	2015-09-04	1499	363	74	1573	0.7777
Straima	2015-09-25	44	56	7	51	0.7777
Melter Man	2015-09-22	15	21	1	16	0.7777
Gulf of Aden - Task Force Somalia	2015-12-14	73	21	1	74	0.7777
The Way We ALL GO	2015-03-24	13	116	19	32	0.7774
Mimpi	2015-01-20	628	243	47	675	0.7767000000000001
Witch's Pranks: Frog's Fortune Collector's Edition	2015-01-15	10	194	36	46	0.7767000000000001
Counter Spell	2015-10-05	81	120	20	101	0.7766
All My Gods	2015-10-13	17	86	13	30	0.7765000000000001
Miracle Fly	2015-10-27	56	81	12	68	0.7765000000000001
Parcel	2015-04-22	47	110	18	65	0.7762000000000001
Tengami	2015-01-15	58	1316	310	368	0.7759
Chip's Challenge 2	2015-05-28	82	100	16	98	0.7757
Alien Robot Monsters	2015-09-10	35	100	16	51	0.7757
Fighties	2015-07-14	94	223	43	137	0.7754000000000001
High School Musical 3	2015-02-24	9	75	11	20	0.7751000000000001
Soccer Rage	2015-06-02	6	543	119	125	0.7748999999999999
Super Indie Karts	2015-05-06	11	346	72	83	0.7745000000000001
Last Word	2015-05-08	58	316	65	123	0.7744
Windward	2015-05-12	3510	2748	686	4196	0.7743000000000001
Wave Mechanics	2015-08-03	10	38	4	14	0.7743000000000001
D4: Dark Dreams Don't Die	2015-06-05	268	1542	372	640	0.7742
Halo: Spartan Strike	2015-04-16	117	1034	243	360	0.7737999999999999
Planetbase	2015-10-15	6670	6959	1819	8489	0.7737
Survivalist	2015-01-30	592	1971	485	1077	0.7737
LIGHTNING RETURNS: FINAL FANTASY XIII	2015-12-10	2503	3112	786	3289	0.7736000000000001
Zenzizenzic	2015-07-23	13	74	11	24	0.7736000000000001
Living Legends: The Frozen Fear Collection	2015-10-13	17	74	11	28	0.7736000000000001
MechWarrior Online	2015-12-10	4155	8262	2183	6338	0.7731
Project CARS	2015-05-06	10688	11175	2989	13677	0.7726999999999999
Decisive Campaigns: Case Blue	2015-05-07	19	48	6	25	0.7725
Galacide	2015-07-28	235	78	12	247	0.7724
iZBOT	2015-09-01	20	217	43	63	0.7719
Vietnam ‘65	2015-03-05	127	322	68	195	0.7716
Cursed Sight	2015-08-03	61	173	33	94	0.7716
Unpossible	2015-07-03	11	110	19	30	0.7712000000000001
Star Ruler 2	2015-03-27	370	572	130	500	0.7711
Tales of the Orient: The Rising Sun	2015-02-27	1739	300	63	1802	0.7711
Resident Evil Revelations 2	2015-02-25	3686	18447	5058	8744	0.7709999999999999
STAR WARS™: TIE Fighter Special Edition	2015-04-28	134	431	95	229	0.7709999999999999
Steel Armor: Blaze of War	2015-03-05	30	241	49	79	0.7709999999999999
Tomb of Tyrants	2015-06-26	112	253	52	164	0.7706999999999999
Titan Souls	2015-04-14	4404	8876	2392	6796	0.7704000000000001
Default Dan	2015-03-18	7	52	7	14	0.7702
The Last Warlock	2015-08-24	25	52	7	32	0.7702
Way of the Samurai 4	2015-07-23	1557	1333	329	1886	0.7697
Gryphon Knight Epic	2015-08-20	173	221	45	218	0.7693000000000001
Oceanhorn: Monster of Uncharted Seas	2015-03-17	394	1525	381	775	0.7692
Reiner Knizia's The Confrontation	2015-09-22	5	12	0	5	0.7690000000000001
Block N Load	2015-04-30	8640	12063	3318	11958	0.7687
Spider: Rite of the Shrouded Moon	2015-08-06	17	94	16	33	0.7687
The Last NightMary - A Lenda do Cabeça de Cuia	2015-11-02	412	570	132	544	0.7686000000000001
Umihara Kawase Shun	2015-11-24	20	56	8	28	0.7683
The Uninvited: MacVenture Series	2015-01-26	27	51	7	34	0.7682
Redshift Blueshift	2015-09-24	56	46	6	62	0.7682
Color Symphony 2	2015-10-16	107	46	6	113	0.7682
Arcana Heart 3 LOVE MAX!!!!!	2015-09-30	172	358	79	251	0.7681
Razenroth	2015-08-28	1018	485	111	1129	0.768
NEON STRUCT	2015-05-20	82	268	57	139	0.7678
Loot Hound	2015-11-17	33	70	11	44	0.7675000000000001
Blood Bowl 2	2015-09-22	6511	6517	1774	8285	0.7671
Elite Dangerous	2015-04-02	28923	67860	19590	48513	0.767
Fake Colours	2015-01-01	1984	128	24	2008	0.7669
Heroes of Might & Magic III - HD Edition	2015-01-29	4656	14172	3964	8620	0.7667
Call of Tomsk-7	2015-08-10	75	370	83	158	0.7666
Gigachess	2015-12-15	36	74	12	48	0.7665000000000001
Gunjitsu	2015-07-31	155	692	166	321	0.7664
Hack RUN	2015-06-17	43	166	33	76	0.7664
Big Thinkers 1st Grade	2015-08-18	12	55	8	20	0.7664
Monstro: Battle Tactics	2015-12-03	1006	24	2	1008	0.7662000000000001
Volvox	2015-12-07	13	24	2	15	0.7662000000000001
Boogeyman	2015-11-02	136	467	108	244	0.7661
Aquadelic GT	2015-03-25	8	50	7	15	0.7661
Legends of Atlantis: Exodus	2015-09-03	16	69	11	27	0.7659
Shades of Black	2015-09-09	5	18	1	6	0.7658
A Bastard's Tale	2015-05-26	500	276	60	560	0.7656999999999999
Heroes Never Lose: Professor Puzzler's Perplexing Ploy	2015-11-24	19	64	10	29	0.7654000000000001
Earth Overclocked	2015-12-04	481	152	30	511	0.7653
Block Story	2015-12-10	75	1019	255	330	0.765
How to Take Off Your Mask	2015-07-10	61	143	28	89	0.7648999999999999
Khaba	2015-01-12	120	29	3	123	0.7645000000000001
Hack Run ZERO	2015-07-13	14	29	3	17	0.7645000000000001
Steel Rain	2015-12-03	194	86	15	209	0.7641
Gravity Error	2015-08-12	7	49	7	14	0.7640000000000001
The Secret of Tremendous Corporation	2015-10-12	127	272	60	187	0.7637
An Octave Higher	2015-03-27	34	236	51	85	0.7637
Parallax	2015-03-10	22	129	25	47	0.7637
Wait - Extended	2015-10-29	32	44	6	38	0.7637
Welcome to Boon Hill	2015-10-31	11	34	4	15	0.7637
2064: Read Only Memories	2015-10-06	139	1237	317	456	0.7636000000000001
Dev Guy	2015-05-21	275	1389	359	634	0.7635
The Reject Demon: Toko Chapter 0 - Prelude	2015-05-08	97	154	31	128	0.7635
Undefeated	2015-04-03	230	133	26	256	0.7635
One Final Chaos	2015-10-21	4	11	0	4	0.7634000000000001
Fingerbones	2015-08-03	177	2609	701	878	0.7631
Sakura Beach	2015-08-14	324	1137	291	615	0.763
No Time To Explain Remastered	2015-07-17	513	1893	501	1014	0.7628
Cosmophony	2015-07-09	203	85	15	218	0.7628
King of Dragon Pass	2015-07-28	1599	360	83	1682	0.7626999999999999
Plush	2015-02-14	8	67	11	19	0.7626000000000001
RPG MO	2015-08-18	810	2138	571	1381	0.7624
Luminosity	2015-04-09	2226	53	8	2234	0.7624
Mystery of Unicorn Castle: The Beastmaster	2015-12-18	14	71	12	26	0.7618
Darksiders II Deathinitive Edition	2015-11-05	2927	11789	3387	6314	0.7615999999999999
In Verbis Virtus	2015-04-03	248	1305	341	589	0.7613
Hyphen	2015-02-12	10	28	3	13	0.7612000000000001
Hegemony III: Clash of the Ancients	2015-08-25	251	394	93	344	0.7611
Weapon of Choice	2015-09-23	32	57	9	41	0.7611
Intergalactic Bubbles	2015-05-29	782	923	236	1018	0.7609
Quarries of Scred	2015-04-23	10	52	8	18	0.7603
Defend Your Life	2015-04-10	1367	847	217	1584	0.7597
Emily Wants To Play	2015-12-10	63	1460	389	452	0.7595000000000001
Venusian Vengeance	2015-03-27	32	74	13	45	0.7595000000000001
Caromble!	2015-08-28	117	47	7	124	0.7595000000000001
TY the Tasmanian Tiger 4	2015-09-17	41	209	46	87	0.7594
Home Design 3D	2015-11-20	240	1704	459	699	0.7593000000000001
Jotun: Valhalla Edition	2015-09-29	27501	6336	1812	29313	0.7592
Convoy	2015-04-21	464	1081	283	747	0.7592
Super Star Path	2015-06-22	100	271	62	162	0.7592
Pizza Express	2015-06-25	195	189	41	236	0.7592
Kingdoms	2015-10-23	781	2953	820	1601	0.7590000000000001
Hyperspace Invaders II: DX	2015-09-04	216	308	72	288	0.7586
Super Snow Fight	2015-11-24	5	22	2	7	0.7586
Pix the Cat	2015-01-29	153	303	71	224	0.7581
Crookz - The Big Heist	2015-08-25	101	257	59	160	0.7579000000000001
Mainland	2015-05-08	53	195	43	96	0.7579000000000001
DungeonRift	2015-07-01	10	32	4	14	0.7576999999999999
It came from space and ate our brains	2015-03-19	190	399	97	287	0.7575000000000001
Master Spy	2015-09-08	97	279	65	162	0.7575000000000001
Absent	2015-08-31	53	278	65	118	0.757
Destination Sol	2015-02-06	513	1047	278	791	0.7569
The Amber Throne	2015-07-06	21	142	30	51	0.7565999999999999
Highlands	2015-04-21	40	193	43	83	0.7565000000000001
ルナティックドーン 前途への道標	2015-01-09	38	41	6	44	0.7562000000000001
RIDE: Game	2015-03-27	598	1649	453	1051	0.7561
I Am Bread	2015-04-09	453	4410	1270	1723	0.7559
Dracula's Legacy	2015-10-22	710	558	142	852	0.7558
VERSUS: The Lost Ones	2015-08-21	123	141	30	153	0.7556
Domestic Dog	2015-04-10	228	390	96	324	0.7555
199X	2015-03-10	10	180	40	50	0.7555
Stories of Bethem: Full Moon	2015-12-11	97	84	16	113	0.7553000000000001
Idol Magical Girl Chiru Chiru Michiru Part 2	2015-07-30	60	67	12	72	0.755
Through Abandoned: The Underground City	2015-07-22	3561	392	97	3658	0.7549
Rescue Team 5	2015-11-19	192	92	18	210	0.7549
Toto Temple Deluxe	2015-09-29	20	45	7	27	0.7548
Sound Shift	2015-08-26	14	116	24	38	0.7545000000000001
8-Bit Adventures 1: The Forgotten Journey Remastered Edition	2015-05-22	138	112	23	161	0.7545000000000001
Networm	2015-10-27	5	21	2	7	0.7544
Lilly and Sasha: Curse of the Immortals	2015-04-29	872	317	77	949	0.7542
MANOS: The Hands of Fate ~ Director's Cut	2015-07-30	15	159	35	50	0.7542
Paperbound	2015-03-31	99	26	3	102	0.7541
The Charnel House Trilogy	2015-04-16	182	496	127	309	0.7535
Roads of Rome	2015-10-16	28	66	12	40	0.7533
NASCAR '15 Victory Edition	2015-05-22	109	852	229	338	0.753
Forge Quest	2015-05-29	493	430	109	602	0.753
Cross Set	2015-11-17	65	161	36	101	0.7526999999999999
The Secret Order 2: Masked Intent	2015-11-05	213	335	83	296	0.7525000000000001
Major\Minor	2015-12-08	72	335	83	155	0.7525000000000001
Evil Defenders	2015-11-11	177	295	72	249	0.7525000000000001
Seven Kingdoms 2 HD	2015-02-05	104	269	65	169	0.7523000000000001
Homesick	2015-05-28	80	1023	280	360	0.7522
Written in the Sky	2015-11-09	148	1654	468	616	0.7515999999999999
7,62 Hard Life	2015-10-01	138	368	93	231	0.7512000000000001
Pumped BMX +	2015-09-18	32	245	59	91	0.7512000000000001
Lucky Rabbit Reflex!	2015-10-09	57	30	4	61	0.7512000000000001
SUMICO - The Numbers Game	2015-07-03	4	15	1	5	0.751
SKYHILL	2015-10-06	384	3236	950	1334	0.7509
Ninja Pizza Girl	2015-09-30	62	251	61	123	0.7505
BEARZERKERS	2015-10-23	4	9	0	4	0.75
Puzzle Strike	2015-12-21	27	43	7	34	0.7498
Highschool Romance	2015-11-18	62	455	119	181	0.7495
Prismatica	2015-07-01	5	34	5	10	0.7493000000000001
Inbetween Land	2015-02-20	97	194	46	143	0.7492000000000001
Vortex Attack	2015-05-27	168	80	16	184	0.7492000000000001
Miner Warfare	2015-06-12	525	119	26	551	0.7491
Into The Gloom	2015-04-07	58	179	42	100	0.7490000000000001
Galactic Civilizations III	2015-05-14	6297	7697	2360	8657	0.7488
Interplanetary	2015-05-12	364	622	168	532	0.7488
stratO	2015-06-01	52	51	9	61	0.7484999999999999
Big Thinkers Kindergarten	2015-08-18	27	51	9	36	0.7484999999999999
Noctropolis	2015-09-03	44	51	9	53	0.7484999999999999
NEO AQUARIUM - The King of Crustaceans -	2015-06-08	32	251	62	94	0.7484000000000001
Mu Complex	2015-10-24	60	156	36	96	0.7484000000000001
Star Trek™: Starfleet Academy	2015-05-08	22	87	18	40	0.7479000000000001
Hypership Out of Control	2015-09-29	691	29	4	695	0.7478
Asguaard	2015-04-10	77	83	17	94	0.7477
Lux Delux	2015-05-01	259	271	68	327	0.7476
Stay Alight	2015-03-02	240	155	36	276	0.7475
Empire TV Tycoon	2015-10-20	296	660	181	477	0.7473000000000001
This Starry Midnight We Make	2015-06-01	16	42	7	23	0.7471
Inferno 2	2015-07-29	18	42	7	25	0.7471
Corgi Warlock	2015-12-03	2365	277	70	2435	0.747
Sky Gamblers: Storm Raiders	2015-01-08	41	191	46	87	0.747
MotoGP™15	2015-06-23	276	682	188	464	0.7469
Alpha Polaris : A Horror Adventure Game	2015-10-22	69	354	92	161	0.7469
Shipwreck	2015-02-13	21	169	40	61	0.7469
Mold on Pizza 🍕	2015-09-25	28	113	25	53	0.7467
Way to Go!	2015-06-08	4	24	3	7	0.7463
Flem	2015-04-28	9	33	5	14	0.7461
Mayhem Triple	2015-09-04	50	33	5	55	0.7461
Waste Walkers	2015-12-01	85	157	37	122	0.746
Luckslinger	2015-07-16	13	101	22	35	0.7459
Front Office Football Seven	2015-02-04	132	116	26	158	0.7458
David.	2015-02-16	549	575	158	707	0.7454000000000001
Clandestine	2015-11-05	136	371	98	234	0.7454000000000001
Naught Reawakening	2015-09-10	5	14	1	6	0.7453000000000001
神楽道中記(KaguraDouchuuki)	2015-10-23	11	14	1	12	0.7453000000000001
Formula Truck 2013	2015-02-02	31	156	37	68	0.7452
Starship Rubicon	2015-07-13	106	37	6	112	0.7451000000000001
Mos Speedrun 2	2015-09-03	4	19	2	6	0.7451000000000001
Curse of the Assassin	2015-05-13	40	19	2	42	0.7451000000000001
Crystal Towers 2	2015-08-11	46	19	2	48	0.7451000000000001
Hard West	2015-11-18	874	3361	1025	1899	0.745
Order of Battle: World War II	2015-04-30	2171	2006	598	2769	0.745
Castle In The Darkness	2015-02-05	273	926	265	538	0.7445999999999999
Shmadow	2015-11-03	34	159	38	72	0.7445999999999999
DiscStorm	2015-08-20	12	28	4	16	0.7441
An Assassin in Orlandes	2015-05-13	624	69	14	638	0.7440000000000001
Air Brawl	2015-11-05	107	1126	328	435	0.7438
InMind VR	2015-01-19	42	333	88	130	0.7438
Venetica	2015-01-23	123	438	119	242	0.7437
Age of Fear 2: The Chaos Lord GOLD	2015-03-27	68	249	64	132	0.7432
NOBUNAGA'S AMBITION: Kakushin with Power Up Kit	2015-06-26	364	186	46	410	0.7432
Minecraft: Story Mode - A Telltale Games Series	2015-10-13	6423	6162	1944	8367	0.7429000000000001
Guild of Dungeoneering Ultimate Edition	2015-07-14	1793	1886	569	2362	0.7426
Teddy Floppy Ear - The Race	2015-05-22	1675	793	228	1903	0.7423000000000001
Color Guardians	2015-05-12	9	23	3	12	0.742
Rainbow Hero	2015-03-19	7	23	3	10	0.742
Invisible Apartment 2	2015-09-24	4	8	0	4	0.7419
Machina of the Planet Tree -Planet Ruler-	2015-07-28	227	145	35	262	0.7417
The Madness of Little Emma	2015-12-21	22	116	27	49	0.7415
Big Pharma	2015-08-27	2614	1383	414	3028	0.7414000000000001
Adventure in the Tower of Flight	2015-07-03	142	75	16	158	0.7411
Last Horizon	2015-11-18	33	186	47	80	0.7406
Taimumari: Definitive Edition	2015-12-16	2157	224	58	2215	0.7404999999999999
Yomi	2015-05-08	98	115	27	125	0.7403000000000001
Solar War	2015-01-06	14	27	4	18	0.7403000000000001
MOAI: Build Your Dream	2015-02-26	141	147	36	177	0.7402
Ludoku	2015-05-25	5	18	2	7	0.74
Daydreamer	2015-08-21	4	18	2	6	0.74
Hard to Be a God	2015-08-24	13	78	17	30	0.7398
FINAL FANTASY V	2015-09-24	683	1051	313	996	0.7397
Egg Returns Home	2015-05-05	267	387	107	374	0.7395999999999999
Woof Blaster	2015-09-22	89	107	25	114	0.7393000000000001
The Tiny Tale 2	2015-01-30	25	31	5	30	0.7393000000000001
Sym	2015-05-07	13	31	5	18	0.7393000000000001
Trigonarium	2015-09-01	178	31	5	183	0.7393000000000001
The Incredible Adventures of Van Helsing: Final Cut	2015-11-06	1322	2515	786	2108	0.7390000000000001
BloodLust Shadowhunter	2015-09-21	172	259	69	241	0.7390000000000001
Dungeon Nightmares II : The Memory	2015-09-14	16	208	54	70	0.7390000000000001
Miko Gakkou Monogatari: Kaede Episode	2015-11-27	3	13	1	4	0.7389
Vindicator: Uprising	2015-07-03	5	13	1	6	0.7389
Defend The Highlands	2015-11-06	2844	272	73	2917	0.7388
Shoot 1UP	2015-09-23	39	103	24	63	0.7388
Super Furball	2015-04-21	68	47	9	77	0.7388
Littlewitch Romanesque: Editio Regia	2015-04-04	50	92	21	71	0.7387
Stardust Vanguards	2015-01-30	133	81	18	151	0.7386
Strife	2015-05-22	3435	3627	1154	4589	0.7384000000000001
Alpha Runner	2015-09-02	1827	331	91	1918	0.7383
Fitz the Fox	2015-08-06	70	99	23	93	0.7383
Monument	2015-06-05	2674	623	181	2855	0.7382
Spirits of Xanadu	2015-03-26	134	334	92	226	0.7382
Decay - The Mare	2015-02-13	243	1367	418	661	0.7379000000000001
Big Fish Legend	2015-07-20	80	102	24	104	0.7375
Let the Cat In	2015-08-28	137	785	233	370	0.7373999999999999
AX:EL	2015-12-04	35956	945	284	36240	0.7373000000000001
Zombie Vikings	2015-12-07	63	256	69	132	0.7373000000000001
The Last Dream: Developer's Edition	2015-12-03	132	268	73	205	0.7366
Dreamscape	2015-02-02	69	50	10	79	0.7366
Submerged	2015-08-04	521	3366	1081	1602	0.7364
Pale Echoes	2015-12-10	50	46	9	59	0.7362000000000001
Overture	2015-01-26	1546	944	286	1832	0.7361
Perils of Man	2015-04-28	71	177	46	117	0.7361
Legends of Eisenwald	2015-07-02	872	1293	399	1271	0.736
in Space	2015-04-27	46	83	19	65	0.736
Wyrmsun	2015-05-22	462	197	52	514	0.7359
XIIZEAL	2015-06-05	8	42	8	16	0.7359
quadrant	2015-05-01	7	30	5	12	0.7356999999999999
Saints Row: Gat out of Hell	2015-01-22	5827	6854	2263	8090	0.7356
A Wise Use of Time	2015-09-04	95	97	23	118	0.7354999999999999
Job the Leprechaun	2015-07-31	1061	142	36	1097	0.7353000000000001
Space Colony	2015-04-30	220	405	116	336	0.7352
Stranded In Time	2015-07-17	2544	145	37	2581	0.7349
Pixel Fodder	2015-07-20	127	114	28	155	0.7348
Gon' E-Choo!	2015-11-26	50	75	17	67	0.7347
ルナティックドーン レジェンドパック	2015-01-09	7	17	2	9	0.7345
Dyscourse	2015-03-25	96	345	98	194	0.7343000000000001
Kiai Resonance	2015-04-23	263	158	41	304	0.7343000000000001
Doodle God	2015-09-24	812	867	265	1077	0.7339
Scourge of War: Waterloo	2015-11-19	43	181	48	91	0.7339
Dungeon Lords Steam Edition	2015-12-21	71	449	131	202	0.7338
Egyptian Senet	2015-08-21	32	250	69	101	0.7337
Remnants of Isolation	2015-05-01	843	78	18	861	0.7337
One More Dungeon	2015-11-23	139	491	145	284	0.7331000000000001
Questerium: Sinister Trinity HD	2015-01-15	242	150	39	281	0.7331000000000001
The Fool	2015-03-09	7	41	8	15	0.733
Silver Creek Falls - Chapter 2	2015-09-30	95	41	8	103	0.733
Nevermind	2015-09-29	55	326	93	148	0.7329000000000001
UFHO2	2015-06-02	89	21	3	92	0.7327
Republique	2015-02-26	198	527	157	355	0.7326
Icebound	2015-08-05	4	7	0	4	0.7326
Drone Zero Gravity	2015-10-02	4	7	0	4	0.7326
SLIDE: platformer	2015-07-17	2	7	0	2	0.7326
Cinderella Escape! R12	2015-11-16	56	302	86	142	0.7321
The Depths of Tolagal	2015-01-05	11	33	6	17	0.7321
Teddy Floppy Ear - Kayaking	2015-01-16	994	453	134	1128	0.7319
Marine Park Empire	2015-09-03	16	84	20	36	0.7319
Let's Explore The Jungle (Junior Field Trips)	2015-04-24	9	29	5	14	0.7319
Box Out!	2015-05-04	6	12	1	7	0.7319
Sandmason	2015-05-04	12	48	10	22	0.7316
Pretty Girls Mahjong Solitaire	2015-08-25	116	554	167	283	0.7314
Radium	2015-03-13	812	118	30	842	0.7314
Lethal RPG: War	2015-07-17	49	161	43	92	0.731
Home is Where One Starts...	2015-05-13	815	472	141	956	0.7309
Tales of Aravorn: Seasons Of The Wolf	2015-01-15	48	55	12	60	0.7308
Pixel Puzzles 2: Birds	2015-02-20	2251	245	69	2320	0.7306999999999999
Bloodsports.TV	2015-03-30	824	446	133	957	0.7305
Stealth Inc 2	2015-04-30	3142	738	230	3372	0.7293000000000001
Dragon Fantasy: The Volumes of Westeria	2015-04-09	25	36	7	32	0.7293000000000001
Combat Cats	2015-06-26	7	36	7	14	0.7293000000000001
Gear Up	2015-01-28	2743	6320	2166	4909	0.7287
Korwin The Game	2015-10-01	49	178	49	98	0.7287
Alphadia Genesis	2015-01-12	84	99	25	109	0.7286
Super Sky Arena	2015-10-05	7	32	6	13	0.7286
Pizzarian	2015-02-04	5	16	2	7	0.7286
Call of Cthulhu: Shadow of the Comet	2015-11-04	6	54	12	18	0.7284
Garden Rescue: Christmas Edition	2015-11-09	903	54	12	915	0.7284
Out There: Ω Edition	2015-04-02	491	1203	388	879	0.7283
Bedlam	2015-10-13	413	655	204	617	0.7282
FLAMBERGE	2015-03-25	8	102	26	34	0.7281000000000001
Ultimate Space Commando	2015-05-12	860	43	9	869	0.728
Link: The Unleashed Nexus	2015-08-21	15	43	9	24	0.728
Aveyond 3-4: The Darkthrop Prophecy	2015-02-13	6	28	5	11	0.7279000000000001
Sakura Beach 2	2015-11-06	297	454	138	435	0.7278
Spaceport Hope	2015-09-14	3055	355	106	3161	0.7275
Zero Reflex	2015-11-05	47	183	51	98	0.7275
Hypnosis	2015-01-28	11	24	4	15	0.7275
Shadows on the Vatican - Act II: Wrath	2015-10-26	84	88	22	106	0.7273000000000001
Chaos Reborn	2015-10-26	346	830	264	610	0.7272
FreakOut: Extreme Freeride	2015-01-13	8	57	13	21	0.7272
Gender Bender DNA Twister Extreme	2015-11-23	42	172	48	90	0.7263
Bard's Gold	2015-08-14	299	104	27	326	0.7263
Nature's Zombie Apocalypse	2015-07-23	6	35	7	13	0.7259000000000001
Starsphere	2015-10-26	170	35	7	177	0.7259000000000001
Volume	2015-08-18	180	514	160	340	0.7256999999999999
Nom Nom Galaxy	2015-08-03	336	742	237	573	0.7255
Modular Combat	2015-03-20	224	1078	352	576	0.7254
Lords of the Realm	2015-12-03	26	63	15	41	0.7251000000000001
Super Hipster Lumberjack	2015-07-20	21	340	103	124	0.7248
Airport Madness: World Edition	2015-05-28	87	251	74	161	0.7245999999999999
Simply Chess	2015-09-11	596	2464	839	1435	0.7245
Aqua Panic!	2015-11-09	4	11	1	5	0.7242000000000001
Daily Espada	2015-09-30	3	11	1	4	0.7242000000000001
The BoX	2015-12-03	5	11	1	6	0.7242000000000001
The Rivers of Alice - Extended Version	2015-11-16	15	76	19	34	0.7241
Knee Deep	2015-07-06	66	131	36	102	0.7236
I Can't Escape: Darkness	2015-09-17	15	52	12	27	0.7236
Galagan's Island: Reprymian Rising	2015-06-16	2788	69	17	2805	0.7234999999999999
Making History: The Great War	2015-01-29	114	331	101	215	0.7234
Epic Quest of the 4 Crystals	2015-09-25	1001	118	32	1033	0.7234
PERFECT ANGLE: The puzzle game based on optical illusions	2015-12-22	1515	255	76	1591	0.7232999999999999
Lost Legends: The Weeping Woman Collector's Edition	2015-10-21	16	62	15	31	0.723
Beyond Sol	2015-10-13	106	143	40	146	0.7229000000000001
Bloody Streets	2015-03-12	191	95	25	216	0.7228
Sylvio	2015-06-05	17	111	30	47	0.7226
THE GAME OF LIFE 	2015-11-03	340	1598	542	882	0.7222
Space Xonix	2015-09-17	5	15	2	7	0.7222
Light Bound	2015-04-23	44	19	3	47	0.7221
Trigger Saint	2015-10-09	6	19	3	9	0.7221
Bocce Revolution	2015-10-23	6	19	3	9	0.7221
Trap Them	2015-07-10	185	41	9	194	0.7220000000000001
Viking Saga: The Cursed Ring	2015-10-29	18	41	9	27	0.7220000000000001
Finders	2015-04-09	481	123	34	515	0.7217
Mactabilis	2015-07-10	4	6	0	4	0.7217
Dad Beat Dads	2015-10-19	3	6	0	3	0.7217
Pixel Heroes: Byte & Magic	2015-02-06	487	389	122	609	0.7212999999999999
Clandestinity of Elsie	2015-07-08	509	110	30	539	0.7212999999999999
Greyfox	2015-02-24	2624	1313	444	3068	0.7212000000000001
SAMURAI WARRIORS 4-II	2015-09-29	608	980	327	935	0.721
TorqueL	2015-01-23	7	30	6	13	0.7209000000000001
Horizon Shift	2015-05-29	1608	242	73	1681	0.7208
Almightree: The Last Dreamer	2015-09-07	980	119	33	1013	0.7206999999999999
Rescue Team 3	2015-09-23	66	44	10	76	0.7206
Labyronia RPG 2	2015-08-28	2325	476	153	2478	0.7199
Kanji Training Game	2015-09-23	53	77	20	73	0.7199
Ironcast	2015-03-26	1089	648	213	1302	0.7195999999999999
Damn virgins	2015-07-30	3	26	5	8	0.7194
Viking Saga: New World	2015-11-05	15	26	5	20	0.7194
The Last Crown: Midnight Horror	2015-10-29	44	99	27	71	0.7192000000000001
Ankh - Anniversary Edition	2015-05-21	101	83	22	123	0.7191
Mystery of Neuschwanstein	2015-02-18	23	70	18	41	0.7190000000000001
Nova-111	2015-08-25	155	130	37	192	0.7189
Locoland	2015-05-28	554	105	29	583	0.7188
Plazma Being	2015-02-09	952	295	92	1044	0.7187
Arclight Cascade	2015-08-25	71	33	7	78	0.7187
Fingered	2015-08-18	343	678	225	568	0.7184999999999999
Extreme Exorcism	2015-09-23	16	50	12	28	0.7184
Star Sky	2015-10-23	115	205	62	177	0.718
Total Extreme Wrestling 2010	2015-03-19	44	95	26	70	0.718
Daemon Detective Gaiden	2015-08-14	47	22	4	51	0.7178
SinaRun	2015-10-26	68	135	39	107	0.7176
ROCKETSROCKETSROCKETS	2015-05-01	188	411	133	321	0.7172
Feist	2015-07-23	55	382	123	178	0.7171
A Pixel Story	2015-03-30	282	36	8	290	0.7170000000000001
Vertigo Void	2015-10-30	36	36	8	44	0.7170000000000001
Fort Defense	2015-05-22	2193	283	89	2282	0.7169
Dwarven Brawl Bros	2015-06-25	112	29	6	118	0.7169
Anomaly 1729	2015-12-31	5	29	6	11	0.7169
Tap Tap Infinity	2015-07-17	2166	688	231	2397	0.7168000000000001
Quintet	2015-05-12	143	274	86	229	0.7168000000000001
NOBUNAGA'S AMBITION: Tendou with Power Up Kit	2015-06-26	321	122	35	356	0.7167
Caveman Craig	2015-08-28	101	91	25	126	0.7166
Planet Diver	2015-12-01	36	46	11	47	0.7166
FreeStyle 2: Street Basketball	2015-04-01	10356	8826	3263	13619	0.7165
Diabolical	2015-11-06	149	94	26	175	0.7165
Trainz: A New Era	2015-05-14	303	1656	582	885	0.7164
STAR WARS™ X-Wing vs TIE Fighter: Balance of Power Campaigns™	2015-04-28	82	185	56	138	0.7164
SEAL Team 12	2015-03-18	11	18	3	14	0.7162999999999999
InnerCube	2015-02-13	6	18	3	9	0.7162999999999999
Country Tales	2015-08-27	11	18	3	14	0.7162999999999999
Pendragon Rising	2015-12-04	110	75	20	130	0.7162000000000001
Moonchild	2015-05-13	576	109	31	607	0.7158
Tobari and the Night of the Curious Moon	2015-05-26	13	62	16	29	0.7156999999999999
Pixel Puzzles 2: Anime	2015-03-27	2960	713	242	3202	0.7154
Square Brawl	2015-10-22	19	127	37	56	0.7154
Assassin’s Creed® Chronicles: China	2015-04-21	591	2354	844	1435	0.7153
Neoncube	2015-10-02	44	68	18	62	0.7149
Vintage Year	2015-01-02	598	71	19	617	0.7145999999999999
Fairy Tale Mysteries 2: The Beanstalk	2015-10-08	600	247	78	678	0.7145
Tap Heroes	2015-06-05	1511	940	326	1837	0.7143
Reign of Bullets	2015-08-19	26	77	21	47	0.7141
Loot Hero DX	2015-07-03	14306	1058	370	14676	0.7139
STAR WARS™: X-Wing Special Edition	2015-04-28	92	272	87	179	0.7139
Proto Raider	2015-08-28	353	80	22	375	0.7139
Isbarah	2015-02-25	361	45	11	372	0.7137000000000001
The Living Dungeon	2015-11-02	201	45	11	212	0.7137000000000001
Enigmoon	2015-09-28	13753	561	190	13943	0.7134
ClusterPuck 99	2015-01-23	15	92	26	41	0.7133
Rugby League Live 3	2015-09-30	80	119	35	115	0.713
Citizens of Earth	2015-01-20	311	293	95	406	0.7128
Getsuei Gakuen -kou-	2015-11-04	15	21	4	19	0.7125
Foosball: World Tour	2015-12-11	10	73	20	30	0.7123999999999999
Mighty Switch Force! Academy	2015-11-23	43	38	9	52	0.7123
Pike and Shot: Campaigns	2015-08-13	133	229	73	206	0.7120000000000001
Porcunipine	2015-05-21	292	118	35	327	0.7117
Labyronia RPG	2015-08-14	2350	907	320	2670	0.7111
Office Battle	2015-12-02	1988	693	241	2229	0.7111
Slipstream 5000	2015-10-09	1590	287	94	1684	0.711
Cuban Missile Crisis	2015-03-25	25	173	54	79	0.711
Gunpowder	2015-07-08	124	31	7	131	0.711
Awe	2015-10-09	210	190	60	270	0.7107
The chronicles of Emerland. Solitaire.	2015-07-29	951	111	33	984	0.7103
Blood Code	2015-12-29	304	1489	540	844	0.7101999999999999
Samsa and the Knights of Light	2015-12-02	417	34	8	425	0.7098000000000001
MOAI 2: Path to Another World	2015-07-16	95	50	13	108	0.7097
STEEL STRIDER	2015-11-12	9	50	13	22	0.7097
The Men of Yoshiwara: Kikuya	2015-10-15	71	351	118	189	0.7094
Niko: Through The Dream	2015-07-17	107	148	46	153	0.7091
Asphyxia	2015-08-04	138	182	58	196	0.7088
Wimp: Who Stole My Pants?	2015-06-05	37	37	9	46	0.7088
Ninjahtic	2015-07-06	231	62	17	248	0.7087000000000001
Tembo The Badass Elephant	2015-07-21	77	396	135	212	0.7086
Dustbowl	2015-05-18	42	92	27	69	0.7084999999999999
Goats on a Bridge	2015-02-06	99	127	39	138	0.7083
Swords and Sorcery - Underworld - DEFINITIVE EDITION	2015-12-15	26	77	22	48	0.7083
ROOT	2015-11-16	29	147	46	75	0.7081000000000001
Survivor Squad: Gauntlets	2015-05-01	204	118	36	240	0.7079000000000001
The Albino Hunter™ (Original)	2015-03-11	451	248	82	533	0.7077
Army of Pixels	2015-10-29	58	43	11	69	0.7076000000000001
JamG	2015-07-06	3	13	2	5	0.7075
Cubicle Quest	2015-02-25	927	504	176	1103	0.7073
White Night	2015-03-03	54	247	82	136	0.7070000000000001
Celia's Quest	2015-06-24	4140	49	13	4153	0.7069
Last Half of Darkness - Society of the Serpent Moon	2015-08-03	11	30	7	18	0.7068000000000001
ZombieZoid® Zenith	2015-10-01	12	20	4	16	0.7068000000000001
Fair Strike	2015-04-23	847	61	17	864	0.7064
Cash_Out	2015-05-27	5	33	8	13	0.7059000000000001
Death Ray Manta	2015-09-17	202	153	49	251	0.7054
Shutter	2015-04-02	1809	153	49	1858	0.7054
Terraform	2015-05-08	24	36	9	33	0.7051999999999999
Starchaser: Priestess of the Night Sky	2015-07-24	20	36	9	29	0.7051999999999999
FortressCraft Evolved	2015-11-09	732	2097	793	1525	0.7051000000000001
Cross of the Dutchman	2015-09-10	73	265	90	163	0.7044
Squirreltopia	2015-01-12	305	213	71	376	0.7044
Cards and Castles	2015-12-18	670	561	201	871	0.7042
Rogue State	2015-10-16	120	188	62	182	0.7042
Sentinel 4: Dark Star	2015-08-13	48	45	12	60	0.7042
Dead In Bermuda	2015-08-27	267	375	131	398	0.7041
Diadra Empty	2015-07-21	175	66	19	194	0.7041
MoW: Face Off M	2015-07-16	166	321	111	277	0.7040000000000001
World War I	2015-04-09	22	171	56	78	0.7039
Demon Hearts	2015-08-07	116	54	15	131	0.7039
Battle for Blood - Epic battles within 30 seconds!	2015-07-08	428	565	203	631	0.7038
RymdResa	2015-08-20	106	223	75	181	0.7037000000000001
Megatect	2015-11-04	8	26	6	14	0.7034
Airport Madness: Time Machine	2015-09-18	225	86	26	251	0.7033
Always The Same Blue Sky...	2015-05-21	105	173	57	162	0.7031999999999999
Zombeer	2015-01-30	11	197	66	77	0.7026000000000001
Robinson Crusoe and the Cursed Pirates	2015-02-10	7	29	7	14	0.7025
Turnover	2015-12-15	6	29	7	13	0.7025
Respawn Man	2015-12-21	40	32	8	48	0.7019
18 Wheels of Steel: Extreme Trucker 2	2015-05-08	9	105	33	42	0.7018000000000001
Bolt	2015-02-24	15	116	37	52	0.7015000000000001
The Red Solstice	2015-07-09	82980	1727	663	83643	0.7012
The fall of gods	2015-12-18	4122	41	11	4133	0.7012
200% Mixed Juice!	2015-10-23	463	621	228	691	0.7011000000000001
The Hero of Kendrickstone	2015-03-13	147	79	24	171	0.701
Carnivores: Dinosaur Hunter Reborn	2015-05-27	130	574	210	340	0.7009000000000001
A Wolf in Autumn	2015-10-27	83	254	88	171	0.7008
Lightbender	2015-12-18	7	19	4	11	0.7008
The Deletion	2015-07-30	1082	162	54	1136	0.7005
Camera Obscura	2015-02-19	966	1113	422	1388	0.7004
Revolution Under Siege Gold	2015-07-02	25	101	32	57	0.7000000000000001
Mighty Gunvolt	2015-09-29	29	250	87	116	0.6999
The Hurricane of the Varstray -Collateral hazard-	2015-12-21	23	145	48	71	0.6998000000000001
OH! RPG!	2015-12-11	773	276	97	870	0.6996
MASSIVE CHALICE	2015-06-01	697	1284	492	1189	0.6995
Dungeon Highway	2015-03-23	8	22	5	13	0.6994
Dodge	2015-03-16	98	58	17	115	0.6990999999999999
Bleeding Blocks	2015-09-16	8	12	2	10	0.6990999999999999
Fate Tectonics	2015-09-09	643	147	49	692	0.6990000000000001
Reload	2015-02-13	12	75	23	35	0.6988
Drive to Hell	2015-01-30	353	55	16	369	0.6988
Magic Duels	2015-07-29	14586	16982	6983	21569	0.6986
Holy Potatoes! A Weapon Shop?!	2015-07-13	677	1399	541	1218	0.6985
Pulsen	2015-07-27	9	49	14	23	0.6983
Kult: Heretic Kingdoms	2015-08-26	17	108	35	52	0.6981
Ashes of Immortality	2015-06-26	943	69	21	964	0.6981
N2O	2015-06-29	21	28	7	28	0.698
The Guilt and the Shadow	2015-02-02	8	43	12	20	0.6979000000000001
GALAK-Z	2015-10-29	397	379	138	535	0.6976000000000001
Overclocked: A History of Violence	2015-04-03	11	77	24	35	0.6972
There Came an Echo	2015-02-24	161	274	98	259	0.6968000000000001
Gun Rocket	2015-08-07	593	507	189	782	0.6966
Satellite Reign	2015-08-28	7251	3546	1429	8680	0.6964
Morphine	2015-10-28	536	481	179	715	0.6964
Yet Another World	2015-11-30	1226	54	16	1242	0.6962
Expander	2015-12-01	30	15	3	33	0.6959000000000001
Sword of Asumi	2015-01-08	124	272	98	222	0.6955
Arvale	2015-08-14	870	76	24	894	0.6951999999999999
Inventioneers	2015-10-05	9	18	4	13	0.6944
Dawn of the Plow	2015-11-03	31	8	1	32	0.6944
Ratings War	2015-10-02	60	39	11	71	0.6943
S.K.I.L.L. - Special Force 2	2015-05-19	3918	8109	3371	7289	0.6940000000000001
The Legend of Dark Witch	2015-12-02	134	174	61	195	0.6940000000000001
ChargeShot	2015-09-18	72	67	21	93	0.6937000000000001
The World Named Fred	2015-02-27	9	30	8	17	0.6934
DSY: Don't Shoot Yourself	2015-04-10	14	27	7	21	0.6933
Shu's Garden	2015-08-12	5	27	7	12	0.6933
Xenocide	2015-08-28	200	24	6	206	0.6933
Where Angels Cry 2: Tears Of The Fallen Collectors Edition	2015-11-09	8	24	6	14	0.6933
Choice Chamber	2015-07-16	138	199	71	209	0.6931
Star Hammer: The Vanguard Prophecy 	2015-06-04	150	110	37	187	0.6931
Wurm Unlimited	2015-10-21	1958	2080	841	2799	0.6929000000000001
Funk of Titans	2015-07-24	38	83	27	65	0.6929000000000001
Tiki Man	2015-06-06	418	170	60	478	0.6927
Belladonna	2015-02-27	163	510	195	358	0.6924
Airport Madness 4	2015-07-24	137	112	38	175	0.6922
Rack N Ruin	2015-09-01	109	58	18	127	0.6920000000000001
MX vs. ATV Unleashed	2015-04-17	30	369	139	169	0.6917
Laserlife	2015-09-22	51	85	28	79	0.6916
Time Tenshi (2015)	2015-11-20	17	85	28	45	0.6916
Garden Rescue	2015-02-02	843	98	33	876	0.691
Evolve Stage 2	2015-02-10	51127	33814	14659	65786	0.6899
Gunslugs	2015-06-02	420	84	28	448	0.6898000000000001
Call of Cthulhu: Prisoner of Ice	2015-11-04	6	68	22	28	0.6898000000000001
Professor Why™: Chemistry 1	2015-10-14	5	11	2	7	0.6897
Impulse Revolution	2015-09-10	4	11	2	6	0.6897
Abomination Tower	2015-02-13	66	32	9	75	0.6894
Super Slam Dunk Touchdown	2015-12-16	6	32	9	15	0.6894
DELTAZEAL	2015-10-16	11	46	14	25	0.6893000000000001
RETSNOM	2015-07-23	35	65	21	56	0.6890999999999999
Karos Returns	2015-07-30	174	361	138	312	0.6890000000000001
Train Simulator	2015-09-17	3821	17541	7582	11403	0.6888
The Adventures of Fatman	2015-10-01	727	107	37	764	0.6887000000000001
Steam and Metal	2015-02-09	980	54	17	997	0.6887000000000001
Explosionade	2015-09-23	30	54	17	47	0.6887000000000001
InfiniTrap Classic	2015-12-22	40	54	17	57	0.6887000000000001
Telepath Tactics	2015-04-16	84	86	29	113	0.6886
Crazy Chicken - Invasion	2015-02-20	3	43	13	16	0.6885
TankZone Battle	2015-09-21	9	62	20	29	0.6884
Raptor: Call of The Shadows - 2015 Edition	2015-02-13	55	347	133	188	0.6881999999999999
Slow Down, Bull	2015-04-20	9	14	3	12	0.688
BADBLOOD	2015-11-13	5	14	3	8	0.688
Crashed Lander	2015-02-04	11	40	12	23	0.6877
Song of the Myrne: What Lies Beneath	2015-01-13	174	67	22	196	0.6876000000000001
Mysterious Space	2015-05-15	95	20	5	100	0.6875
Unfair Jousting Fair	2015-09-03	10	20	5	15	0.6875
Little Cells	2015-06-05	56	17	4	60	0.6875
VROOM: Aerie	2015-06-24	4	17	4	8	0.6875
Rake	2015-07-14	113	2988	1258	1371	0.6872
City of Chains	2015-12-08	4570	234	88	4658	0.6869
Elementary My Dear Majesty!	2015-04-16	1670	126	45	1715	0.6866
Mordheim: City of the Damned	2015-11-19	2715	5132	2203	4918	0.6859999999999999
Sometimes: Success Requires Sacrifice	2015-02-27	4991	415	163	5154	0.6859000000000001
Spaceman Sparkles 2	2015-05-20	105	53	17	122	0.6859000000000001
VoidExpanse	2015-04-02	644	524	209	853	0.6854000000000001
Cuban Missile Crisis: Ice Crusade	2015-03-25	13	50	16	29	0.6849
Artifact Adventure	2015-06-01	38	117	42	80	0.6847
Pool Nation FX	2015-12-07	1127	1269	530	1657	0.6839000000000001
Solitaire Christmas. Match 2 Cards	2015-12-25	1013	86	30	1043	0.6838
Zoo Empire	2015-09-03	18	101	36	54	0.6834
Dark Quest	2015-01-21	15	101	36	51	0.6834
Secret Ponchos	2015-10-13	1365	935	388	1753	0.6829999999999999
Contract With The Devil	2015-12-11	973	207	79	1052	0.6829999999999999
One More Line	2015-08-28	481	177	67	548	0.6824
Lumber Island - That Special Place	2015-10-01	9	75	26	35	0.6823
The Park	2015-10-27	541	2005	858	1399	0.6820999999999999
High Strangeness	2015-05-06	91	22	6	97	0.682
Immortal Empire	2015-12-03	165	208	80	245	0.6819
Keebles	2015-03-27	81	62	21	102	0.6819
Anno 2205	2015-11-02	7446	3668	1597	9043	0.6818000000000001
Game Type	2015-09-23	32	33	10	42	0.6818000000000001
The Body Changer	2015-10-16	39	41	13	52	0.6817000000000001
Heroes of Normandie	2015-10-01	235	159	60	295	0.6815000000000001
Warlock's Citadel	2015-10-10	8	7	1	9	0.6815000000000001
Tanita: a plasticine dream	2015-08-06	1	7	1	2	0.6815000000000001
Amos From Outer Space	2015-10-06	4	7	1	5	0.6815000000000001
RONIN	2015-06-30	236	1554	663	899	0.6812
PING 1.5+	2015-08-13	378	19	5	383	0.6809999999999999
Island Tribe	2015-10-19	10	30	9	19	0.6805
Castaway Paradise	2015-05-19	57	405	164	221	0.6804000000000001
Two Digits	2015-05-22	1410	273	108	1518	0.6804000000000001
SEEP Universe	2015-07-15	687	51	17	704	0.6801
Cradle	2015-07-24	594	1257	536	1130	0.68
Lapland Solitaire	2015-09-14	8	16	4	12	0.68
Furfly	2015-12-18	4	16	4	8	0.68
Destructamundo	2015-01-28	11	13	3	14	0.6793000000000001
Erwin's Timewarp	2015-09-22	4	13	3	7	0.6793000000000001
SodaCity	2015-12-09	76	13	3	79	0.6793000000000001
MagNets	2015-01-30	349	10	2	351	0.6793000000000001
Jaques Roque	2015-04-01	8	10	2	10	0.6793000000000001
RED Fuse: Rolling Explosive Device	2015-09-17	36	10	2	38	0.6793000000000001
Dungeon Kingdom: Sign of the Moon	2015-11-19	22	108	40	62	0.6788
Sleep Attack	2015-05-28	39	48	16	55	0.6788
Vector Strain	2015-12-09	314	48	16	330	0.6788
No Time To Live	2015-09-30	629	110	41	670	0.6781
Metal Reaper Online	2015-09-18	508	344	140	648	0.6779999999999999
Legend of Mysteria	2015-10-09	2557	539	225	2782	0.6777
Gran Vitreous	2015-05-20	23	24	7	30	0.6776000000000001
Soccertron	2015-03-12	1022	45	15	1037	0.6775
City Quest	2015-08-20	37	32	10	47	0.6775
Robo Miner	2015-06-11	14	32	10	24	0.6775
Particula	2015-02-02	7590	1613	703	8293	0.6774
Vagrant Hearts	2015-02-28	26	85	31	57	0.6773
Natural Soccer	2015-02-02	7	50	17	24	0.6770999999999999
Chicken Little	2015-02-24	38	349	143	181	0.677
ZanZarah: The Hidden Portal	2015-08-20	67	637	269	336	0.6769
Independence War 2: Edge of Chaos	2015-05-07	7	55	19	26	0.6769
The Dwarf Run	2015-10-21	148	109	41	189	0.6766
The Oil Blue	2015-08-06	451	121	46	497	0.6765000000000001
Dandy: Or a Brief Glimpse into the Life of the Candy Alchemist	2015-08-04	34	37	12	46	0.6765000000000001
Finding Nemo	2015-02-24	21	99	37	58	0.6761
Sinless	2015-12-16	951	180	71	1022	0.6759999999999999
1931: Scheherazade at the Library of Pergamum	2015-03-26	1200	135	52	1252	0.6759999999999999
0RBITALIS	2015-05-28	60	208	83	143	0.6759000000000001
Lucadian Chronicles	2015-10-15	154	21	6	160	0.6759000000000001
Steel Ocean	2015-11-12	2444	3101	1389	3833	0.6755
Frozen Cortex	2015-02-19	303	191	76	379	0.6753
A Druid's Duel	2015-02-26	95	79	29	124	0.6751
Toby: The Secret Mine	2015-10-20	270	433	182	452	0.6746
Ruzar - The Life Stone	2015-12-03	20	86	32	52	0.6745
Piloteer	2015-09-25	8	18	5	13	0.674
Caverns of the Snow Witch	2015-08-03	83	26	8	91	0.6739
Atonement: Scourge of Time	2015-07-16	18727	263	108	18835	0.6737000000000001
Pongo	2015-05-11	2644	372	156	2800	0.6736
Shiftlings	2015-03-03	141	71	26	167	0.6736
Stairs	2015-09-28	31	235	96	127	0.6734
FreeCell Quest	2015-10-19	228	328	137	365	0.6731
The Next Penelope	2015-05-29	37	186	75	112	0.6729
Invisible Apartment	2015-03-02	41	284	118	159	0.6725
Mugen Souls	2015-10-22	263	197	80	343	0.6724
Flame Over	2015-05-28	60	118	46	106	0.6723
Friendship Club	2015-03-24	7	15	4	11	0.672
Pixel: ru²	2015-03-06	994	15	4	998	0.672
Disorder	2015-01-13	18	63	23	41	0.6718999999999999
Kaiju Panic	2015-10-09	16	23	7	23	0.6718000000000001
Abandoned: Chestnut Lodge Asylum	2015-09-24	12	23	7	19	0.6718000000000001
Deathless: The City's Thirst	2015-10-23	43	23	7	50	0.6718000000000001
This Book Is A Dungeon	2015-10-09	1082	189	77	1159	0.6714
TeraBlaster	2015-07-10	1102	723	317	1419	0.6711
MEDIEVAL: Total War™ - Gold Edition	2015-06-25	321	1222	546	867	0.6709999999999999
Alum	2015-05-15	16	124	49	65	0.6709
MoW: Face Off XL	2015-11-18	101	117	46	147	0.6709
Roads of Rome 3	2015-10-19	13	28	9	22	0.6709
Lethis - Path of Progress	2015-06-25	270	791	349	619	0.6706000000000001
Aspectus: Rinascimento Chronicles	2015-05-04	3	3	0	3	0.6706000000000001
Band of Drones	2015-03-25	2	3	0	2	0.6706000000000001
Questria: Rise of the Robot Skullfaces	2015-11-09	2	3	0	2	0.6706000000000001
DNO Rasa's Journey	2015-06-01	1	3	0	1	0.6706000000000001
Dolguth	2015-10-21	2	3	0	2	0.6706000000000001
Command: Northern Inferno	2015-10-22	32	33	11	43	0.6705
Gnumz: Masters of Defense	2015-12-21	2074	119	47	2121	0.6704000000000001
Battle of Empires : 1914-1918	2015-04-22	210	1395	629	839	0.6701
Battle of the Bulge	2015-09-17	86	107	42	128	0.6698999999999999
The Spatials	2015-03-30	426	228	95	521	0.6698000000000001
Pavel Quest	2015-05-13	7	12	3	10	0.6698000000000001
Albino Lullaby: Episode 1	2015-09-15	44	257	108	152	0.6696
Conflicks - Revolutionary Space Battles	2015-11-05	192	123	49	241	0.6695000000000001
Bubsy Two-Fur	2015-12-17	75	300	128	203	0.6685
My Paper Boat	2015-09-23	7	35	12	19	0.6684
Baseball Mogul 2015	2015-07-24	20	35	12	32	0.6684
Grey Goo	2015-01-23	3999	2802	1299	5298	0.6683
CMYW	2015-10-16	5	30	10	15	0.6683
Inside Me	2015-09-29	779	30	10	789	0.6683
The Weaponographist	2015-04-29	35	59	22	57	0.6678000000000001
Steamalot: Epoch's Journey	2015-08-31	58	9	2	60	0.6676000000000001
Marble Muse	2015-08-14	28	9	2	30	0.6676000000000001
Vulture for NetHack	2015-02-02	55	126	51	106	0.6673
Coffin Dodgers	2015-07-08	318	498	220	538	0.6668999999999999
Zenohell	2015-10-15	6	61	23	29	0.6668000000000001
The Four Kings Casino and Slots	2015-06-01	455	2461	1147	1602	0.6666
Traps N' Gemstones	2015-04-16	6	17	5	11	0.6666
Cheats 4 Hire	2015-06-26	39	17	5	44	0.6666
Cute Things Dying Violently	2015-09-03	50	37	13	63	0.6665000000000001
Mysteries & Nightmares: Morgiana	2015-04-13	10	6	1	11	0.6662
Dr. Bulbaceous	2015-11-19	7	6	1	8	0.6662
Just Survive Test Server	2015-04-16	2032	274	118	2150	0.6659999999999999
Hypt	2015-04-23	6	32	11	17	0.6659999999999999
The Grave Digger	2015-04-29	68	22	7	75	0.6657
Mayjasmine episode01 What is God? 五月茉莉	2015-12-02	101	227	97	198	0.6654000000000001
Three Heroes	2015-09-17	669	656	296	965	0.6651
RaidersSphere4th	2015-06-01	164	113	46	210	0.665
Harold	2015-02-12	16	39	14	30	0.6648999999999999
Colortone	2015-10-29	2333	184	78	2411	0.6645000000000001
Soccer Manager 2016	2015-10-07	1031	473	212	1243	0.6638
Warhammer 40,000: Deathwatch - Enhanced Edition	2015-10-16	524	562	254	778	0.6637000000000001
Axis Football 2015	2015-07-15	1673	264	115	1788	0.6637000000000001
Super Mega Bob	2015-12-03	102	14	4	106	0.6633
Combat Monsters	2015-01-20	167	134	56	223	0.663
Traverser	2015-07-09	20	71	28	48	0.6629
Warhammer 40,000: Regicide	2015-09-08	516	1278	597	1113	0.6628000000000001
Orion Trail	2015-10-12	65	136	57	122	0.6628000000000001
Toilet Tycoon	2015-09-17	59	116	48	107	0.6627
East Tower - Kurenai (ET Series Vol. 4)	2015-07-30	25	24	8	33	0.6627
Putrefaction	2015-08-07	1813	299	132	1945	0.6626000000000001
Hacker Evolution Source Code	2015-05-11	6	19	6	12	0.6625
Star Nomad 2	2015-12-14	129	109	45	174	0.6623
Celestian Tales: Old North	2015-08-10	245	294	130	375	0.6620999999999999
AGON - The Lost Sword of Toledo	2015-11-19	104	50	19	123	0.6620999999999999
KHOLAT	2015-06-09	272019	4264	2063	274082	0.6615000000000001
Among Ripples	2015-01-22	366	969	452	818	0.6615000000000001
TREBUCHET	2015-07-30	4	31	11	15	0.6614
Supreme League of Patriots Issue 2: Patriot Frames	2015-01-29	123	31	11	134	0.6614
Pony World 3	2015-04-27	27	237	104	131	0.6613
Curse of the Crescent Isle DX	2015-08-21	191	68	27	218	0.6612
Dead or Alive 5 Last Round	2015-03-30	2827	6110	2980	5807	0.6611
Soccer Manager 2015	2015-07-16	715	352	158	873	0.6611
Legend of Kay Anniversary	2015-07-27	52	206	90	142	0.6606000000000001
Chronicles of Teddy	2015-04-02	31	210	92	123	0.6604000000000001
Tea Party Simulator 2015™	2015-04-23	1339	460	210	1549	0.6603
Color Assembler	2015-06-03	6	26	9	15	0.6603
That Old Time Religion	2015-07-03	54	26	9	63	0.6603
Olympia Rising	2015-07-23	165	72	29	194	0.66
Karmaflow: The Rock Opera Videogame	2015-01-19	46	136	58	104	0.6598999999999999
Buff Knight Advanced	2015-09-02	24	40	15	39	0.6596
Warhammer Quest	2015-01-07	689	743	347	1036	0.6595000000000001
Deity Quest	2015-01-20	255	21	7	262	0.6593000000000001
Decromancer	2015-10-13	6	11	3	9	0.6593000000000001
Mystery Expedition: Prisoners of Ice	2015-11-09	9	11	3	12	0.6593000000000001
Energy Balance	2015-07-02	2378	200	88	2466	0.6591
Close Combat : Panthers in the Fog	2015-05-14	71	120	51	122	0.6589
Stargazer	2015-05-29	366	76	31	397	0.6589
Snake Blocks	2015-12-21	6	49	19	25	0.6589
The Dreamatorium of Dr. Magnus 2	2015-09-09	427	58	23	450	0.6587000000000001
MadSpace: To Hell and Beyond	2015-05-01	3	16	5	8	0.6586
Capsule Force	2015-08-25	5	28	10	15	0.6581999999999999
Toukiden: Kiwami	2015-06-26	588	844	399	987	0.6581
Aaru's Awakening	2015-02-23	12	93	39	51	0.6576000000000001
Infinite Space III: Sea of Stars	2015-10-29	112	82	34	146	0.6576000000000001
Tachyon Project	2015-07-15	99	44	17	116	0.6574
Pneuma: Breath of Life	2015-02-27	63	136	59	122	0.6570999999999999
War, the Game	2015-01-12	352	306	140	492	0.6565000000000001
Wildlife Camp	2015-11-20	11	30	11	22	0.6565000000000001
Sunset	2015-05-21	41	182	81	122	0.6562
DRAGON QUEST HEROES™ Slime Edition	2015-12-03	933	858	410	1343	0.6561
DRAGON: A Game About a Dragon	2015-04-24	734	404	188	922	0.6557
House of Caravan	2015-04-16	685	522	246	931	0.6554000000000001
Othello	2015-03-19	220	70	29	249	0.6553
Armor Clash	2015-10-21	9	59	24	33	0.6553
Cannibal	2015-10-28	5	32	12	17	0.655
Teddy Terror	2015-05-21	9	32	12	21	0.655
Spectra	2015-07-10	9	32	12	21	0.655
Adventurezator: When Pigs Fly	2015-09-17	211	72	30	241	0.6548999999999999
River City Super Sports Challenge ~All Stars Special~	2015-12-17	105	554	263	368	0.6544
World of Mixed Martial Arts 3	2015-03-19	31	104	45	76	0.6542
A列車で行こう8	2015-01-09	17	8	2	19	0.6542
inSynch	2015-09-30	2	8	2	4	0.6542
Titanis	2015-06-08	7	13	4	11	0.6537999999999999
Ironclads 2: American Civil War	2015-11-05	8	34	13	21	0.6537000000000001
Dreamscapes: Nightmare's Heir - Premium Edition	2015-03-11	14	112	49	63	0.6534000000000001
Astray	2015-02-03	10	152	68	78	0.6533
ENYO ARCADE	2015-11-09	104	67	28	132	0.6533
Hare In The Hat	2015-04-01	870	272	126	996	0.6531999999999999
The Prism	2015-09-03	2129	154	69	2198	0.6531999999999999
Marble Mayhem: Fragile Ball	2015-07-08	1782	719	347	2129	0.6531
Beyond Eyes	2015-08-11	170	1019	498	668	0.6528
AoF World Online	2015-02-27	2799	84	36	2835	0.6528
Dinosaur Hunt	2015-09-17	2412	2459	1229	3641	0.6527
Metro Warp	2015-08-05	11	20	7	18	0.6525
City of Fools	2015-07-10	551	60	25	576	0.652
Aerannis	2015-09-15	15	92	40	55	0.6518
The Indie Mixtape	2015-04-23	31	49	20	51	0.6517000000000001
Life is Feudal: Your Own	2015-11-17	7896	7693	3942	11838	0.6516
Castle	2015-01-07	711	194	89	800	0.6516
The I of the Dragon	2015-03-06	11612	599	290	11902	0.6513
There Was a Caveman	2015-10-08	48	98	43	91	0.6512000000000001
Meridian: Age of Invention	2015-10-01	833	64	27	860	0.6512000000000001
Black Home	2015-08-07	1489	51	21	1510	0.6511
MegaSphere	2015-08-26	34	81	35	69	0.6509999999999999
Valiant: Resurrection	2015-05-08	186	40	16	202	0.6508
FIVE: Guardians of David	2015-11-24	149	129	58	207	0.6506000000000001
I Shall Remain	2015-08-24	82	108	48	130	0.6503
Aveyond 3-3: The Lost Orb	2015-01-16	6	22	8	14	0.6503
Black Sails	2015-09-17	116	174	80	196	0.6501
Kumoon : Ballistic Physics Puzzle	2015-11-10	31	55	23	54	0.6501
Loot Hunter	2015-01-23	55	72	31	86	0.6498999999999999
Normality	2015-10-09	2416	253	119	2535	0.6498
Else Heart.Break()	2015-09-24	162	491	238	400	0.6497
Zombie Grinder	2015-10-16	49	204	95	144	0.6495000000000001
Magnetic: Cage Closed	2015-05-26	42	220	103	145	0.6493000000000001
Exile's End	2015-09-01	19	33	13	32	0.6492
Requiem	2015-03-04	325	539	263	588	0.6491
Dynasty Warriors 8 Empires	2015-02-27	1052	922	458	1510	0.649
Divine Slice of Life	2015-10-22	148	195	91	239	0.6487
Relive	2015-10-15	47	107	48	95	0.6487
Weather Lord: The Successor's Path	2015-05-07	438	24	9	447	0.6487
123 Slaughter Me Street	2015-09-25	9	223	105	114	0.6485
World of Subways 4 – New York Line 7	2015-03-23	163	227	107	270	0.6484000000000001
Lord of the Dark Castle	2015-08-13	7137	65	28	7165	0.6483
Adam's Venture Chronicles	2015-08-03	325	178	83	408	0.6479
AntharioN	2015-07-15	74	125	57	131	0.6479
Rktcr	2015-05-12	104	5	1	105	0.6478
Second Coming: Tactical Training	2015-04-30	11	5	1	12	0.6478
Ongaku	2015-05-28	10	5	1	11	0.6478
Knight & Damsel	2015-08-20	3	5	1	4	0.6478
Bosch's Damnation	2015-07-21	4	10	3	7	0.6476000000000001
Bass Blocks	2015-09-15	6	10	3	9	0.6476000000000001
Incandescent	2015-06-30	1185	98	44	1229	0.6475
Crayon Chronicles	2015-03-02	20	37	15	35	0.6475
WonderCat Adventures	2015-09-11	25	37	15	40	0.6475
Ladra	2015-11-13	306	37	15	321	0.6475
XLarn	2015-05-25	17	26	10	27	0.6473000000000001
Our Love Will Grow	2015-12-04	195	102	46	241	0.6472
Quantum Conscience	2015-06-09	132	39	16	148	0.6468
League of Mermaids	2015-09-22	15	39	16	31	0.6468
Shoppy Mart: Steam Edition	2015-09-25	94	56	24	118	0.6467
Highschool Possession	2015-12-09	12	118	54	66	0.6466
Astro Lords	2015-09-29	73	128	59	132	0.6464
Chicken Little Ace in Action	2015-02-24	6	41	17	23	0.6463
Farmpocalypse	2015-11-24	23	89	40	63	0.6459999999999999
Gynophobia	2015-07-31	27	468	231	258	0.6459
Statues	2015-10-27	37	176	83	120	0.6459
Plastiland	2015-12-01	54	64	28	82	0.6456999999999999
Dragon Saga	2015-12-22	599	855	432	1031	0.6453
Fairspace	2015-10-21	20	19	7	27	0.6452
Princess Battles	2015-04-13	8	19	7	15	0.6452
Spud!	2015-03-03	2	19	7	9	0.6452
ASDAD: All-Stars Dungeons and Diamonds	2015-10-01	2	19	7	9	0.6452
Bomb The Monsters!	2015-11-06	2660	115	53	2713	0.6451000000000001
Warriors & Castles	2015-06-30	26	47	20	46	0.6448999999999999
Corrosion: Cold Winter Waiting [Enhanced Edition]	2015-07-02	214	159	75	289	0.6448
Black & White Bushido	2015-10-02	15	114	53	68	0.6436000000000001
The Eigengrau Menagerie	2015-06-04	17	12	4	21	0.6435
Celestial Tear: Demon's Revenge	2015-11-19	6	12	4	10	0.6435
When In Rome	2015-10-29	15	12	4	19	0.6435
Blackguards 2	2015-01-20	610	721	367	977	0.6429
Alter World	2015-05-29	1547	356	177	1724	0.6426000000000001
Last Heroes	2015-11-13	727	71	32	759	0.6425
Metaverse Construction Kit	2015-12-07	59	151	72	131	0.6424
APT	2015-08-27	12	23	9	21	0.6424
Diner Mania	2015-06-26	14	89	41	55	0.6421
Act of Aggression	2015-09-02	3131	1964	1030	4161	0.642
Cluck Yegger in Escape From The Planet of the Poultroid	2015-11-09	6	44	19	25	0.6417
Kaiju-A-GoGo	2015-04-23	178	203	99	277	0.6414
Vektor Wars	2015-06-04	7	48	21	28	0.6412000000000001
East Tower - Akio (ET Series Vol. 1)	2015-04-27	49	50	22	71	0.6409999999999999
InCell VR	2015-09-03	60	179	87	147	0.6408
Puzzle Expedition	2015-06-29	2	2	0	2	0.6408
Hauntsters	2015-12-22	2	2	0	2	0.6408
Beach Bounce	2015-08-14	193	233	115	308	0.6404000000000001
Cataegis : The White Wind	2015-09-25	2809	246	122	2931	0.64
WRC 5	2015-10-08	187	597	307	494	0.6397
Painters Guild	2015-09-01	576	343	173	749	0.6396000000000001
Entropy Rising	2015-11-20	6	31	13	19	0.6395000000000001
FALL	2015-12-17	5	7	2	7	0.6389
MicroRC Simulation	2015-12-15	3	7	2	5	0.6389
Celestrion	2015-12-07	3	7	2	5	0.6389
Hidden Object Bundle 5 in 1	2015-02-27	68	144	70	138	0.6386000000000001
Siege Wars	2015-07-30	174	99	47	221	0.6384000000000001
Boneless Zombie	2015-07-28	6	47	21	27	0.6377
samurai_jazz	2015-01-27	11	63	29	40	0.6376
Vampire of the Sands	2015-07-17	248	61	28	276	0.6376
Fist Slash: Of Ultimate Fury	2015-12-10	742	53	24	766	0.6376
ORBIT	2015-09-30	5	18	7	12	0.6375000000000001
UnSummoning: the Spectral Horde	2015-12-21	372	20	8	380	0.6365
Quadrant	2015-05-26	9	84	40	49	0.6359
Stick 'Em Up 2	2015-07-27	14	82	39	53	0.6358
Epanalepsis	2015-05-21	100	22	9	109	0.6358
TIMEframe	2015-07-07	36	429	223	259	0.6355
Tiny Bridge: Ratventure	2015-05-08	764	624	329	1093	0.6352000000000001
Devouring Stars	2015-07-03	92	26	11	103	0.6349
Everything is Black and White	2015-04-23	2	9	3	5	0.6345000000000001
Death Tractor	2015-10-29	58	52	24	82	0.6344
AGON - The Mysterious Codex (Trilogy)	2015-11-18	74	50	23	97	0.6343
The Travels of Marco Polo	2015-05-06	113	32	14	127	0.6343
Alice's Mom's Rescue	2015-09-03	3	32	14	17	0.6343
Planetship	2015-09-24	6	46	21	27	0.6342
The Musketeers: Victoria's Quest	2015-08-20	872	38	17	889	0.6341
Copa Petrobras de Marcas	2015-04-08	403	1622	881	1284	0.634
Power of Love	2015-07-21	3143	79	38	3181	0.6335000000000001
Riddled Corpses	2015-06-02	172	149	75	247	0.6328
Journey To The Center Of The Earth	2015-09-26	13027	422	223	13250	0.6323
Albert and Otto: The Adventure Begins	2015-10-28	4461	413	218	4679	0.6323
Trine 3: The Artifacts of Power	2015-08-20	672	5148	2876	3548	0.6321
Terra Incognita Chapter One: The Descendant	2015-02-03	13352	665	357	13709	0.632
BlastZone 2	2015-02-19	242	59	28	270	0.6319
Yatagarasu Attack on Cataclysm	2015-07-07	458	187	96	554	0.6314000000000001
Z.A.R.	2015-05-01	5	49	23	28	0.6309
Distant Star: Revenant Fleet	2015-04-07	82	190	98	180	0.6307
PONCHO	2015-11-03	56	123	62	118	0.6307
Devilry	2015-06-30	17	43	20	37	0.6303
The Escapists: The Walking Dead	2015-09-30	269	470	252	521	0.6302000000000001
Cruel Arena	2015-08-18	1494	206	107	1601	0.6301
Deja Vu: MacVenture Series	2015-01-26	24	39	18	42	0.63
ZOMBI	2015-08-18	961	1528	847	1808	0.6296
Bloop Reloaded	2015-02-06	1387	227	119	1506	0.6292
Drift Streets Japan	2015-12-22	5559	2208	1235	6794	0.6291
Aberoth	2015-07-17	265	903	496	761	0.629
Heroes of Legionwood	2015-07-24	22	27	12	34	0.629
Sherlock Holmes Consulting Detective: The Case of the Mystified Murderess	2015-06-08	4	25	11	15	0.6289
BRAWL	2015-08-13	76	52	25	101	0.6281
Dungeon Manager ZV	2015-10-17	151	50	24	175	0.6278
Euro Fishing	2015-11-02	414	1109	616	1030	0.6277
Shutshimi	2015-08-25	27	108	55	82	0.6276
Sketch Tales	2015-09-28	52	95	48	100	0.6275000000000001
Kings of Kung Fu	2015-06-25	43	445	242	285	0.6271
Oscura: Lost Light	2015-02-25	93	76	38	131	0.6267
Epic Arena	2015-05-05	224	191	101	325	0.6262
Heroes of Loot	2015-05-26	285	57	28	313	0.626
Rise: Battle Lines	2015-11-17	110	57	28	138	0.626
栄冠は君に レジェンドパック	2015-01-09	2	4	1	3	0.6251
Gene	2015-01-30	2	4	1	3	0.6251
Star Balls	2015-08-18	3	4	1	4	0.6251
Rugby League Team Manager 2015	2015-06-19	126	34	16	142	0.6249
Pillar	2015-05-29	742	34	16	758	0.6249
Save Your Mother	2015-12-03	336	34	16	352	0.6249
Euclidean	2015-09-26	25	159	84	109	0.6248
RC Mini Racers	2015-07-16	9	88	45	54	0.6246
Hello Kitty and Sanrio Friends Racing	2015-07-09	16	73	37	53	0.624
Romance of the Three Kingdoms Maker	2015-12-10	755	192	103	858	0.6236
Dr.Green	2015-01-03	5	28	13	18	0.6235
Age of Enigma: The Secret of the Sixth Ghost	2015-05-11	5	28	13	18	0.6235
Alarameth TD	2015-06-23	46	28	13	59	0.6235
Faron's Fate	2015-10-16	9	28	13	22	0.6235
The Adventures of Mr. Bobley	2015-07-01	717	245	133	850	0.6233
Stone Tales	2015-12-11	137	26	12	149	0.6231
Porradaria Upgrade	2015-09-30	2388	41	20	2408	0.6224000000000001
BLADESTORM: Nightmare	2015-05-29	158	256	140	298	0.6223
Edolie	2015-02-27	6	22	10	16	0.6221
The Viceroy	2015-07-28	31	22	10	41	0.6221
Lunch Truck Tycoon	2015-05-28	41	169	91	132	0.6219
Toren	2015-05-12	170	827	470	640	0.6217
Calvino Noir	2015-08-27	333	234	128	461	0.6215999999999999
F1 2015	2015-07-09	88029	5363	3149	91178	0.6215
East Tower - Kuon (ET Series Vol. 3)	2015-06-26	26	20	9	35	0.6215
Tisnart Tiles	2015-08-31	140	20	9	149	0.6215
ANKI	2015-08-24	1719	90	47	1766	0.6213000000000001
Nandeyanen!? - The 1st Sûtra	2015-07-22	7	18	8	15	0.621
Mondrian - Abstraction in Beauty	2015-09-21	626	18	8	634	0.621
Robot Exploration Squad	2015-09-16	121	18	8	129	0.621
Lucid Awakening 2	2015-01-08	7	6	2	9	0.621
Queen's Quest: Tower of Darkness	2015-09-10	204	191	104	308	0.6209
Incitement 3	2015-08-19	15408	97	51	15459	0.6209
Project Green Beat	2015-01-16	5	14	6	11	0.62
Voyage to Farland	2015-06-02	46	14	6	52	0.62
Blue Libra	2015-07-28	5	8	3	8	0.6197
عالم أريب	2015-11-02	3	8	3	6	0.6197
Nulldrifters	2015-12-14	2	8	3	5	0.6197
Lighthockey	2015-10-30	4	8	3	7	0.6197
Quatro Luzes	2015-11-14	22	8	3	25	0.6197
Tile Rider	2015-06-04	12	10	4	16	0.6195
The Forgotten Forest	2015-11-11	9	10	4	13	0.6195
Battle Fantasia -Revised Edition-	2015-07-08	50	119	64	114	0.619
Cricket Captain 2015	2015-07-08	276	42	21	297	0.619
Swords & Crossbones: An Epic Pirate Story	2015-09-30	55	51	26	81	0.6186
Dance of Death	2015-12-22	236	199	110	346	0.6184000000000001
Sherlock Holmes Consulting Detective: The Case of the Mummy’s Curse	2015-06-08	6	40	20	26	0.6183
The Deer God	2015-02-27	1039	297	167	1206	0.618
MotoGP™15 Compact	2015-12-10	19	99	53	72	0.618
Serpent in the Staglands	2015-05-28	69	113	61	130	0.6179
Night Mysteries: The Amphora Prisoner	2015-02-26	1123	90	48	1171	0.6177
The Big Secret of a Small Town	2015-10-22	280	74	39	319	0.6176
Lootfest	2015-05-14	5	38	19	24	0.6176
Void & Meddler	2015-10-28	132	179	99	231	0.6175
A-Train 9 V4.0 : Japan Rail Simulator	2015-10-21	27	79	42	69	0.6169
Batla	2015-05-14	1629	1968	1165	2794	0.6168
LocoSoccer Classic	2015-12-10	2252	168	93	2345	0.6168
The Swindle	2015-07-28	187	370	211	398	0.6167
Hidden: On the trail of the Ancients	2015-08-05	21	54	28	49	0.6165999999999999
The Incredible Adventures of Van Helsing III	2015-05-22	923	721	419	1342	0.6165
The Ritual on Weylyn Island	2015-12-05	10	45	23	33	0.6165
BattleLore: Command	2015-03-31	35	77	41	76	0.6164000000000001
Musclecar Online	2015-02-12	6	23	11	17	0.616
Soul Locus	2015-04-30	34	23	11	45	0.616
Corpse of Discovery	2015-08-26	19	115	63	82	0.6154000000000001
Anoxemia	2015-01-16	2299	265	151	2450	0.6147
Mahjong Pretty Girls Battle	2015-01-21	170	242	138	308	0.614
Nyctophilia	2015-09-23	68	191	108	176	0.6139
Sonic Lost World	2015-11-02	252	2351	1415	1667	0.6138
A Fistful of Gun	2015-09-24	216	299	172	388	0.6137
God Game : The Odyssey	2015-11-06	686	338	196	882	0.6129
The Masterplan	2015-06-04	163	328	190	353	0.6129
Supreme: Pizza Empire	2015-01-09	28	72	39	67	0.6127
Supreme League of Patriots Issue 1: A Patriot Is Born	2015-01-29	204	65	35	239	0.6126
SCS deORBIT	2015-08-17	7	17	8	15	0.6125
Haywire on Fuel Station Zeta	2015-09-25	528	17	8	536	0.6125
Fermi's Path	2015-04-20	132	35	18	150	0.6121
Jump	2015-07-30	5	26	13	18	0.6118
World of Soccer 	2015-08-27	533	692	412	945	0.6114
The Moment of Silence	2015-03-27	12	61	33	45	0.6111
MyDream	2015-02-20	12	61	33	45	0.6111
Hyperspeed	2015-04-01	4	15	7	11	0.6111
Space Robot Samurai Zombie Slayer	2015-05-21	3	15	7	10	0.6111
You Are Not a Banana: Better Edition	2015-02-19	572	90	50	622	0.6107
Hektor	2015-03-13	1880	608	363	2243	0.6103000000000001
Spandex Force: Champion Rising	2015-06-24	751	45	24	775	0.6098
ASA: A Space Adventure - Remastered Edition	2015-03-04	20	31	16	36	0.6098
Gare Sapphire Mechs	2015-04-01	6	31	16	22	0.6098
I, Gladiator	2015-04-07	77	98	55	132	0.6097
Blues and Bullets	2015-07-23	118	847	511	629	0.6096
Buggy	2015-07-06	3	13	6	9	0.6095
Superstar Dance Club	2015-08-04	4	13	6	10	0.6095
Legena: Union Tides	2015-10-08	5	13	6	11	0.6095
FINAL FANTASY IV: THE AFTER YEARS	2015-05-11	271	299	176	447	0.6092000000000001
Night Shift	2015-02-23	68	74	41	109	0.6092000000000001
Ski Park Tycoon	2015-02-03	15	50	27	42	0.6091
ORBITOR	2015-08-21	4	22	11	15	0.609
Unfinished - An Artist's Lament	2015-08-04	535	22	11	546	0.609
CAFE 0 ~The Drowned Mermaid~	2015-01-29	67	106	60	127	0.6089
Marble Duel	2015-11-12	1328	196	114	1442	0.6088
The Great Fusion	2015-02-25	36	43	23	59	0.6088
Runes of Brennos	2015-10-16	102	29	15	117	0.6085
Football Mogul 2014	2015-05-28	16	29	15	31	0.6085
Rituals	2015-05-27	29	164	95	124	0.6082
The Seven Years War (1756-1763)	2015-10-30	26	82	46	72	0.6081000000000001
Odysseus: Long Way Home	2015-02-23	842	48	26	868	0.6081000000000001
Tinboy	2015-08-31	1713	305	181	1894	0.6078
Hot Tin Roof: The Cat That Wore A Fedora	2015-02-20	459	132	76	535	0.6077
Lilly and Sasha: Nexus of Souls	2015-05-26	372	41	22	394	0.6077
Twilight City: Love as a Cure	2015-12-18	9	53	29	38	0.6076
Sun Dogs	2015-10-29	5	11	5	10	0.6076
Supreme League of Patriots Issue 3: Ice Cold in Ellis	2015-01-29	92	27	14	106	0.6071
FINAL FANTASY TYPE-0 HD	2015-08-18	2673	1771	1097	3770	0.6068
VolChaos	2015-12-08	779	32	17	796	0.6059
Hoven the Sages Spinel	2015-08-31	6	18	9	15	0.6055
Poppy Kart	2015-10-09	2	9	4	6	0.6054
All Fall Down	2015-10-16	67	9	4	71	0.6054
Freedom Poopie	2015-10-16	5	9	4	9	0.6054
Carrotting Brain	2015-10-23	5	9	4	9	0.6054
Agent Awesome	2015-02-17	1759	534	326	2085	0.6051
Legend	2015-11-10	131	47	26	157	0.6045
GabeN: The Final Decision	2015-09-21	1322	425	259	1581	0.6043000000000001
Velocity 2X	2015-08-19	49	82	47	96	0.6043000000000001
Mahjong Pretty Girls Battle : School Girls Edition	2015-06-23	121	159	94	215	0.6042000000000001
RESCUE 2	2015-06-03	143	162	96	239	0.6039
Jim Power -The Lost Dimension 	2015-09-30	136	40	22	158	0.6035
Heckabomb	2015-02-27	1519	181	108	1627	0.6034
Wildlife Park - Wild Creatures	2015-04-01	8	16	8	16	0.6034
StaudSoft's Synthetic World	2015-02-10	4	16	8	12	0.6034
The Apotheosis Project	2015-07-10	801	70	40	841	0.6033
Wildlife Park	2015-04-01	18	50	28	46	0.6032000000000001
FreezeME	2015-12-10	10	50	28	38	0.6032000000000001
Krosmaster Arena	2015-11-09	466	184	110	576	0.6031000000000001
Sun Blast	2015-04-03	1264	406	249	1513	0.6028
Castles	2015-10-09	168	28	15	183	0.6028
Aces of the Luftwaffe	2015-05-08	7	73	42	49	0.6026
Cults and Daggers	2015-02-12	46	33	18	64	0.6023
Cahors Sunset	2015-01-13	14	48	27	41	0.6020000000000001
Mirrored - Chapter 1	2015-10-30	131	71	41	172	0.6017
The Architect	2015-06-04	220	21	11	231	0.6017
Threads of Destiny	2015-12-04	1314	21	11	1325	0.6017
Never Ending Night	2015-09-30	4	14	7	11	0.6009000000000001
99 Waves to Die	2015-04-09	6	14	7	13	0.6009000000000001
Sparkle 3 Genesis	2015-04-24	1964	310	191	2155	0.6005
Lucius II	2015-02-13	335	1219	776	1111	0.5998
SpaceCorn	2015-06-23	2329	241	148	2477	0.5997
Prometheus - The Fire Thief	2015-04-20	4	5	2	6	0.5997
Floors of Discomfort	2015-05-26	2	5	2	4	0.5997
iaidoka_interlude	2015-04-24	11	44	25	36	0.5994
TableTop Cricket	2015-02-25	71	19	10	81	0.5994
Red Stone Online	2015-04-16	106	182	111	217	0.5993
Audition Online	2015-06-04	367	934	594	961	0.599
Shin Samurai Jazz	2015-03-16	8	57	33	41	0.599
Giana Sisters 2D	2015-10-23	39	153	93	132	0.5987
Goblin Defenders: Steel‘n’ Wood	2015-11-24	815	73	43	858	0.5985
BOMB	2015-07-29	19	47	27	46	0.5982999999999999
Helena The 3rd	2015-05-01	4	12	6	10	0.598
Mystery Castle: The Mirror's Secret	2015-12-18	8	42	24	32	0.5979
Ruzh Delta Z	2015-05-11	35	312	195	230	0.5977
Three Fourths Home: Extended Edition	2015-03-20	397	130	79	476	0.5976
Way of Gold and Steel	2015-08-17	95	71	42	137	0.5975
Miner Mayhem	2015-09-23	130	71	42	172	0.5975
Ravenmark: Scourge of Estellion	2015-09-10	71	58	34	105	0.5971000000000001
Super Dungeon Run	2015-07-17	50	85	51	101	0.5966
VROOM: Galleon	2015-10-27	4	22	12	16	0.5966
Eternal Step	2015-10-16	35	40	23	58	0.5963
House of Nightmares B-Movie Edition	2015-04-23	9	3	1	10	0.596
The Facility	2015-09-03	2	3	1	3	0.596
Pro Cycling Manager 2015	2015-06-18	2451	233	146	2597	0.5956
Hit Tank PRO	2015-12-02	471	75	45	516	0.5955
Blue Rose Reprise	2015-04-23	193	86	52	245	0.5953
Colonial Conquest	2015-07-28	88	147	91	179	0.595
Chronicles of the Witches and Warlocks	2015-11-18	2767	122	75	2842	0.595
Son of Nor	2015-03-31	56	125	77	133	0.5948
Escape	2015-04-20	45	173	108	153	0.5945
Knight of the Hamsters	2015-04-15	8	10	5	13	0.5943
Diamond Deeps	2015-06-02	3	10	5	8	0.5943
Tank: The M1A1 Abrams Battle Tank Simulation	2015-11-13	3	10	5	8	0.5943
One Last Day	2015-04-28	32	65	39	71	0.5942000000000001
Fjall	2015-09-07	2	1	0	2	0.5942000000000001
Fringes of the Empire	2015-11-16	2	1	0	2	0.5942000000000001
Save the Creatures	2015-10-19	1	1	0	1	0.5942000000000001
Blessed Ones: The Magic Wolves	2015-12-05	2	1	0	2	0.5942000000000001
Pulut Adventure	2015-07-09	5	57	34	39	0.594
Tenshu General	2015-12-01	33	20	11	44	0.594
Build 'n Bump	2015-07-22	98	20	11	109	0.594
Discouraged Workers	2015-09-16	242	90	55	297	0.5938
Tic-Toc-Tower	2015-09-28	194	49	29	223	0.5938
Solarix	2015-04-30	1459	263	167	1626	0.5937
Malebolgia	2015-05-06	54	79	48	102	0.5937
Standpoint	2015-03-05	6	15	8	14	0.5937
MX vs. ATV Supercross Encore	2015-10-28	100	464	299	399	0.5935
ManaCollect	2015-04-17	35	44	26	61	0.5929
Nomad	2015-06-26	293	2774	1846	2139	0.5925
Into the Void	2015-12-04	96	80	49	145	0.5924
Sentris	2015-08-12	17	23	13	30	0.5921000000000001
The Race for the White House	2015-01-02	14	31	18	32	0.5918
Bret Airborne	2015-01-29	36	42	25	61	0.5912
Shred! Remastered	2015-07-08	21	70	43	64	0.5908
Black Fire	2015-02-13	408	197	126	534	0.5906
Eron	2015-03-17	3950	197	126	4076	0.5906
gravilon	2015-03-30	975	753	497	1472	0.5904
Astronaut Simulator	2015-04-02	8	37	22	30	0.5901
Ghost in the Machine	2015-04-22	4	13	7	11	0.59
Tidal Affair: Before The Storm	2015-11-24	4	13	7	11	0.59
Tiki Galore	2015-10-06	5	8	4	9	0.5897
Louie Cooks	2015-11-10	96	8	4	100	0.5897
Blood and Gold: Caribbean!	2015-12-10	497	728	483	980	0.5892000000000001
Let There Be Life	2015-02-13	7	21	12	19	0.5892000000000001
War Trigger 3	2015-12-22	1843	4914	3341	5184	0.589
16 Bit Arena	2015-03-24	799	43	26	825	0.5889
Warlocks vs Shadows	2015-08-19	157	172	111	268	0.5881000000000001
In Exilium	2015-03-13	1988	49	30	2018	0.5881000000000001
CINEVEO - Virtual Reality Cinema	2015-04-24	8	75	47	55	0.5878
Pay2Win: The Tricks Exposed	2015-12-15	26	78	49	75	0.5877
Void Destroyer	2015-01-20	137	206	134	271	0.5876
Just Survive	2015-01-15	40335	46472	32230	72565	0.5874
8BitMMO	2015-01-26	674	2620	1786	2460	0.5871000000000001
Nightside	2015-08-06	405	73	46	451	0.5866
Walkover	2015-03-23	43	79	50	93	0.5864
The Gate	2015-04-28	223	142	92	315	0.5861999999999999
Chronicles of a Dark Lord: Episode II War of The Abyss	2015-01-17	585	33	20	605	0.5857
Geocore	2015-07-31	1577	22	13	1590	0.5849000000000001
The Journey Back	2015-08-12	12	22	13	25	0.5849000000000001
Deepworld	2015-04-22	425	435	292	717	0.5848
Starship Traveller	2015-03-11	33	42	26	59	0.5848
Resilience Wave Survival	2015-12-23	10	111	72	82	0.5844
One Manga Day	2015-05-04	536	549	371	907	0.5843
MiniOne Racing	2015-07-01	678	28	17	695	0.5836
Tkl Online	2015-01-27	7	14	8	15	0.5833
Deja Vu II: MacVenture Series	2015-01-26	22	14	8	30	0.5833
Velocity Stream	2015-10-05	9	6	3	12	0.5833
Lands of Hope Redemption	2015-10-15	14	6	3	17	0.5833
Lost Labyrinth Extended Version	2015-11-24	8	37	23	31	0.5828
Scribble Space	2015-06-01	90	61	39	129	0.5826
Mighty Dungeons	2015-03-03	66	52	33	99	0.5825
ENKI	2015-07-31	68	98	64	132	0.5822999999999999
Zotrix	2015-07-24	920	120	79	999	0.5821000000000001
Frozen Free Fall: Snowball Fight	2015-09-15	867	1143	790	1657	0.5820000000000001
Return NULL - Episode 1	2015-04-02	106	59	38	144	0.5810000000000001
Spy Bugs	2015-06-26	7	23	14	21	0.5809000000000001
Puzzle Station 15th Anniversary Retro Release	2015-04-30	4	23	14	18	0.5809000000000001
Freshman Year	2015-04-20	6	125	83	89	0.5807
Bunker - The Underground Game	2015-05-21	654	44	28	682	0.5806
Shadow Hunter	2015-04-20	16	41	26	42	0.5805
The Princess' Heart	2015-07-30	30	32	20	50	0.5805
Zombie Camp: Last Survivor	2015-04-17	15	29	18	33	0.5805
Sister’s Secrecy: Arcanum Bloodlines - Premium Edition	2015-05-28	10	35	22	32	0.5804
Shadowrun Chronicles - Boston Lockdown	2015-04-28	720	788	546	1266	0.5803
Ant War: Domination	2015-10-02	156	132	88	244	0.5803
Devil's Bluff	2015-10-29	106	113	75	181	0.5802
VEGA Conflict	2015-12-14	3814	2688	1896	5710	0.5796
Jane's Realty	2015-10-21	7	9	5	12	0.5796
Lamia Must Die	2015-08-26	20	114	76	96	0.5794
Wanderlust Adventures	2015-08-11	587	147	99	686	0.579
Legend of Dungeon: Masters	2015-11-30	825	115	77	902	0.5787
Royal Bounty HD	2015-08-10	550	96	64	614	0.5783
Shadowgate: MacVenture Series	2015-01-26	27	39	25	52	0.5782
Untamed: Life Of A Cougar	2015-08-27	20	77	51	71	0.578
Starlaxis Supernova Edition	2015-02-11	992	33	21	1013	0.5779
Skyshine's BEDLAM	2015-09-16	789	518	361	1150	0.5777
Playing History - The Plague	2015-10-21	3	30	19	22	0.5777
Woolfe - The Red Hood Diaries	2015-03-17	133	857	602	735	0.5776
Super Trench Attack 2	2015-11-06	242	71	47	289	0.5776
Beatbuddy: On Tour	2015-12-04	5	15	9	14	0.5776
Mushroom Men: Truffle Trouble 	2015-03-10	67	27	17	84	0.5775
Rolling Shapes	2015-06-08	349	27	17	366	0.5775
Superstatic	2015-09-15	581	21	13	594	0.5773
Sherlock Holmes Consulting Detective: The Case of the Tin Soldier	2015-06-08	5	21	13	18	0.5773
Expert Rifleman - Reloaded	2015-08-14	40	18	11	51	0.5773
Cast of the Seven Godsends - Redux	2015-07-17	105	94	63	168	0.5772
Disillusions Manga Horror	2015-01-16	170	312	216	386	0.5771000000000001
Star Chronicles: Delta Quadrant	2015-07-07	2936	171	117	3053	0.5767
Jones On Fire	2015-03-27	395	131	89	484	0.5767
Gem Wars: Attack of the Jiblets	2015-12-15	139	43	28	167	0.5765
Black Island	2015-10-14	8	43	28	36	0.5765
Akuatica	2015-11-27	230	43	28	258	0.5765
CaesarIA	2015-01-20	333	817	577	910	0.5763
The Mystery of a Lost Planet	2015-12-17	21	56	37	58	0.5761000000000001
Grass Simulator	2015-04-01	572	579	408	980	0.5758
Agarest: Generations of War 2	2015-02-19	376	139	95	471	0.5758
Hyperspace Pinball	2015-09-30	22	31	20	42	0.5750000000000001
The Battle of Sol	2015-07-01	34	57	38	72	0.5747
Aero's Quest	2015-06-08	64	57	38	102	0.5747
Pyramid Raid	2015-12-15	111	97	66	177	0.5746
Lovely Weather We're Having	2015-11-10	6	44	29	35	0.5746
Selfie: Sisters of the Amniotic Lens	2015-05-08	672	114	78	750	0.5745
Luna's Wandering Stars	2015-05-15	37	64	43	80	0.5742
XenoBloom	2015-09-23	10	25	16	26	0.5740999999999999
Spheritis	2015-06-04	2	4	2	4	0.5739
Birth of Shadows	2015-11-05	71	4	2	73	0.5739
Axes and Arrows	2015-10-09	2	4	2	4	0.5739
Towers of Altrac	2015-01-05	166	71	48	214	0.5738000000000001
The Corporate Machine	2015-03-25	30	51	34	64	0.5738000000000001
Nicolas Eymerich The Inquisitor Book II : The Village	2015-01-22	9	22	14	23	0.5736
Vicky Saves the Big Dumb World	2015-10-01	429	22	14	443	0.5736
Tony Tough and the Night of Roasted Moths	2015-05-07	5	19	12	17	0.5731
SWR JST DX Selective Memory Erase Effect	2015-04-20	52	19	12	64	0.5731
Spoko and Poko	2015-05-11	810	19	12	822	0.5731
Spirit Of War	2015-03-12	44	45	30	74	0.5728
Shadow Ninja: Apocalypse	2015-09-22	750	100	69	819	0.5722
Slinki	2015-04-15	346	13	8	354	0.5721
Frizzy	2015-12-23	3	13	8	11	0.5721
Spaceforce Rogue Universe HD	2015-05-26	37	29	19	56	0.5719
Visibility	2015-05-25	6	49	33	39	0.5718
StartBolita	2015-07-30	2	7	4	6	0.5718
Brain Guzzler	2015-05-14	3	7	4	7	0.5718
Dissonance: An Interactive Novelette	2015-12-01	10	7	4	14	0.5718
ATLAS レジェンドパック	2015-01-09	4	10	6	10	0.5717
Icarus-X: Tides of Fire	2015-06-24	51	10	6	57	0.5717
RoBoRumble	2015-12-10	13029	115	80	13109	0.5714
Motorbike	2015-01-19	12	36	24	36	0.5710000000000001
Backgammon Blitz	2015-11-12	35	116	81	116	0.5708
Kyn	2015-07-28	118	88	61	179	0.5706
Dark Matter	2015-02-27	6	88	61	67	0.5706
Data Hacker: Reboot	2015-04-17	8774	113	79	8853	0.5704
Star Horizon	2015-05-28	47	85	59	106	0.5700999999999999
Curses 'N Chaos	2015-08-18	67	71	49	116	0.5700000000000001
Subject 13	2015-05-28	678	172	122	800	0.5697
Dragon Fin Soup	2015-11-03	196	169	120	316	0.5694
Terra Lander Remastered	2015-02-06	17	129	91	108	0.5694
Card Dungeon	2015-06-02	33	30	20	53	0.5694
theHunter: Primal	2015-03-31	1138	2336	1727	2865	0.5688000000000001
Centauri Sector	2015-06-23	525	27	18	543	0.5684
Evil Hazard	2015-09-16	6	17	11	17	0.5683
Orbit HD	2015-03-18	463	48	33	496	0.568
Reign Of Kings	2015-12-16	13278	8573	6421	19699	0.5678
Chronicle Keepers: The Dreaming Garden	2015-06-11	13	77	54	67	0.5676
Your Quest	2015-11-02	905	88	62	967	0.5675
East Tower - Takashi (ET Series Vol. 2)	2015-05-27	52	24	16	68	0.5673
Skyflower	2015-06-25	5	24	16	21	0.5673
Treeker: The Lost Glasses	2015-05-14	22	38	26	48	0.5671
Seeders	2015-08-21	582	31	21	603	0.5671
Nexus : One Core	2015-02-26	4	14	9	13	0.5669
In Space We Brawl	2015-07-17	16	14	9	25	0.5669
Block Legend DX	2015-02-24	879	78	55	934	0.5667
Pregnancy	2015-03-02	42	199	144	186	0.5664
Last Days of Spring Visual Novel	2015-10-07	570	71	50	620	0.5663
Yargis - Space Melee	2015-06-30	1790	112	80	1870	0.5662
Sir! I'd Like To Report A Bug!	2015-10-19	988	21	14	1002	0.5660000000000001
Crossbow Warrior - The Legend of William Tell	2015-12-10	7	21	14	21	0.5660000000000001
The Quivering	2015-01-28	3	11	7	10	0.5653
4089: Ghost Within	2015-01-09	125	61	43	168	0.5652
Chronicles of a Dark Lord: Rhapsody Clash	2015-11-20	577	18	12	589	0.5644
TRISTOY	2015-01-15	285	77	55	340	0.5642
Fated Souls	2015-07-30	1275	36	25	1300	0.5640999999999999
Vertiginous Golf	2015-05-07	1330	620	464	1794	0.5632
Challenge of the Five Realms	2015-04-01	3	8	5	8	0.5632
Grail to the Thief	2015-05-26	39	22	15	54	0.5629
Metal War Online: Retribution	2015-12-11	803	566	424	1227	0.5627000000000001
The Language Game	2015-07-09	3	15	10	13	0.5625
Rememoried	2015-08-31	64	127	93	157	0.5621
Cosplay Maker	2015-12-10	54	26	18	72	0.562
Eden Star	2015-01-30	110	617	465	575	0.5617
Tales Runner	2015-02-17	734	338	253	987	0.5614
Attack of the Labyrinth +	2015-03-30	58	30	21	79	0.5614
History in Letters - The Eternal Alchemist	2015-12-08	4	5	3	7	0.5605
Exostorm	2015-05-15	4	5	3	7	0.5605
The ORPHEUS Ruse	2015-12-18	12	5	3	15	0.5605
Curse of Mermos	2015-06-23	164	151	112	276	0.5603
Osteya	2015-11-21	2093	62	45	2138	0.56
The Sandbox	2015-06-29	116	321	242	358	0.5597
Armikrog	2015-09-30	1202	825	630	1832	0.5595
How To Survive Third Person	2015-07-02	667	706	539	1206	0.5592
Dream Of Mirror Online	2015-08-14	371	298	226	597	0.5583
But to Paint a Universe	2015-01-15	255	20	14	269	0.5579999999999999
The Tower Of Elements	2015-08-05	5139	187	141	5280	0.5579
Showing Tonight: Mindhunters Incident	2015-11-12	1981	48	35	2016	0.5577000000000001
Streamline	2015-09-02	5	32	23	28	0.5575
Inevitability	2015-08-24	8	28	20	28	0.5575
UfoPilot : Astro-Creeps Elite	2015-05-05	1	2	1	2	0.5569
StarDrive 2	2015-04-09	3609	1140	884	4493	0.5568
Super Goo Goo	2015-04-16	4	9	6	10	0.5566
Cars Radiator Springs Adventures	2015-02-24	9	45	33	42	0.5563
Circuit Breakers	2015-11-17	239	62	46	285	0.556
Cave Coaster	2015-06-04	547	37	27	574	0.5559000000000001
FranknJohn	2015-03-04	4	13	9	13	0.5555
Ninjahtic Mind Tricks	2015-07-16	205	21	15	220	0.5552
Snik	2015-09-04	1440	63	47	1487	0.5551
Novus Inceptio	2015-10-05	153	690	538	691	0.5546
Farm Mechanic Simulator 2015	2015-04-23	42	55	41	83	0.5545
Deadly Sin	2015-03-27	73	38	28	101	0.5544
Dream	2015-07-31	224	543	424	648	0.5538000000000001
Dream Chamber	2015-07-31	6	30	22	28	0.5536
DEUS EX MACHINA 2	2015-03-11	6	61	46	52	0.5529999999999999
Pirates vs Corsairs: Davy Jones's Gold	2015-03-16	4	18	13	17	0.5522
NOBUNAGA'S AMBITION: Tenshouki with Power Up Kit HD Version	2015-11-11	241	31	23	264	0.5519
The Dark Stone from Mebara	2015-02-27	1901	113	87	1988	0.5518
Will Fight for Food: Super Actual Sellout: Game of the Hour	2015-04-22	86	49	37	123	0.5516
Regimental Chess	2015-04-29	3271	109	84	3355	0.5515
Rustbucket Rumble	2015-05-04	358	209	163	521	0.5514
Tower of Eglathia	2015-04-07	9	6	4	13	0.5514
Mass Destruction	2015-08-24	2	6	4	6	0.5514
Rothschild: The Sheep Will Wake	2015-11-23	5	6	4	9	0.5514
Invisible Apartment Zero	2015-05-06	3	10	7	10	0.5513
Fury Of The Gods	2015-06-04	5	10	7	12	0.5513
Midnight's Blessing	2015-05-25	1107	27	20	1127	0.5512
Dark Heritage: Guardians of Hope	2015-09-24	357	187	146	503	0.5509000000000001
VERLIES II	2015-09-25	872	68	52	924	0.5509000000000001
Raiden Legacy	2015-12-10	13	135	105	118	0.5505
Chronostorm: Siberian Border	2015-11-20	1595	50	38	1633	0.5505
Tango Fiesta	2015-09-24	73	41	31	104	0.5504
Interstellaria	2015-07-17	952	228	179	1131	0.5503
STATIC: Investigator Training	2015-04-14	4	19	14	18	0.5496
Affected Zone Tactics	2015-11-17	99	172	135	234	0.5495
The Defenders: The Second Wave	2015-03-30	453	51	39	492	0.5495
AION Free-to-Play	2015-12-16	2987	2620	2113	5100	0.5494
AdvertCity	2015-06-05	136	47	36	172	0.5488000000000001
Crystal Picnic	2015-11-02	39	15	11	50	0.5484
Trouble In The Manor	2015-11-17	2161	172	136	2297	0.5479999999999999
Double Dragon Trilogy	2015-01-15	159	490	393	552	0.5478000000000001
Uncanny Valley	2015-04-23	77	275	220	297	0.547
Heavy Fire: Shattered Spear	2015-10-23	36	44	34	70	0.5468999999999999
Mystical	2015-07-31	6	11	8	14	0.5468999999999999
Parallels	2015-11-13	53	11	8	61	0.5468999999999999
Sky Battles	2015-03-25	806	49	38	844	0.5468000000000001
Kidnapped	2015-08-04	1421	299	240	1661	0.5465
Green Moon	2015-05-15	874	16	12	886	0.5455
Macabre	2015-07-06	1983	16	12	1995	0.5455
Ghost Cleaner	2015-11-05	5	16	12	17	0.5455
Demigods	2015-10-15	6	16	12	18	0.5455
Ancestory	2015-10-13	72	21	16	88	0.545
Trapped Dead: Lockdown	2015-03-20	24	98	78	102	0.5449
The Tape	2015-11-19	682	233	188	870	0.5448
Lilly and Sasha: Guardian Angels	2015-07-07	235	41	32	267	0.5448
Heart of Ember 	2015-07-27	3	7	5	8	0.5448
Goggles - World of Vaporia	2015-10-09	1209	7	5	1214	0.5448
Arcane Sorcery	2015-09-15	207	31	24	231	0.5447
Avaris 2	2015-12-15	56	31	24	80	0.5447
Hyperdrive Massacre	2015-10-12	181308	193	156	181464	0.5439
MiniDrivers	2015-08-31	717	69	55	772	0.5433
Ride the Bullet	2015-05-22	5	12	9	14	0.5433
Hogs of War	2015-07-28	18	213	173	191	0.5432
Advent	2015-05-16	3	17	13	16	0.543
Forsaken Isle	2015-02-06	101	204	166	267	0.5427000000000001
Hero Generations	2015-04-10	217	120	97	314	0.5425
TNN Motorsports Hardcore TR	2015-08-10	3	3	2	5	0.5417000000000001
The Makeshifter	2015-08-21	39	3	2	41	0.5417000000000001
RELIC ALONE	2015-11-27	3	3	2	5	0.5417000000000001
Drew and the Floating Labyrinth	2015-02-04	226	28	22	248	0.5416
Valhalla Hills	2015-12-02	557	669	554	1111	0.5415
Breach & Clear: Deadline Rebirth (2016)	2015-07-21	425	468	388	813	0.5406000000000001
A.V.	2015-02-14	46	13	10	56	0.5402
Janky Tanks	2015-02-12	5	8	6	11	0.5398
VR Karts	2015-04-17	4	8	6	10	0.5398
Downpour 	2015-05-14	33	8	6	39	0.5398
Ramayana	2015-05-25	4	8	6	10	0.5398
One Hundred Ways	2015-10-23	1112	35	28	1140	0.5397
METAL SLUG DEFENSE	2015-05-01	413	998	838	1251	0.539
ShipLord	2015-12-02	13869	360	300	14169	0.539
Labyrinth Simulator	2015-09-21	63	71	58	121	0.5387
The Little Crane That Could	2015-04-27	11	19	15	26	0.5387
R.O.O.T.S	2015-04-01	11	36	29	40	0.5386
Freedom Cry	2015-09-04	1000	36	29	1029	0.5386
Ghost Pirates of Vooju Island	2015-01-27	8	42	34	42	0.5384000000000001
BiT Evolution	2015-06-09	178	96	79	257	0.5383
Stones of Sorrow	2015-05-26	1079	54	44	1123	0.5382
One Way To Die	2015-09-01	40	178	148	188	0.538
Match 3 Revolution	2015-09-11	6	25	20	26	0.538
Survarium	2015-04-02	4382	13977	11934	16316	0.5376
Orion: A Sci-Fi Visual Novel	2015-09-28	8	43	35	43	0.5375
Al Emmo's Postcards from Anozira	2015-06-02	763	20	16	779	0.5368
Pilot Brothers 3: Back Side of the Earth	2015-01-22	5	32	26	31	0.5366
Castle Chaos	2015-12-08	6	32	26	32	0.5366
After All	2015-04-20	2828	26	21	2849	0.5366
Might & Magic Heroes VII 	2015-09-29	4993	3074	2627	7620	0.5363
WolfWars	2015-01-02	698	9	7	705	0.5359
Atlantic Quest Solitaire	2015-06-22	5	9	7	12	0.5359
Club Manager 2016	2015-11-19	164	52	43	207	0.5354
1,000 Heads Among the Trees	2015-12-11	1600	65	54	1654	0.5353
Factions: Origins of Malu	2015-03-23	26	15	12	38	0.5352
Starlight Tactics	2015-04-07	21	15	12	33	0.5352
Deserter Simulator	2015-07-31	22	35	29	51	0.5335
SAGA	2015-08-04	146	69	58	204	0.5333
Snails	2015-05-04	3	4	3	6	0.5332
Soda Star	2015-05-14	2	4	3	5	0.5332
Tick: The Time Based Puzzle Game	2015-08-21	3	4	3	6	0.5332
Blues and Bullets - Digital Comic	2015-07-23	3	4	3	6	0.5332
SickBrick	2015-01-30	393	111	94	487	0.5331
Vagrant Hearts 2	2015-05-20	22	16	13	35	0.5331
Yohjo Simulator	2015-11-17	26	141	120	146	0.5327000000000001
Phineas and Ferb: New Inventions	2015-02-24	3	10	8	11	0.5327000000000001
Playing History 2 - Slave Trade	2015-08-27	6	78	66	72	0.5324
Zombie Killtime	2015-08-04	1848	23	19	1867	0.5323
Trap Them - Sniper Edition	2015-10-09	184	17	14	198	0.5313
Illuminascii	2015-08-11	15	24	20	35	0.531
Blowy Fish	2015-09-25	63	24	20	83	0.531
B.A.D Battle Armor Division	2015-08-18	4	31	26	30	0.5309
Tulpa	2015-01-29	518	130	112	630	0.5301
Bowl Bound College Football	2015-09-03	68	62	53	121	0.5297999999999999
Ringies	2015-09-10	11	25	21	32	0.5297999999999999
Noct	2015-10-21	57	306	267	324	0.529
Coast Guard	2015-10-21	51	64	55	106	0.5289
Project Tarvotan	2015-09-25	3131	26	22	3153	0.5288
Jagged Alliance Online: Reloaded	2015-09-24	95	80	69	164	0.5287
Pester	2015-08-21	1004	57	49	1053	0.5285
War of Beach	2015-10-16	428	273	239	667	0.5281
Nature Defenders	2015-12-22	2	5	4	6	0.5278
Drizzlepath	2015-03-12	46	311	274	320	0.527
Dale Hardshovel HD	2015-09-22	3334	20	17	3351	0.527
President for a Day - Floodings	2015-08-12	9	28	24	33	0.5268
Hydraulic Empire	2015-07-31	75	37	32	107	0.5261
Bermuda	2015-03-17	49	115	101	150	0.526
Navpoint	2015-09-23	131	13	11	142	0.5259
Reigning Cats	2015-08-28	44	13	11	55	0.5259
Front Wars	2015-08-17	21	31	27	48	0.5244
Wave of Darkness	2015-11-05	40	49	43	83	0.5243
SCHAR: Blue Shield Alliance	2015-03-03	49	14	12	61	0.5242
CastleAbra	2015-06-05	3	6	5	8	0.5239
The Logomancer	2015-08-04	119	6	5	124	0.5239
The Worm	2015-09-29	2	6	5	7	0.5239
Reflections	2015-06-26	18	41	36	54	0.5236999999999999
Truck Mechanic Simulator 2015	2015-05-01	63	100	89	152	0.5231
Albedo: Eyes from Outer Space	2015-04-10	155	140	125	280	0.523
TDP4:Team Battle	2015-03-12	201	441	397	598	0.5228
1942: The Pacific Air War	2015-04-01	5	24	21	26	0.5228
Barter Empire	2015-02-06	33	15	13	46	0.5228
Omnipresent	2015-09-28	43	15	13	56	0.5228
Adventures of Robinson Crusoe	2015-01-09	7	63	56	63	0.5225
Giana Sisters: Dream Runners	2015-08-26	82	25	22	104	0.522
Break_In	2015-04-29	11	25	22	33	0.522
Hatch and Slay	2015-12-22	125	25	22	147	0.522
The Land Of Lamia	2015-11-23	181	35	31	212	0.5218
Nightmare on Azathoth	2015-10-30	25	16	14	39	0.5215
Wickland	2015-02-06	300	447	405	705	0.5214
Car Mechanic Manager	2015-09-23	21	56	50	71	0.5214
An Imp? A Fiend!	2015-03-16	437	36	32	469	0.5212
Starlord	2015-11-13	3	7	6	9	0.5211
Umbra: Shadow of Death	2015-12-19	35	7	6	41	0.5211
Pulse	2015-10-20	13	37	33	46	0.5207
ArcheAge	2015-03-26	6509	3756	3442	9951	0.5203
Gamer Simulator	2015-09-22	5	17	15	20	0.5203
Mortal Online	2015-08-31	1185	1532	1402	2587	0.5202
Sword Daughter	2015-02-13	9	62	56	65	0.5194
Uebergame	2015-10-26	45	253	231	276	0.5192
Lost in Paradise	2015-08-20	445	40	36	481	0.5192
Gunslingers	2015-12-17	230	182	166	396	0.519
LA Cops	2015-03-13	47	87	79	126	0.5189
Troubles Land	2015-09-11	3	8	7	10	0.5189
Wicked Witches	2015-11-27	5	8	7	12	0.5189
Monster RPG 2	2015-10-12	65	19	17	82	0.5184000000000001
Ceres	2015-10-16	57	78	71	128	0.5183
A Sirius Game	2015-08-21	1181	32	29	1210	0.5175
Paparazzi	2015-02-17	5	9	8	13	0.5171
Hunter Gatherer	2015-03-24	5	9	8	13	0.5171
Kingdoms CCG	2015-01-22	543	72	66	609	0.5168
Battle Chess: Game of Kings™	2015-12-11	19	169	156	175	0.5165
Desert Law	2015-03-25	6	35	32	38	0.5161
Idle Civilization	2015-11-24	249	92	85	334	0.5156000000000001
Bridge Creator 2015	2015-01-26	15	10	9	24	0.5156000000000001
Rooftop Cop	2015-03-02	3	10	9	12	0.5156000000000001
Colony Assault	2015-12-15	4	10	9	13	0.5156000000000001
Worms World Party Remastered	2015-07-16	135	741	691	826	0.5155
Biodrone Battle	2015-07-16	515	141	131	646	0.515
NBA 2K16	2015-09-29	9322	3800	3567	12889	0.5147
Wild Island Quest	2015-09-04	1820	160	149	1969	0.5146000000000001
Eisenbahn X	2015-06-08	11	11	10	21	0.5144
The Hole Story	2015-07-14	41	11	10	51	0.5144
Action Alien	2015-06-26	1927	183	171	2098	0.5141
Ted by Dawn	2015-06-29	6	26	24	30	0.5139
Pure Hold'em	2015-08-20	151	57	53	204	0.5138
Island Defense	2015-07-23	1373	57	53	1426	0.5138
Flight of the Paladin	2015-10-23	810	191	179	989	0.5135000000000001
Signal to Noise	2015-11-20	97	12	11	108	0.5134000000000001
Paper Dungeons	2015-04-20	688	44	41	729	0.513
Goodnight Butcher	2015-12-18	307	28	26	333	0.513
The Troma Project	2015-10-28	8868	184	173	9041	0.5128
Shadowrun Chronicles: INFECTED Director's Cut	2015-12-10	49	29	27	76	0.5126
Squarelands	2015-07-17	1549	83	78	1627	0.5122
Abduction Action! Plus	2015-09-01	5	30	28	33	0.5122
Oblitus	2015-02-27	63	67	63	126	0.5118
Usagi Yojimbo: Way of the Ronin	2015-01-30	6	14	13	19	0.5117
Urja	2015-01-09	53	89	84	137	0.5114
Force of Elements	2015-12-30	32	51	48	80	0.5114
Knights of the Sky	2015-04-01	3	16	15	18	0.5104
Mad Snowboarding	2015-09-09	5	16	15	20	0.5104
Astral Terra	2015-11-10	8	79	75	83	0.5101
EPSILON	2015-10-01	924	58	55	979	0.5101
The Mystery of the Druids	2015-04-07	6	58	55	61	0.5101
Spirit Run - Fire vs. Ice	2015-02-12	7	17	16	23	0.5099
Mytheon	2015-12-08	65	60	57	122	0.5098
Gunslugs 2	2015-01-14	980	18	17	997	0.5094
The Way of the Pixelated Fist	2015-04-27	4	18	17	21	0.5094
DRIFT 84	2015-07-14	9	19	18	27	0.509
Redemption: Eternal Quest	2015-08-28	1556	68	65	1621	0.5086999999999999
Afterlife Empire	2015-08-21	30	44	42	72	0.5086
Lightrise	2015-12-22	9	21	20	29	0.5082
Legions of Steel	2015-07-16	26	22	21	47	0.5079
The Lost Battalion: All Out Warfare	2015-04-23	2099	50	48	2147	0.5075999999999999
Darkness Assault	2015-02-06	2051	314	305	2356	0.5062
Hoyle Official Card Games Collection	2015-11-18	35	33	32	67	0.5055
Sphere 3: Enchanted World	2015-12-02	258	208	203	461	0.5051
Auto Dealership Tycoon	2015-10-23	260	94	92	352	0.5043
Train of Afterlife	2015-01-14	97	92	90	187	0.5043
Fly in the House	2015-03-06	1447	95	93	1540	0.5042
Epic Cards Battle(TCG)	2015-07-10	392	381	374	766	0.504
Rubber and Lead	2015-09-04	740	48	47	787	0.5039
Destiny Warriors	2015-09-11	2992	544	535	3527	0.5037
Gabe Newell Simulator	2015-12-14	41	323	318	359	0.5033
X-note	2015-01-16	111	125	123	234	0.5033
Battle Ranch	2015-02-02	1028	499	494	1522	0.5022
Cibele	2015-11-02	119	643	637	756	0.5021
Lost in a Forest	2015-01-26	18	45	45	63	0.5
Apothecarium: The Renaissance of Evil - Premium Edition	2015-05-28	11	44	44	55	0.5
Butsbal	2015-06-03	136	35	35	171	0.5
Tokyo Hosto	2015-06-02	3	33	33	36	0.5
WarBirds - World War II Combat Aviation	2015-05-05	8	31	31	39	0.5
MiniBikers	2015-11-05	465	31	31	496	0.5
Hacker's Beat	2015-09-25	9	30	30	39	0.5
Necromonads	2015-10-27	6	21	21	27	0.5
Silicone-2	2015-06-04	2876	19	19	2895	0.5
Don'Yoku	2015-06-29	146	18	18	164	0.5
Rumble	2015-10-14	5	17	17	22	0.5
Mech Marines: Steel March	2015-01-09	46	16	16	62	0.5
Rise of Keepers	2015-12-05	10	16	16	26	0.5
The Curse of Nordic Cove	2015-04-23	4	15	15	19	0.5
Hills Of Glory 3D	2015-05-28	7	14	14	21	0.5
A-Men 2	2015-06-24	96	13	13	109	0.5
The Sheltered	2015-04-23	7	9	9	16	0.5
Galaxy Union	2015-06-02	9	9	9	18	0.5
Unheard Screams - King Leopold II's Rule Over The Congo	2015-05-11	8	8	8	16	0.5
Professor Why™: The Quantum Eye	2015-12-01	7	8	8	15	0.5
Dexterity Ball 3D	2015-12-07	4	8	8	12	0.5
Fatty Maze's Adventures	2015-02-20	3	6	6	9	0.5
GravBlocks	2015-12-15	53	6	6	59	0.5
Spectrum: First Light	2015-07-24	16	4	4	20	0.5
Nirvana: The First Travel	2015-07-31	2	4	4	6	0.5
Actua Golf 3	2015-08-31	3	4	4	7	0.5
The Ultimate Showdown	2015-09-17	8	4	4	12	0.5
In The Dead Of Night - Urszula's Revenge	2015-12-18	2	4	4	6	0.5
SuperBike TT	2015-02-25	2	3	3	5	0.5
Virus Jigglin' Fever	2015-05-05	3	3	3	6	0.5
Dungeoncraft	2015-06-05	2	2	2	4	0.5
Voxel Blast	2015-10-22	229	2	2	231	0.5
Mass Vector	2015-11-24	2	2	2	4	0.5
Gremlin Invasion: Survivor	2015-05-01	3	1	1	4	0.5
ScudBuster	2015-12-18	2	1	1	3	0.5
Secret Of Magia	2015-08-21	3218	423	426	3644	0.4985
Wooden Floor	2015-02-13	13	103	104	117	0.49810000000000004
Sumo Revise	2015-06-25	504	69	70	574	0.4972
Social Justice Warriors	2015-02-27	43	60	61	104	0.4968
Elements: Soul of Fire	2015-01-12	3388	95	97	3485	0.49590000000000006
Street Arena	2015-07-10	10	36	37	47	0.495
Three Digits	2015-08-14	1731	76	78	1809	0.4949
Overruled!	2015-09-15	331	34	35	366	0.49479999999999996
Sirius Online	2015-06-01	747	99	102	849	0.494
Murder	2015-10-21	8	185	191	199	0.49340000000000006
Vendetta - Curse of Raven's Cry	2015-11-20	6854	292	302	7156	0.4928
Arevan	2015-07-24	1051	23	24	1075	0.4927
C-Wars	2015-08-13	6	47	49	55	0.4922
Sid Meier's Starships	2015-03-12	3404	1121	1162	4566	0.4919
Poker Pretty Girls Battle: Texas Hold'em	2015-10-22	115	96	100	215	0.4919
Timber and Stone	2015-10-20	538	411	427	965	0.4917
Heroes of Scene	2015-08-26	309	329	342	651	0.4917
STAR-BOX: RPG Adventures in Space!	2015-08-17	462	41	43	505	0.49119999999999997
Vector Thrust	2015-07-02	76	344	359	435	0.4908
Dead But Alive! Southern England	2015-10-02	44	37	39	83	0.4904
Red Goddess: Inner World	2015-08-31	7	36	38	45	0.4902
Empires Of Creation	2015-11-20	156	15	16	172	0.48960000000000004
Clown House (Palyaço Evi)	2015-08-24	52	549	576	628	0.4894
Breakout Invaders	2015-04-24	10	32	34	44	0.4891
CITYCONOMY: Service for your City	2015-12-02	156	191	202	358	0.4883
Deliverance	2015-08-31	8	13	14	22	0.4883
Cyberpunk 3776	2015-03-24	4	29	31	35	0.4882
SoulCraft	2015-06-01	10	62	66	76	0.488
Guild Commander	2015-01-23	95	43	46	141	0.4875
Hostile Dimension	2015-06-26	31	12	13	44	0.4875
Lost Horizon 2	2015-10-02	39	90	96	135	0.4872
Dungeon Crawlers HD	2015-06-01	185	38	41	226	0.48610000000000003
Aftermath	2015-09-24	4302	5473	5812	10114	0.48590000000000005
High On Racing	2015-05-25	2856	125	134	2990	0.48590000000000005
Veteran Combat	2015-02-16	11	23	25	36	0.48560000000000003
Not without my donuts	2015-04-28	235	23	25	260	0.48560000000000003
Dungeon Hero	2015-07-08	34	50	54	88	0.4855
A Mass of Dead	2015-07-15	188	22	24	212	0.4851
Airport Firefighters - The Simulation	2015-05-13	72	101	109	181	0.48479999999999995
Cosmonautica	2015-07-31	849	544	584	1433	0.4844
Choice of the Petal Throne	2015-04-10	34	9	10	44	0.4844
Judgement	2015-09-15	3	9	10	13	0.4844
Rolling Sun	2015-06-03	552	391	423	975	0.483
GRAV	2015-01-08	6367	3322	3576	9943	0.4829
Quadle	2015-07-23	3	8	9	12	0.4829
OASE - Other Age Second Encounter	2015-09-30	117	8	9	126	0.4829
Artizens	2015-03-05	5	18	20	25	0.48240000000000005
Pump-Action Captain	2015-08-20	3	18	20	23	0.48240000000000005
Elements: Epic Heroes	2015-12-21	11	17	19	30	0.4816
ReLoaded	2015-07-27	5	7	8	13	0.4811
DGU: Death God University	2015-07-15	12	16	18	30	0.4807
DiggerOnline	2015-06-02	3837	8755	9540	13377	0.4797
Barbarian Brawl	2015-02-12	23	15	17	40	0.4797
Cylne	2015-03-05	4	33	37	41	0.4793
KRUM - Edge Of Darkness	2015-11-24	2967	90	100	3067	0.47909999999999997
Anno Online	2015-07-01	1465	486	535	2000	0.479
Driveby Gangster	2015-09-10	3	6	7	10	0.4789
My Bones	2015-08-03	2622	175	195	2817	0.47750000000000004
Minimon	2015-03-25	137	38	43	180	0.4773
Pahelika: Secret Legends	2015-01-23	7	29	33	40	0.47700000000000004
Ghost Encounters: Deadwood - Collector's Edition	2015-03-13	144	71	80	224	0.4768
Crossfire: Dungeons	2015-05-21	344	37	42	386	0.4768
Space Station Alpha	2015-02-27	23	36	41	64	0.47630000000000006
Playing History 3 - Vikings	2015-07-01	4	20	23	27	0.47630000000000006
Vector Assault	2015-12-10	59	5	6	65	0.4761
Lords of the Realm III	2015-12-03	8	12	14	22	0.4758
Scott in Space	2015-07-23	298	26	30	328	0.47490000000000004
The Book of Desires	2015-12-18	6	33	38	44	0.47450000000000003
Grand Ages: Medieval	2015-09-25	4274	904	1014	5288	0.4743
Bit Odyssey	2015-01-20	6	18	21	27	0.4742
Go Home - Rage incoming	2015-08-03	4	18	21	25	0.4742
Bernie Needs Love	2015-08-21	2	11	13	15	0.47409999999999997
Shot In The Dark	2015-06-10	624	77	88	712	0.47380000000000005
TRIP Steam Edition	2015-06-19	9	136	155	164	0.4733
Hospital Manager	2015-03-25	83	113	129	212	0.4733
Symulator Farmy 2016	2015-11-20	254	75	86	340	0.4732
Astro Emporia	2015-02-02	1462	38	44	1506	0.4731
Handball 16	2015-11-27	44	38	44	88	0.4731
TDP5 Arena 3D	2015-03-26	99	103	118	217	0.47270000000000006
Lex Mortis	2015-02-09	2509	72	83	2592	0.4723
The Legend of Tango	2015-09-11	6	10	12	18	0.4722
SkyScrappers	2015-10-15	4	10	12	16	0.4722
Synonymy	2015-03-06	247	36	42	289	0.4719
Monster Truck Destruction	2015-07-10	26	150	172	198	0.4718
CroNix	2015-07-17	169	205	235	404	0.47140000000000004
Glass Wing	2015-06-24	12	83	96	108	0.47130000000000005
Alexia Crow	2015-05-04	46	28	33	79	0.4708
Ashes of Immortality II	2015-08-28	1009	21	25	1034	0.47020000000000006
Worlds of Magic	2015-03-19	212	230	265	477	0.47009999999999996
Monster Jam	2015-06-10	322	59	69	391	0.47000000000000003
Bard to the Future	2015-02-27	10	33	39	49	0.4698
Undercover Missions: Operation Kursk K-141	2015-12-11	17	20	24	41	0.469
Galactic Inheritors	2015-06-09	185	37	44	229	0.4683
Comic Book Hero: The Greatest Cape	2015-12-09	66	60	71	137	0.46770000000000006
Solar Shifter EX	2015-09-11	98	42	50	148	0.4676
Bloop	2015-01-16	59	164	192	251	0.46740000000000004
Make it indie!	2015-04-01	2704	575	667	3371	0.4673
Wrestling Spirit 3	2015-12-09	10	35	42	52	0.4668
Magnetron	2015-11-16	3	3	4	7	0.4668
Puzzle Ball	2015-10-01	5207	29	35	5242	0.46649999999999997
Love And Order	2015-04-10	60	28	34	94	0.46549999999999997
Spartans Vs Zombies Defense	2015-01-06	378	337	397	775	0.4647
Burgers	2015-09-04	2971	298	352	3323	0.4644
Mystery Maze Of Balthasar Castle	2015-07-10	18	7	9	27	0.46409999999999996
Dark Storm VR Missions 	2015-08-19	91	11	14	105	0.4625
The Last Dogma	2015-06-30	33	15	19	52	0.46130000000000004
Cell HD: emergence	2015-02-20	3	6	8	11	0.46020000000000005
Chronoclysm	2015-11-13	5	6	8	13	0.46020000000000005
iso-Sphere	2015-11-13	50	10	13	63	0.4598
Unlimited Escape	2015-02-05	2	2	3	5	0.4583
Luminoso	2015-04-17	58	2	3	61	0.4583
OVERGRAVITY	2015-07-24	15	2	3	18	0.4583
VERGE:Lost chapter	2015-10-02	1146	156	191	1337	0.4582
Servo	2015-05-28	70	48	60	130	0.45799999999999996
Crystal Catacombs	2015-01-15	12	39	49	61	0.4579
Golden Rush	2015-09-23	519	230	282	801	0.457
Red Goblin: Cursed Forest	2015-05-15	117	13	17	134	0.457
BANZAI PECAN: The Last Hope For the Young Century	2015-01-26	10	42	53	63	0.4568
Knight Adventure	2015-10-16	2391	25	32	2423	0.45670000000000005
Orc Slayer	2015-11-05	7	9	12	19	0.45670000000000005
Emergency 2016	2015-10-15	146	119	148	294	0.4558
World War II GI	2015-11-13	3	28	36	39	0.45530000000000004
Pahelika: Revelations HD	2015-03-02	8	32	41	49	0.45520000000000005
DREAMFLIGHT VR	2015-05-21	2	5	7	9	0.45520000000000005
SnarfQuest Tales	2015-09-15	3	5	7	10	0.45520000000000005
Nyctophobia	2015-08-25	1653	264	329	1982	0.4532
CO-OP : Decrypted	2015-08-17	8	30	39	47	0.4529
Luna Sky	2015-10-02	499	69	88	587	0.45270000000000005
Forest Warrior	2015-06-25	4	22	29	33	0.4523
Weapons Genius	2015-07-08	5994	483	602	6596	0.4518
Arkhelom 3D	2015-05-29	13	18	24	37	0.4516
The Archetype	2015-09-16	2183	36	47	2230	0.4512
President for a Day - Corruption	2015-08-05	23	25	33	56	0.4512
Barren Roads	2015-06-02	9	32	42	51	0.4509
Mechs & Mercs: Black Talons	2015-01-09	98	62	80	178	0.4508
Air Guardians	2015-01-28	12	77	99	111	0.4507
Red Lake	2015-03-25	1865	407	511	2376	0.45060000000000006
Get Over Here	2015-08-20	96	14	19	115	0.4504
All Is Dust	2015-06-26	136	579	726	862	0.45020000000000004
Navy Field 2 : Conqueror of the Ocean	2015-03-05	1548	611	766	2314	0.4501
Blaster Shooter GunGuy!	2015-08-11	1028	179	229	1257	0.44880000000000003
SBX: Invasion	2015-06-01	2	4	6	8	0.4486
True Bliss	2015-05-22	7	37	49	56	0.4484
Incognito	2015-03-23	791	13	18	809	0.44780000000000003
ZombieRun	2015-06-03	5	26	35	40	0.4475
Time Mysteries: Inheritance - Remastered	2015-02-26	196	319	408	604	0.4472
R.B.I. Baseball 15	2015-04-30	60	69	91	151	0.4461
Badland Bandits	2015-07-16	67	65	86	153	0.4458
Arms Dealer	2015-03-27	82	85	112	194	0.4454
Arson & Plunder: Unleashed	2015-09-25	60	40	54	114	0.44439999999999996
Bleeding Border	2015-11-09	1832	65	87	1919	0.4435
A Stroke of Fate: Operation Bunker	2015-08-24	4	6	9	13	0.4434
Heresy	2015-11-19	2	1	2	4	0.44310000000000005
European Ship Simulator	2015-02-19	85	295	386	471	0.4426
ROGUS - Kingdom of The Lost Souls	2015-06-30	12	14	20	32	0.44200000000000006
Hidden Mysteries: Civil War	2015-08-11	4	14	20	24	0.44200000000000006
Angels That Kill - The Final Cut	2015-11-20	84	11	16	100	0.4414
The Lady	2015-01-29	307	93	125	432	0.4411
Indie Game Battle	2015-10-29	48	76	103	151	0.4404
Switch Galaxy Ultra	2015-11-20	99	39	54	153	0.4399
Star Command Galaxies	2015-09-17	54	185	247	301	0.43979999999999997
Call of the Ninja!	2015-02-16	3	3	5	8	0.43950000000000006
CodeSpells	2015-09-18	75	102	138	213	0.4394
ARM Planetary Prospectors Episode 1	2015-10-02	5	27	38	43	0.4394
Blood of Magic	2015-12-18	8	32	45	53	0.43829999999999997
Ferrum's Secrets: where is grandpa?	2015-08-14	210	49	68	278	0.43810000000000004
Big Journey to Home	2015-08-20	491	18	26	517	0.438
ADventure Lib	2015-08-04	30	43	60	90	0.4379
3d Engineers	2015-10-19	5	10	15	20	0.4375
Break the Cube	2015-01-27	2	10	15	17	0.4375
Containment Protocol	2015-08-31	3	5	8	11	0.4368
Abyss Raiders: Uncharted	2015-04-30	1595	58	81	1676	0.436
Clergy Splode	2015-09-17	2942	209	284	3226	0.43570000000000003
Our Nation's Miner	2015-12-22	44	12	18	62	0.43560000000000004
Dark Gates	2015-01-26	329	17	25	354	0.4355
Idol Hands	2015-02-18	863	65	91	954	0.4349
TOTM	2015-02-03	2	7	11	13	0.4347
Pocket God vs Desert Ashes	2015-08-19	6	7	11	17	0.4347
MadOut Ice Storm	2015-09-08	5	19	28	33	0.4341
Space Thinger	2015-09-25	4	14	21	25	0.434
Relativity Wars - A Science Space RTS	2015-04-10	4	9	14	18	0.43310000000000004
Anti-Opoly	2015-08-14	10	21	31	41	0.4329
Firefly Online Cortex	2015-01-29	220	277	380	600	0.43270000000000003
Burstfire	2015-09-25	1727	348	478	2205	0.43170000000000003
Isaac the Adventurer	2015-03-02	3	11	17	20	0.43170000000000003
3D Mini Golf	2015-05-29	7	30	44	51	0.43119999999999997
Project Pulsation	2015-12-15	2195	72	103	2298	0.4301
16bit Trader	2015-06-04	1345	718	985	2330	0.43
Owys	2015-08-25	4	15	23	27	0.42969999999999997
TownCraft	2015-02-25	93	41	60	153	0.4293
Escape Machines	2015-04-14	8841	278	388	9229	0.4291
Super Pixalo	2015-02-03	16	6	10	26	0.4283
Geared	2015-05-15	7	4	7	14	0.4282
Toy Wars Invasion	2015-05-28	35	4	7	42	0.4282
Withstand: Apotheosis	2015-07-31	39	4	7	46	0.4282
Two Steps Back	2015-08-06	64	8	13	77	0.4279
3d Bridges	2015-03-24	4	10	16	20	0.4274
Tactical Soccer The New Season	2015-11-20	33	10	16	49	0.4274
Airport Simulator 2015	2015-04-22	55	67	98	153	0.42619999999999997
CDF Ghostship	2015-06-26	19	43	64	83	0.4258
Animal Gods	2015-10-12	17	18	28	45	0.4254
The Flock	2015-08-21	155	123	178	333	0.425
Devils & Demons	2015-10-06	33	42	63	96	0.42460000000000003
Mars Colony: Frontier	2015-09-25	34	22	34	68	0.42460000000000003
True Lover's Knot	2015-11-19	505	48	72	577	0.4236
Undeadz!	2015-09-25	18	28	43	61	0.42350000000000004
Universal Combat CE	2015-02-06	179	107	157	336	0.423
Predator Simulator	2015-05-15	16	34	52	68	0.4226
Gratuitous Space Battles 2	2015-04-16	154	113	166	320	0.42240000000000005
New kind of adventure	2015-06-04	3215	617	879	4094	0.42210000000000003
Soccer Legends	2015-08-05	5	7	12	17	0.4218
Rotieer	2015-03-05	3	5	9	12	0.4204
Magician's Apprentice	2015-11-09	46	5	9	55	0.4204
MadOut	2015-06-05	7	22	35	42	0.41960000000000003
Heroes of SoulCraft	2015-07-20	105	193	284	389	0.41950000000000004
dUpLicity ~Beyond the Lies~	2015-01-08	67	24	38	105	0.41950000000000004
Gunnheim	2015-10-16	930	129	192	1122	0.4191
Terraformer Expedition to Mars	2015-11-20	11	14	23	34	0.4191
Go To Bed: Survive The Night	2015-10-28	4	14	23	27	0.4191
Stay Dead Evolution	2015-02-04	78	46	71	149	0.4186
Might & Magic Heroes Online	2015-11-24	1003	316	464	1467	0.4179
Revenge: Rhobar's myth	2015-09-08	120	3	6	126	0.4167
Vapour	2015-07-03	1015	70	108	1123	0.4157
Epic Showdown	2015-10-27	4	16	27	31	0.413
Just Alone	2015-07-27	6	21	35	41	0.41200000000000003
SNOWFLAKE TATTOO	2015-03-27	732	43	69	801	0.4119
Flix The Flea	2015-06-01	1282	78	123	1405	0.4107
Battle For The Sun	2015-07-22	6	24	40	46	0.4106
Forktuck Challenge	2015-07-24	8	4	8	16	0.4103
Stellar 2D	2015-07-30	3944	380	578	4522	0.4097
The Undying Plague	2015-04-10	2221	54	87	2308	0.4093
D Series OFF ROAD Driving Simulation	2015-05-19	19	23	39	58	0.408
Onikira: Demon Killer	2015-08-27	130	138	217	347	0.40770000000000006
Fruits Inc. Deluxe Pack	2015-02-19	8	8	15	23	0.40630000000000005
Bloodwood Reload	2015-11-02	77	151	239	316	0.40590000000000004
Joe's Diner	2015-03-31	35	85	137	172	0.40590000000000004
Dragon Rider	2015-11-02	1	0	1	2	0.4058
Run Run And Die	2015-09-11	6	14	25	31	0.4054
Infect and Destroy	2015-01-29	7	20	35	42	0.4042
Perfection of Wisdom	2015-04-06	2	1	3	5	0.40399999999999997
Strange Space	2015-12-22	2	1	3	5	0.40399999999999997
Unlimited Escape 3 & 4 Double Pack	2015-05-21	1	1	3	4	0.40399999999999997
Fallen: A2P Protocol	2015-08-14	146	86	140	286	0.40390000000000004
Bitweb	2015-06-03	6	49	82	88	0.40299999999999997
Doomed'n Damned	2015-07-13	2	6	12	14	0.402
Crazy Steam Bros 2	2015-04-03	57	13	24	81	0.4011
Damnation City of Death	2015-03-03	10	28	49	59	0.4004
Coated	2015-08-25	6	2	5	11	0.40030000000000004
HIS (Heroes In the Sky)	2015-03-03	219	206	333	552	0.39990000000000003
The Clans - Saga of the Twins	2015-04-21	406	23	41	447	0.3994
Tiamat X	2015-05-29	501	41	71	572	0.3983
Assault CorpsII	2015-07-16	11	15	28	39	0.3972
InsanZ - Retro Survival Horror	2015-04-27	2	3	7	9	0.3972
The Glow	2015-12-11	5	8	16	21	0.39659999999999995
Raywin	2015-07-29	1063	32	57	1120	0.3958
Pirate's Life	2015-04-17	86	23	42	128	0.39530000000000004
ALPAGES : THE FIVE BOOKS	2015-10-23	8	82	140	148	0.395
Battletank LOBA	2015-03-17	26	4	9	35	0.3946
Countless Rooms of Death	2015-01-09	1209	13	25	1234	0.3945
Human Extinction Simulator	2015-01-21	30	13	25	55	0.3945
Solar System Conflict	2015-04-06	9	13	25	34	0.3945
Alganon	2015-05-19	85	79	136	221	0.3937
Spellcrafter	2015-05-04	8	21	39	47	0.3935
Cities XXL	2015-02-05	2092	848	1374	3466	0.3933
REVERSE SIDE	2015-07-31	9	32	58	67	0.39270000000000005
CHAOS - In the Darkness	2015-10-07	4	10	20	24	0.3926
BattleQuiz	2015-09-03	4	10	20	24	0.3926
HIT	2015-02-09	88	177	298	386	0.3925
gShift	2015-08-25	3	5	11	14	0.3924
Sim Junta	2015-08-18	16	22	41	57	0.3923
A.I. Invasion	2015-09-30	132	23	43	175	0.3912
Road Works	2015-08-11	4	6	13	17	0.39049999999999996
Soccer Pinball Thrills	2015-06-26	4	6	13	17	0.39049999999999996
Corona MotorSport	2015-03-13	8	24	45	53	0.39020000000000005
Etherium	2015-03-25	1725	342	574	2299	0.3896
Fantastic Pinball Thrills	2015-06-26	3	12	24	27	0.3895
Martial Law	2015-05-26	5	7	15	20	0.3889
PeriAreion	2015-02-19	58	18	35	93	0.3879
The Settlers Online	2015-08-19	2042	399	675	2717	0.3872
BattleSpace	2015-01-08	72	28	53	125	0.3866
Shrooms	2015-05-08	9	15	30	39	0.386
Fireflies	2015-09-07	1665	20	39	1704	0.3859
Botology	2015-06-24	2048	130	230	2278	0.3847
Streets of Chaos	2015-01-29	986	31	59	1045	0.38450000000000006
SUPER DISTRO	2015-07-22	1990	404	694	2684	0.384
Spheroid	2015-08-31	8	38	72	80	0.3829
The Lost Valley	2015-04-20	2229	124	222	2451	0.38270000000000004
Hot Pinball Thrills	2015-06-26	3	14	29	32	0.3814
Days Under Custody	2015-11-23	149	51	96	245	0.3809
Blasted Fortress	2015-01-09	688	4	10	698	0.3805
Siege of Turtle Enclave	2015-02-13	4	5	12	16	0.3804
The Empty Inn	2015-07-28	8	3	8	16	0.3803
Eaten Alive	2015-09-30	2429	181	324	2753	0.3801
Hatland Adventures	2015-02-04	2	7	16	18	0.37950000000000006
Realm of Perpetual Guilds	2015-05-18	3	8	18	21	0.379
Death Pirate	2015-06-08	25	2	6	31	0.379
Ironkraft - Road to Hell	2015-10-22	6	2	6	12	0.379
Amygdala	2015-07-16	55	11	24	79	0.3774
Agricultural Simulator 2012: Deluxe Edition	2015-04-17	4	12	26	30	0.3769
Wild Season - Episode 1	2015-11-23	52	125	231	283	0.3765
AWAKE	2015-12-16	3	13	28	31	0.3765
Shadows of War	2015-01-02	246	49	95	341	0.376
Car Washer: Summer of the Ninja	2015-11-04	469	14	30	499	0.376
Valzar	2015-12-22	3	1	4	7	0.3749
Yasai Ninja	2015-07-21	180	17	36	216	0.3747
Kitchen Simulator 2015	2015-09-02	1931	66	127	2058	0.3743
Forsaken Fortress Strategy	2015-09-18	41	67	129	170	0.3741
Tompi Jones	2015-05-22	17	36	72	89	0.3739
Age of Castles: Warlords	2015-05-16	43	20	42	85	0.3736
500 Years Act 1	2015-04-15	422	21	44	466	0.37320000000000003
Atlantis 2: Beyond Atlantis	2015-04-17	5	27	56	61	0.3713
Red Crow Mysteries: Legion	2015-05-28	8	12	27	35	0.371
All Guns On Deck	2015-08-28	34	168	316	350	0.37090000000000006
World of Cinema - Movie Tycoon	2015-04-02	26	13	29	55	0.37090000000000006
Purgatory: War of the Damned	2015-02-11	4	7	17	21	0.37070000000000003
Retaliation	2015-12-18	74	31	64	138	0.3703
INIT.	2015-08-19	281	5	13	294	0.3694
The Emptiness Deluxe Edition	2015-04-17	9	35	72	81	0.3693
March of Industry	2015-10-07	143	24	52	195	0.36560000000000004
Uriel's Chasm 2: את	2015-11-13	2280	122	239	2519	0.3655
15 Days	2015-04-01	15	45	93	108	0.3655
The Lost City Of Malathedra	2015-03-31	2	3	9	11	0.3655
3D Paraglider	2015-08-03	11	10	24	35	0.36469999999999997
Princess KAGUYA	2015-08-05	118	26	57	175	0.3625
Outpost 13	2015-10-27	15	23	51	66	0.3624
Top Trumps Turbo	2015-03-20	11	69	143	154	0.3602
The Interview	2015-02-04	11	53	112	123	0.35960000000000003
Retention	2015-01-13	1642	226	446	2088	0.3594
Temporal Shift	2015-07-16	4	0	2	6	0.3592
Despair	2015-05-13	2128	643	1234	3362	0.3588
Apollo4x	2015-05-05	275	15	36	311	0.3568
STOORM - Yellow Edition.	2015-08-31	1	4	12	13	0.3565
Edge of Space	2015-09-17	1210	925	1803	3013	0.3539
Robot vs Birds Zombies	2015-07-23	8898	35	79	8977	0.3533
Rock, the Tree Hugger	2015-07-30	2	3	10	12	0.35240000000000005
We Are Legion	2015-08-07	17	42	94	111	0.3523
Egyptian Settlement Gold	2015-05-12	8	1	5	13	0.3522
GunWorld	2015-02-12	71	20	48	119	0.3517
Hush	2015-07-29	70	13	33	103	0.3508
AoF Chess Club 2.0	2015-11-04	2488	13	33	2521	0.3508
Trucker 2	2015-08-14	3	5	15	18	0.35000000000000003
Catorize	2015-11-12	962	5	15	977	0.35000000000000003
Ampersand	2015-10-19	4524	338	695	5219	0.3486
Undead Shadows	2015-02-02	8	18	45	53	0.34700000000000003
Vortex	2015-07-17	2	2	8	10	0.3458
Axion	2015-12-11	132	33	79	211	0.34409999999999996
Fasaria World Online	2015-11-05	4064	8	23	4087	0.3433
Terminal Hacker - Into the Deep	2015-10-31	3	3	11	14	0.3407
Pilot Crusader	2015-07-10	23	15	40	63	0.3404
The Lost Island	2015-11-20	258	18	47	305	0.3401
Lonath Online	2015-10-16	5	9	26	31	0.3397
Naninights	2015-07-24	5	20	52	57	0.33890000000000003
Shadow of Kingdoms	2015-08-12	127	30	75	202	0.33840000000000003
Flight Unlimited Las Vegas	2015-07-08	5	6	19	24	0.3375
Genesis Online	2015-11-11	391	609	1309	1700	0.33630000000000004
Masterspace	2015-06-15	34	50	122	156	0.3351
Legends of Dawn Reborn	2015-10-20	112	22	58	170	0.33490000000000003
Red Bit Ninja	2015-04-30	118	7	22	140	0.3343
Production Inc.	2015-12-31	4	1	6	10	0.33380000000000004
Man Alive Game	2015-05-26	2	5	17	19	0.33340000000000003
Tetris® Ultimate	2015-12-10	31	126	293	324	0.3331
Steam Heroes	2015-01-30	671	31	80	751	0.3326
Moonbase 332	2015-09-18	1362	37	94	1456	0.3325
Datswer	2015-02-05	2	2	9	11	0.33240000000000003
Industry Transporters	2015-08-31	22	12	35	57	0.33159999999999995
Witches, Heroes and Magic	2015-06-29	3	6	20	23	0.3306
Quantum Flux	2015-08-21	3	3	12	15	0.33020000000000005
Pluck	2015-07-31	2	0	3	5	0.32939999999999997
Vol'Talkes - The AI War	2015-02-26	3	0	3	6	0.32939999999999997
The Asskickers	2015-02-06	172	22	61	233	0.327
Super Space Meltdown	2015-07-31	32	6	21	53	0.3241
It's time to get out from the solar system	2015-09-01	614	15	45	659	0.3225
I Must Kill: Fresh Meat	2015-11-30	22	71	182	204	0.3221
Bridge!	2015-10-28	23	11	35	58	0.321
Karma	2015-07-15	29	11	35	64	0.321
Autobahn Police Simulator	2015-08-26	824	635	1483	2307	0.31980000000000003
Unlimited Escape 2	2015-04-22	2	1	7	9	0.3185
Zxill: A Legend of Time	2015-09-04	2	1	7	9	0.3185
Russian Front	2015-07-23	15	8	28	43	0.3159
Ninja Guy	2015-01-05	7	43	120	127	0.3147
Second Warfare	2015-06-22	139	25	74	213	0.3144
Ice Cream Surfer	2015-06-22	4	11	37	41	0.3131
Shmup Love Boom	2015-09-18	3	4	17	20	0.3125
"""Glow Ball"" - The billiard puzzle game"	2015-07-21	1388	34	99	1487	0.3116
You Are Not The Hero	2015-06-02	8	8	29	37	0.31120000000000003
Dark Years	2015-10-16	5	27	82	87	0.309
Infinite Game Works Episode 1	2015-10-26	3	0	4	7	0.308
Motorhead	2015-09-16	2	6	24	26	0.30670000000000003
Shallow Space	2015-10-21	111	58	166	277	0.3061
Spellbind	2015-03-17	29	4	18	47	0.3056
Monkey King Saga	2015-12-01	6	1	8	14	0.3056
SHOFER Race Driver	2015-07-01	5	22	71	76	0.3037
ABD: A Beautiful Day	2015-08-15	23	10	37	60	0.3023
QuestEvent	2015-09-09	6	5	22	28	0.3006
Get Rich or Die Gaming	2015-09-03	3	6	26	29	0.29660000000000003
Damned Nation Reborn	2015-02-12	6	17	60	66	0.29600000000000004
D/Generation HD	2015-10-23	5	11	42	47	0.2956
Deer Hunt Legends	2015-01-16	6	10	39	45	0.2952
Hope in Hell	2015-11-04	2	1	9	11	0.2943
SECTOR	2015-06-29	7	28	97	104	0.2884
Project Druid - 2D Labyrinth Explorer-	2015-07-30	99	29	101	200	0.28690000000000004
TAKEN	2015-07-07	5	8	35	40	0.2865
BoxesWithGuns	2015-04-14	4	17	65	69	0.2847
Nightclub Emporium	2015-08-07	5	1	10	15	0.2845
Exowar	2015-03-23	14	19	72	86	0.2834
Professional Lumberjack 2015	2015-03-05	41	24	90	131	0.2799
HoD: On open seas	2015-07-20	4	3	19	23	0.2779
Dream Factory	2015-11-02	701	17	69	770	0.27649999999999997
Zone 22	2015-07-31	5	1	11	16	0.2758
The Light Empire	2015-12-02	3	1	11	14	0.2758
Caffeine	2015-10-05	9	9	42	51	0.2749
Island Flight Simulator	2015-04-17	5	7	35	40	0.2741
Luxury Hotel Emporium	2015-08-07	7	3	20	27	0.2724
CortexGear:AngryDroids	2015-09-24	1059	23	92	1151	0.2717
Overlord: Fellowship of Evil	2015-10-19	275	148	490	765	0.27030000000000004
CHARIOT WARS	2015-05-26	5	1	12	17	0.2681
Radial Impact	2015-08-03	2	0	7	9	0.26739999999999997
Evolution II: Fighting for Survival	2015-02-12	11	3	22	33	0.2625
MotorSport Revolution	2015-01-15	4	14	66	70	0.2616
Into The War	2015-12-02	46	103	371	417	0.2615
199CentsSTUDIO	2015-03-25	21	65	245	266	0.2613
Alone in the Dark: Illumination	2015-06-11	115	74	278	393	0.25980000000000003
One Final Breath	2015-08-10	38	21	95	133	0.2571
Caribbean Odyssey	2015-11-12	2	1	14	16	0.2547
Wonky Pigeon!	2015-11-27	4	16	81	85	0.24920000000000003
Prison Tycoon Alcatraz	2015-05-11	5	2	21	26	0.24559999999999998
Time Ramesside (A New Reckoning)	2015-04-30	2919	71	297	3216	0.24480000000000002
Voodoo Chronicles: The First Sign HD - Director’s Cut Edition	2015-05-28	6	3	27	33	0.24230000000000002
BlackShadows	2015-09-11	20	28	136	156	0.2415
The Legend of Candlewind	2015-02-12	20	6	44	64	0.23629999999999998
After Reset RPG	2015-03-09	5	23	131	136	0.2262
Once Bitten, Twice Dead	2015-07-07	41	16	104	145	0.21989999999999998
10 Years After	2015-01-30	9	14	105	114	0.20809999999999998
Jurassic Island: The Dinosaur Zoo	2015-11-23	5	10	87	92	0.2029
Age of Survival	2015-08-25	67	25	209	276	0.18280000000000002
The Binding of Isaac: Rebirth	2014-11-04	70701	229745	5495	76196	0.9651000000000001
BattleBlock Theater	2014-05-15	14781	65745	1841	16622	0.9561000000000001
The Room	2014-07-28	649	22572	517	1166	0.9544
One Finger Death Punch	2014-03-03	1921	15733	320	2241	0.9540000000000001
Grimm	2014-01-06	30886	30906	911	31797	0.9506
The Expendabros	2014-08-05	3088	17292	497	3585	0.9473
Kingdom Rush	2014-01-06	2022	10794	308	2330	0.9437000000000001
METAL GEAR RISING: REVENGEANCE	2014-01-09	12205	61939	2672	14877	0.9423
Everlasting Summer	2014-11-19	1907	62424	2973	4880	0.9384
LISA	2014-12-15	1158	12454	484	1642	0.9358
The Talos Principle	2014-12-11	4007	25277	1146	5153	0.9353
Shovel Knight: Treasure Trove	2014-06-26	2875	14244	580	3455	0.9353
Valiant Hearts: The Great War™ / Soldats Inconnus : Mémoires de la Grande Guerre™	2014-06-25	5683	21836	985	6668	0.9346
NEKOPARA Vol. 1	2014-12-30	487	24964	1201	1688	0.9329000000000001
Hexcells	2014-02-19	384	5001	163	547	0.9327
Hexcells Infinite	2014-09-01	384	3701	107	491	0.9325
Tales from the Borderlands	2014-11-25	8690	15837	798	9488	0.9278000000000001
LYNE	2014-03-17	239	7683	334	573	0.9277
planetarian ~the reverie of a little planet~	2014-09-12	63	1968	49	112	0.9276000000000001
Creeper World 3: Arc Eternal	2014-03-27	3303	4117	149	3452	0.9275
Epic Battle Fantasy 4	2014-02-25	1128	2770	93	1221	0.9248999999999999
Geometry Dash	2014-12-22	16400	217158	15338	31738	0.9235
Transistor	2014-05-20	6727	27527	1649	8376	0.9234
Free to Play	2014-03-19	53002	10441	540	53542	0.9234
Mount Your Friends	2014-07-29	1141	7285	362	1503	0.922
Floating Point	2014-06-06	754	3582	151	905	0.9209
Choice of Robots	2014-12-19	244	1880	65	309	0.9189
Bloons TD5	2014-11-19	1660	9642	549	2209	0.9184000000000001
Enigmatis 2: The Mists of Ravenwood	2014-06-05	292	1337	40	332	0.9175
Rise of Nations: Extended Edition	2014-06-12	2734	11642	701	3435	0.9172
Door Kickers	2014-10-20	2041	8816	508	2549	0.9170999999999999
Blackwell Epiphany	2014-04-24	105	786	15	120	0.917
Freedom Planet	2014-07-21	347	4246	212	559	0.9164
This War of Mine	2014-11-14	9503	85263	6424	15927	0.9161
Pajama Sam in No Need to Hide When It's Dark Outside	2014-04-17	169	984	25	194	0.9159999999999999
Life Goes On	2014-04-17	432	2249	96	528	0.9147
RollerCoaster Tycoon: Deluxe	2014-05-21	1233	6090	351	1584	0.9137000000000001
Alien: Isolation	2014-10-06	10870	47231	3585	14455	0.913
Five Nights at Freddy's 2	2014-11-11	1725	15568	1060	2785	0.9129
Hidden in Plain Sight	2014-07-16	34	468	5	39	0.9128000000000001
Sleeping Dogs: Definitive Edition	2014-10-14	4035	48721	3837	7872	0.9108
Assetto Corsa	2014-12-19	17513	84738	7034	24547	0.9098
Lethal League	2014-08-27	1929	5647	349	2278	0.9096
Grim Legends: The Forsaken Bride	2014-08-21	715	1387	56	771	0.9096
Resident Evil 4 (2005)	2014-02-28	5343	56687	4625	9968	0.9092
Middle-earth™: Shadow of Mordor™	2014-09-30	48668	73307	6121	54789	0.9087999999999999
100% Orange Juice	2014-05-16	3860	22366	1699	5559	0.9087999999999999
Hatoful Boyfriend	2014-09-04	429	6511	427	856	0.9079
TowerFall Ascension	2014-03-11	355	2920	161	516	0.9079
Octodad: Dadliest Catch	2014-01-30	1815	8509	586	2401	0.9076000000000001
Insurgency	2014-01-22	121575	114375	10258	131833	0.9055
One Way Heroics	2014-02-28	775	3696	227	1002	0.9055
Five Nights at Freddy's	2014-08-19	1316	33996	2826	4142	0.9054000000000001
Age of Mythology: Extended Edition	2014-05-08	11074	26989	2201	13275	0.9054000000000001
Obscure	2014-03-10	91	1758	88	179	0.9053
Detective Grimoire	2014-08-18	86	1662	82	168	0.9051
Estranged: Act I	2014-01-16	1202	6428	455	1657	0.9036
Hexcells Plus	2014-02-19	211	2212	125	336	0.9033
Double Action: Boogaloo	2014-10-23	1184	10397	801	1985	0.9026000000000001
The Legend of Heroes: Trails in the Sky	2014-07-29	2014	6909	504	2518	0.9025
The Last Door - Collector's Edition	2014-05-20	232	1975	110	342	0.9024
The Plan	2014-02-14	298	20515	1718	2016	0.902
KAMI	2014-01-23	124	1118	51	175	0.902
NoLimits 2 Roller Coaster Simulation	2014-08-21	196	1111	51	247	0.9016
Amazing Frog?	2014-11-21	629	7801	590	1219	0.9014
Out There Somewhere	2014-05-21	2615	6421	475	3090	0.9009999999999999
Ikaruga	2014-02-18	335	1915	110	445	0.9006000000000001
Original War	2014-01-27	152	1678	93	245	0.9004000000000001
Child of Light	2014-04-30	2696	11664	959	3655	0.8993000000000001
Chicken Invaders 4	2014-06-06	34	431	11	45	0.8992
A Story About My Uncle	2014-05-28	190590	25913	2309	192899	0.8991
Jazzpunk: Director's Cut	2014-02-07	546	6123	470	1016	0.8983
Lambda Wars	2014-12-05	1015	5526	420	1435	0.898
You Have to Win the Game	2014-05-06	660	5216	393	1053	0.898
Turbo Dismount	2014-05-21	761	4838	361	1122	0.8978
Infested Planet	2014-03-06	1280	2592	171	1451	0.8978
Nightmares from the Deep 2: The Siren`s Call	2014-05-15	160	790	35	195	0.897
Fistful of Frags	2014-05-09	3537	31587	2973	6510	0.8962000000000001
Putt-Putt Saves The Zoo	2014-07-03	53	606	24	77	0.8956000000000001
Freddi Fish and the Case of the Missing Kelp Seeds	2014-04-17	71	544	20	91	0.8956000000000001
Max: The Curse of Brotherhood	2014-05-21	218	1283	73	291	0.8953
Wolfenstein: The New Order	2014-05-19	11986	44444	4379	16365	0.8944
Farming Simulator 15	2014-10-30	18711	13027	1168	19879	0.8942
Guacamelee! Super Turbo Championship Edition	2014-08-21	2723	5693	465	3188	0.8937999999999999
Descent	2014-02-11	56	394	12	68	0.8934000000000001
Men of War: Assault Squad 2	2014-05-15	9750	34500	3402	13152	0.8931
fault - milestone one	2014-12-15	313	2948	218	531	0.8931
The Journey Down: Chapter Two	2014-08-25	87	485	18	105	0.8929
Divinity: Original Sin (Classic)	2014-06-30	22040	10685	964	23004	0.8923000000000001
Super Panda Adventures	2014-07-14	171	839	44	215	0.8918
Unepic	2014-07-25	3095	7015	616	3711	0.8909
If My Heart Had Wings	2014-11-25	239	4058	339	578	0.8891
Sid Meier's Colonization (Classic)	2014-10-09	245	735	39	284	0.8889
Goat Simulator	2014-04-01	10108	57006	6132	16240	0.8884000000000001
Momodora III	2014-07-01	79	1108	70	149	0.8882
Sanitarium	2014-10-29	112	898	54	166	0.8871
Sunrider: Mask of Arcadius	2014-07-09	1024	2560	204	1228	0.887
Rodina	2014-07-28	224	1229	83	307	0.8864000000000001
Black Ice	2014-07-09	47	550	27	74	0.8864000000000001
Pajama Sam 2: Thunder And Lightning Aren't So Frightening	2014-05-01	35	262	7	42	0.8861
Banished	2014-02-18	24636	35726	3879	28515	0.8855
Crimzon Clover WORLD IGNITION	2014-06-06	136	1371	98	234	0.8851000000000001
Pajama Sam 3: You Are What You Eat From Your Head To Your Feet	2014-05-15	25	307	11	36	0.8834000000000001
SPY Fox in: Dry Cereal	2014-04-17	139	429	20	159	0.8831
Escape Goat 2	2014-03-24	76	387	17	93	0.8828
Crimsonland	2014-06-11	479	2482	212	691	0.8822
Valkyria Chronicles™	2014-11-11	5039	10994	1152	6191	0.8813
Freddi Fish 2: The Case of the Haunted Schoolhouse	2014-05-01	39	248	8	47	0.8805
LUFTRAUSERS	2014-03-18	605	3850	364	969	0.8801000000000001
ibb & obb	2014-05-26	1076	5425	537	1613	0.88
Boson X	2014-09-15	549	1436	116	665	0.8787
Metro: Last Light Redux	2014-08-27	2819	50599	6063	8882	0.8784000000000001
Panzer Corps	2014-03-12	1056	2108	187	1243	0.8778
Sherlock Holmes: Crimes and Punishments	2014-09-30	889	5430	563	1452	0.8765000000000001
LEGO® Pirates of the Caribbean The Video Game	2014-10-06	407	3232	314	721	0.8763
Metro 2033 Redux	2014-08-28	5139	62881	7830	12969	0.8758
Vangers	2014-04-24	73	921	71	144	0.8748
Knightmare Tower	2014-06-16	64	554	36	100	0.8747
Legend of Grimrock 2	2014-10-15	4146	3076	308	4454	0.8736
Screencheat	2014-10-21	303	1583	142	445	0.8734000000000001
DARK SOULS™ II	2014-04-25	79528	35815	4466	83994	0.8731
G-Force	2014-10-06	48	508	33	81	0.873
Nameless ~The one thing you must recall~	2014-12-24	61	665	48	109	0.8728
FINAL FANTASY XIV Online	2014-02-18	95150	57532	7395	102545	0.8724
The Jackbox Party Pack	2014-11-26	3913	1489	134	4047	0.8723000000000001
Lovely Planet	2014-07-31	2999	2343	230	3229	0.872
Wargame: Red Dragon	2014-04-17	4779	15150	1831	6610	0.8713
NEO Scavenger	2014-12-15	531	4367	471	1002	0.8713
Town of Salem	2014-12-15	3787	31828	4051	7838	0.8706
Nightmares from the Deep: The Cursed Heart	2014-02-05	271	1424	132	403	0.8697
METAL SLUG 3	2014-02-14	2879	6898	797	3676	0.8695999999999999
Year Walk	2014-03-06	79	1750	170	249	0.8692000000000001
Micron	2014-07-23	23	161	5	28	0.8692000000000001
Marvin's Mittens	2014-12-17	169	187	7	176	0.8691
The Banner Saga	2014-01-14	4476	13029	1603	6079	0.8687
Sokobond	2014-07-21	81	506	36	117	0.8684000000000001
Nidhogg	2014-01-13	2215	6579	775	2990	0.8676
Clockwork Tales: Of Glass and Ink	2014-04-24	254	975	86	340	0.8675
Roundabout	2014-09-18	98	517	38	136	0.8672
Super Trench Attack!	2014-07-24	119	1150	106	225	0.8671
Shadowrun: Dragonfall - Director's Cut	2014-09-18	2703	5222	608	3311	0.8666
Toribash	2014-05-16	2724	13936	1771	4495	0.8661
QP Shooting - Dangerous!!	2014-11-14	101	448	32	133	0.8658
Blood: One Unit Whole Blood	2014-07-14	61	1208	115	176	0.8656
Danmaku Unlimited 2	2014-03-18	36	406	28	64	0.8654999999999999
Sigils of Elohim	2014-10-13	250	963	88	338	0.865
LEGO® Batman™ 3: Beyond Gotham	2014-11-11	2186	5781	694	2880	0.8648
Contraption Maker	2014-07-07	332	1075	101	433	0.8648
Freddi Fish 3: The Case of the Stolen Conch Shell	2014-05-15	25	254	14	39	0.8647
Mountain	2014-08-18	1667	14122	1837	3504	0.8640000000000001
The Desolate Hope	2014-05-05	1677	1161	113	1790	0.8634999999999999
Craft The World	2014-11-24	3283	12066	1574	4857	0.8627
Depth	2014-11-03	10916	28406	3923	14839	0.8620000000000001
Icewind Dale: Enhanced Edition	2014-10-30	856	2361	265	1121	0.8618000000000001
Blitzkrieg Anthology	2014-09-16	186	1111	110	296	0.8617
Splatter - Zombiecalypse Now	2014-06-04	864	2037	225	1089	0.8614
LOVE	2014-02-14	1774	1022	100	1874	0.8613
BlazBlue: Continuum Shift Extend	2014-12-11	340	1345	139	479	0.8612000000000001
Home Sheep Home: Farmageddon Party Edition	2014-02-17	25	230	13	38	0.8612000000000001
Dungeonmans	2014-12-09	248	899	86	334	0.8609
The Vanishing of Ethan Carter	2014-09-25	1443	7569	974	2417	0.8606999999999999
RollerCoaster Tycoon 2: Triple Thrill Pack	2014-05-21	833	4057	497	1330	0.8599
Death Skid Marks	2014-11-21	150	643	58	208	0.8592000000000001
FATE: The Traitor Soul	2014-08-27	102	400	31	133	0.8592000000000001
THE KING OF FIGHTERS '98 ULTIMATE MATCH FINAL EDITION	2014-12-16	640	2140	246	886	0.8587
Rexaura	2014-12-10	33	792	76	109	0.8587
Letter Quest: Grimm's Journey	2014-11-21	803	360	27	830	0.8587
Harvester	2014-04-04	132	997	101	233	0.8584
Abyss: The Wraiths of Eden	2014-04-03	394	1225	131	525	0.8573999999999999
Monsters Ate My Birthday Cake	2014-07-01	23	92	2	25	0.8572
The Counting Kingdom	2014-08-05	25	104	3	28	0.8567
Putt-Putt Joins the Parade	2014-04-17	21	254	17	38	0.8564
Oknytt	2014-04-04	219	489	43	262	0.8558
Company of Heroes: The Great War 1918	2014-08-21	82	514	46	128	0.8556999999999999
Putt-Putt Travels Through Time	2014-05-15	24	269	19	43	0.8552
Half Minute Hero: The Second Coming	2014-04-04	248	493	44	292	0.8551000000000001
Tex Murphy: Under a Killing Moon	2014-06-12	22	124	5	27	0.8547
Gabriel Knight - Sins of the Fathers	2014-10-15	356	883	92	448	0.8545999999999999
Cannon Brawl	2014-09-19	232	706	70	302	0.8545
9 Clues: The Secret of Serpent Creek	2014-07-10	341	1237	138	479	0.8543000000000001
REVOLVER360 RE:ACTOR	2014-10-24	75	338	27	102	0.8540000000000001
Loadout	2014-01-31	29424	34539	5217	34641	0.8536
Sentinels of the Multiverse	2014-12-22	330	1332	153	483	0.8529000000000001
Dungeon of the ENDLESS™	2014-10-27	35159	10306	1477	36636	0.8523999999999999
Xenonauts	2014-06-16	1619	3776	502	2121	0.8518000000000001
Circuits	2014-04-17	248	1850	227	475	0.8515
Geometry Wars 3: Dimensions Evolved	2014-11-25	397	1251	145	542	0.8514
Among the Sleep	2014-05-29	488	5685	790	1278	0.8511
Freedom Fall	2014-01-10	57	356	31	88	0.8501000000000001
Putt-Putt Enters the Race	2014-05-29	19	156	9	28	0.8498000000000001
METAL SLUG X	2014-10-02	373	2595	340	713	0.8494
Oblivious Garden ~Carmina Burana	2014-12-12	82	496	49	131	0.8486
Choice of the Deathless	2014-08-29	96	295	25	121	0.8476
The Fall	2014-05-30	423	3135	429	852	0.8473
About Love, Hate and the other ones	2014-12-12	195	709	78	273	0.8471
6180 the moon	2014-09-19	79	440	43	122	0.8471
Eufloria HD	2014-10-14	115	616	66	181	0.8467
Ryse: Son of Rome	2014-10-10	3257	29466	4729	7986	0.8461
Freddi Fish 4: The Case of the Hogfish Rustlers of Briny Gulch	2014-05-29	16	117	6	22	0.8455
TRON 2.0	2014-10-10	59	538	57	116	0.8452
realMyst: Masterpiece Edition	2014-02-05	292	1201	150	442	0.8445999999999999
Magicmaker	2014-09-22	332	518	55	387	0.8443
Yet Another Zombie Defense	2014-03-28	67959	10492	1627	69586	0.8442000000000001
Bardbarian	2014-04-01	224	1296	165	389	0.8439
Microsoft Flight Simulator X: Steam Edition	2014-12-18	6051	20102	3252	9303	0.8433
Astebreed: Definitive Edition	2014-05-30	133	1321	171	304	0.8427
Super Time Force Ultra	2014-08-25	476	812	97	573	0.8427
Death Rally (Classic)	2014-05-05	699	501	54	753	0.8426
Deponia: The Complete Journey	2014-07-08	13321	5239	789	14110	0.8422000000000001
Platypus	2014-08-15	975	437	46	1021	0.8418000000000001
Quake Live	2014-09-17	6154	12610	2036	8190	0.8409000000000001
Outcast 1.1	2014-12-18	130	476	52	182	0.8407
Cho Dengeki Stryker	2014-09-20	30	108	6	36	0.8401000000000001
Don Bradman Cricket 14	2014-06-25	286	626	74	360	0.8394
Warrior Kings: Battles	2014-05-07	32	227	20	52	0.8393
Gray Matter	2014-04-01	78	575	67	145	0.8392000000000001
Strife: Veteran Edition	2014-12-12	92	490	55	147	0.8392000000000001
JUJU	2014-12-10	20	97	5	25	0.8392000000000001
Ascension	2014-12-16	197	1163	154	351	0.8390000000000001
Angvik	2014-02-24	257	2102	301	558	0.8388
Putt-Putt Goes to the Moon	2014-05-05	20	184	15	35	0.8384999999999999
Black Mirror II	2014-04-02	53	470	53	106	0.8381000000000001
Battle Academy 2: Eastern Front	2014-09-12	64	183	15	79	0.838
Card City Nights	2014-02-14	352	844	108	460	0.8375
Costume Quest 2	2014-10-07	359	743	93	452	0.8375
Black Mirror III	2014-04-03	44	365	39	83	0.8373
Rollers of the Realm	2014-11-18	243	584	70	313	0.8372
BlazeRush	2014-10-28	181	1263	173	354	0.8370000000000001
Soul Gambler	2014-07-10	2273	2307	340	2613	0.8369
Dark Arcana: The Carnival	2014-10-28	678	595	72	750	0.8367
Murder Miners	2014-07-25	1769	5315	852	2621	0.8357
Heroine's Quest: The Herald of Ragnarok	2014-03-21	2078	1138	156	2234	0.8356
Nosferatu: The Wrath of Malachi	2014-03-06	851	2381	357	1208	0.8355
Riptide GP2	2014-03-07	127	436	50	177	0.8355
Hitman: Contracts	2014-01-21	175	1998	296	471	0.8349
The LEGO® Movie - Videogame	2014-02-07	1402	3530	553	1955	0.8347
The Evil Within	2014-10-14	4499	21381	3746	8245	0.8343
Jets'n'Guns Gold	2014-02-05	299	1223	172	471	0.8341
Disney's Princess Enchanted Journey	2014-10-10	44	251	25	69	0.8341
STARWHAL	2014-09-29	86	612	77	163	0.8340000000000001
WazHack	2014-02-17	160	597	75	235	0.8337000000000001
SPY Fox 2: Some Assembly Required	2014-05-01	23	149	12	35	0.8334999999999999
Inherit the Earth: Quest for the Orb	2014-11-26	6	98	6	12	0.8333
Faces of War	2014-04-16	108	832	112	220	0.8329000000000001
Fatty Bear's Birthday Surprise	2014-10-23	16	164	14	30	0.8329000000000001
Go! Go! Nippon! ~My First Trip to Japan~	2014-02-21	300	2681	418	718	0.8327
Disney-Pixar Brave	2014-10-06	32	131	10	42	0.8326000000000001
Super Win the Game	2014-10-01	3001	549	69	3070	0.8323
Ziggurat	2014-10-23	809	3213	512	1321	0.8320000000000001
T.E.C. 3001	2014-04-11	921	351	40	961	0.8318000000000001
Ascension to the Throne	2014-04-23	36	450	55	91	0.8311000000000001
So Many Me	2014-07-17	19	95	6	25	0.8311000000000001
Cosmic DJ	2014-10-30	63	936	131	194	0.831
Beyond Gravity	2014-09-24	159	785	107	266	0.8309000000000001
Skyborn	2014-02-21	2245	1450	216	2461	0.8307
Gunman Clive	2014-01-03	18	667	89	107	0.8303
Nearwood - Collector's Edition	2014-04-16	28	254	27	55	0.8300000000000001
Sudeki	2014-02-24	85	721	98	183	0.8299
Velocibox	2014-09-08	171	562	74	245	0.8287000000000001
BlazBlue: Calamity Trigger	2014-02-13	269	2532	408	677	0.8286
Qbeh-1: The Atlas Cube	2014-05-15	65	593	79	144	0.8286
Magicite	2014-06-09	1985	6393	1106	3091	0.8285
Chronology	2014-05-12	764	718	99	863	0.8285
Jacob Jones and the Bigfoot Mystery : Episode 1	2014-09-15	10	34	0	10	0.8285
Lumino City	2014-12-03	110	1107	163	273	0.8284
Tesla Effect	2014-05-07	494	1071	157	651	0.8284
FOTONICA	2014-11-06	226	721	100	326	0.828
Time Rifters	2014-10-21	497	364	44	541	0.828
Drox Operative	2014-02-18	386	276	31	417	0.8279000000000001
FATE: The Cursed King	2014-11-19	128	370	45	173	0.8278
Fable Anniversary	2014-09-12	6186	10026	1792	7978	0.8277
Freddi Fish 5: The Case of the Creature of Coral Cove	2014-06-06	16	123	10	26	0.8276000000000001
Descent 2	2014-02-19	14	115	9	23	0.8275
Flashpoint Campaigns: Red Storm	2014-11-21	92	204	21	113	0.8271
Haunt the House: Terrortown	2014-06-06	265	1426	223	488	0.8256
Guilty Gear X2 #Reload	2014-09-05	1251	644	90	1341	0.8256
Space Run	2014-06-13	1488	1713	274	1762	0.8253
EvilQuest	2014-02-20	173	568	78	251	0.8251999999999999
Carmageddon 2: Carpocalypse Now	2014-09-19	85	639	90	175	0.8248000000000001
MouseCraft	2014-07-08	115	253	29	144	0.8246
ENDLESS™ Legend	2014-09-18	10468	14258	2668	13136	0.8240999999999999
Sneaky Sneaky	2014-11-12	121	250	29	150	0.8234
Pivvot	2014-07-14	79	209	23	102	0.8231999999999999
Of Guards And Thieves	2014-07-16	425	3634	634	1059	0.8231
DYNASTY WARRIORS 8: Xtreme Legends Complete Edition	2014-05-13	3878	9751	1815	5693	0.8226000000000001
Disney Winnie the Pooh	2014-10-06	23	201	22	45	0.8226000000000001
Darklands	2014-10-17	52	187	20	72	0.8225
KAMUI	2014-12-11	21	152	15	36	0.8225
A Bird Story	2014-11-07	1313	7749	1429	2742	0.8222
Defense Grid 2	2014-09-23	1331	2396	408	1739	0.8220000000000001
World of Guns: Gun Disassembly	2014-05-21	1597	14928	2872	4469	0.8209000000000001
Cinders	2014-05-01	149	668	99	248	0.8207
NOBUNAGA'S AMBITION: Souzou	2014-08-27	392	873	135	527	0.8204000000000001
NARUTO SHIPPUDEN: Ultimate Ninja STORM Revolution	2014-09-16	6831	6675	1253	8084	0.8190000000000001
Max Gentlemen	2014-08-21	162	753	116	278	0.8187000000000001
Bird Assassin	2014-08-27	29	300	39	68	0.8184
Castlevania: Lords of Shadow 2	2014-02-25	3802	3946	734	4536	0.8162
Rising World	2014-12-03	486	4026	754	1240	0.8155
METAL GEAR SOLID V: GROUND ZEROES	2014-12-18	5810	12380	2470	8280	0.8151999999999999
DeadCore	2014-10-17	273	1684	295	568	0.8151999999999999
Lili: Child of Geos	2014-05-09	77	828	134	211	0.8151
Raptor: Call of the Shadows (1994 Classic Edition)	2014-05-05	11	153	17	28	0.8149
Shantae: Risky's Revenge - Director's Cut	2014-07-15	332	1159	196	528	0.8148000000000001
Dandelion - Wishes brought to you -	2014-09-29	75	628	98	173	0.8148000000000001
Wolfenstein: The New Order German Edition	2014-05-19	2790	1848	328	3118	0.8147
Final Fantasy IV (3D Remake)	2014-09-17	667	2081	375	1042	0.8142
Shadowgate	2014-08-21	323	558	86	409	0.8142
Strata	2014-05-29	40	304	42	82	0.8135
Driftmoon	2014-01-03	26	226	29	55	0.8135
J.U.L.I.A.: Among the Stars	2014-09-12	379	734	119	498	0.8131999999999999
Heroes Rise: HeroFall	2014-07-11	121	124	13	134	0.8131999999999999
Coin Crypt	2014-10-28	344	508	78	422	0.8131
Broken Age	2014-01-28	3260	6319	1245	4505	0.8126000000000001
Toybox Turbos	2014-11-11	139	1463	259	398	0.8125
F1 2014	2014-10-16	2393	2419	448	2841	0.8124
My Lands	2014-09-16	1226	2765	518	1744	0.8123
Spy Chameleon - RGB Agent	2014-06-11	201	259	35	236	0.8122
Mechanik Maszyn Rolniczych 2015	2014-12-02	73	228	30	103	0.8117000000000001
The Impossible Game	2014-05-09	123	1084	188	311	0.8113
Aqua Kitty - Milk Mine Defender	2014-02-03	148	411	62	210	0.8112
Khet 2.0	2014-10-01	902	140	16	918	0.8107
Sword of the Samurai	2014-10-17	26	127	14	40	0.8106
Prelogate	2014-12-10	53	87	8	61	0.8106
Date Warp	2014-09-02	13	146	17	30	0.8105
TRI: Of Friendship and Madness	2014-10-09	46	413	63	109	0.8102
Squishy the Suicidal Pig	2014-10-23	1089	2887	553	1642	0.81
NaissanceE	2014-02-13	230	2481	470	700	0.81
Mechanic Escape	2014-04-15	1400	666	110	1510	0.8099
Street Racing Syndicate	2014-04-24	2270	2983	574	2844	0.8097
The Promised Land	2014-04-25	225	600	98	323	0.8095
Cloudbuilt	2014-03-20	1782	762	129	1911	0.8093000000000001
I, Zombie	2014-12-09	553	2044	384	937	0.8090999999999999
Ichi	2014-06-12	234	543	88	322	0.8088
Styx: Master of Shadows	2014-10-07	1639	7534	1552	3191	0.8079999999999999
Enemy Mind	2014-06-06	1165	669	113	1278	0.8077
Aritana and the Harpy's Feather	2014-08-15	121	104	11	132	0.8077
Morphopolis	2014-08-14	362	3977	795	1157	0.8074
Disney Princess : My Fairytale Adventure	2014-10-06	38	195	26	64	0.8072
War of the Human Tanks	2014-01-10	182	454	73	255	0.8067000000000001
Another Perspective	2014-08-09	37	274	40	77	0.8067000000000001
Enigmatis: The Ghosts of Maple Creek	2014-10-16	233	1224	225	458	0.8062
Hard Truck Apocalypse / Ex Machina	2014-03-14	169	1848	353	522	0.8061
Sniper Elite 3	2014-06-27	10861	19845	4324	15185	0.8057
MoonBase Commander	2014-02-06	43	138	17	60	0.805
10 Second Ninja	2014-03-05	93	633	109	202	0.8048000000000001
RefleX	2014-03-28	54	190	26	80	0.8045
Sid Meier's Covert Action (Classic)	2014-10-09	41	113	13	54	0.8045
FRACT OSC	2014-04-22	311	492	82	393	0.8044
Meltdown	2014-06-05	172	684	120	292	0.8039000000000001
Aperture Tag: The Paint Gun Testing Initiative	2014-07-15	913	4826	1005	1918	0.8036
Car Mechanic Simulator 2014	2014-01-24	1078	4104	847	1925	0.8035
Full Mojo Rampage	2014-05-08	465	1038	192	657	0.8035
7 Wonders: Magical Mystery Tour	2014-02-18	17	93	10	27	0.8034
Soldiers: Heroes of World War II	2014-07-03	96	535	92	188	0.8025
Wasteland 2	2014-09-19	18856	6571	1408	20264	0.8019
Bik - A Space Adventure	2014-10-14	50	45	3	53	0.8019
Dreamfall Chapters	2014-10-21	1711	3519	730	2441	0.8017000000000001
They Breathe	2014-05-23	54	1046	197	251	0.8015000000000001
Castlevania: Lords of Shadow – Mirror of Fate HD	2014-03-27	482	1559	307	789	0.8007
Strider	2014-02-19	839	2885	598	1437	0.8001
Blitzkrieg 2 Anthology	2014-09-16	150	921	174	324	0.7996
Terrorhedron	2014-07-25	752	961	183	935	0.7992
Chuck's Challenge 3D 2020	2014-02-28	32	175	25	57	0.799
WORLD END ECONOMiCA episode.01	2014-06-17	79	570	103	182	0.7981
Pilot Brothers	2014-12-18	17	206	31	48	0.7981
FootLOL: Epic Soccer League	2014-04-16	1310	885	169	1479	0.7979
Metal Dead	2014-10-06	75	411	71	146	0.7978000000000001
Magicians & Looters	2014-07-02	2069	111	14	2083	0.7975
Q.U.B.E: Director's Cut	2014-05-21	206	1478	298	504	0.7973
Procyon	2014-02-26	39	105	13	52	0.7973
Blake Stone: Aliens of Gold	2014-05-05	7	81	9	16	0.7970999999999999
Ballad of Solar	2014-05-22	220	166	24	244	0.7968000000000001
Thinking with Time Machine	2014-04-18	627	3434	739	1366	0.7967000000000001
Stick RPG 2	2014-06-16	130	731	138	268	0.7967000000000001
Mecha Ace	2014-12-05	42	127	17	59	0.7966
QbQbQb	2014-10-29	9	92	11	20	0.7961
Dark Scavenger	2014-05-16	2263	202	31	2294	0.7959
Final Fantasy III (3D Remake)	2014-05-27	792	2325	492	1284	0.7956000000000001
Frederic: Evil Strikes Back	2014-05-23	2882	662	125	3007	0.7954000000000001
Galcon 2	2014-12-05	327	706	135	462	0.7948000000000001
Command: Modern Air / Naval Operations WOTY	2014-09-26	194	507	93	287	0.7947
Construction-Simulator 2015	2014-11-18	1824	5284	1182	3006	0.7946
Orbital Gear	2014-08-07	2034	1467	302	2336	0.7946
Brink of Consciousness: Dorian Gray Syndrome	2014-07-18	19	241	39	58	0.7946
Frederic: Resurrection of Music	2014-05-16	1209	804	157	1366	0.7941
Hive	2014-03-20	801	239	39	840	0.7937000000000001
Battle Academy	2014-04-16	68	254	42	110	0.7936
Command HQ	2014-11-06	20	66	7	27	0.7935
Breach & Clear	2014-03-21	517	1949	416	933	0.7928000000000001
Instant Dungeon!	2014-11-25	54	149	22	76	0.7925
bit Dungeon II	2014-12-15	257	1757	374	631	0.7922
Iron Fisticle	2014-09-16	319	342	61	380	0.7914
Chip	2014-04-25	2569	947	193	2762	0.7909999999999999
The Sun and Moon	2014-11-14	15	147	22	37	0.7909999999999999
ALLTYNEX Second	2014-12-11	20	115	16	36	0.7909999999999999
Phoenix Force	2014-11-13	2543	657	129	2672	0.7908
Betrayer	2014-03-24	725	2984	666	1391	0.7907
Braveland	2014-03-17	218169	2408	531	218700	0.7905
Battlepillars Gold Edition	2014-04-28	314	276	48	362	0.7902
Black Mirror I	2014-06-17	112	901	184	296	0.7901
Fork Parker's Holiday Profit Hike	2014-12-18	2491	562	109	2600	0.79
Hero of Many	2014-09-15	14	114	16	30	0.79
SPY Fox 3: Operation Ozone	2014-05-15	14	103	14	28	0.7898999999999999
Never Alone (Kisima Ingitchuna)	2014-11-18	482	6489	1517	1999	0.7898000000000001
Dead Man's Draw	2014-02-06	1478	501	96	1574	0.7897
Gauntlet™ 	2014-09-23	12730	7185	1692	14422	0.7894
Disciples Sacred Lands Gold	2014-10-07	30	263	46	76	0.7887000000000001
Saviors	2014-12-01	988	1381	298	1286	0.788
Little Racers STREET	2014-02-06	231	868	181	412	0.7870999999999999
Age of Wonders III	2014-03-31	19469	9459	2298	21767	0.7864
LEGO® The Hobbit™	2014-04-10	5550	6852	1645	7195	0.7863
Blade Kitten	2014-05-22	94	847	178	272	0.7859
Pixel Puzzles: Japan	2014-04-17	3423	2066	468	3891	0.7855
Summoner	2014-03-12	66	372	71	137	0.7855
Great Permutator	2014-09-15	284	119	18	302	0.785
The Yawhg	2014-02-27	114	1121	244	358	0.7847
Robin's Quest	2014-04-17	11	98	14	25	0.7846
Heavy Bullets	2014-09-18	205	1187	260	465	0.7845000000000001
Left in the Dark: No One on Board	2014-10-02	504	578	118	622	0.7844
My Riding Stables: Life with Horses	2014-03-27	50	182	31	81	0.784
Gems of War	2014-11-20	3007	7325	1792	4799	0.7839
IL-2 Sturmovik: Battle of Stalingrad	2014-10-22	1061	5991	1454	2515	0.7839
Outland	2014-09-29	16166	3128	737	16903	0.7836
Whispering Willows	2014-07-09	2527	1283	285	2812	0.7835
Planet Alcatraz	2014-04-16	1285	460	92	1377	0.7835
Northmark: Hour of the Wolf	2014-08-02	261	251	46	307	0.783
Battle Group 2	2014-06-13	200	413	82	282	0.7827
Mr. Bree+	2014-05-01	180	194	34	214	0.7825
BasketBelle	2014-12-09	152	131	21	173	0.7823000000000001
Terminal Velocity: Legacy	2014-05-05	7	64	8	15	0.782
Ultimate General: Gettysburg	2014-10-16	910	2125	496	1406	0.7817000000000001
Back to Bed	2014-08-06	30771	2105	491	31262	0.7817000000000001
Munin	2014-06-10	692	710	152	844	0.7814
Corporate Lifestyle Simulator	2014-03-12	57	539	112	169	0.7813
Qvadriga	2014-06-13	100	324	63	163	0.7812000000000001
Hocus Pocus	2014-05-05	7	115	18	25	0.7812000000000001
Last Dream	2014-03-13	266	414	84	350	0.7803
Lost Chronicles of Zerzura	2014-07-10	12	94	14	26	0.7801
Suguri	2014-07-01	75	157	27	102	0.7798999999999999
Full Bore	2014-05-06	2892	194	35	2927	0.7796
Tribloos 2	2014-01-30	1004	239	45	1049	0.7793000000000001
Putt-Putt Joins the Circus	2014-05-29	16	78	11	27	0.7793000000000001
Time Mysteries 3: The Final Enigma	2014-09-11	232	328	65	297	0.7792
Bad Mojo Redux	2014-07-03	9	132	22	31	0.7789
The Collider	2014-09-15	57	760	168	225	0.7782
Quest for Infamy	2014-07-10	108	178	32	140	0.7782
Etherlords II	2014-02-13	105	342	69	174	0.7779
The Lost Crown	2014-06-06	112	363	74	186	0.7777
Avoid Sensory Overload	2014-04-08	66	177	32	98	0.7775
The Floor is Jelly	2014-05-30	24	345	70	94	0.7774
Graviteam Tactics: Operation Star	2014-02-11	98	370	76	174	0.7770999999999999
Deadlings - Rotten Edition	2014-11-11	1201	226	43	1244	0.7770999999999999
Brink of Consciousness: The Lonely Hearts Murders	2014-11-24	11	120	20	31	0.7766
Gardens Inc. – From Rakes to Riches	2014-03-25	30	76	11	41	0.7765000000000001
CastleMiner Z	2014-02-03	452	7830	2020	2472	0.7764
Mitsurugi Kamui Hikae	2014-03-10	188	2610	641	829	0.7763
Our Darker Purpose	2014-01-29	247	592	130	377	0.7758
The Treasures of Montezuma 4	2014-05-16	193	450	96	289	0.7756000000000001
Oniken	2014-02-05	101	705	158	259	0.7755
Polarity	2014-11-07	886	3768	949	1835	0.7754000000000001
Rock Boshers DX: Director's Cut	2014-12-10	8	44	5	13	0.7754000000000001
1001 Spikes	2014-06-03	118	567	125	243	0.7748
Heroes of a Broken Land	2014-08-07	142	173	32	174	0.7747
Defense Zone 2	2014-05-30	39	118	20	59	0.7747
Deadly Sin 2	2014-05-12	175	94	15	190	0.7744
Slave Zero	2014-10-23	12	163	30	42	0.774
Bus Driver	2014-06-03	60	1577	383	443	0.7735
Loren The Amazon Princess	2014-01-15	302	467	102	404	0.7733
Wings of Vi	2014-11-28	279	975	230	509	0.7726000000000001
Disney Universe	2014-10-06	33	231	46	79	0.7726000000000001
Major Mayhem	2014-02-24	119	235	47	166	0.7724
SuperPower 2 Steam Edition	2014-04-18	227	2008	500	727	0.7721
Perimeter	2014-04-03	370	178	34	404	0.772
Tex Murphy: The Pandora Directive	2014-06-12	9	58	8	17	0.772
Pajama Sam: Games to Play on Any Day	2014-10-23	12	42	5	17	0.7709
Boot Hill Heroes	2014-10-10	103	91	15	118	0.7706999999999999
Bridge Constructor Medieval	2014-09-15	185	393	86	271	0.7705
Rise of the Triad: Dark War	2014-05-05	8	95	16	24	0.7698999999999999
Farm for your Life	2014-06-16	337	495	112	449	0.7697
Run or Die	2014-12-12	70	131	24	94	0.7697
Lords of Xulima	2014-11-14	657	940	226	883	0.7696
Millie	2014-04-18	1688	577	133	1821	0.7694
Return to Mysterious Island	2014-03-06	59	295	63	122	0.7689
Tropico 5	2014-05-23	13483	10590	2902	16385	0.7686000000000001
The Last Tinker: City of Colors	2014-05-12	541	710	168	709	0.7685
Warhammer 40,000: Armageddon	2014-11-26	587	698	165	752	0.7685
Memories of a Vagabond	2014-07-07	4991	955	232	5223	0.7684000000000001
Scania Truck Driving Simulator	2014-02-27	111	1368	342	453	0.7681
Obscure 2	2014-03-10	35	761	182	217	0.768
Halo: Spartan Assault	2014-04-04	680	3428	906	1586	0.7676000000000001
Split/Second	2014-10-06	85	1436	362	447	0.7674
Tower of Guns	2014-03-04	364	936	229	593	0.7672
F-117A Nighthawk Stealth Fighter 2.0	2014-10-30	9	97	17	26	0.7668
Heroes Rise: The Prodigy	2014-06-17	217	322	71	288	0.7665000000000001
Hangeki	2014-08-11	12	35	4	16	0.7665000000000001
Cosmo's Cosmic Adventure	2014-05-05	9	92	16	25	0.7661
Constant C	2014-03-12	193	45	6	199	0.766
Aura Kingdom	2014-07-04	2165	6816	1874	4039	0.7658
Red Orchestra 2/Rising Storm Alpha Community Maps	2014-09-23	3	18	1	4	0.7658
Vertical Drop Heroes HD	2014-07-25	276	585	139	415	0.7656000000000001
Talisman: Digital Edition	2014-02-25	3590	6444	1775	5365	0.7652
Road Not Taken	2014-08-05	135	271	59	194	0.7652
Sakura Spirit	2014-07-09	537	5624	1544	2081	0.7648999999999999
Eets Munchies	2014-03-11	423	582	139	562	0.7648999999999999
Advanced Tactics Gold	2014-08-15	41	117	22	63	0.7645000000000001
Fantasy Grounds Classic	2014-05-09	991	974	244	1235	0.7644
Pajama Sam's Sock Works	2014-06-06	8	54	8	16	0.7644
Sweezy Gunner	2014-05-06	223	188	39	262	0.7642
Crystal Caves	2014-05-05	10	94	17	27	0.763
Sproggiwood	2014-10-24	131	449	106	237	0.7629000000000001
Gun Metal	2014-01-16	1091	768	191	1282	0.7628
rymdkapsel	2014-01-30	105	206	44	149	0.7626000000000001
Namariel Legends: Iron Lord Premium Edition	2014-07-09	11	115	22	33	0.7624
Rooms: The Main Building	2014-07-11	221	140	28	249	0.7622
Electronic Super Joy: Groove City	2014-06-06	116	455	109	225	0.7612000000000001
MXGP - The Official Motocross Videogame	2014-03-28	639	1119	290	929	0.761
Airline Tycoon Deluxe	2014-11-14	93	390	92	185	0.761
The Marvellous Miss Take	2014-11-20	91	255	57	148	0.761
Leviathan: The Last Day of the Decade	2014-11-19	133	518	126	259	0.7609
Praetorians	2014-04-11	56	483	117	173	0.7606
Dreamscapes: The Sandman - Premium Edition	2014-04-16	18	191	41	59	0.7606
Konung 2	2014-04-23	21	138	28	49	0.7603
Runers	2014-09-02	275	226	50	325	0.7602
Rising Angels: Reborn	2014-09-12	103	469	114	217	0.7597
GRID Autosport	2014-06-26	3554	6627	1894	5448	0.7595000000000001
Gardens Inc. 2: The Road to Fame	2014-05-21	13	47	7	20	0.7595000000000001
Strike Suit Zero: Director's Cut	2014-04-08	140	278	64	204	0.7589
Dragons and Titans	2014-03-12	991	2688	745	1736	0.7586
OMG Zombies!	2014-02-13	246	307	72	318	0.7582
Eradicator	2014-11-06	7	73	13	20	0.7579000000000001
Chariot	2014-11-12	59	310	73	132	0.7578
Super Game Jam	2014-05-22	48	55	9	57	0.7571
Eldevin	2014-11-06	1013	1264	341	1354	0.7564000000000001
Fight The Dragon	2014-12-04	754	1053	281	1035	0.7562000000000001
Secret Agent	2014-05-05	8	80	15	23	0.7555
Sir, You Are Being Hunted	2014-05-02	744	2970	848	1592	0.7547
Acceleration of Suguri X-Edition	2014-07-01	111	182	41	152	0.7541
Serena	2014-01-30	1418	4877	1429	2847	0.7538
Farm Frenzy 4	2014-04-29	96	312	76	172	0.7536
Words for Evil	2014-12-11	634	359	89	723	0.7534000000000001
Signs of Life	2014-01-27	104	615	161	265	0.7531
aerofly RC 7	2014-11-06	25	169	38	63	0.753
Stargunner	2014-05-05	64	86	17	81	0.7522
Mega Coin Squad	2014-08-15	21	69	13	34	0.7512000000000001
Project Temporality	2014-05-20	54	85	17	71	0.7506999999999999
Killing Floor - Toy Master	2014-10-16	268	25	3	271	0.7503000000000001
Braveland Wizard	2014-12-04	86	337	85	171	0.7502
Super Life of Pixel	2014-10-22	61	297	74	135	0.7499
Infinity Wars - Animated Trading Card Game	2014-09-05	1635	2658	780	2415	0.7495999999999999
Pilot Brothers 2	2014-12-31	6	64	12	18	0.7495999999999999
Anomaly Defenders	2014-05-29	2032	427	111	2143	0.7495
The Howler	2014-07-04	574	1625	466	1040	0.7494
Commander : The Great War	2014-07-25	264	209	50	314	0.7494
iO	2014-12-05	862	172	40	902	0.7493000000000001
NOBUNAGA'S AMBITION: Souzou with Power Up Kit	2014-12-11	6856	115	25	6881	0.7490000000000001
Last Knight: Rogue Rider Edition	2014-10-03	82	185	44	126	0.748
OlliOlli	2014-07-22	271	666	182	453	0.7479000000000001
Double Dragon Neon	2014-02-06	208	1825	533	741	0.7475
Mashed	2014-04-24	20	374	98	118	0.7465999999999999
Retro Game Crunch	2014-05-19	50	325	84	134	0.7465
The Forest of Doom	2014-10-30	70	222	55	125	0.746
Alchemy Mysteries: Prague Legends	2014-12-22	582	877	248	830	0.7458
Deep Dungeons of Doom	2014-10-14	363	549	150	513	0.7456999999999999
Famaze	2014-05-05	63	306	79	142	0.7456999999999999
Red Orchestra 2/Rising Storm Beta Community Maps	2014-09-23	5	14	1	6	0.7453000000000001
Millennium 4 - Beyond Sunset	2014-09-19	382	37	6	388	0.7451000000000001
[Old Edition] Croixleur Sigma	2014-04-30	117	266	68	185	0.7449
Paper Sorcerer	2014-01-22	759	482	131	890	0.7448
Reversion - The Escape	2014-06-10	606	1189	346	952	0.7444
Radiant Defense	2014-07-11	32	92	20	52	0.7440000000000001
Putt-Putt and Fatty Bear's Activity Pack	2014-05-15	15	80	17	32	0.7431
Sentinel 3: Homeworld	2014-02-03	35	106	24	59	0.7427
Game of Thrones - A Telltale Games Series	2014-12-02	6771	7986	2542	9313	0.7426
Theatre Of The Absurd	2014-05-08	25	206	52	77	0.7424
Hero Siege	2014-01-29	5015	26633	8743	13758	0.7421
A.I.M.2 Clan Wars	2014-05-22	22	353	95	117	0.7421
Haunted Past: Realm of Ghosts	2014-04-10	12	131	31	43	0.742
DreadOut	2014-05-15	176	3654	1139	1315	0.7419
Disney Planes	2014-10-06	17	60	12	29	0.7417
The Happy Hereafter	2014-06-05	705	307	82	787	0.7412000000000001
LocoCycle	2014-02-14	52	252	66	118	0.7409
Randal's Monday	2014-11-12	188	1058	313	501	0.7408
Daedalus - No Escape	2014-10-28	42	108	25	67	0.7406
Ski Region Simulator	2014-01-31	102	369	101	203	0.7404000000000001
Darkstone	2014-09-26	54	359	98	152	0.7404000000000001
Flyhunter Origins	2014-12-10	200	27	4	204	0.7403000000000001
Leona's Tricky Adventures	2014-11-11	6	27	4	10	0.7403000000000001
Wings! Remastered Edition	2014-10-17	98	378	104	202	0.74
Lifeless Planet	2014-06-06	410	2574	802	1212	0.7397
FATE: Undiscovered Realms	2014-04-17	68	277	74	142	0.7397
Jagged Alliance Gold	2014-04-23	298	313	85	383	0.7392000000000001
Assassin's Creed Freedom Cry	2014-02-25	447	1551	474	921	0.7391
Dead Rising 3	2014-09-05	11418	12155	3995	15413	0.7390000000000001
Labyrinthine Dreams	2014-05-23	926	262	70	996	0.7388
Season Match 3 - Curse of the Witch Crow	2014-10-30	451	113	27	478	0.7379000000000001
Heroes Rise: The Hero Project	2014-06-17	111	134	33	144	0.7377
Killer is Dead	2014-05-23	4255	5954	1939	6194	0.7373000000000001
Imperial Glory	2014-04-11	135	871	261	396	0.737
Battle Islands	2014-08-06	1002	2585	821	1823	0.7366
Heroes of Steel RPG	2014-04-23	58	208	55	113	0.7366
Bravada	2014-08-22	336	50	10	346	0.7366
Aeon Command	2014-07-03	621	304	84	705	0.7364
Wyv and Keep: The Temple of the Lost Idol	2014-08-08	159	76	17	176	0.7364
Winged Sakura: Mindy's Arc	2014-11-07	73	143	36	109	0.7363
Buzz Aldrin's Space Program Manager	2014-10-31	461	354	100	561	0.7354
Journal	2014-02-17	20	269	74	94	0.7353000000000001
Supreme Ruler Ultimate	2014-10-17	302	866	263	565	0.7349
Civil War II	2014-07-03	107	232	63	170	0.7348
Distant Worlds: Universe	2014-05-23	1254	1326	414	1668	0.7343000000000001
WAKFU	2014-09-18	4078	6859	2286	6364	0.7340000000000001
Empress Of The Deep 2: Song Of The Blue Whale	2014-05-08	12	78	18	30	0.7337
Monster Bash	2014-05-05	7	45	9	16	0.7336
EPOCH	2014-06-05	834	92	22	856	0.7334
The Witcher Adventure Game	2014-11-27	294	976	302	596	0.7331000000000001
Millennium 3 - Cry Wolf	2014-08-29	421	41	8	429	0.733
Jacob Jones and the Bigfoot Mystery : Episode 2	2014-09-23	4	21	3	7	0.7327
Elastrix	2014-12-18	5	21	3	8	0.7327
Watch_Dogs	2014-05-27	47887	25844	8943	56830	0.7325
Putt-Putt and Pep's Balloon-o-Rama	2014-04-17	9	63	14	23	0.7325
B-17 Flying Fortress: The Mighty 8th	2014-10-30	6	63	14	20	0.7325
UFO: Aftermath	2014-04-23	45	199	54	99	0.7323999999999999
Freespace 2	2014-06-06	28	224	62	90	0.7317
Bio Menace	2014-05-05	9	48	10	19	0.7316
Battle Mages: Sign of Darkness	2014-07-24	879	101	25	904	0.7314
Deadly 30	2014-01-08	770	1290	410	1180	0.7313
Saturday Morning RPG	2014-01-29	977	395	116	1093	0.7313
Neverending Nightmares	2014-09-26	146	1984	644	790	0.7311
Super Motherload	2014-04-04	219	580	176	395	0.7309
Detective Case and Clown Bot in: Murder in the Hotel Lisbon	2014-07-17	98	197	54	152	0.7309
Pretentious Game	2014-05-20	8	226	63	71	0.7308
Defense Zone	2014-07-14	57	55	12	69	0.7308
FINAL FANTASY XIII	2014-10-09	8320	11279	3878	12198	0.7306999999999999
Elsword	2014-07-02	2587	6820	2316	4903	0.7306999999999999
The Whispered World Special Edition	2014-05-06	223	1299	416	639	0.7301000000000001
Descent: Freespace - The Great War	2014-05-07	35	163	44	79	0.7298
Muffin Knight	2014-05-20	33	325	95	128	0.7293999999999999
Dokuro	2014-12-08	11	54	12	23	0.7284
Xeodrifter™	2014-12-11	39	599	186	225	0.7277
Wacky Wheels	2014-05-05	6	105	27	33	0.7277
Aces Wild: Manic Brawling Action!	2014-01-31	65	265	77	142	0.7273999999999999
LogiGun	2014-07-22	57	50	11	68	0.7273999999999999
Z	2014-07-04	1102	874	280	1382	0.7266
Realms of the Haunting	2014-04-24	221	356	107	328	0.7265
7,62 High Calibre	2014-04-30	673	322	96	769	0.7264
Small Town Terrors Pilgrim's Hook Collector's Edition	2014-07-16	13	104	27	40	0.7263
GamersGoMakers	2014-08-08	247	303	90	337	0.7262000000000001
Risen 3 - Titan Lords	2014-08-15	8011	4111	1418	9429	0.7253000000000001
Fenix Rage	2014-09-24	39	129	35	74	0.725
Always Sometimes Monsters	2014-05-21	805	1794	602	1407	0.7248
Quest of Dungeons	2014-03-25	125	523	164	289	0.7247
Amphora	2014-11-12	12	151	42	54	0.7245999999999999
Do Not Fall	2014-12-19	7	11	1	8	0.7242000000000001
Shadow Ops: Red Mercury	2014-07-02	16	191	55	71	0.7238
Reprisal Universe	2014-09-15	160	304	92	252	0.7234999999999999
Putt-Putt and Pep's Dog on a Stick	2014-05-01	5	45	10	15	0.7234999999999999
Disney Epic Mickey 2	2014-10-06	57	551	175	232	0.7232999999999999
The Culling Of The Cows	2014-05-09	1483	2525	867	2350	0.7232
Psy High	2014-12-22	88	114	31	119	0.7223999999999999
Hostile Waters: Antaeus Rising	2014-01-30	1294	316	97	1391	0.7219
Crazy Plant Shop	2014-08-04	101	207	61	162	0.7218000000000001
The Sands Whisper Your Name	2014-11-27	4	6	0	4	0.7217
Ukrainian Ninja	2014-12-23	591	554	178	769	0.7216
Fearless Fantasy	2014-05-15	1886	791	260	2146	0.7215
FarSky	2014-04-25	439	2857	997	1436	0.7212000000000001
Thief Town	2014-12-04	32	132	37	69	0.7212000000000001
Hail to the King: Deathbat	2014-10-30	54	160	46	100	0.7211
Paranormal State: Poison Spring Collector's Edition	2014-04-09	160	266	81	241	0.7208
Disney Pirates of the Caribbean: At Worlds End	2014-10-06	27	239	72	99	0.7208
Spoiler Alert	2014-06-30	760	915	305	1065	0.7206
Joe Dever's Lone Wolf HD Remastered	2014-11-27	98	542	175	273	0.7206
Mirror Mysteries	2014-04-10	22	187	55	77	0.7205
Feel-A-Maze	2014-11-25	13	87	23	36	0.7204
Ascendant	2014-05-13	2000	159	46	2046	0.7202
Dominique Pamplemousse	2014-03-11	71	339	106	177	0.7201000000000001
Space Farmers	2014-04-17	1961	1352	462	2423	0.7197
Motte Island	2014-04-07	26	67	17	43	0.7195
Sea Legends: Phantasmal Light Collector's Edition	2014-09-17	15	105	29	44	0.7188
Silence of the Sleep	2014-10-01	407	489	159	566	0.7184
OTTTD	2014-08-07	133	253	78	211	0.7183
Cubic Castles	2014-08-13	1348	3143	1125	2473	0.7173
The Last Federation	2014-04-18	650	365	117	767	0.7172
Slip	2014-04-29	21	85	23	44	0.7171
Freddi Fish and Luther's Maze Madness	2014-04-17	9	56	14	23	0.7169
The Moon Sliver	2014-10-28	2153	722	243	2396	0.7168000000000001
Season Match	2014-09-15	480	140	41	521	0.7164
Orborun	2014-09-05	99	311	99	198	0.7162999999999999
Archeblade	2014-04-25	3460	5650	2070	5530	0.7162000000000001
Dead State	2014-12-04	1408	1751	618	2026	0.7161
Kraven Manor	2014-09-26	48	471	155	203	0.7161
Millennium 2 - Take Me Higher	2014-07-10	212	49	12	224	0.7156999999999999
RC Cars	2014-04-23	14	298	95	109	0.7155
Voyage: Journey to the Moon	2014-08-29	16	121	35	51	0.7155
Final Dusk	2014-12-12	592	289	92	684	0.7154
Where is my Heart?	2014-05-29	28	133	39	67	0.7153
Myths Of Orion	2014-12-03	51	32	7	58	0.7149
Influent	2014-03-20	487	1133	397	884	0.7141
Cars 2	2014-10-06	58	530	178	236	0.7141
Homebrew - Patent Unknown	2014-11-14	100	708	243	343	0.7134999999999999
Contagion	2014-04-14	7624	10741	4054	11678	0.7134
Echo of the Wilds	2014-06-10	179	140	42	221	0.7131000000000001
Deadstone	2014-11-12	17	51	13	30	0.7123999999999999
Midnight Mysteries: Witches of Abraham - Collector's Edition	2014-11-24	9	38	9	18	0.7123
Actual Sunlight	2014-04-03	1990	424	142	2132	0.7122
Depth Hunter 2: Deep Dive	2014-08-20	253	712	247	500	0.7118000000000001
Gigantic Army	2014-03-06	161	257	83	244	0.7117
Halfway	2014-07-22	189	651	225	414	0.7115
Machines At War 3	2014-07-23	17	57	15	32	0.7115
Hard Truck: Apocalypse Rise Of Clans / Ex Machina: Meridian 113	2014-03-14	277	538	184	461	0.7114
Trace Vector	2014-08-19	40	41	10	50	0.7114
Diehard Dungeon	2014-03-05	1146	355	118	1264	0.7112999999999999
Flockers	2014-09-19	36	147	45	81	0.7111
Get Off My Lawn!	2014-11-11	330	1220	438	768	0.7105
8BitBoy	2014-05-05	220	1413	511	731	0.7103
Princess Isabella - Return of the Curse	2014-04-15	11	75	21	32	0.7103
Potatoman Seeks the Troof	2014-12-03	1852	578	200	2052	0.7101999999999999
Shadows on the Vatican - Act I: Greed	2014-06-09	983	529	182	1165	0.7101999999999999
Moorhuhn - Tiger and Chicken	2014-09-24	6	47	12	18	0.7101000000000001
Monochroma	2014-05-28	37	512	176	213	0.71
Ubersoldier II	2014-03-25	38	360	121	159	0.7098000000000001
Pox Nora	2014-10-15	780	550	191	971	0.7091
Victory At Sea	2014-08-08	347	400	136	483	0.7091
Realms of Arkania 3 - Shadows over Riva Classic	2014-01-10	58	56	15	73	0.7090000000000001
Vampires: Guide Them to Safety!	2014-10-22	35	37	9	44	0.7088
Realms of Chaos	2014-05-05	4	37	9	13	0.7088
O.R.B.	2014-03-13	33	74	21	54	0.7083
Fleet Defender: The F-14 Tomcat Simulation	2014-10-30	4	27	6	10	0.7081000000000001
Crowntakers	2014-11-07	170	465	161	331	0.7079000000000001
King's Bounty: Dark Side	2014-08-19	1282	1132	412	1694	0.7076000000000001
Rogue Shooter: The FPS Roguelike	2014-04-24	235	270	90	325	0.7075
UFO: Aftershock	2014-04-16	70	149	47	117	0.7072
Realms of Arkania 2 - Star Trail Classic	2014-01-10	55	46	12	67	0.7072
Schein	2014-10-10	1990	236	78	2068	0.7071
Moebius: Empire Rising	2014-04-15	196	233	77	273	0.7069
Jet Gunner	2014-08-04	4013	454	158	4171	0.7068000000000001
Rube Works	2014-04-22	21	20	4	25	0.7068000000000001
Gridiron Solitaire	2014-01-21	68	61	17	85	0.7064
Rex Rocket	2014-08-05	79	182	59	138	0.7062999999999999
Lexica	2014-07-04	60	267	90	150	0.7057
World of Subways 2 – Berlin Line 7	2014-06-13	39	184	60	99	0.7056
World of Subways 3 – London Underground Circle Line	2014-05-12	58	437	153	211	0.7054
Dead Effect	2014-12-17	1032	2596	989	2021	0.7051000000000001
Battle Fleet 2	2014-11-20	139	255	86	225	0.705
Pixel Puzzles: UndeadZ	2014-06-06	3153	639	230	3383	0.7047
Verde Station	2014-12-18	21	238	80	101	0.7046
Millennium - A New Hope	2014-04-25	1967	295	101	2068	0.7045
Boo Bunny Plague	2014-09-04	102	202	67	169	0.7044
1954 Alcatraz	2014-03-11	97	1091	404	501	0.7043
Agarest Zero	2014-04-17	442	270	92	534	0.7042
Math Rescue	2014-05-05	5	45	12	17	0.7042
Color Symphony	2014-09-15	167	942	347	514	0.7041
Finn and Jake's Epic Quest	2014-04-11	218	350	122	340	0.7037000000000001
Spud's Quest	2014-07-31	28	26	6	34	0.7034
DragonSphere	2014-10-17	5	26	6	11	0.7034
Ether One	2014-03-25	82	314	109	191	0.7031000000000001
Collapse	2014-04-11	201	573	207	408	0.703
Space Hulk Ascension	2014-11-12	389	635	231	620	0.7028
NEOTOKYO°	2014-07-04	900	1939	746	1646	0.7015000000000001
Sledgehammer / Gear Grinder	2014-03-12	62	102	32	94	0.7015000000000001
Foresight	2014-11-28	1399	35	9	1408	0.7015000000000001
Richard & Alice	2014-06-05	136	300	105	241	0.7012999999999999
Shan Gui	2014-08-19	185	1635	629	814	0.7005
Reversion - The Meeting	2014-07-08	2145	145	48	2193	0.6998000000000001
Darkness Within: In Pursuit of Loath Nolder	2014-11-13	106	381	137	243	0.6997
Princess Isabella	2014-04-15	12	109	35	47	0.6995
CAPSULE	2014-05-29	21	125	41	62	0.6988
Cyto	2014-07-10	574	72	22	596	0.6984
Revolution Ace	2014-03-19	1050	1382	535	1585	0.6981999999999999
Insanity's Blade	2014-12-05	14	205	71	85	0.6981
It's A Wipe!	2014-12-12	235	94	30	265	0.6977
Royal Defense	2014-11-11	2713	249	88	2801	0.6975
Amerzone: The Explorer's Legacy	2014-08-22	13	212	74	87	0.6973
TransOcean: The Shipping Company	2014-09-23	1304	830	317	1621	0.6968000000000001
The Guild Gold Edition	2014-09-09	173	341	124	297	0.6966
Carmageddon TDR 2000	2014-12-04	51	297	107	158	0.6966
Wildlife Park 2 - Horses	2014-07-17	31	57	17	48	0.6966
Woah Dave!	2014-10-30	26	85	27	53	0.6965000000000001
Cinemaware Anthology: 1986-1991	2014-11-14	25	85	27	52	0.6965000000000001
Stronghold Crusader 2	2014-09-22	5763	10219	4234	9997	0.6955
Shadow Puppeteer	2014-09-29	41	117	39	80	0.6954000000000001
Terrian Saga: KR-17	2014-07-09	812	199	70	882	0.6953
Vlad the Impaler	2014-07-16	100	297	108	208	0.6951
Xsyon - Prelude	2014-12-29	45	266	96	141	0.6950000000000001
Faery - Legends of Avalon	2014-06-16	217	502	189	406	0.6949
Raiden III Digital Edition	2014-09-24	26	258	93	119	0.6948000000000001
Toast Time	2014-08-27	96	59	18	114	0.6945
CONSORTIUM	2014-01-08	3180	1087	426	3606	0.6943
The Detail	2014-10-28	485	475	179	664	0.6942
The Old City: Leviathan	2014-12-03	51	504	191	242	0.6938
Toy Story 3	2014-10-06	212	805	313	525	0.6934
Alea Jacta Est	2014-11-04	35	86	28	63	0.6934
Thieves' Gambit: Curse of the Black Cat	2014-10-17	13	24	6	19	0.6933
NAM	2014-11-06	9	182	65	74	0.6918000000000001
Perpetuum	2014-10-17	291	534	206	497	0.6912999999999999
Kromaia	2014-10-23	68	82	27	95	0.691
Panzer Tactics HD	2014-05-22	77	145	51	128	0.6909000000000001
Eschalon: Book 3	2014-02-14	207	63	20	227	0.6908
McDROID	2014-09-05	102	142	50	152	0.6904000000000001
Gods Will Be Watching	2014-07-24	1082	1944	796	1878	0.6901999999999999
Marauder	2014-04-04	109	446	172	281	0.6897
A Golden Wake	2014-10-09	51	195	71	122	0.6897
Rogue's Tale	2014-03-28	190	450	174	364	0.6893000000000001
Sportsfriends	2014-12-19	19	46	14	33	0.6893000000000001
Supreme Ruler 1936	2014-05-09	276	202	74	350	0.6892
Bionic Heart	2014-08-13	75	89	30	105	0.6892
A.R.E.S. Extinction Agenda EX	2014-10-03	41	146	52	93	0.6890999999999999
Smooth Operators	2014-06-10	205	199	73	278	0.6888
Damned	2014-10-06	1038	2717	1134	2172	0.6884
Elliot Quest	2014-11-11	22	130	46	68	0.6884
Battle Mages	2014-05-30	1140	122	43	1183	0.688
Battle Of Europe	2014-09-18	5	17	4	9	0.6875
Disney Tangled	2014-10-06	21	77	26	47	0.6864
Jet Car Stunts	2014-05-01	21	118	42	63	0.6861
Haunted	2014-08-18	228	74	25	253	0.6856
Mercenary Kings	2014-03-25	846	1675	700	1546	0.6855
Melissa K. and the Heart of Gold Collector's Edition	2014-09-19	1630	525	211	1841	0.6840999999999999
Vanguard Princess	2014-03-03	674	2007	850	1524	0.684
Dream Tale	2014-12-16	3	25	7	10	0.6831
The Crew	2014-12-02	12236	10555	4701	16937	0.6813
Starpoint Gemini 2	2014-09-26	20842	2805	1219	22061	0.6809000000000001
1849	2014-05-08	131	252	99	230	0.6806
Major Stryker	2014-05-05	4	30	9	13	0.6805
Royal Quest	2014-08-06	1410	965	407	1817	0.6802
Fancy Skulls	2014-06-16	337	222	87	424	0.6796
Curse: The Eye of Isis	2014-08-22	7	106	39	46	0.6795
Miko Gakkou: Second Year	2014-11-13	4	13	3	7	0.6793000000000001
Retrobooster	2014-07-11	4	10	2	6	0.6793000000000001
Proxy Blade Zero	2014-07-28	10	118	44	54	0.6790999999999999
Probability 0	2014-06-13	22	48	16	38	0.6788
X-Plane 10 Global - 64 Bit	2014-07-14	439	717	303	742	0.6777
The Samaritan Paradox	2014-04-18	168	153	59	227	0.6776000000000001
Wrack	2014-09-30	1049	401	166	1215	0.6765000000000001
3089 -- Futuristic Action RPG	2014-01-10	877	386	160	1037	0.6759000000000001
My Ex-Boyfriend the Space Tyrant	2014-07-22	12	89	33	45	0.6756000000000001
Spate	2014-03-28	16	261	106	122	0.6755
Ionball 2 : Ionstorm	2014-06-06	826	460	193	1019	0.6754000000000001
Parkan 2	2014-04-16	446	226	91	537	0.6754000000000001
Roommates	2014-10-15	154	162	64	218	0.6745
The Curse of the Werewolves	2014-09-01	10	18	5	15	0.674
Wildlife Park 2	2014-07-17	214	350	146	360	0.6739
Gold Rush! Classic	2014-07-25	2165	258	106	2271	0.6734
MXGP - The Official Motocross Videogame Compact	2014-12-03	16	114	44	60	0.6734
Salammbo: Battle for Carthage	2014-05-30	5	56	20	25	0.6728000000000001
Hexus	2014-09-17	15	56	20	35	0.6728000000000001
Lost Marbles	2014-05-30	311	36	12	323	0.6725
Guns'N'Zombies	2014-10-30	599	668	292	891	0.6711
StarMade	2014-12-04	960	2016	914	1874	0.6709999999999999
GhostControl Inc.	2014-06-06	45	124	49	94	0.6709
Chompy Chomp Chomp	2014-05-16	2705	386	165	2870	0.6706000000000001
Viktor	2014-06-13	37	163	66	103	0.6706000000000001
El Matador	2014-04-03	15	301	127	142	0.6705
Zombie Solitaire	2014-07-03	153	107	42	195	0.6698999999999999
Dwarf Tower	2014-12-23	306	185	76	382	0.6697
The Incredible Adventures of Van Helsing II	2014-05-22	1714	1623	737	2451	0.6696
Foosball - Street Edition	2014-04-16	12	130	52	64	0.6696
A Wizard's Lizard	2014-06-16	376	306	130	506	0.6695000000000001
Battlepaths	2014-05-31	1819	592	260	2079	0.6693000000000001
Warlock 2: the Exiled	2014-04-10	984	807	359	1343	0.6692
Wild Warfare	2014-07-15	133	695	308	441	0.6688
Warface	2014-07-01	13867	54647	26447	40314	0.6681
Anarchy Arcade	2014-09-03	529	1526	699	1228	0.6676000000000001
War on Folvos	2014-08-08	229	80	31	260	0.6674
Paranautical Activity: Deluxe Atonement Edition	2014-10-20	305	975	441	746	0.6673
Trials Fusion	2014-04-24	2500	1455	667	3167	0.6672
Girls Like Robots	2014-02-14	203	183	77	280	0.6657
Luxuria Superbia	2014-01-28	21	176	74	95	0.6653
Doorways: The Underworld	2014-09-17	406	265	115	521	0.6644
Beware Planet Earth	2014-04-11	177	208	89	266	0.6643000000000001
ULTRAWORLD EXODUS	2014-12-05	20	53	20	40	0.6642
The Maker's Eden	2014-07-30	26	83	33	59	0.6641
Bound By Flame	2014-05-08	2639	2361	1114	3753	0.664
Sinking Island	2014-12-05	16	157	66	82	0.664
Warrior Kings	2014-04-24	15	76	30	45	0.6638
Memento Mori 2	2014-05-13	34	85	34	68	0.6636
Konung 3: Ties of the Dynasty	2014-04-03	20	69	27	47	0.6636
Celestial Command	2014-11-21	75	408	183	258	0.6625
Tex Murphy: Martian Memorandum	2014-06-12	6	36	13	19	0.6624
Paganitzu	2014-05-05	5	36	13	18	0.6624
SPACECOM	2014-09-17	1223	322	143	1366	0.6622
War in a Box: Paper Tanks	2014-07-04	43	137	58	101	0.6612
Blake Stone: Planet Strike	2014-05-05	4	33	12	16	0.6596
Strike Vector	2014-01-28	686	1520	728	1414	0.6589
Battlegrounds of Eldhelm	2014-10-22	172	146	63	235	0.6589
Shattered Planet	2014-07-03	209	421	194	403	0.6579
7 Wonders of the Ancient World	2014-02-18	26	117	50	76	0.6577
Nostradamus: The Last Prophecy	2014-04-24	36	134	58	94	0.6573000000000001
Alice in Wonderland	2014-10-06	31	155	68	99	0.6568
Armored Hunter GUNHOUND EX	2014-05-01	40	144	63	103	0.6564
Close Combat - Gateway to Caen	2014-06-06	254	298	137	391	0.6554000000000001
Echelon: Wind Warriors	2014-08-08	991	61	25	1016	0.6547
Bet On Soldier	2014-12-05	14	178	80	94	0.6543000000000001
Counter-Strike Nexon: Studio	2014-10-07	10007	27025	13877	23884	0.6542
Global Outbreak: Doomsday Edition	2014-08-11	1453	52	21	1474	0.6542
Baron Wittard	2014-04-24	5	8	2	7	0.6542
Volo Airsport	2014-12-04	14	129	57	71	0.6535
Darkness Within 2: The Dark Lineage Director's Cut Edition	2014-12-05	17	150	67	84	0.6534000000000001
Realms of Arkania 1 - Blade of Destiny Classic	2014-01-10	78	82	35	113	0.6531
Lara Croft and the Temple of Osiris	2014-12-08	3438	2543	1270	4708	0.653
Cherry Tree High I! My! Girls!	2014-11-20	132	116	51	183	0.653
Cars Toon: Mater's Tall Tales	2014-10-06	9	45	18	27	0.653
SunAge: Battle for Elysium	2014-12-15	38	109	48	86	0.6519
Fritz Chess 14	2014-06-04	42	75	32	74	0.6519
Trucks & Trailers	2014-06-04	37	333	157	194	0.6518
Volt	2014-04-14	792	274	128	920	0.6518
Reaper - Tale of a Pale Swordsman	2014-02-08	270	292	137	407	0.6515000000000001
GunZ 2: The Second Duel	2014-05-01	10441	7015	3592	14033	0.6514
Wildlife Park 2 - Marine World	2014-07-17	27	29	11	38	0.6514
Dragon Nest Europe	2014-01-09	2028	2854	1442	3470	0.6511
Sky Mercenaries	2014-12-16	772	81	35	807	0.6509999999999999
Cavern Kings	2014-09-30	653	150	68	721	0.6509
The Dungeoning	2014-05-02	38	53	22	60	0.6506000000000001
Bot Colony	2014-06-16	7	68	29	36	0.6505
Squirt's Adventure	2014-03-05	46	15	5	51	0.65
Pyrite Heart	2014-09-25	27	194	90	117	0.6497
Bridge Constructor Playground	2014-07-02	59	159	73	132	0.6494
The Princess and The Frog	2014-10-06	9	33	13	22	0.6492
Merchants of Kaidan	2014-11-10	1716	330	158	1874	0.6489
GoD Factory: Wingmen	2014-08-29	731	201	94	825	0.6487
Point Perfect	2014-07-17	165	142	65	230	0.6487
Wildlife Park 2 - Farm World	2014-07-17	23	24	9	32	0.6487
Trainz Trouble	2014-08-26	7	35	14	21	0.6483
Infinity Runner	2014-07-14	131	88	39	170	0.6481
Qora	2014-10-02	288	322	155	443	0.6476999999999999
Windforge	2014-03-11	212	399	194	406	0.6476000000000001
Passing Pineview Forest	2014-11-21	77	1108	559	636	0.647
The Treasures of Montezuma 3	2014-10-17	428	265	127	555	0.6469
Brigade E5: New Jagged Union	2014-04-30	20	77	34	54	0.6469
Blade Symphony	2014-05-07	3155	3113	1616	4771	0.6459
ACE - Arena: Cyber Evolution	2014-08-18	288	711	357	645	0.6454000000000001
The Hat Man: Shadow Ward	2014-09-18	699	2235	1160	1859	0.6446
Fat Chicken	2014-12-04	95	32	13	108	0.6444
Runaway Express Mystery	2014-09-23	8	34	14	22	0.6437999999999999
KickBeat Steam Edition	2014-01-20	376	507	254	630	0.6437
Devil's Dare	2014-10-21	76	104	48	124	0.6437
The Sacred Tears TRUE	2014-09-25	81	55	24	105	0.6437
Growing Pains	2014-05-28	7	21	8	15	0.6436000000000001
Unrest	2014-07-23	406	130	61	467	0.6435
Magnetic By Nature	2014-11-11	56	57	25	81	0.6435
Pixel Piracy	2014-07-31	2176	4719	2502	4678	0.6429
MIND Path to Thalamus E.Edition	2014-08-05	301	905	464	765	0.6428
Redline	2014-10-23	5	67	30	35	0.6428
Wildlife Park 2 - Crazy Zoo	2014-07-17	17	38	16	33	0.6426999999999999
Nicole	2014-07-25	60	81	37	97	0.6422
Enemy Front	2014-06-10	613	3276	1734	2347	0.6421
Call of Cthulhu: The Wasted Land	2014-03-06	111	131	62	173	0.6421
Schrödinger's Cat and the Raiders of the Lost Quark	2014-09-23	139	85	39	178	0.6421
Sinister City	2014-10-20	900	1010	522	1422	0.6418
The Book of Legends	2014-03-14	111	182	88	199	0.6418
Deadlock II - Shrine Wars	2014-10-23	12	44	19	31	0.6417
Cold War	2014-01-08	23	168	81	104	0.6416
Pixel Boy and the Ever Expanding Dungeon	2014-05-30	94	158	76	170	0.6413
See No Evil	2014-08-26	1102	237	117	1219	0.6406000000000001
Enola	2014-09-18	65	104	49	114	0.6403
Flower Shop: Summer In Fairbrook	2014-05-16	138	86	40	178	0.6401000000000001
Space Warp	2014-11-04	15	29	12	27	0.64
Guns and Robots	2014-08-04	1060	1117	585	1645	0.6396000000000001
Paper Monsters Recut	2014-10-23	4	31	13	17	0.6395000000000001
Empress Of The Deep	2014-05-08	17	97	46	63	0.6384000000000001
White Noise Online	2014-05-22	259	448	230	489	0.6382
Pro Cycling Manager 2014	2014-06-19	1198	178	88	1286	0.6377
Word Rescue	2014-05-05	6	49	22	28	0.6377
TinyKeep	2014-09-29	133	271	137	270	0.6373
Epigenesis	2014-08-01	799	750	394	1193	0.6369
Ultionus: A Tale of Petty Revenge	2014-02-25	141	211	106	247	0.6364
Elminage Gothic	2014-09-18	179	125	61	240	0.6364
Over The Void	2014-11-11	87	109	53	140	0.6355
Science Girls	2014-03-21	50	103	50	100	0.6352000000000001
Descent 3	2014-04-15	10	58	27	37	0.6346
Rooks Keep	2014-12-05	132	58	27	159	0.6346
Tex Murphy: Mean Streets	2014-06-12	17	56	26	43	0.6346
Depths of Fear :: Knossos	2014-04-24	92	280	144	236	0.6344
Castle: Never Judge a Book by its Cover	2014-06-09	29	114	56	85	0.6343
Save the Furries	2014-10-10	4	32	14	18	0.6343
Claire	2014-07-07	81	255	131	212	0.6339
Aveyond 3-1: Lord of Twilight	2014-02-07	54	100	49	103	0.6333
Crystals of Time	2014-06-13	1157	661	355	1512	0.6319
Call of Duty: Advanced Warfare	2014-11-03	12675	15272	8667	21342	0.6313000000000001
Explodemon	2014-03-25	16	68	33	49	0.6302000000000001
Haegemonia: The Solon Heritage	2014-05-01	33	68	33	66	0.6302000000000001
Zoo Rampage	2014-07-09	45	85	42	87	0.63
Robot Rescue Revolution	2014-07-11	162	39	18	180	0.63
Train Fever	2014-09-04	3406	2199	1227	4633	0.6296
Third Eye Crime	2014-07-23	6	33	15	21	0.6294
FaeVerse Alchemy	2014-04-02	4593	216	113	4706	0.6292
School Bus Fun	2014-07-03	104	60	29	133	0.6292
Viking Brothers	2014-04-23	22	31	14	36	0.6292
Mystic Towers	2014-05-05	6	31	14	20	0.6292
Perimeter: Emperor's Testament	2014-05-22	12	27	12	24	0.629
Derrick the Deathfin	2014-06-16	8	19	8	16	0.629
Fairy Tale About Father Frost, Ivan and Nastya	2014-04-30	8	75	37	45	0.6288
Noir Syndrome	2014-06-04	181	116	59	240	0.6285000000000001
YAIBA: NINJA GAIDEN Z	2014-03-21	121	522	285	406	0.6273
Stonerid	2014-08-15	985	128	66	1051	0.6271
Platformines	2014-03-28	248	206	109	357	0.6267
Deadnaut	2014-12-09	60	100	51	111	0.6265
Deep Under the Sky	2014-08-22	14	38	18	32	0.6257
KRUNCH	2014-03-19	222	34	16	238	0.6249
Riding Star	2014-03-27	14	64	32	46	0.6246
Ilamentia	2014-11-25	96	64	32	128	0.6246
Prophour23	2014-10-22	27	49	24	51	0.6244
Real Boxing™	2014-07-02	153	826	464	617	0.6241
Particulars	2014-11-19	154	60	30	184	0.6238
Rise of Prussia Gold	2014-05-07	16	28	13	29	0.6235
Amazing Princess Sarah	2014-08-18	43	136	72	115	0.623
Fading Hearts	2014-02-06	175	127	67	242	0.623
The Golf Club	2014-08-19	215	701	395	610	0.6226
Spice Road	2014-04-24	73	41	20	93	0.6224000000000001
Cheesecake Cool Conrad	2014-10-08	4	22	10	14	0.6221
Three Dead Zed	2014-07-07	418	110	58	476	0.6217
Hazard Ops	2014-10-08	1578	917	523	2101	0.6215
Elegy For A Dead World	2014-12-10	48	195	106	154	0.6213000000000001
Rime Berta	2014-12-16	182	90	47	229	0.6213000000000001
UFO: Afterlight	2014-01-06	187	300	167	354	0.62
Grimind	2014-02-13	1838	176	96	1934	0.6199
Scourge: Outbreak	2014-04-02	157	353	198	355	0.6196
Only If	2014-07-25	713	3749	2212	2925	0.6195
Crazy Chicken Tales	2014-09-30	4	31	15	19	0.6193
Pineview Drive	2014-07-31	66	373	210	276	0.6192000000000001
Poltergeist: A Pixelated Horror	2014-10-21	17	29	14	31	0.6186
Deep Eclipse	2014-10-28	2324	101	54	2378	0.6185
Dogs of War Online - Beta	2014-02-04	995	443	252	1247	0.6183
Flower Shop: Winter In Fairbrook	2014-07-31	62	67	35	97	0.618
Gates of Horizon	2014-12-18	97	67	35	132	0.618
Haegemonia: Legions of Iron	2014-05-01	22	49	25	47	0.618
IGT Slots Paradise Garden	2014-09-17	17	86	46	63	0.6168
Chronicles of a Dark Lord: Episode 1 Tides of Fate Complete	2014-12-19	531	63	33	564	0.6168
My Best Friends - Cats & Dogs	2014-03-27	5	36	18	23	0.6168
Mythos: The Beginning	2014-10-27	69	45	23	92	0.6165
Demon Hunter: Chronicles from Beyond	2014-12-04	119	301	171	290	0.6161
Frayed Knights: The Skull of S'makh-Daon	2014-07-24	23	23	11	34	0.616
Freddi Fish and Luther's Water Worries	2014-05-01	6	34	17	23	0.6159
Frozen Synapse Prime	2014-11-14	226	214	121	347	0.6147
Return to Mysterious Island 2	2014-03-06	28	109	60	88	0.6141
Abyss Odyssey	2014-07-15	928	1535	918	1846	0.6138
Ampu-Tea	2014-05-30	2037	1276	762	2799	0.6134000000000001
My Vet Practice: In the Country	2014-03-27	6	17	8	14	0.6125
GAUGE	2014-05-23	14	154	87	101	0.6124
Clash of Puppets	2014-12-16	141	42	22	163	0.6118
NEStalgia	2014-04-15	451	229	132	583	0.6115
Rock Zombie	2014-11-20	18	33	17	35	0.611
Numba Deluxe	2014-05-23	82	168	96	178	0.6109
The Great Jitters: Pudding Panic	2014-05-22	13	47	25	38	0.6108
Super Killer Hornet: Resurrection	2014-02-06	1674	501	297	1971	0.6107
Rush for Glory	2014-06-17	12	90	50	62	0.6107
International Snooker	2014-05-30	79	379	224	303	0.6098
Dark Lore Mysteries: The Hunt For Truth	2014-04-08	8	45	24	32	0.6098
Blackguards	2014-01-22	2360	2186	1341	3701	0.6095
Data Hacker: Initiation	2014-07-21	14518	145	83	14601	0.6095
To End All Wars	2014-08-29	125	113	64	189	0.6093000000000001
Pandora: First Contact	2014-05-30	295	377	224	519	0.6088
Aveyond 3-2: Gates of Night	2014-04-18	61	72	40	101	0.6084
Rabbit Hole 3D: Steam Edition	2014-04-26	231	198	116	347	0.6075
Shadow Warrior (Classic)	2014-05-05	4	20	10	14	0.6074
Mars Colony: Challenger	2014-03-04	95	78	44	139	0.6066
Adventure Chronicles: The Search For Lost Treasure	2014-04-29	11	56	31	42	0.6063000000000001
Sign Motion	2014-10-24	16	56	31	47	0.6063000000000001
Black Rainbow	2014-04-30	9	32	17	26	0.6059
Millennium 5 - The Battle of the Millennium	2014-11-07	482	32	17	499	0.6059
ReignMaker	2014-04-16	2070	219	130	2200	0.6056
A Vampyre Story	2014-07-15	11	99	57	68	0.6052000000000001
Global ATC Simulator	2014-11-10	43	74	42	85	0.605
Magical Battle Festa	2014-11-21	117	231	138	255	0.6048
Crash And Burn Racing	2014-12-09	8	30	16	24	0.6043999999999999
PAC-MAN MUSEUM	2014-02-25	33	170	101	134	0.6038
99 Levels To Hell	2014-02-19	164	366	224	388	0.6027
Kill The Bad Guy	2014-05-28	83	215	130	213	0.6020000000000001
Mirror Mysteries 2: Forgotten Kingdoms	2014-04-10	12	51	29	41	0.6009000000000001
Train Town	2014-08-26	8	46	26	34	0.6007
Rooster Teeth vs. Zombiens	2014-12-19	14	36	20	34	0.6006
Heldric - The legend of the shoemaker	2014-04-17	197	31	17	214	0.6006
Overcast - Walden and the Werewolf	2014-04-18	6084	1719	1103	7187	0.5992000000000001
World of Subways 1 – The Path	2014-11-05	11	68	40	51	0.5981000000000001
Wildlife Park 2 - Dino World	2014-07-17	46	45	26	72	0.5969
Rhiannon: Curse of the Four Branches	2014-05-15	11	85	51	62	0.5966
Fritz for Fun 13	2014-12-10	11	22	12	23	0.5966
BloodRayne: Betrayal (Legacy)	2014-04-30	215	534	341	556	0.5959000000000001
Alpha Zylon	2014-07-15	5	102	62	67	0.5957
The Forgotten Ones	2014-07-17	214	966	625	839	0.5955
Lords Of The Fallen	2014-10-28	8024	11081	7379	15403	0.5951
DIG IT! - A Digger Simulator	2014-10-15	140	122	75	215	0.595
Q*bert: Rebooted	2014-07-08	23	103	63	86	0.5947
Karos	2014-12-24	565	390	249	814	0.5946
Victim of Xen	2014-05-21	986	268	170	1156	0.594
Ethan: Meteor Hunter	2014-02-07	82	143	89	171	0.5938
Nicolas Eymerich The Inquisitor	2014-04-30	16	60	36	52	0.5935
Villagers and Heroes	2014-04-17	2964	1947	1287	4251	0.5931000000000001
Iron Storm	2014-05-08	6	85	52	58	0.5931000000000001
Platypus II	2014-08-15	1687	349	225	1912	0.5921000000000001
Adventurer Manager	2014-12-04	1100	339	219	1319	0.5915
Magnifico	2014-12-02	838	95	59	897	0.5913
Silent Service	2014-11-06	3	18	10	13	0.5910000000000001
Velvet Sundown	2014-07-22	380	1088	721	1101	0.5908
Minimum	2014-09-10	1960	2429	1629	3589	0.5905
Silent Service 2	2014-11-06	12	37	22	34	0.5901
Captain Morgane and the Golden Turtle	2014-01-03	124	105	66	190	0.5898
Soulbringer	2014-03-13	25	140	89	114	0.5897
Firefighters 2014	2014-05-21	230	343	224	454	0.5894
My Riding Stables	2014-03-28	8	32	19	27	0.5887
FIST OF AWESOME	2014-07-04	39	210	136	175	0.5886
Heileen 3: New Horizons	2014-07-17	121	46	28	149	0.5885
Abalone	2014-04-23	109	92	58	167	0.5883
Hunters Of The Dead	2014-09-04	267	92	58	325	0.5883
Ninja Cats vs Samurai Dogs	2014-02-21	45	24	14	59	0.5879
Lost Saga North America	2014-11-26	470	416	275	745	0.5878
Humans Must Answer	2014-01-16	27	38	23	50	0.5875
The Stalin Subway	2014-09-19	458	350	231	689	0.5872999999999999
Legions of Ashworld	2014-07-04	23	27	16	39	0.5870000000000001
Ihf Handball Challenge 12	2014-03-21	25	47	29	54	0.5864
Sentinel	2014-04-22	18	50	31	49	0.5861999999999999
Sid Meier's Civilization: Beyond Earth	2014-10-24	86892	12685	8803	95695	0.5858
Dead Bits	2014-06-07	14137	4999	3454	17591	0.5854
Shiny The Firefly	2014-05-16	98	68	43	141	0.5854
Star Traders: 4X Empires	2014-12-17	68	42	26	94	0.5848
Hegemony Rome: The Rise of Caesar	2014-05-15	250	262	174	424	0.5847
Star Nomad	2014-12-29	521	28	17	538	0.5836
Secrets of Rætikon	2014-04-17	84	278	186	270	0.5835
Time Mysteries 2: The Ancient Spectres	2014-07-31	76	320	215	291	0.5833
Man in a Maze: Deathmatch	2014-10-17	6	6	3	9	0.5833
Borealis	2014-09-02	332	298	200	532	0.5832
3 Stars of Destiny	2014-03-28	461	131	86	547	0.5832
HTR+ Slot Car Simulation	2014-05-29	8	34	21	29	0.583
Railroad Pioneer	2014-07-02	84	144	95	179	0.5828
Eidolon	2014-08-01	57	249	167	224	0.5825
Evil Pumpkin: The Lost Halloween	2014-07-11	188	55	35	223	0.5825
FINAL FANTASY XIII-2	2014-12-11	1883	2823	1971	3854	0.5819
School of Dragons: How to Train Your Dragon	2014-12-04	2033	3057	2138	4171	0.5817
Always Remember Me	2014-04-18	75	159	106	181	0.5814
Depression Quest	2014-08-12	515	2295	1604	2119	0.5813
Shadows: Heretic Kingdoms	2014-11-20	106	254	172	278	0.5807
The Cameron Files: The Secret at Loch Ness	2014-07-18	8	44	28	36	0.5806
Bombing Bastards	2014-12-04	14	72	47	61	0.5802
BLOCKADE 3D	2014-12-19	6968	15389	11010	17978	0.5791
POP: Methodology Experiment One	2014-12-10	25	51	33	58	0.579
1Heart	2014-10-13	54	106	71	125	0.5781000000000001
Residue: Final Cut	2014-08-01	45	62	41	86	0.5768
Clans	2014-03-13	14	79	53	67	0.5759000000000001
Fiesta Online NA	2014-05-20	117	397	278	395	0.5758
SPY Fox in: Cheese Chase	2014-05-29	6	34	22	28	0.5754
Cube & Star: An Arbitrary Love	2014-02-14	25	83	56	81	0.5752
Fall of the New Age Premium Edition	2014-07-25	15	97	66	81	0.5746
Top Hat	2014-07-31	7	38	25	32	0.5737
Cricket Captain 2014	2014-08-08	258	35	23	281	0.5731
Prime World	2014-03-31	2912	2203	1600	4512	0.5727000000000001
Rex Nebular and the Cosmic Gender Bender	2014-10-17	3	26	17	20	0.5712
Skara - The Blade Remains	2014-10-27	522	369	264	786	0.5710000000000001
Al Emmo and the Lost Dutchman's Mine	2014-05-09	74	36	24	98	0.5710000000000001
Rambo The Video Game	2014-02-21	78	330	236	314	0.5707
Dracula 4 and 5 - Special Steam Edition	2014-05-29	37	78	54	91	0.5700999999999999
Horizon	2014-02-06	618	265	190	808	0.5694
Planet Stronghold	2014-05-05	130	61	42	172	0.5694
Transport Giant	2014-09-05	99	232	166	265	0.5692
Season Match 2	2014-10-10	479	62	43	522	0.5683
CubeGun	2014-05-21	37	183	131	168	0.5681
Wildlife Park 3	2014-05-12	303	289	209	512	0.5679
Alpha Kimori™ Episode One 	2014-03-17	223	128	91	314	0.5678
Ship Simulator: Maritime Search and Rescue	2014-07-01	117	95	67	184	0.5678
Power-Up	2014-08-29	1251	149	107	1358	0.5666
Last Inua	2014-12-11	92	157	113	205	0.5664
Fiesta Online	2014-04-28	135	292	213	348	0.5662
Crab Cakes Rescue	2014-11-14	723	46	32	755	0.5657
Experience 112	2014-10-24	32	57	40	72	0.5656
Super Toy Cars	2014-06-06	57	220	161	218	0.5645
Fireworks Simulator	2014-11-26	74	146	106	180	0.5644
Light	2014-07-14	41	197	144	185	0.5643
Bliss	2014-12-09	5	29	20	25	0.5636
Redux: Dark Matters	2014-12-12	6	22	15	21	0.5629
7th Legion	2014-10-23	6	48	34	40	0.5628000000000001
Zoo Park	2014-06-13	48	170	125	173	0.5625
Pirates! Gold Plus (Classic)	2014-10-09	12	52	37	49	0.5625
Munich Bus Simulator	2014-04-07	23	168	124	147	0.5617
Monuments of Mars	2014-05-05	3	19	13	16	0.561
Lichdom: Battlemage	2014-08-26	868	1626	1243	2111	0.5607
Pure Pool	2014-07-31	122	317	238	360	0.5606
Smugglers 5	2014-04-11	278	87	64	342	0.5594
Holy Avatar vs. Maidens of the Dead	2014-02-20	32	83	61	93	0.5593
Rocko's Quest	2014-04-24	4	35	25	29	0.5592
Task Force 1942: Surface Naval Action in the South Pacific	2014-11-06	6	16	11	17	0.5586
Wings Over Europe	2014-05-30	7	64	47	54	0.5581
theHunter Classic	2014-06-03	3984	21838	17228	21212	0.5566
Pe-2: Dive Bomber	2014-08-06	12	9	6	18	0.5566
AR-K	2014-07-21	129	269	206	335	0.556
Dark Horizons: Mechanized Corps	2014-07-22	11	37	27	38	0.5559000000000001
Quantum Rush Champions	2014-12-04	631	93	70	701	0.5554
Flashout 2	2014-06-06	32	126	96	128	0.5543
Warhammer 40,000: Kill Team	2014-05-22	307	594	464	771	0.5539000000000001
Pitiri 1977	2014-11-07	65	65	49	114	0.5534
Heroes & Legends: Conquerors of Kolhar	2014-08-21	121	52	39	160	0.5531
StuntMANIA Reloaded	2014-11-14	30	61	46	76	0.5529999999999999
Drifter	2014-03-04	47	114	88	135	0.5514
Continue?9876543210	2014-01-03	14	97	75	89	0.5504
Pulstar	2014-06-11	90	64	49	139	0.5504
The Egyptian Prophecy: The Fate of Ramses	2014-06-06	18	64	49	67	0.5504
Rugby Union Team Manager 2015	2014-12-03	74	46	35	109	0.5499
Super Chain Crusher Horizon	2014-09-22	507	19	14	521	0.5496
Gold Rush! Anniversary	2014-11-07	629	105	82	711	0.5488000000000001
Shadowcrypt	2014-09-15	27	62	48	75	0.5482
Asteria	2014-07-04	174	132	104	278	0.5479
A City Sleeps	2014-10-16	112	53	41	153	0.5476
Dwelvers	2014-09-11	79	144	114	193	0.5472
Meadowland	2014-10-23	76	39	30	106	0.5471
Concursion	2014-06-06	66	44	34	100	0.5468999999999999
Heavy Fire: Afghanistan	2014-08-15	297	186	149	446	0.5456000000000001
Blackbay Asylum	2014-08-01	1115	301	243	1358	0.5453
Gods vs Humans	2014-10-10	81	61	48	129	0.5451
CT Special Forces: Fire for Effect	2014-03-13	39	136	109	148	0.5446
Arctic Adventure	2014-05-05	4	27	21	25	0.5431
Across the Rhine	2014-11-06	5	17	13	18	0.543
The Abbey	2014-07-15	6	33	26	32	0.542
Pier Solar and the Great Architects	2014-09-30	62	66	53	115	0.5417000000000001
Escape The Lost Kingdom: The Forgotten Pharaoh	2014-04-29	10	44	35	45	0.5417000000000001
Dark Ages	2014-05-05	3	18	14	17	0.5407000000000001
Arcadecraft	2014-05-22	19	80	65	84	0.5402
Run For Rum	2014-07-02	3	8	6	9	0.5398
Roaming Fortress	2014-11-20	13	8	6	19	0.5398
Pajama Sam's Lost & Found	2014-06-06	7	19	15	22	0.5387
Toy Story Mania	2014-10-06	7	25	20	27	0.538
Majestic Nights	2014-10-30	36	61	50	86	0.5376
Frontline : Road to Moscow	2014-08-08	49	32	26	75	0.5366
Nanofights	2014-12-11	20	288	243	263	0.536
My Pet Hotel 2	2014-03-27	5	9	7	12	0.5359
Metrocide	2014-12-15	111	91	76	187	0.5353
Legionwood 2: Rise of the Eternal's Realm	2014-05-16	22	27	22	44	0.5353
Putt-Putt: Pep's Birthday Surprise	2014-06-06	10	46	38	48	0.5351
Incoming Forces	2014-03-06	1530	174	147	1677	0.5347
Desert Ashes	2014-11-10	71	41	34	105	0.534
RADical ROACH Remastered	2014-05-16	6170	578	495	6665	0.5339
Lantern Forge	2014-07-18	274	152	129	403	0.5334000000000001
Robin's Island Adventure	2014-09-17	10	29	24	34	0.533
White Haven Mysteries	2014-04-17	22	50	42	64	0.5324
Hack 'n' Slash	2014-09-09	373	452	391	764	0.5314
Heileen 2: The Hands Of Fate	2014-06-11	110	25	21	131	0.5297999999999999
Heileen 1: Sail Away	2014-06-06	72	64	55	127	0.5289
Assassin's Creed Liberation	2014-01-15	1174	1338	1184	2358	0.5276
Unearthed: Trail of Ibn Battuta - Episode 1 - Gold Edition	2014-01-03	53	431	380	433	0.5273
Antisquad	2014-05-22	457	154	135	592	0.5269
QuestRun	2014-04-18	1968	429	379	2347	0.5268
Millionaire Manor	2014-05-15	27	45	39	66	0.5263
Coma: Mortuary	2014-05-12	2057	478	424	2481	0.5261
The Repopulation	2014-12-22	497	605	538	1035	0.5258
1Quest	2014-12-03	269	90	79	348	0.5256000000000001
Gunspell: Steam Edition	2014-11-07	230	174	154	384	0.5252
Time of Fury	2014-07-18	39	22	19	58	0.5246999999999999
Bionic Heart 2	2014-09-22	66	22	19	85	0.5246999999999999
Guilty Gear Isuka	2014-01-16	195	229	204	399	0.5242
Where Angels Cry	2014-02-27	14	59	52	66	0.5239
Appointment With FEAR	2014-08-27	82	52	46	128	0.5229
Smugglers 5: Invasion	2014-10-16	12	16	14	26	0.5215
MotoGP™14	2014-06-20	151	272	246	397	0.5213
Z Steel Soldiers	2014-08-01	683	122	111	794	0.519
Pirate Hell	2014-11-07	5	8	7	12	0.5189
Freight Tycoon Inc.	2014-04-03	114	221	202	316	0.5188
Sweet Lily Dreams	2014-05-17	111	76	69	180	0.5188
Lost Civilization	2014-04-15	13	65	59	72	0.5185000000000001
Jamsouls	2014-08-21	821	31	28	849	0.518
Catmouth Island	2014-12-31	169	43	39	208	0.5179
Biglands: A Game Made By Kids	2014-08-25	5	32	29	34	0.5175
The Labyrinth of Time	2014-11-26	2	9	8	10	0.5171
Kingdom Tales 2	2014-08-06	9	9	8	17	0.5171
Neocolonialism	2014-12-01	8	22	20	28	0.5161
DRAKERZ-Confrontation	2014-05-19	424	133	123	547	0.5159
DarkEnd	2014-10-17	1844	178	165	2009	0.5157
World of Diving	2014-08-26	78	375	350	428	0.5149
Scooby-Doo! & Looney Tunes Cartoon Universe: Adventure	2014-07-16	25	24	22	47	0.5149
Disney Fairies: Tinker Bell's Adventure	2014-10-06	19	25	23	42	0.5144
Team Indie	2014-10-08	36	57	53	89	0.5138
Kingdom Tales	2014-02-13	27	27	25	52	0.5134000000000001
Rage Runner	2014-05-16	97	27	25	122	0.5134000000000001
Roadside Assistance Simulator	2014-09-25	29	45	42	71	0.5128
Alien Carnage / Halloween Harry	2014-05-05	7	29	27	34	0.5126
Cobi Treasure Deluxe	2014-05-23	35	189	178	213	0.5125
Evolution RTS	2014-04-07	304	193	182	486	0.5122
Kingdom Elemental	2014-05-02	8	14	13	21	0.5117
Exodus	2014-07-11	13	14	13	26	0.5117
Project Root	2014-05-01	18	57	54	72	0.5102
Crunch Time!	2014-12-31	10	39	37	47	0.5096
The Nightmare Cooperative	2014-07-16	55	62	59	114	0.5095000000000001
Steam Marines	2014-09-24	557	166	159	716	0.5089
The Few	2014-06-18	227	95	91	318	0.5085000000000001
Tex Murphy: Overseer	2014-06-12	6	22	21	27	0.5079
Super Lemonade Factory	2014-07-09	275	22	21	296	0.5079
The Good Life	2014-11-21	52	81	78	130	0.5074000000000001
BloodNet	2014-10-17	5	24	23	28	0.5073
Cubesis	2014-08-22	10	25	24	34	0.5071
Commando Jack	2014-08-22	1363	280	272	1635	0.5062
Orc Attack: Flatulent Rebellion	2014-05-15	9	34	33	42	0.5054
Alcatraz Builder	2014-10-24	7	35	34	41	0.5052000000000001
BIT.TRIP FLUX	2014-06-05	25	79	77	102	0.505
Daylight	2014-04-29	1444	783	768	2212	0.5043
The Waste Land	2014-09-16	41	48	47	88	0.5039
Aggression: Europe Under Fire	2014-04-09	26	53	52	78	0.5036
NS2: Combat	2014-10-31	144	127	126	270	0.5015999999999999
Dungeon Defenders Eternity	2014-07-22	4708	796	796	5504	0.5
Darkwind: War on Wheels	2014-08-22	159	230	230	389	0.5
Rulers of Nations	2014-07-16	43	82	82	125	0.5
300 Dwarves	2014-06-05	9	37	37	46	0.5
Obludia	2014-07-18	367	35	35	402	0.5
Into Blue Valley	2014-12-24	5	30	30	35	0.5
Demonlisher	2014-09-16	2	13	13	15	0.5
Sharpe Investigations: Death on the Seine	2014-07-15	13	11	11	24	0.5
Tail Drift	2014-10-30	3	9	9	12	0.5
Bounders and Cads	2014-07-08	7	4	4	11	0.5
LEVEL UP!	2014-11-24	2	2	2	4	0.5
SpellForce 2 - Demons of the Past	2014-01-16	232	143	144	376	0.4986
Divine Souls	2014-11-20	307	441	444	751	0.4985
Cult of the Wind	2014-07-01	117	217	219	336	0.49810000000000004
The Tomorrow War	2014-04-03	144	50	51	195	0.4963
Blood II: The Chosen + Expansion	2014-07-14	28	222	226	254	0.4962
Whisper of a Rose	2014-11-14	165	44	45	210	0.4958
Galactic Arms Race	2014-06-05	237	40	41	278	0.4955
Let's Sing	2014-02-13	13	74	76	89	0.49479999999999996
The Castle Doctrine	2014-01-29	345	185	190	535	0.49450000000000005
Zero Point	2014-10-28	20	30	31	51	0.49420000000000003
Pressured	2014-07-18	1710	270	278	1988	0.4938
Speed Kills	2014-05-16	1381	200	207	1588	0.4928
The Sun at Night	2014-08-01	209	20	21	230	0.4918
Steam Bandits: Outpost	2014-01-14	32	35	37	69	0.48990000000000006
Pro Wrestling X	2014-11-18	8	128	135	143	0.4892
Akane the Kunoichi	2014-05-02	174	358	377	551	0.4888
Stained	2014-07-10	9	13	14	23	0.4883
Eterium	2014-04-15	42	45	48	90	0.488
Arcane Worlds	2014-01-28	18	110	117	135	0.4876
Data Hacker: Corruption	2014-10-22	20258	59	63	20321	0.4875
New York Bus Simulator	2014-08-06	8	43	46	54	0.4875
A-men	2014-01-24	54	26	28	82	0.48700000000000004
Wildlife Park 2 - Fantasy	2014-07-17	34	38	41	75	0.48610000000000003
KEL Reaper of Entropy	2014-11-18	22	23	25	47	0.48560000000000003
Battleplan: American Civil War	2014-07-04	2051	141	152	2203	0.48460000000000003
Taxi	2014-08-22	147	167	180	327	0.48450000000000004
I Will Escape	2014-12-22	6	8	9	15	0.4829
The Stalin Subway: Red Veil	2014-10-24	410	250	273	683	0.4814
IHF Handball Challenge 14	2014-03-28	32	27	30	62	0.4814
RECYCLE	2014-09-03	121	134	147	268	0.4811
Pharaoh's Tomb	2014-05-05	3	16	18	21	0.4807
Hell	2014-11-13	30	25	28	58	0.4802
ZAMB! Biomutant Extermination	2014-06-20	20	15	17	37	0.4797
Storm over the Pacific	2014-06-13	10	15	17	27	0.4797
Dungeon of Elements	2014-06-12	4157	113	125	4282	0.4796
Railroad X	2014-06-09	12	23	26	38	0.47880000000000006
QUALIA 3: Multi Agent	2014-04-18	7	22	25	32	0.478
Long Night	2014-07-07	14	39	44	58	0.4778
Jane Angel: Templar Mystery	2014-09-17	12	30	34	46	0.47759999999999997
Gunship!	2014-07-11	5	38	43	48	0.4773
Vault Cracker	2014-05-15	9	21	24	33	0.4772
Moonlight Minions	2014-10-22	10	21	24	34	0.4772
Enforcer: Police Crime Action	2014-10-24	2231	1093	1212	3443	0.4767
Meridian: New World	2014-09-26	473	237	265	738	0.4764
Spirited Heart Deluxe	2014-05-29	38	36	41	79	0.47630000000000006
I Am Vegend	2014-05-22	10	36	41	51	0.47630000000000006
Dusk 12	2014-08-22	995	86	97	1092	0.47619999999999996
Yury	2014-12-09	3007	233	261	3268	0.47600000000000003
Maszyny Rolnicze 2015	2014-12-02	238	100	113	351	0.4756
Chess 2: The Sequel	2014-08-19	25	50	57	82	0.4753
Dracula: The Resurrection	2014-04-17	150	202	228	378	0.4746
Dungeons: The Eye of Draconus	2014-08-12	2840	91	104	2944	0.47350000000000003
Rhythm Destruction	2014-06-16	532	61	70	602	0.47350000000000003
The World II: Hunting BOSS	2014-11-07	6	29	34	40	0.4717
Jagged Alliance Flashback	2014-10-21	274	349	401	675	0.47009999999999996
Litil Divil	2014-03-19	50	201	232	282	0.47000000000000003
Club Manager 2015	2014-12-04	71	46	54	125	0.47000000000000003
Echelon	2014-07-03	958	62	73	1031	0.4685
Airship Dragoon	2014-08-26	159	25	30	189	0.4681
Blockscape	2014-07-03	88	412	479	567	0.4673
D.W.A.R.F.S.	2014-03-20	5	8	10	15	0.4673
Blast Em!	2014-01-23	12	136	160	172	0.4668
Final Rush	2014-11-21	132	68	81	213	0.466
The Entente Gold	2014-06-16	601	282	331	932	0.4658
The Blue Flamingo	2014-11-18	1203	281	330	1533	0.4657
LUDWIG	2014-06-06	25	28	34	59	0.46549999999999997
Kill Fun Yeah	2014-05-30	21	38	46	67	0.46490000000000004
Shannon Tweed's Attack Of The Groupies	2014-04-01	4	21	26	30	0.46340000000000003
Organic Panic	2014-05-14	26	11	14	40	0.4625
Swipecart	2014-05-08	448	242	290	738	0.4617
Direct Hit: Missile War	2014-08-07	35	10	13	48	0.4598
Probably Archery	2014-02-06	76	174	212	288	0.459
Desert Gunner	2014-03-18	6	30	38	44	0.4576
Pixel Hunter	2014-07-17	21	91	113	134	0.4569
One Day For Ched	2014-09-12	2095	139	172	2267	0.45640000000000003
Magic 2015	2014-07-16	14071	1829	2216	16287	0.4561
Racer 8	2014-06-06	1357	599	733	2090	0.45549999999999996
Canyon Capers	2014-04-25	1595	856	1051	2646	0.45409999999999995
Masters of the World	2014-02-05	85	261	324	409	0.45409999999999995
Redneck Racers	2014-04-28	13	27	35	48	0.454
Moto Racer Collection	2014-10-02	3	50	64	67	0.4533
Robowars	2014-10-24	1310	126	159	1469	0.45270000000000005
Claustrophobia: The Downward Struggle	2014-09-09	34	89	113	147	0.4526
Metaverse	2014-09-30	12	33	43	55	0.452
Ancient Space	2014-09-23	283	152	192	475	0.45189999999999997
Into the Dark	2014-05-01	2007	99	126	2133	0.45170000000000005
World War 2: Time of Wrath	2014-06-06	24	29	38	62	0.45170000000000005
The Joylancer: Legendary Motor Knight	2014-11-07	14	66	85	99	0.451
Tales From The Dragon Mountain 2: The Lair	2014-03-13	6	7	10	16	0.4487
Vitrum	2014-04-22	146	30	40	186	0.4484
Strategic War in Europe	2014-03-21	131	68	89	220	0.44770000000000004
Warmachine Tactics	2014-11-20	939	494	630	1569	0.44680000000000003
Etherlords	2014-02-13	15	90	118	133	0.4462
Deadlock - Planetary Conquest	2014-10-23	8	37	50	58	0.4447
Space Legends: At the Edge of the Universe	2014-11-24	14	56	75	89	0.44420000000000004
Post Master 	2014-03-07	238	123	163	401	0.4428
Selknam Defense	2014-07-26	34	23	32	66	0.4425
Colin McRae Rally	2014-07-30	272	1000	1302	1574	0.44079999999999997
Truffle Saga	2014-06-06	4	51	70	74	0.44
Calibre 10 Racing Series	2014-03-26	70	48	66	136	0.44
Back To Life 3	2014-12-16	1	3	5	6	0.43950000000000006
Broken Sword 4 - the Angel of Death	2014-11-04	31	154	207	238	0.4391
Space Hack	2014-08-05	221	329	439	660	0.43810000000000004
Defenders of Time	2014-11-04	14	18	26	40	0.438
Hotel Collectors Edition	2014-04-25	14	15	22	36	0.43710000000000004
BorderZone	2014-04-23	466	41	58	524	0.43560000000000004
Coldfire Keep	2014-05-09	28	45	64	92	0.434
Starion Tactics	2014-09-05	342	71	101	443	0.4313
Fabula Mortis	2014-10-27	188	35	51	239	0.43119999999999997
Necronomicon: The Dawning of Darkness	2014-07-11	18	72	103	121	0.4301
SPY Fox in: Hold the Mustard	2014-06-06	5	15	23	28	0.42969999999999997
Desert Thunder	2014-03-19	16	101	144	160	0.429
Draconian Wars	2014-08-28	73	17	26	99	0.4288
Logistics Company	2014-11-05	41	47	69	110	0.4278
Escape The Museum	2014-04-29	16	25	38	54	0.4263
Anmynor Puzzles	2014-03-20	3	2	4	7	0.4261
The Memory of Eldurim	2014-02-08	17	99	144	161	0.4251
Batman™: Arkham Origins Blackgate - Deluxe Edition	2014-04-01	153	926	1298	1451	0.42460000000000003
Brick-Force	2014-12-11	1514	1649	2322	3836	0.42229999999999995
Tales From The Dragon Mountain: The Strix	2014-02-20	16	27	42	58	0.4216
Inescapable	2014-05-20	21	48	73	94	0.42100000000000004
BeatBlasters III	2014-02-21	43	33	51	94	0.42100000000000004
Psichodelya	2014-08-08	1080	39	60	1140	0.4205
GhostshipAftermath	2014-07-18	90	41	63	153	0.4203
Farm Machines Championships 2014	2014-03-14	34	47	72	106	0.41979999999999995
Angels of Fasaria: Version 2.0	2014-12-09	2910	24	38	2948	0.41950000000000004
Back To Life 2	2014-05-07	2	3	6	8	0.4167
Voice Of Pripyat	2014-11-19	84	32	51	135	0.4157
Infinite Game Works Episode 0	2014-06-11	17	6	11	28	0.41450000000000004
Nether	2014-06-05	10930	7053	10172	21102	0.4143
Montas	2014-03-24	19	64	100	119	0.41380000000000006
Ground Pounders	2014-07-15	667	18	30	697	0.41369999999999996
Pajama Sam 4: Life Is Rough When You Lose Your Stuff!	2014-05-29	11	51	81	92	0.41240000000000004
Farming World	2014-05-02	405	118	184	589	0.4103
Panzer Elite Action Fields of Glory	2014-05-16	22	77	122	144	0.40990000000000004
Cargo 3	2014-12-08	7	75	119	126	0.4098
Nux	2014-08-15	1846	183	283	2129	0.4096
Dusty Revenge	2014-02-17	100	84	133	233	0.4094
May’s Mysteries: The Secret of Dragonville	2014-10-15	98	25	42	140	0.40880000000000005
Inside The Gear	2014-11-21	825	48	78	903	0.4086
Basketball Pro Management 2015	2014-11-19	26	23	39	65	0.408
The Fifth Day	2014-07-25	212	364	561	773	0.4071
Red Johnson's Chronicles - 1+2 - Steam Special Edition	2014-09-05	10	24	41	51	0.40630000000000005
Black Viper: Sophia's Fate	2014-10-16	9	29	49	58	0.4062
MotoGP™14 Compact	2014-11-21	12	28	48	60	0.40399999999999997
Starlite: Astronaut Rescue	2014-01-27	23	73	121	144	0.40159999999999996
Martial Arts: Capoeira	2014-06-12	4	19	34	38	0.4011
Spaceforce Homeworld	2014-02-19	2	2	5	7	0.40030000000000004
Near Impact	2014-09-16	2	2	5	7	0.40030000000000004
The Campaign Series: Fall Weiss	2014-05-30	54	26	46	100	0.3993
Sudokuball Detective	2014-05-15	6	7	14	20	0.39909999999999995
Real Horror Stories Ultimate Edition	2014-04-01	194	494	787	981	0.39890000000000003
Colossal Kaiju Combat™: Kaijuland Battles	2014-08-11	20	38	66	86	0.3985
TriBlaster	2014-07-01	4	11	21	25	0.3983
The House	2014-07-02	12	34	60	72	0.3968
US and THEM	2014-03-18	28	33	59	87	0.3948
Space Salvager	2014-11-25	6	9	18	24	0.3945
Wayward Manor	2014-07-15	64	28	51	115	0.3934
Tales of Adventure 2	2014-07-14	17	14	27	44	0.3929
Warehouse and Logistics Simulator	2014-02-25	15	101	173	188	0.39280000000000004
Starwalker	2014-12-23	1873	10	20	1893	0.3926
TesserAct	2014-10-24	4	5	11	15	0.3924
Guise Of The Wolf	2014-01-24	55	79	138	193	0.3909
SilverQuest: Gaiden	2014-12-29	4	6	13	17	0.39049999999999996
Akaneiro: Demon Hunters	2014-11-26	80	135	235	315	0.3876
Hippocampal: The White Sofa	2014-05-27	5	36	68	73	0.3841
Motorama	2014-11-21	13	135	242	255	0.38189999999999996
Rover Rescue	2014-05-08	30	42	80	110	0.38079999999999997
Demolition Master 3D	2014-04-11	6	4	10	16	0.3805
SPORT1 Live : Duel	2014-05-30	5	3	8	13	0.3803
Industry Empire	2014-07-30	232	81	151	383	0.37840000000000007
Final Hours of Titanfall	2014-04-16	33	102	190	223	0.3766
Crouching Pony Hidden Dragon	2014-07-14	10	27	55	65	0.3744
Blinding Dark	2014-08-12	10	19	40	50	0.3739
OCEAN CITY RACING: Redux	2014-11-14	13	245	450	463	0.37310000000000004
World Truck Racing	2014-09-16	4	43	86	90	0.3718
Stranded	2014-05-20	685	166	312	997	0.3711
Koya Rift	2014-10-27	6	13	29	35	0.37090000000000006
Dracula 3: The Path of the Dragon	2014-04-17	26	77	150	176	0.37060000000000004
4x4 Dream Race	2014-07-15	2	17	37	39	0.37020000000000003
TUG	2014-03-28	159	349	644	803	0.3701
Defense Grid 2: A Matter of Endurance	2014-09-22	11	5	13	24	0.3694
Mining Industry	2014-11-28	22	24	51	73	0.3689
G-Ball	2014-05-28	12	27	57	69	0.3683
Beyond Space	2014-06-18	58	57	116	174	0.36560000000000004
Deus Ex: The Fall	2014-03-18	428	1461	2671	3099	0.3655
Skilltree Saga	2014-12-04	52	60	122	174	0.3652
Dungeon Lurk II - Leona	2014-10-27	4	11	26	30	0.3651
Steel & Steam: Episode 1	2014-07-16	19	31	66	85	0.365
Crazy Machines: Golden Gears	2014-03-28	19	10	24	43	0.36469999999999997
Beach Resort Simulator	2014-11-28	27	17	39	66	0.3617
Helicopter Simulator 2014: Search and Rescue	2014-02-28	37	116	237	274	0.3579
4PM	2014-07-09	13	76	159	172	0.3575
Frontline : The Longest Day	2014-12-09	16	4	12	28	0.3565
Dangerous	2014-12-16	7	14	34	41	0.35619999999999996
Monomino	2014-10-03	7	7	19	26	0.35479999999999995
Mission Control: NanoMech	2014-12-17	5	3	10	15	0.35240000000000005
N.P.P.D. RUSH - The milk of Ultra violet	2014-02-13	1230	255	521	1751	0.3517
CubeZ	2014-12-01	8	14	35	43	0.3517
Tiestru	2014-08-20	10	13	33	43	0.3508
Snowcat Simulator	2014-11-26	5	12	31	36	0.3498
Them - The Summoning	2014-05-16	6	15	38	44	0.3483
Motorcycle Club	2014-11-28	51	38	88	139	0.34770000000000006
Dark Shadows - Army of Evil	2014-03-11	39883	88	193	40076	0.34740000000000004
Imagine Me	2014-12-09	181	136	293	474	0.3465
Dragon: The Game	2014-11-07	98	248	523	621	0.3458
Dracula 2: The Last Sanctuary	2014-04-17	12	71	166	178	0.3382
Recruits	2014-07-31	22	26	66	88	0.3382
Luna: Shattered Hearts: Episode 1	2014-11-24	772	16	43	815	0.3379
Robotex	2014-11-19	1468	271	594	2062	0.33770000000000006
Journey of the King	2014-12-15	4	6	19	23	0.3375
Manhunter	2014-05-30	23	232	514	537	0.3368
Humanity Asset	2014-02-20	2158	150	341	2499	0.3356
Chaos Domain	2014-05-01	64	258	574	638	0.33520000000000005
Marine Sharpshooter II: Jungle Warfare	2014-04-03	70	172	391	461	0.3344
Corto Maltese Secrets of Venice	2014-12-04	64	8	25	89	0.3315
My Pet Hotel	2014-03-27	3	3	12	15	0.33020000000000005
Dungeon Shooter 2	2014-12-04	4	0	3	7	0.32939999999999997
One Late Night: Deadline	2014-12-23	10	44	115	125	0.32520000000000004
Metal Planet	2014-06-04	183	14	42	225	0.324
Ku: Shroud of the Morrigan	2014-03-17	734	23	65	799	0.3232
Evopollution	2014-04-23	860	34	93	953	0.3216
Sniper Art of Victory	2014-01-31	63	523	1223	1286	0.3207
Pacific Liberation Force	2014-09-16	3	3	13	16	0.3207
Zen Fish SIM	2014-09-18	2	1	7	9	0.3185
Hard Truck Apocalypse: Arcade / Ex Machina: Arcade	2014-03-14	574	57	153	727	0.3171
Solar Struggle	2014-11-18	30	5	20	50	0.3125
Snow Light	2014-10-24	5	4	17	22	0.3125
European Fishing	2014-11-20	3	6	23	26	0.3122
Undead Overlord	2014-07-18	43	49	138	181	0.31120000000000003
Movie Studio Boss: The Sequel	2014-12-17	53	18	57	110	0.3106
1953: NATO vs Warsaw Pact	2014-12-04	127	17	55	182	0.3086
The Terminal 2	2014-08-08	99	45	130	229	0.3084
Galactic Command Echo Squad SE	2014-03-10	4	0	4	8	0.308
Driving School Simulator	2014-09-25	15	52	149	164	0.3075
Glacier 3: The Meltdown	2014-01-23	45	122	330	375	0.3064
Cypress Inheritance: The Beginning	2014-03-10	4	4	18	22	0.3056
The Escapist	2014-09-15	4	4	18	22	0.3056
Starlight Inception	2014-04-22	20	13	45	65	0.305
Toxic Bunny HD	2014-07-18	39	10	37	76	0.3023
Monster Challenge Circus	2014-05-15	2	6	25	27	0.3015
C-RUSH	2014-02-17	8	24	81	89	0.2952
Sam Glyph: Private Eye!	2014-10-09	3	9	38	41	0.2877
Eurofighter Typhoon	2014-05-02	21	50	163	184	0.28750000000000003
Bloodbath	2014-06-16	30	8	35	65	0.2865
Basketball Pro Management 2014	2014-01-06	17	10	42	59	0.2854
The Secret Of Hildegards	2014-03-27	14	10	42	56	0.2854
Sacred 3	2014-08-01	1981	1123	3138	5119	0.2827
Colonies Online	2014-05-01	80	69	225	305	0.2826
Kick-Ass 2	2014-08-15	44	59	197	241	0.2812
Cannons Lasers Rockets	2014-08-25	73	125	392	465	0.2811
Dark Raid	2014-06-03	8	29	107	115	0.2784
Mining & Tunneling Simulator	2014-03-05	13	28	105	118	0.2768
Uprising44: The Silent Shadows	2014-04-18	18	8	38	56	0.2762
Hyper Fighters	2014-01-23	24	97	321	345	0.2756
The Witch's Yarn	2014-04-03	4	4	24	28	0.2725
Children of Liberty	2014-04-18	5	3	20	25	0.2724
Chernobyl Commando	2014-06-06	16	115	385	401	0.2716
Ski-World Simulator	2014-11-18	5	10	47	52	0.271
Xenophage	2014-05-05	3	8	40	43	0.27
Pro Rugby Manager 2015	2014-09-18	371	33	128	499	0.2688
Final Slam 2	2014-06-12	378	105	366	744	0.2663
Aviator - Bush Pilot	2014-11-04	46	13	60	106	0.2662
Iron Soul	2014-02-26	6	10	50	56	0.2634
World Of Leaders	2014-12-17	32	22	96	128	0.2608
Isomer	2014-07-11	16	12	61	77	0.25620000000000004
Lords of the Black Sun	2014-09-12	143	78	307	450	0.2521
The Flying Dutchman	2014-09-12	4	9	51	55	0.2515
Tesla Breaks the World!	2014-09-26	1518	8	47	1565	0.251
Victorian Admirals Anthology	2014-02-11	5	5	34	39	0.25070000000000003
Recovery Search and Rescue Simulation 	2014-01-09	5	11	60	65	0.2502
Haunted House: Cryptic Graves	2014-11-25	6	2	23	29	0.23750000000000002
Burning Cars	2014-01-31	3999	4	34	4033	0.23629999999999998
Paradigm Shift	2014-05-19	4	7	49	53	0.23600000000000002
The Tower	2014-08-04	7	15	87	94	0.2345
Line Of Defense Tactics - Tactical Advantage	2014-02-11	25	1	18	43	0.23420000000000002
Towtruck Simulator 2015	2014-03-11	11	53	253	264	0.23149999999999998
Extreme Roads USA	2014-06-06	7	7	60	67	0.21550000000000002
Kinetic Void	2014-11-21	651	275	1274	1925	0.2129
Front Page Sports Football	2014-10-02	38	6	56	94	0.2126
The Shopkeeper	2014-10-23	12	18	125	137	0.2097
Uriel's Chasm	2014-09-12	759	487	2242	3001	0.2082
Spacebase DF-9	2014-10-27	986	765	3432	4418	0.20809999999999998
Legends of Persia	2014-06-03	19	22	153	172	0.2046
Game Tycoon 1.5	2014-02-11	1519	99	560	2079	0.1998
Construction Machines 2014	2014-03-28	28	34	276	304	0.179
Race To Mars	2014-03-07	87	20	242	329	0.1555
The Wolf Among Us	2013-10-11	14321	29380	672	14993	0.9562
Papers, Please	2013-08-08	6129	57275	1730	7859	0.9534
Don't Starve	2013-04-23	16796	97675	3244	20040	0.9533
Outlast	2013-09-04	11827	96170	3600	15427	0.9494
The Walking Dead: Season Two	2013-12-17	18627	26128	1036	19663	0.9405
Game Dev Tycoon	2013-08-29	7761	38218	1831	9592	0.9356
Dust: An Elysian Tail	2013-05-25	2669	17002	789	3458	0.9317000000000001
Neighbours from Hell	2013-11-07	101	2599	65	166	0.9313
Call of Juarez Gunslinger	2013-05-22	11902	30530	1588	13490	0.9307
Brothers - A Tale of Two Sons	2013-09-03	2019	37543	2171	4190	0.927
Antichamber	2013-01-31	2369	15170	780	3149	0.9266
BioShock Infinite	2013-03-26	65332	123136	8003	73335	0.9263
PAC-MAN Championship Edition DX+	2013-09-24	3694	7035	322	4016	0.925
Tales of Maj'Eyal	2013-12-13	867	5483	256	1123	0.9218000000000001
Skullgirls 2nd Encore	2013-08-22	4016	26042	1638	5654	0.9205
Long Live The Queen	2013-11-08	2623	6477	340	2963	0.9186
Risk of Rain	2013-11-08	5462	26934	1828	7290	0.9166
Sonic & All-Stars Racing Transformed Collection	2013-01-31	5861	14610	939	6800	0.9156000000000001
The Swapper	2013-05-30	890	6636	380	1270	0.9148000000000001
Space Rangers HD: A War Apart	2013-03-15	778	5427	299	1077	0.9147
System Shock 2	2013-05-10	2395	6326	365	2760	0.914
DmC Devil May Cry	2013-01-24	5757	23777	1677	7434	0.9136
Cook, Serve, Delicious!	2013-10-08	1560	5064	287	1847	0.9127
FATE	2013-12-12	354	2939	152	506	0.9107
Brütal Legend	2013-02-26	7172	16178	1200	8372	0.9081
The Stanley Parable	2013-10-17	4818	39968	3272	8090	0.9073000000000001
Super Amazing Wagon Adventure	2013-10-17	510	1819	88	598	0.9070999999999999
Race The Sun	2013-12-10	6455	5840	393	6848	0.9055
SteamWorld Dig	2013-12-05	1459	6068	413	1872	0.9052
Shadow Warrior	2013-09-26	25890	22744	1883	27773	0.9034000000000001
The Cat Lady	2013-12-04	187	4655	322	509	0.9017000000000001
Guacamelee! Gold Edition	2013-08-08	1698	5401	386	2084	0.9014
Deus Ex: Human Revolution - Director's Cut	2013-10-25	3392	23320	1996	5388	0.9013
Hero of the Kingdom	2013-11-14	1003	4035	284	1287	0.8993000000000001
Spelunky	2013-08-08	2919	14182	1214	4133	0.898
Tetrobot and Co.	2013-10-15	620	453	13	633	0.8979
Escape Goat	2013-10-09	142	639	25	167	0.897
Arma 3	2013-09-12	56679	219506	23116	79795	0.895
Papo & Yo	2013-04-18	239	2583	180	419	0.8948
Just Cause 2: Multiplayer Mod	2013-12-16	10574	13825	1250	11824	0.8940000000000001
140	2013-10-16	551	4069	320	871	0.8929
PAYDAY 2	2013-08-13	247709	553002	63734	311443	0.8895000000000001
Stick It To The Man!	2013-12-13	73	735	39	112	0.8889
Farming Simulator 2013	2013-10-09	4639	4615	395	5034	0.8887
Savant - Ascent	2013-12-04	599	2569	205	804	0.8869
Baldur's Gate II: Enhanced Edition	2013-11-15	2644	7226	675	3319	0.8868
No More Room in Hell	2013-10-31	10922	60867	6855	17777	0.8848
Rocksmith® 2014 Edition - Remastered	2013-10-22	4063	19104	2014	6077	0.8844
Bleed	2013-07-03	249	1726	133	382	0.8840000000000001
BIT.TRIP Presents... Runner2: Future Legend of Rhythm Alien	2013-02-26	795	2758	238	1033	0.8828
THE KING OF FIGHTERS XIII STEAM EDITION	2013-09-13	1100	8374	873	1973	0.8795999999999999
Viscera Cleanup Detail: Santa's Rampage	2013-12-13	686	4842	476	1162	0.8795000000000001
Sanctum 2	2013-05-15	13621	12558	1395	15016	0.8774
Rayman Legends	2013-08-29	1266	5858	605	1871	0.8774
7 Days to Die	2013-12-13	70664	224326	29324	99988	0.8753000000000001
NARUTO SHIPPUDEN: Ultimate Ninja STORM 3 Full Burst	2013-10-24	4713	11280	1281	5994	0.8748
Contrast	2013-11-15	518	4693	490	1008	0.8745999999999999
Saints Row IV	2013-08-20	42270	67452	8674	50944	0.873
Marlow Briggs	2013-09-20	187	1926	190	377	0.8693000000000001
Path of Exile	2013-10-23	211637	174710	24156	235793	0.8689
Hammerwatch	2013-08-12	3253	5631	645	3898	0.8687
Electronic Super Joy	2013-08-23	949	3010	323	1272	0.868
Batman™: Arkham Origins	2013-10-25	25017	38326	5081	30098	0.8676
Castle of Illusion	2013-09-04	608	2829	307	915	0.8665
Dominions 4	2013-12-05	557	1306	128	685	0.8647
Pool Nation	2013-10-18	831	2464	280	1111	0.8613
FINAL FANTASY VIII	2013-12-05	4470	7400	954	5424	0.8604
TrackMania² Stadium	2013-06-20	3597	5600	710	4307	0.8597
10,000,000	2013-01-15	1210	1956	220	1430	0.8593999999999999
Samurai Gunn	2013-12-10	80	401	31	111	0.8593999999999999
Memoria	2013-08-29	860	1927	218	1078	0.8588
Warframe	2013-03-25	189837	460655	71724	261561	0.8584
The Inner World	2013-09-27	98	996	102	200	0.8576
Intake	2013-11-06	128	366	29	157	0.8561
Desktop Dungeons	2013-11-07	1528	1257	140	1668	0.8545999999999999
Slender: The Arrival	2013-10-28	461	6696	912	1373	0.8543000000000001
Nihilumbra	2013-10-25	2740	2524	317	3057	0.853
Angry Video Game Nerd Adventures	2013-09-20	420	2751	353	773	0.8519
Nimble Quest	2013-12-06	321	660	67	388	0.8517
Marc Eckō's Getting Up: Contents Under Pressure	2013-12-13	113	1461	175	288	0.8506999999999999
Broken Sword 5 - the Serpent's Curse	2013-12-04	1101	2070	261	1362	0.8504
Goodbye Deponia	2013-10-17	1103	1865	233	1336	0.85
Cry of Fear	2013-04-25	3075	38798	6085	9160	0.8499
CastleStorm	2013-07-29	1280	1339	161	1441	0.8492000000000001
Unholy Heights	2013-10-04	706	1346	163	869	0.8487
Organ Trail: Director's Cut	2013-03-19	4629	2553	340	4969	0.8478
Journey of a Roach	2013-11-04	153	1564	196	349	0.8477
DuckTales Remastered	2013-08-13	2052	5554	799	2851	0.8473999999999999
Skulls of the Shogun	2013-07-29	402	658	71	473	0.8473
Wizardry 8	2013-09-10	212	844	96	308	0.8472
Wargame: AirLand Battle	2013-05-22	4439	3743	522	4961	0.8471
Soundodger+	2013-10-11	97	715	79	176	0.8469
Poker Night 2	2013-04-26	11260	5994	882	12142	0.8456999999999999
The Bridge	2013-02-22	1015	3577	504	1519	0.8456999999999999
Startopia	2013-10-10	182	786	90	272	0.8456
Super Puzzle Platformer Deluxe	2013-05-24	202	429	43	245	0.8449
MURI	2013-12-06	101	429	43	144	0.8449
DCS World Steam Edition	2013-08-02	3328	23546	3792	7120	0.8445999999999999
Megabyte Punch	2013-10-15	212	962	117	329	0.8437000000000001
I Have No Mouth, and I Must Scream	2013-10-17	185	1329	171	356	0.8433
The Typing of The Dead: Overkill	2013-10-29	559	2956	434	993	0.8398000000000001
Eldritch	2013-10-21	436	1842	258	694	0.8394
The Cave	2013-01-23	2320	2249	326	2646	0.8383
Sang-Froid - Tales of Werewolves	2013-04-05	493	1648	231	724	0.8381000000000001
Eryi's Action	2013-11-20	123	1203	165	288	0.8362
PixelJunk™ Shooter	2013-11-11	425	504	60	485	0.8351999999999999
Artemis Spaceship Bridge Simulator	2013-09-16	162	410	48	210	0.8327
Knock-knock	2013-10-04	172	1462	215	387	0.8320000000000001
Desperados - Wanted Dead or Alive	2013-11-20	283	1646	247	530	0.8314
The Apogee Throwback Pack	2013-07-01	101	272	29	130	0.8312999999999999
Gas Guzzlers Extreme	2013-10-08	355	3126	501	856	0.8312
Shadow Man	2013-10-19	42	609	80	122	0.8301999999999999
Vector	2013-12-03	72	808	112	184	0.8298000000000001
Cloudberry Kingdom	2013-08-02	201	195	19	220	0.8296
ENSLAVED™: Odyssey to the West™ Premium Edition	2013-10-24	914	5581	949	1863	0.8295
The Journey Down: Chapter One	2013-01-09	245	1083	158	403	0.8290000000000001
State of Decay	2013-11-05	10079	14904	2737	12816	0.8267
OMSI 2	2013-12-11	2228	8456	1556	3784	0.8231
Dota 2	2013-07-09	1295114	1618770	341275	1636389	0.8217
Sniper Elite: Nazi Zombie Army 2	2013-10-31	3563	3396	605	4168	0.8201
Teslagrad	2013-12-13	169	1963	347	516	0.8158
King Arthur's Gold	2013-11-05	1294	4200	793	2087	0.8149
Oozi: Earth Adventure	2013-12-05	47	784	127	174	0.8143000000000001
Knights and Merchants	2013-10-14	7481	3558	670	8151	0.8139000000000001
Remember Me	2013-06-04	3117	12091	2455	5572	0.8127
The Incredible Adventures of Van Helsing	2013-05-22	4231	7622	1551	5782	0.8097
Valdis Story: Abyssal City	2013-10-30	1959	2188	412	2371	0.8095
How to Survive	2013-10-23	9231	13898	2914	12145	0.8092
Edna & Harvey: The Breakout	2013-10-25	263	1186	214	477	0.8079000000000001
Total War: ROME II - Emperor Edition	2013-09-03	118240	63134	14035	132275	0.8074
ShootMania Storm	2013-04-10	646	706	121	767	0.8069
Surgeon Simulator	2013-04-19	3487	13102	2806	6293	0.8059999999999999
Toki Tori 2+	2013-07-11	209	794	141	350	0.8047
Divekick	2013-08-20	953	1488	283	1236	0.8044
Evoland	2013-04-04	1202	4748	995	2197	0.8026000000000001
Magic 2014 	2013-06-26	14104	3761	792	14896	0.8002
Final Exam	2013-11-05	315	937	180	495	0.7979
Knytt Underground	2013-10-25	701	359	61	762	0.7972
Bloody Trapland	2013-11-18	1221	3190	684	1905	0.7965000000000001
Scribblenauts Unmasked	2013-09-24	647	1737	357	1004	0.7965000000000001
Syder Arcade	2013-10-24	223	561	106	329	0.7929
Another World	2013-04-04	226	1456	305	531	0.7924
Hate Plus	2013-08-19	312	483	91	403	0.7909999999999999
Ring Runner: Flight of the Sages	2013-11-19	192	661	130	322	0.7906000000000001
Shufflepuck Cantina Deluxe	2013-12-06	4747	443	83	4830	0.7903
9.03m	2013-11-20	21	903	185	206	0.7898000000000001
Urban Trial Freestyle	2013-09-18	310	1289	275	585	0.7888
Element4l	2013-05-24	98	540	107	205	0.787
Castlevania: Lords of Shadow - Ultimate Edition	2013-08-27	1585	6014	1444	3029	0.7855
Volgarr the Viking	2013-09-13	332	1902	436	768	0.7831999999999999
Eador. Genesis	2013-10-14	193	317	61	254	0.7819
TrackMania² Canyon	2013-02-27	730	1423	323	1053	0.7817000000000001
Cognition: An Erica Reed Thriller	2013-09-19	362	630	134	496	0.7806000000000001
War Thunder	2013-08-15	113250	306319	83593	196843	0.7797000000000001
Finding Teddy	2013-12-03	67	772	171	238	0.7781
Company of Heroes 2	2013-06-25	164688	78994	21411	186099	0.7778
Viscera Cleanup Detail: Shadow Warrior	2013-10-11	1164	3157	775	1939	0.7778
Receiver	2013-04-29	1224	3250	811	2035	0.7757
La-Mulana	2013-04-15	794	1789	432	1226	0.7755
YOU DON'T KNOW JACK Vol. 4 The Ride	2013-11-05	28	109	18	46	0.7751000000000001
The Shivah	2013-11-21	102	618	140	242	0.7725
America's Army: Proving Grounds	2013-08-29	3073	8349	2241	5314	0.7706999999999999
Giana Sisters: Twisted Dreams - Rise of the Owlverlord	2013-09-26	153	316	68	221	0.7691
Leisure Suit Larry in the Land of the Lounge Lizards: Reloaded	2013-06-27	350	384	88	438	0.7645000000000001
Type:Rider	2013-11-06	644	1266	325	969	0.7636000000000001
YOU DON'T KNOW JACK Vol. 3	2013-11-05	13	58	9	22	0.763
Neverwinter	2013-12-05	14866	27725	8104	22970	0.7622
PixelJunk™ Monsters Ultimate	2013-08-26	974	870	223	1197	0.76
Soldier Front 2	2013-07-03	1395	1563	418	1813	0.7595999999999999
Anomaly 2	2013-05-15	3055	727	185	3240	0.7590000000000001
TrackMania² Valley	2013-07-04	465	445	109	574	0.758
Tiny Barbarian DX	2013-12-03	120	191	42	162	0.7579000000000001
Space Ace	2013-08-27	10	114	23	33	0.7568000000000001
Not The Robots	2013-12-12	933	444	111	1044	0.7553000000000001
Foul Play	2013-09-18	88	508	129	217	0.7549
A Walk in the Dark	2013-11-07	38	303	73	111	0.7545999999999999
Gone Home	2013-08-15	1198	13104	3956	5154	0.7538
Anomaly Warzone Earth Mobile Campaign	2013-11-06	1804	381	96	1900	0.7521
Wizardry 7: Crusaders of the Dark Savant	2013-09-10	43	164	37	80	0.752
PAC-MAN™ and the Ghostly Adventures	2013-10-29	29	171	39	68	0.7515000000000001
The Last Express Gold Edition	2013-11-21	58	254	62	120	0.7501000000000001
Monster Loves You!	2013-03-18	526	923	257	783	0.7487
Anomaly Korea	2013-11-06	1932	562	151	2083	0.7483
YOU DON'T KNOW JACK Vol. 2	2013-11-05	12	63	12	24	0.7477
Trials Evolution Gold Edition	2013-03-21	4318	1623	475	4793	0.7462000000000001
Wasteland 1 - The Original Classic	2013-11-13	95	328	86	181	0.7447
Draw a Stickman: EPIC	2013-12-03	151	889	254	405	0.7444
Strike Suit Zero	2013-01-23	1093	1261	374	1467	0.742
Avadon 2: The Corruption	2013-10-30	272	144	35	307	0.7406999999999999
ORION: Prelude	2013-04-15	7944	21707	7155	15099	0.7406
Dominions 3	2013-08-31	109	100	23	132	0.7397
Ballpoint Universe: Infinite	2013-12-17	120	541	154	274	0.7395999999999999
MotoGP™13	2013-06-20	255	701	204	459	0.7392000000000001
Gomo	2013-12-06	777	1276	388	1165	0.7382
Dragon's Lair 2: Time Warp	2013-10-24	7	73	16	23	0.7376
Tiny Brains	2013-12-11	93	387	112	205	0.7331000000000001
Elder Sign: Omens	2013-11-27	85	313	89	174	0.7328
Beatbuddy: Tale of the Guardians	2013-08-06	397	879	271	668	0.7327
Star Conflict	2013-02-27	4973	10576	3644	8617	0.73
Bridge Constructor	2013-10-16	400	1110	353	753	0.7299
Democracy 3	2013-10-14	2674	5353	1838	4512	0.7275
Fester Mudd: Curse of the Gold - Episode 1	2013-11-04	7	91	23	30	0.7268000000000001
Mars: War Logs	2013-04-26	1462	1936	645	2107	0.7266
Dracula: Love Kills	2013-10-29	90	197	56	146	0.726
Dysfunctional Systems: Learning to Manage Chaos	2013-09-26	86	601	189	275	0.7258
RaceRoom Racing Experience 	2013-02-12	2630	13671	4889	7519	0.7243
Prime World: Defenders	2013-06-05	808	757	244	1052	0.7242000000000001
Ragnarok Online - Free to Play - European Version	2013-11-01	128	286	86	214	0.7236
Master Reboot	2013-10-29	155	511	164	319	0.7209000000000001
Truck Racer	2013-10-18	25	232	70	95	0.7202
Dark Fall 1: The Journal	2013-12-03	28	180	54	82	0.7172
Bionic Dues	2013-10-08	1869	723	243	2112	0.7171
FORCED	2013-10-24	1577	2009	709	2286	0.7170000000000001
Lilly Looking Through	2013-11-01	291	509	168	459	0.7165
Ragnarok	2013-11-01	973	1470	514	1487	0.7164
The Novelist	2013-12-10	156	751	254	410	0.7164
Blockland	2013-12-16	2358	4073	1504	3862	0.7132
Deadfall Adventures	2013-11-15	2010	1759	632	2642	0.713
Pinball Arcade	2013-11-04	417	2786	1021	1438	0.7123999999999999
Legend of Dungeon	2013-09-13	1688	1181	424	2112	0.7103
Kairo	2013-04-24	82	1246	450	532	0.7097
The Banner Saga: Factions	2013-02-25	1619	611	213	1832	0.7095
Poof	2013-11-08	76	174	55	131	0.7093
Velocity®Ultra	2013-12-12	273	174	55	328	0.7093
Super Splatters	2013-06-26	129	130	40	169	0.7084
YOU DON'T KNOW JACK Vol. 1 XL	2013-11-05	48	143	45	93	0.7068000000000001
Mutant Mudds Deluxe	2013-11-21	159	426	148	307	0.7064
Wizardry 6: Bane of the Cosmic Forge	2013-09-10	54	155	50	104	0.7046
WRC 4 FIA WORLD RALLY CHAMPIONSHIP	2013-10-25	245	1199	447	692	0.7039
Aarklash: Legacy	2013-09-12	461	581	210	671	0.7031000000000001
Solar Flux	2013-10-24	939	226	77	1016	0.7019
Saints Row IV Inauguration Station	2013-08-06	313	293	102	415	0.7018000000000001
Magrunner: Dark Pulse	2013-06-20	612	725	271	883	0.6994
Sparkle 2 Evo	2013-10-24	1408	1420	551	1959	0.698
Anachronox	2013-10-17	61	375	138	199	0.6957
Agarest: Generations of War	2013-10-03	3813	1310	515	4328	0.6951
Gimbal	2013-11-19	76	171	60	136	0.6936
Fist Puncher	2013-06-21	152	208	76	228	0.6900000000000001
Cranky Cat	2013-06-05	15	20	5	20	0.6875
Space Hulk	2013-08-15	3505	1408	581	4086	0.6868000000000001
Zigfrak	2013-12-13	1607	175	65	1672	0.6851999999999999
Marvel Puzzle Quest	2013-12-05	3002	2919	1246	4248	0.6845
God Mode	2013-04-19	2256	1757	745	3001	0.6831
Amnesia: A Machine for Pigs	2013-09-10	7249	6869	3036	10285	0.6814
Dark Fall 2: Lights Out	2013-12-03	8	64	22	30	0.6805
Small World	2013-12-11	462	934	407	869	0.674
Age of Conan: Unchained	2013-02-22	1286	1642	732	2018	0.6731999999999999
The Mysterious Cities of Gold - Secret Paths	2013-11-20	18	75	28	46	0.6718000000000001
Urban Chaos	2013-10-15	14	142	57	71	0.6702
Secret Files: Sam Peters	2013-10-18	29	128	51	80	0.67
Sacred Citadel	2013-04-16	489	763	345	834	0.6658
Eador. Masters of the Broken World	2013-04-19	118780	1785	830	119610	0.6655
Ironclad Tactics	2013-09-18	937	421	186	1123	0.6655
Alien Rage - Unlimited	2013-09-24	496	2200	1035	1531	0.6643000000000001
Zombie Tycoon 2: Brainhov's Revenge	2013-12-09	68	222	97	165	0.6614
Kingdom Wars	2013-04-01	1241	1848	883	2124	0.6604000000000001
Reach for the Sun	2013-11-07	145	229	101	246	0.6601
RainBlood Chronicles: Mirage	2013-11-11	58	115	49	107	0.658
Demonicon	2013-10-25	599	627	294	893	0.6576000000000001
Deadly Premonition: The Director's Cut	2013-10-29	320	2599	1272	1592	0.6570999999999999
Sid Meier's Ace Patrol	2013-08-27	415	500	235	650	0.6556000000000001
Omegalodon	2013-09-20	35	264	123	158	0.6519
Zafehouse: Diaries	2013-09-06	409	298	140	549	0.6515000000000001
Bunny Must Die! Chelsea and the 7 Devils	2013-09-26	52	241	112	164	0.6515000000000001
Inquisitor	2013-08-07	269	423	203	472	0.6504000000000001
Blood Omen 2: Legacy of Kain	2013-09-24	56	635	310	366	0.6501
March of the Eagles	2013-02-18	1286	233	109	1395	0.65
Champions of Regnum	2013-02-27	785	740	364	1149	0.6496
Alone in the Dark: The New Nightmare	2013-10-29	19	317	151	170	0.6495000000000001
Rise of the Triad	2013-07-31	2035	1584	803	2838	0.6479
Omikron - The Nomad Soul	2013-09-26	473	364	176	649	0.6479
Jack Orlando Director's Cut	2013-10-04	7425	399	194	7619	0.6476000000000001
Panzar	2013-11-25	2789	3321	1733	4522	0.645
Battle Worlds: Kronos	2013-11-04	372	195	93	465	0.6448999999999999
Survivor Squad	2013-11-08	425	535	271	696	0.6419
Storm	2013-06-27	32	68	31	63	0.6402
The 7th Guest	2013-10-19	62	315	159	221	0.6388
Speedball 2 HD	2013-12-05	226	394	205	431	0.6348
Bridge It (plus)	2013-11-18	89	95	46	135	0.6347
Face Noir	2013-10-17	382	201	103	485	0.6324000000000001
The Chaos Engine	2013-08-29	93	255	133	226	0.6311
Salvation Prophecy	2013-10-08	165	149	77	242	0.6282
Violett	2013-12-13	1867	505	292	2159	0.6157
Call of Duty: Ghosts	2013-11-05	13831	17753	10860	24691	0.615
Blood Knights	2013-11-13	117	587	342	459	0.615
Lost Planet 3	2013-08-26	894	2092	1255	2149	0.6142000000000001
Jack Lumber	2013-04-30	128	225	129	257	0.6124
BIT.TRIP FATE	2013-07-11	43	82	45	88	0.6119
Earth 2140 HD	2013-11-15	9027	309	181	9208	0.6104
Emergency 2014	2013-11-15	113	201	116	229	0.6104
Anna - Extended Edition	2013-04-12	319	944	584	903	0.6048
YOU DON'T KNOW JACK HEADRUSH	2013-11-05	20	35	19	39	0.6038
Doorways: Prelude	2013-09-20	425	379	231	656	0.6037
Sid Meier's Ace Patrol: Pacific Skies	2013-11-05	240	247	151	391	0.6007
YOU DON'T KNOW JACK TELEVISION	2013-11-05	10	32	18	28	0.5971000000000001
Gravity Badgers	2013-11-28	137	265	167	304	0.5952000000000001
Rush Bros	2013-05-25	797	533	342	1139	0.5949
Rise of Venice	2013-09-27	587	283	189	776	0.584
Blood of the Werewolf	2013-10-28	1272	360	243	1515	0.5829
Starseed Pilgrim	2013-04-16	145	299	202	347	0.5819
99 Spirits	2013-11-12	316	232	158	474	0.5791
Ragnarok Online 2	2013-05-01	9254	1808	1280	10534	0.5779
ACE COMBAT™ ASSAULT HORIZON Enhanced Edition	2013-01-25	3795	2971	2143	5938	0.5748
Primal Fears	2013-01-08	111	181	126	237	0.5736
MirrorMoon EP	2013-09-04	121	314	222	343	0.5729
Hexodius	2013-06-21	29	26	17	46	0.5712
1953 - KGB Unleashed	2013-09-20	41	355	257	298	0.5685
Paranormal	2013-09-12	193	297	215	408	0.5678
Montague's Mount	2013-11-19	102	244	176	278	0.5678
Signal Ops	2013-11-18	39	52	36	75	0.5674
Flashback	2013-10-01	236	275	200	436	0.5666
Talisman: Prologue	2013-10-14	934	204	156	1090	0.5553
Interstellar Marines	2013-07-02	4426	4341	3498	7924	0.5502
Eleusis	2013-10-16	109	178	143	252	0.5449
Portal 2 Sixense Perceptual Pack	2013-09-20	1913	287	235	2148	0.5422
Rise of Flight United	2013-09-05	236	1255	1044	1280	0.5414
Realms of Arkania: Blade of Destiny	2013-07-30	279	218	180	459	0.5399
Wooden Sen'SeY	2013-12-05	28	70	57	85	0.5393
Teenage Mutant Ninja Turtles: Out of the Shadows	2013-08-28	467	423	354	821	0.5384000000000001
Heli Heroes	2013-11-01	11754	294	247	12001	0.5369
Daikatana	2013-10-01	47	497	428	475	0.5325
King’s Bounty: Legions	2013-12-10	1552	696	604	2156	0.5313
Darkfall Unholy Wars	2013-04-25	837	340	302	1139	0.5254
YOU DON'T KNOW JACK MOVIES	2013-11-05	24	39	34	58	0.5249
DARK	2013-07-05	458	670	599	1057	0.5246999999999999
YOU DON'T KNOW JACK SPORTS	2013-11-05	7	23	20	27	0.5236999999999999
Alien Spidy	2013-03-20	10	106	102	112	0.5077
Ravensword: Shadowlands	2013-12-06	69	254	249	318	0.5042
3079 -- Block Action RPG	2013-11-14	762	242	240	1002	0.5018
Songs2See Game	2013-11-26	12	38	38	50	0.5
Guncraft	2013-08-10	525	576	608	1133	0.48810000000000003
Darkout	2013-12-04	958	416	444	1402	0.4858
Deathtrap Dungeon	2013-10-03	15	76	82	97	0.4851
Dementium II HD	2013-12-17	99	515	570	669	0.4777
A-Train 8	2013-09-18	17	26	30	47	0.47490000000000004
Professional Farmer 2014	2013-11-28	794	283	329	1123	0.4679
A Valley Without Wind 2	2013-02-18	146	99	117	263	0.46659999999999996
Impire	2013-02-14	2547	190	237	2784	0.45380000000000004
Dark Matter	2013-10-17	27035	105	138	27173	0.4451
The 11th Hour	2013-10-19	13	89	118	131	0.444
Dungeon Party	2013-03-13	368	162	219	587	0.43770000000000003
X Rebirth	2013-11-15	14732	3112	4106	18838	0.43590000000000007
Redshirt	2013-11-13	125	162	226	351	0.43119999999999997
Bus-Simulator 2012	2013-11-22	63	417	575	638	0.4303
Perfection.	2013-08-28	8	27	40	48	0.4302
Kingdoms Rise	2013-11-18	251	446	618	869	0.4291
Gravi	2013-10-08	39	41	63	102	0.4203
YOU DON'T KNOW JACK Vol. 6 The Lost Gold	2013-11-05	18	28	44	62	0.4194
Takedown: Red Sabre	2013-09-20	1078	2299	3341	4419	0.41450000000000004
Gentlemen!	2013-11-05	62	52	82	144	0.4136
Postmortem: one must die (Extended Cut)	2013-12-03	29	71	111	140	0.413
Defense Technica	2013-10-24	112	67	105	217	0.413
DIVO	2013-02-01	4	8	15	19	0.40630000000000005
Half-Life: Before	2013-12-04	331	1115	1710	2041	0.4043
Dead Sky	2013-11-22	37	81	141	178	0.3914
Bad Hotel	2013-10-16	199	126	247	446	0.3651
Tank Operations	2013-11-22	81	38	85	166	0.35369999999999996
Air Conflicts: Vietnam	2013-10-02	55	96	213	268	0.3443
Iesabel	2013-10-11	115	226	516	631	0.33130000000000004
Huntsman - The Orphanage Halloween Edition	2013-09-13	51	75	189	240	0.3243
Two Brothers	2013-12-03	16	48	126	142	0.3232
Legends of Aethereus	2013-09-27	373	77	211	584	0.30960000000000004
Agricultural Simulator: Historical Farming	2013-11-06	22	71	207	229	0.3003
Woodcutter Simulator 2013	2013-12-19	48	141	395	443	0.2988
Farming Giant	2013-11-06	117	61	190	307	0.2917
Vox	2013-11-12	202	87	293	495	0.2742
Agricultural Simulator 2013 Steam Edition	2013-06-07	112	145	500	612	0.264
Guardians of Middle-earth	2013-08-29	976	325	1067	2043	0.2636
Spaceforce Constellations	2013-12-12	13	2	18	31	0.26
World Basketball Tycoon	2013-11-18	21	16	89	110	0.2378
Skyscraper Simulator	2013-10-21	86	88	387	473	0.2345
Airport Simulator 2014	2013-12-19	126	175	841	967	0.21300000000000002
Citadels	2013-07-26	282	69	399	681	0.2028
Dishonored	2012-10-11	19938	70890	1764	21702	0.9594
Hotline Miami	2012-10-23	6878	79172	2123	9001	0.9581000000000001
The Walking Dead	2012-04-24	12114	59273	1775	13889	0.9539
Dishonored RHCP	2012-10-11	4604	12381	258	4862	0.9517
Castle Crashers	2012-09-26	16013	94828	3678	19691	0.9481
To the Moon	2012-09-07	615	64365	2389	3004	0.9478
Batman: Arkham City GOTY	2012-09-07	6871	49932	2121	8992	0.9418000000000001
FTL: Faster Than Light	2012-09-14	19301	64638	2902	22203	0.941
XCOM: Enemy Unknown	2012-10-09	70568	48626	2882	73450	0.9270999999999999
Botanicula	2012-05-07	428	5123	232	660	0.9222
Defender's Quest: Valley of the Forgotten	2012-10-30	3014	3164	143	3157	0.9169
Spec Ops: The Line	2012-06-29	13995	46926	3481	17476	0.9144
Orcs Must Die! 2	2012-07-30	16119	17164	1150	17269	0.9144
Thomas Was Alone	2012-11-12	1072	8341	542	1614	0.9106000000000001
Legend of Grimrock	2012-04-11	6075	5493	356	6431	0.9069
Ys Origin	2012-05-31	1162	2725	163	1325	0.9033
Rayman Origins	2012-03-29	870	3256	206	1076	0.9026000000000001
LEGO® Batman™ 2: DC Super Heroes	2012-06-22	523	4544	311	834	0.9020999999999999
DARK SOULS™: Prepare To Die Edition	2012-08-24	11259	70382	6654	17913	0.8996
Thief™ II: The Metal Age	2012-05-22	79	1552	94	173	0.8953
Alan Wake	2012-02-16	6652	34904	3511	10163	0.8916
Ys: The Oath in Felghana	2012-03-19	438	1532	101	539	0.8909
Age of Empires® III (2007)	2012-01-05	9490	28211	2847	12337	0.8902
Blackwell Convergence	2012-01-13	102	483	20	122	0.8895000000000001
Blackwell Deception	2012-01-13	152	487	21	173	0.8884000000000001
Crusader Kings II	2012-02-14	141439	62917	6900	148339	0.8872
Thief Gold	2012-05-22	260	2957	246	506	0.8859
Tiny and Big: Grandpa's Leftovers	2012-06-19	2311	3709	334	2645	0.8831
Counter-Strike: Global Offensive	2012-08-21	1519457	6307931	809845	2329302	0.8829000000000001
The Witcher 2: Assassins of Kings Enhanced Edition	2012-04-17	12884	70504	8257	21141	0.8819
Indie Game: The Movie	2012-06-12	1114	1665	135	1249	0.8805
Guns of Icarus Online	2012-10-29	107883	13203	1450	109333	0.8787
LEGO® The Lord of the Rings™	2012-11-27	5045	10171	1112	6157	0.8773000000000001
Ticket to Ride	2012-05-24	2164	4296	435	2599	0.8761
Blackwell Unbound	2012-01-13	109	568	37	146	0.8751000000000001
Serious Sam 2	2012-01-31	786	9658	1095	1881	0.8738
Noitu Love 2 Devolution	2012-04-23	95	557	37	132	0.8737
The Book of Unwritten Tales	2012-07-31	343	1770	166	509	0.8718000000000001
Chaos on Deponia	2012-11-06	337	2204	223	560	0.8691
Rocksmith	2012-10-16	1406	1179	109	1515	0.8673000000000001
eXceed 3rd - Jade Penetrate Black Package	2012-08-02	129	584	46	175	0.8656999999999999
Sonic CD	2012-01-19	392	4524	526	918	0.8654999999999999
Critter Crunch	2012-09-11	61	300	18	79	0.8652
Avernum: Escape From the Pit	2012-04-11	429	1003	93	522	0.8647
Super Crate Box	2012-08-29	553	5808	734	1287	0.8603000000000001
Sonic Adventure™ 2 	2012-11-19	693	14884	2064	2757	0.858
Titan Attacks	2012-02-03	192	860	86	278	0.8571
Edna & Harvey: Harvey's New Eyes	2012-10-16	211	2487	299	510	0.8566
Tales from Space: Mutant Blobs Attack	2012-08-15	149	714	69	218	0.8565
Deponia	2012-08-06	1257	9653	1364	2621	0.8534
Toy Soldiers	2012-04-24	1912	1241	141	2053	0.8529000000000001
Jet Set Radio	2012-09-19	2065	6150	851	2916	0.8521
Magical Diary: Horse Hall	2012-05-31	293	885	98	391	0.85
Luxor Evolved	2012-03-01	40	277	22	62	0.8498000000000001
Stacking	2012-03-06	660	1476	181	841	0.8488
The Blackwell Legacy	2012-01-13	348	1221	146	494	0.8484999999999999
Call of Duty: Black Ops II	2012-11-13	18277	35364	5652	23929	0.8473999999999999
Resonance	2012-07-25	149	444	44	193	0.8462999999999999
Divine Divinity	2012-07-05	300	2610	355	655	0.846
Retro City Rampage™ DX	2012-10-09	1035	2048	272	1307	0.8456
Worms Revolution	2012-10-10	7770	6960	1041	8811	0.8452
Rune Classic	2012-06-13	28	727	86	114	0.8418000000000001
Dustforce	2012-01-17	570	1933	269	839	0.8406
Stealth Bastard Deluxe	2012-11-28	272	961	122	394	0.8401000000000001
The Dream Machine	2012-05-11	864	1775	247	1111	0.8395999999999999
Intrusion 2	2012-09-11	317	1461	206	523	0.8361000000000001
Natural Selection 2	2012-10-31	9510	10806	1841	11351	0.8338
Gateways	2012-09-13	100	216	21	121	0.8322
Magic: The Gathering - Duels of the Planeswalkers 2013	2012-06-20	7807	1114	158	7965	0.8321
Awesomenauts	2012-08-01	12156	22448	4051	16207	0.8309000000000001
Gotham City Impostors: Free To Play	2012-08-30	7249	10085	1786	9035	0.8288
Binary Domain	2012-04-27	1077	5927	1022	2099	0.8283
Warlock - Master of the Arcane	2012-05-08	3490	2127	338	3828	0.8283
Insanely Twisted Shadow Planet	2012-04-17	408	691	97	505	0.8262999999999999
Hell Yeah!	2012-10-03	3204	3042	513	3717	0.8253
Half Minute Hero: Super Mega Neo Climax Ultimate Boy	2012-09-27	993	1233	194	1187	0.8231999999999999
Realm of the Mad God Exalt	2012-02-20	10051	36389	7124	17175	0.8228
NiGHTS into Dreams...	2012-12-17	149	1328	219	368	0.8192
Lone Survivor: The Director's Cut	2012-04-23	544	1092	181	725	0.8162
Sherlock Holmes and The Hound of The Baskervilles	2012-04-23	90	507	76	166	0.8153
Dwarfs F2P	2012-10-18	1050	1408	245	1295	0.8140000000000001
Adventures of Shuggy	2012-06-13	443	1018	171	614	0.8139000000000001
Chivalry: Medieval Warfare	2012-10-16	25145	54621	11613	36758	0.8131999999999999
Divinity II: Developer's Cut	2012-10-29	1237	3483	661	1898	0.8128000000000001
McPixel	2012-09-25	2311	3205	605	2916	0.8127
Quantum Conundrum	2012-06-21	2941	1645	303	3244	0.8092
FLY'N	2012-11-09	107	417	66	173	0.8068000000000001
Great Big War Game	2012-08-28	232	55	4	236	0.8062
Fortune Summoners: Secret of the Elemental Stone	2012-01-24	425	696	120	545	0.8061
Fairy Bloom Freesia	2012-10-17	174	918	164	338	0.8059000000000001
PlanetSide 2	2012-11-20	29676	56587	12714	42390	0.8055
Symphony	2012-08-06	833	1231	230	1063	0.8044
They Bleed Pixels	2012-08-29	570	2064	404	974	0.8043000000000001
Zombie Driver HD	2012-10-17	1003	2953	603	1606	0.8022
Dynamite Jack	2012-05-10	80	363	59	139	0.8019
Avernum 6	2012-05-11	24	59	5	29	0.8018000000000001
Iron Brigade	2012-08-13	702	853	157	859	0.8016
Penny Arcade's On the Rain-Slick Precipice of Darkness 3	2012-06-25	1084	479	83	1167	0.8
The Lord of the Rings Online™	2012-06-06	3965	14118	3172	7137	0.7998000000000001
Cherry Tree High Comedy Club	2012-11-08	276	489	88	364	0.7963
Nancy Drew: Tomb of the Lost Queen	2012-05-16	30	86	10	40	0.7959999999999999
Lucius	2012-10-26	1509	7855	1844	3353	0.7903
Yesterday	2012-03-22	83	734	148	231	0.7891
Din's Curse	2012-08-22	129	192	32	161	0.7872
eXceed 2nd - Vampire REX	2012-08-02	145	224	39	184	0.7861
Nethergate: Resurrection	2012-10-05	46	83	11	57	0.7857
ENDLESS™ Space - Definitive Edition	2012-07-04	31089	7310	1775	32864	0.785
Tribes: Ascend	2012-06-27	7444	6871	1666	9110	0.7848999999999999
Nancy Drew: The Deadly Device	2012-10-23	22	48	5	27	0.7836
Insane 2	2012-01-24	22	465	95	117	0.7812000000000001
Alien Shooter 2 Conscription	2012-05-18	1249	408	82	1331	0.7811
iBomber Defense Pacific	2012-03-01	352	475	99	451	0.7792
Sine Mora	2012-11-09	259	761	170	429	0.7769
Blood Bowl: Chaos Edition	2012-10-11	1945	1372	324	2269	0.7759999999999999
Bang Bang Racing	2012-06-08	26	469	101	127	0.775
Tiny Troopers	2012-08-24	105	958	225	330	0.773
Deadlight	2012-10-25	1678	9698	2584	4262	0.7726000000000001
Offspring Fling!	2012-05-11	1889	477	105	1994	0.7726000000000001
Star Trek Online	2012-01-31	7910	13889	3759	11669	0.7719
Pickers	2012-02-23	21	169	32	53	0.7718
EverQuest Free-to-Play	2012-12-13	984	1477	362	1346	0.7716
Blades of Time	2012-04-21	247	1799	454	701	0.7693000000000001
Emergency 2013	2012-11-09	108	12	0	108	0.7690000000000001
Lunar Flight	2012-04-10	1015	528	122	1137	0.7679
Rocketbirds: Hardboiled Chicken	2012-10-15	369	2439	638	1007	0.7666
English Country Tune	2012-08-09	165	327	75	240	0.7619
Snuggle Truck	2012-02-03	181	373	87	268	0.7618
PixelJunk Eden	2012-02-02	1221	604	149	1370	0.761
Choplifter HD	2012-01-11	48	222	49	97	0.7601000000000001
Unity of Command	2012-10-17	358	708	179	537	0.7595999999999999
The Testament of Sherlock Holmes	2012-09-20	655	2448	675	1330	0.7587
Avernum 4	2012-05-11	37	82	15	52	0.7585
MacGuffin's Curse	2012-04-19	339	102	20	359	0.7571
Wargame: European Escalation	2012-02-23	3588	2387	688	4276	0.7515999999999999
Conquest of Elysium 3	2012-10-24	235	252	61	296	0.7511
Kung Fu Strike: The Warrior's Rise	2012-07-24	267	860	236	503	0.7501000000000001
Giana Sisters: Twisted Dreams	2012-10-22	494	1392	395	889	0.7497
Scoregasm	2012-02-08	11	115	25	36	0.7490000000000001
Primal Carnage	2012-10-29	2631	4494	1360	3991	0.748
Superbrothers: Sword & Sworcery EP	2012-04-16	731	1945	569	1300	0.7478
Blacklight: Retribution	2012-07-02	12131	12454	3991	16122	0.7434999999999999
Rotastic	2012-10-11	11	32	5	16	0.7428
PROTOTYPE 2	2012-07-24	4070	10083	3252	7322	0.7415
Dogfight 1942	2012-09-21	134	733	211	345	0.7413
Containment: The Zombie Puzzler	2012-03-02	90	218	56	146	0.7411
Pineapple Smash Crew 	2012-02-02	19	97	22	41	0.7406
1000 Amps	2012-02-22	20	255	70	90	0.7348
Evochron Mercenary	2012-01-16	774	329	94	868	0.7328
SONIC THE HEDGEHOG 4 Episode II	2012-05-15	47	1274	404	451	0.7315
Really Big Sky	2012-02-24	5784	1430	462	6246	0.7293999999999999
Galaxy on Fire 2™ Full HD	2012-08-21	605	1467	475	1080	0.7293000000000001
Assassin's Creed® III	2012-11-20	15007	10377	3606	18613	0.7284
Unstoppable Gorg	2012-01-19	188	216	61	249	0.7284
Mabinogi	2012-12-06	1229	2618	922	2151	0.7191
Ether Vapor Remaster	2012-09-27	119	213	66	185	0.7151000000000001
Avernum 5	2012-05-11	12	25	5	17	0.7148000000000001
Of Orcs And Men	2012-10-11	488	1294	457	945	0.7138
Port Royale 3	2012-05-04	614	961	343	957	0.7095999999999999
Tower Wars	2012-08-14	1956	1253	458	2414	0.7076000000000001
Dragon Nest	2012-12-18	1786	1642	609	2395	0.7070000000000001
Game of Thrones 	2012-06-07	961	1602	629	1590	0.6967
C9	2012-09-13	2866	987	382	3248	0.6958
Alan Wake's American Nightmare	2012-05-22	738	4966	2042	2780	0.6940999999999999
BIT.TRIP VOID	2012-12-19	29	67	21	50	0.6937000000000001
Jagged Alliance - Back in Action	2012-02-09	5553	1111	438	5991	0.6934
Puddle	2012-11-09	125	343	129	254	0.6912
Dungeons & Dragons Online®	2012-06-25	2854	4242	1766	4620	0.691
Dead Hungry Diner	2012-05-16	125	104	36	161	0.6881
Luxor Amun Rising HD	2012-09-03	18	44	14	32	0.6828000000000001
Cubemen	2012-03-16	627	354	147	774	0.6748000000000001
Vindictus	2012-06-22	4124	5114	2324	6448	0.6747
Men of War: Condemned Heroes	2012-04-12	65	383	165	230	0.6691
AZMD! Scorepocalypse 	2012-04-18	11	57	21	32	0.6688
MapleStory	2012-08-09	7298	7258	3434	10732	0.6679
Tom Clancy's Ghost Recon Future Soldier	2012-06-26	2667	3247	1527	4194	0.6661
ROSE Online	2012-10-23	382	308	135	517	0.6641
Crazy Machines Elements	2012-02-10	14	26	9	23	0.6603
I Am Alive	2012-09-06	1228	1706	822	2050	0.6583
New Star Soccer 5	2012-09-27	141	421	199	340	0.6531999999999999
Home	2012-08-31	356	1135	559	915	0.6519
The Political Machine	2012-07-31	514	200	92	606	0.6515000000000001
Spirits	2012-09-04	238	165	75	313	0.6515000000000001
Storm in a Teacup	2012-01-18	8	100	44	52	0.6509999999999999
Secret Files 3	2012-09-13	73	97	44	117	0.6456999999999999
Mutant Storm Reloaded	2012-03-21	7	33	14	21	0.6391
Stronghold Kingdoms	2012-02-28	8616	5709	3134	11750	0.6362
Colour Bind	2012-09-24	21	24	10	31	0.6353
Aerofly FS 1 Flight Simulator	2012-10-17	34	108	54	88	0.6307
GTR - FIA GT Racing Game	2012-09-25	40	70	36	76	0.6211
Fieldrunners	2012-05-24	144	186	103	247	0.6175
Hamlet or the last game without MMORPG features, shaders and product placement	2012-10-22	10714	320	184	10898	0.6142000000000001
Myst V	2012-03-16	29	129	73	102	0.6106
Inversion™	2012-07-26	87	373	229	316	0.6022
Crusader Kings Complete	2012-02-14	58	133	79	137	0.6020000000000001
Foreign Legion: Multi Massacre	2012-07-09	66	193	119	185	0.5976
Jagged Alliance: Crossfire	2012-08-24	456	176	109	565	0.5961
Ridge Racer™ Unbounded	2012-03-29	336	865	576	912	0.5891
Call of Duty: Black Ops - OSX	2012-09-27	72	180	116	188	0.5886
Iron Front : Liberation 1944	2012-05-25	485	500	332	817	0.5876
SpellForce 2 - Faith in Destiny	2012-06-19	612	193	127	739	0.585
Fallen Earth Classic	2012-02-23	2186	4374	3044	5230	0.5835
A Valley Without Wind	2012-04-24	537	288	199	736	0.5772
MDK 2 HD	2012-07-30	9	80	54	63	0.5749000000000001
Fowl Space	2012-03-21	8	106	74	82	0.5703
Test Drive®: Ferrari Racing Legends	2012-12-10	86	170	121	207	0.5689000000000001
BIT.TRIP CORE	2012-10-02	30	82	58	88	0.5664
Revelations 2012	2012-04-23	19	221	167	186	0.5579999999999999
Nexuiz	2012-05-10	1139	178	135	1274	0.5565
Street Fighter X Tekken	2012-05-11	1302	1252	1009	2311	0.5485
Krater	2012-06-12	763	479	383	1146	0.5484
King Arthur II - The Role-playing Wargame	2012-01-28	571	253	207	778	0.5421
Roller Coaster Rampage	2012-06-19	28	63	51	79	0.54
Resident Evil: Operation Raccoon City	2012-05-18	1056	2116	1795	2851	0.5376
Oil Rush	2012-01-25	280	243	207	487	0.5336
Shad'O	2012-09-04	556	61	52	608	0.5303
Air Conflicts: Pacific Carriers	2012-09-21	199	265	241	440	0.5201
Gratuitous Tank Battles	2012-05-17	170	53	48	218	0.5186
Beyond Divinity	2012-10-29	39	297	276	315	0.5156000000000001
Hack, Slash, Loot	2012-04-05	546	369	353	899	0.5096
SOL: Exodus	2012-01-25	28	54	52	80	0.5071
Party of Sin	2012-12-13	402	98	98	500	0.5
RAW - Realms of Ancient War	2012-10-11	418	368	378	796	0.49420000000000003
Viking: Battle for Asgard	2012-10-17	790	1064	1132	1922	0.48600000000000004
Babel Rising	2012-08-07	83	50	55	138	0.48200000000000004
Galactic Civilizations I: Ultimate Edition	2012-08-14	191	115	130	321	0.47520000000000007
Carrier Command: Gaea Mission	2012-09-27	1259	500	564	1823	0.4736
eXceed - Gun Bullet Children	2012-08-02	149	225	262	411	0.4679
Farming Simulator 2013 - Modding Tutorials	2012-11-08	21	23	29	50	0.4598
Space Ark	2012-03-16	5	6	9	14	0.4434
SONIC THE HEDGEHOG 4 Episode I	2012-01-19	102	1147	1586	1688	0.42710000000000004
3SwitcheD	2012-03-29	9486	249	355	9841	0.425
Miner Wars Arena 	2012-08-28	4	11	20	24	0.406
Stellar Impact	2012-04-12	669	217	347	1016	0.4019
Postal 3	2012-02-17	49	1209	1910	1959	0.3976
Miner Wars 2081	2012-11-28	291	129	233	524	0.38070000000000004
Defenders of Ardania	2012-03-14	19	38	76	95	0.37329999999999997
Starpoint Gemini	2012-02-15	150	46	92	242	0.3711
Jane's Advanced Strike Fighters	2012-03-09	53	126	247	300	0.3651
Arena Wars 2	2012-10-12	68	130	264	332	0.35810000000000003
Garshasp: Temple of the Dragon	2012-09-24	11	43	93	104	0.358
Gemini Wars	2012-11-02	145	46	111	256	0.3381
Dungeonbowl Knockout Edition	2012-07-02	119	20	55	174	0.33
Deep Black : Reloaded	2012-04-17	11	62	157	168	0.3259
Tryst	2012-09-14	65	14	43	108	0.32049999999999995
Confrontation	2012-04-05	157	89	253	410	0.30160000000000003
Fray	2012-06-19	17	1	49	66	0.167
Terraria	2011-05-16	489886	1088680	24768	514654	0.9705
Saints Row: The Third	2011-11-15	34371	63862	2743	37114	0.9426000000000001
Supreme Commander: Forged Alliance	2011-09-29	2113	11179	358	2471	0.9409000000000001
Batman: Arkham City™	2011-11-15	7162	1992	27	7189	0.9374
Bastion	2011-08-16	4186	34133	1577	5763	0.9364
The Binding of Isaac	2011-09-28	12575	52827	2590	15165	0.9363
Trine 2	2011-12-07	3755	19831	919	4674	0.9328000000000001
Mafia II (Classic)	2011-03-22	29474	47346	2495	31969	0.9326000000000001
Orcs Must Die!	2011-10-12	6000	7057	265	6265	0.932
LIMBO	2011-08-02	27466	42906	3027	30493	0.917
PAYDAY: The Heist	2011-10-20	50316	36288	2599	52915	0.9152
Sonic Generations	2011-11-04	1686	19520	1420	3106	0.9106000000000001
Dungeons of Dredmor	2011-07-13	5098	4756	301	5399	0.9067000000000001
Dungeon Defenders	2011-10-19	21862	15020	1134	22996	0.9065000000000001
Rising Storm/Red Orchestra 2 Multiplayer	2011-09-13	16551	33590	2758	19309	0.9061
Cave Story+	2011-11-21	1235	6521	468	1703	0.9029
Waves	2011-11-16	298	1321	65	363	0.9018
Jamestown	2011-06-08	6432	2135	126	6558	0.9008
Warhammer 40,000: Space Marine - Anniversary Edition	2011-09-06	15653	20080	1768	17421	0.8984000000000001
Costume Quest	2011-10-15	742	3361	238	980	0.897
Fable - The Lost Chapters	2011-12-19	2595	6558	543	3138	0.8942
Tropico 4	2011-09-01	10892	10856	986	11878	0.892
SpaceChem	2011-03-02	1962	4403	383	2345	0.8872
Cthulhu Saves the World 	2011-07-13	653	3072	265	918	0.8840000000000001
X3: Albion Prelude	2011-12-16	1917	1849	147	2064	0.8831
The Cat and the Coup	2011-06-15	15	946	65	80	0.8814000000000001
Sonic Adventure DX	2011-03-04	332	11170	1186	1518	0.8803000000000001
Rock of Ages	2011-09-07	1371	3223	297	1668	0.8801000000000001
EDGE	2011-08-11	363	1910	166	529	0.8779000000000001
Space Pirates and Zombies	2011-08-15	3735	2697	259	3994	0.8752
Rochard	2011-11-15	415	1574	140	555	0.8739
Assassin's Creed Brotherhood	2011-03-22	3848	15412	1901	5749	0.8695
Magicka	2011-01-25	11727	25799	3394	15121	0.8664000000000001
Serious Sam 3: BFE	2011-11-22	2439	22732	2979	5418	0.8661
Solar 2	2011-06-17	2739	1841	189	2928	0.8658
Sanctum	2011-04-15	7380	2835	332	7712	0.8603000000000001
Mount & Blade: With Fire and Sword	2011-05-03	9315	10994	1491	10806	0.8583
Darkest Hour: A Hearts of Iron Game	2011-04-08	502	1674	188	690	0.8577
Syberia	2011-05-19	1292	4644	598	1890	0.8566
Supreme Commander	2011-09-29	578	2206	274	852	0.8525
Men of War: Assault Squad	2011-02-25	1490	3936	524	2014	0.8520000000000001
Worms Ultimate Mayhem	2011-09-28	786	4399	598	1384	0.851
Atom Zombie Smasher 	2011-03-14	3139	1697	207	3346	0.851
Fortix 2	2011-05-06	280	510	49	329	0.851
Kohan II: Kings of War	2011-08-24	108	195	13	121	0.8499
Gemini Rue	2011-10-26	257	1498	183	440	0.8493
The Tiny Bang Story	2011-04-22	164840	5342	758	165598	0.8484999999999999
Space Channel 5: Part 2	2011-03-04	68	1414	176	244	0.8470000000000001
Quake 4	2011-08-04	255	2297	326	581	0.8406
SkyDrift	2011-11-21	186	986	128	314	0.8384999999999999
Anomaly Warzone Earth	2011-04-08	1941	3672	560	2501	0.8379000000000001
Assassin's Creed Revelations	2011-11-29	3105	11880	1980	5085	0.8369
Defy Gravity	2011-07-25	4412	7412	1203	5615	0.8368000000000001
Earth Defense Force: Insect Armageddon	2011-12-14	495	910	119	614	0.8367
Hector: Ep 3	2011-04-27	23	212	20	43	0.8336
SEGA Bass Fishing	2011-03-04	45	693	91	136	0.8323
NightSky	2011-03-01	262	832	115	377	0.8305
BIT.TRIP RUNNER	2011-02-28	926	3289	536	1462	0.8298000000000001
Magic: The Gathering — Duels of the Planeswalkers 2012	2011-06-15	6206	823	117	6323	0.8277
Crazy Taxi	2011-03-04	362	2638	438	800	0.8257
Before the Echo	2011-10-20	1694	1197	183	1877	0.8257
Spiral Knights	2011-06-14	13143	19205	3648	16791	0.8238
Runaway: A Twist of Fate	2011-04-21	54	329	41	95	0.8236
Nancy Drew: Alibi in Ashes	2011-11-02	29	173	18	47	0.8224
Gundemonium Recollection	2011-09-27	8	144	14	22	0.8219
E.Y.E: Divine Cybermancy	2011-07-29	2481	6087	1114	3595	0.8215000000000001
Renegade Ops	2011-10-26	854	2214	379	1233	0.8206
Dino D-Day	2011-04-09	4585	12596	2418	7003	0.8201999999999999
BEEP	2011-05-06	1373	3947	712	2085	0.8199
Puzzle Agent 2	2011-06-30	100	843	132	232	0.8187000000000001
Demolition Company Gold	2011-08-04	37	263	34	71	0.8161
Might & Magic: Clash of Heroes	2011-09-22	4757	2016	357	5114	0.8159000000000001
Bloodline Champions	2011-10-28	1667	1414	245	1912	0.8145
Cloning Clyde	2011-03-15	8	110	11	19	0.8128000000000001
YOU DON'T KNOW JACK	2011-02-08	31	104	11	42	0.8077
SATAZIUS	2011-12-16	190	253	36	226	0.8073
The Haunted: Hells Reach	2011-10-25	745	624	105	850	0.807
Post Apocalyptic Mayhem	2011-03-17	2608	1254	236	2844	0.8037000000000001
Nancy Drew: The Captive Curse	2011-07-25	34	146	19	53	0.8023
Breath of Death VII 	2011-07-13	45	1139	216	261	0.8017000000000001
Myst: Masterpiece Edition	2011-02-02	74	617	113	187	0.7978000000000001
Hard Reset	2011-09-13	921	3753	811	1732	0.7968000000000001
The Next BIG Thing	2011-04-21	77	502	92	169	0.7947
Frozen Synapse	2011-05-26	2155	2113	448	2603	0.7945000000000001
Global Agenda	2011-06-14	7405	1281	261	7666	0.7945000000000001
Kohan: Ahriman's Gift	2011-08-24	28	111	15	43	0.7923
Glowfish	2011-09-30	11	124	18	29	0.7895000000000001
DC Universe Online	2011-11-02	17701	15443	3776	21477	0.7879
Still Life	2011-06-01	99	731	149	248	0.7877
Revenge of the Titans	2011-03-16	3155	961	203	3358	0.7867000000000001
Serious Sam Double D XXL	2011-08-30	63	644	131	194	0.7863
The Lord of the Rings: War in the North	2011-11-01	4664	7175	1750	6414	0.7843000000000001
Universe Sandbox Legacy	2011-04-29	3326	2368	554	3880	0.7823000000000001
Dungeon Siege	2011-04-05	391	2677	647	1038	0.7787999999999999
Drawn: The Painted Tower	2011-01-20	14	145	25	39	0.7779
Puzzle Pirates	2011-08-31	949	1463	356	1305	0.7725
Avadon: The Black Fortress	2011-08-17	516	452	100	616	0.7712000000000001
Arma: Cold War Assault	2011-07-13	3017	4505	1220	4237	0.7656999999999999
Scratches: Director's Cut	2011-04-20	39	317	71	110	0.7644
Dead Rising 2: Off the Record	2011-10-11	725	2391	639	1364	0.7632
GundeadliGne	2011-09-27	11	132	26	37	0.7625000000000001
Gatling Gears	2011-08-30	44	124	25	69	0.7587
EverQuest II	2011-12-07	1611	1744	474	2085	0.7581
GT Power Expansion	2011-04-21	3	31	4	7	0.7545999999999999
Nuclear Dawn	2011-09-25	5283	1865	521	5804	0.7545000000000001
Cossacks II: Battle for Europe	2011-08-26	135	678	180	315	0.7522
Nancy Drew: Shadow at the Water's Edge	2011-09-15	60	230	56	116	0.7488
Monday Night Combat	2011-01-25	7981	875	243	8224	0.7484999999999999
Cossacks: Art of War	2011-08-26	58	215	52	110	0.7484999999999999
Drakensang The River of Time	2011-02-16	50	263	66	116	0.7471
Lightfish	2011-10-19	8	136	31	39	0.7471
Cargo! - The quest for gravity	2011-04-21	104	312	80	184	0.7469
Hitogata Happa	2011-09-27	10	143	33	43	0.7467
Race Injection	2011-11-18	3	14	1	4	0.7453000000000001
Fate of the World	2011-02-28	675	328	88	763	0.7415
Saints Row: The Third - Initiation Station	2011-11-01	40	115	27	67	0.7403000000000001
Cities in Motion	2011-02-22	1170	788	231	1401	0.7393000000000001
Section 8: Prejudice	2011-05-04	2016	800	236	2252	0.7384999999999999
Portal 2 - The Final Hours	2011-05-17	450	521	149	599	0.7384999999999999
STCC II	2011-04-08	2	22	3	5	0.7375
Kohan: Immortal Sovereigns	2011-08-24	107	76	17	124	0.7364
Galactic Civilizations II: Ultimate Edition	2011-12-02	3946	1170	359	4305	0.736
The Retro Expansion	2011-06-23	1	34	6	7	0.7356
Blocks That Matter	2011-08-19	700	587	173	873	0.7354
Capsized	2011-04-29	218	810	248	466	0.733
RIFT	2011-03-01	15546	8016	2734	18280	0.7306999999999999
Sins of a Solar Empire: Trinity	2011-11-16	957	573	174	1131	0.7306
Demolition, Inc.	2011-09-19	413	222	63	476	0.7281000000000001
The Baconing	2011-08-31	202	183	51	253	0.7275
Dwarfs!?	2011-05-04	575	741	240	815	0.7232999999999999
CreaVures	2011-02-23	5	132	37	42	0.7212000000000001
Arma: Gold Edition	2011-07-13	110	851	284	394	0.7197
Puzzler World 2	2011-10-10	47	170	50	97	0.7190000000000001
Demigod	2011-12-14	786	844	283	1069	0.7189
Drakensang 2 - Phileasson's Secret	2011-05-13	19	60	15	34	0.7184999999999999
Lucid	2011-07-19	145	190	57	202	0.718
Majesty 2 Collection	2011-04-19	833	1016	348	1181	0.7170000000000001
The WTCC 2010 Pack	2011-05-20	2	25	5	7	0.7148000000000001
AaaaaAAaaaAAAaaAAAAaAAAAA!!! for the Awesome	2011-11-23	122	797	275	397	0.7137000000000001
Chantelise	2011-07-29	141	514	173	314	0.7134999999999999
Zeit²	2011-01-12	12	31	7	19	0.711
Hunted: The Demon's Forge	2011-05-31	797	823	291	1088	0.7099
Red Faction: Armageddon	2011-06-07	1839	3274	1225	3064	0.7095999999999999
Ancients of Ooga	2011-05-20	9	33	8	17	0.7059000000000001
Fractal: Make Blooms Not War	2011-06-06	60	155	51	111	0.7017
Runespell: Overture	2011-07-20	237	278	97	334	0.7008
Legend of Fae	2011-07-26	20	90	28	48	0.7004
Nancy Drew: Secrets Can Kill	2011-07-25	22	181	62	84	0.6981
Champions Online	2011-06-14	9794	2768	1100	10894	0.6977
Cossacks: European Wars	2011-08-26	81	341	127	208	0.6927
Kaptain Brawe: A Brawe New World	2011-01-20	25	101	34	59	0.6916
iBomber Defense	2011-05-26	34	169	62	96	0.6867
The First Templar	2011-05-12	103	648	263	366	0.6842
Xotic	2011-09-16	8	130	48	56	0.682
inMomentum	2011-10-31	9	129	48	57	0.6807
B.U.T.T.O.N.	2011-02-28	4	38	12	16	0.6804000000000001
Virtua Tennis 4	2011-06-24	288	229	91	379	0.6777
Critical Mass	2011-06-20	24	305	128	152	0.6715000000000001
Alien Zombie Megadeath	2011-10-18	6	52	19	25	0.6683
A.R.E.S.	2011-01-19	756	610	273	1029	0.6661
Patrician IV: Rise of a Dynasty	2011-04-11	167	291	128	295	0.6629
American Conquest - Fight Back	2011-08-26	60	329	148	208	0.6601
Who's That Flying?!	2011-01-31	14	112	47	61	0.66
Hamilton's Great Adventure	2011-05-31	125	210	94	219	0.6567000000000001
Shift 2 Unleashed	2011-03-29	400	1651	802	1202	0.6565000000000001
TRAUMA	2011-08-08	30	445	209	239	0.6548
From Dust	2011-08-17	9759	1756	882	10641	0.6502
Air Conflicts - Secret Wars	2011-07-15	87	274	132	219	0.6462000000000001
IL-2 Sturmovik: Cliffs of Dover	2011-07-19	1185	662	331	1516	0.6458
Vertex Dispenser	2011-06-10	15	23	9	24	0.6424
Mishap 2: An Intentional Haunting	2011-01-28	6	2	0	6	0.6408
American Conquest	2011-08-26	61	350	177	238	0.6393
Smash Cars	2011-10-17	7	30	13	20	0.6344
APB Reloaded	2011-12-07	11813	23091	13208	25021	0.6304
Robin Hood	2011-08-26	56	858	487	543	0.6222
Nancy Drew: Trail of the Twister	2011-07-25	23	78	41	64	0.6187
Memoir '44 Online	2011-10-12	994	369	209	1203	0.618
Pirates of Black Cove	2011-08-02	213	103	56	269	0.6157
LUXOR: 5th Passage 	2011-01-25	23	62	33	56	0.614
Inside a Star-filled Sky 	2011-05-14	11	60	32	43	0.6133
BRINK	2011-05-10	16824	4611	2828	19652	0.6117
Two Worlds II HD	2011-02-03	10863	3899	2400	13263	0.6104
Achron	2011-08-29	9	69	38	47	0.6095
DETOUR	2011-05-16	575	1103	681	1256	0.6059
Data Jammers: FastForward	2011-10-24	90	62	35	125	0.6042000000000001
Alien Hallway	2011-08-19	20	187	113	133	0.6012
Sengoku	2011-09-15	174	260	162	336	0.5972999999999999
Anno 2070	2011-11-17	11217	7044	4651	15868	0.5962
The Clockwork Man: The Hidden World	2011-09-23	16	47	28	44	0.5922999999999999
Steel Storm: Burning Retribution	2011-05-11	475	210	135	610	0.59
Hydrophobia: Prophecy	2011-05-09	705	1363	914	1619	0.589
Yar's Revenge	2011-04-28	4	43	27	31	0.5826
Zombie Pirates	2011-04-20	8	33	21	29	0.5779
Supreme Ruler Cold War	2011-07-29	87	118	80	167	0.5765
Tobe's Vertical Adventure	2011-07-18	9	79	53	62	0.5759000000000001
Dungeon Siege III	2011-06-21	4189	1523	1108	5297	0.5715
Sideway	2011-11-15	13	71	50	63	0.5663
Wasteland Angel	2011-09-01	9	178	129	138	0.5656
Trino	2011-01-27	2	8	5	7	0.5632
Ignite	2011-10-28	33	168	128	161	0.5554
Stroke of Fate: Operation Valkyrie	2011-10-28	8	16	12	20	0.5455
Dinner Date	2011-03-01	9	454	377	386	0.5402
The Clockwork Man	2011-08-10	19	46	37	56	0.5399
Cossacks II: Napoleonic Wars	2011-08-26	53	283	236	289	0.5384000000000001
Post Mortem	2011-08-26	24	181	153	177	0.5346000000000001
Astro Tripper	2011-09-15	6	34	28	34	0.5345000000000001
Armada 2526	2011-04-08	18	19	16	34	0.5283
Naval Warfare	2011-05-25	34	143	126	160	0.5257000000000001
Real Warfare	2011-11-30	11	47	42	53	0.5208
Grotesque Tactics 2 - Dungeons and Donuts	2011-11-21	61	121	112	173	0.5156000000000001
Elizabeth Find M.D. - Diagnosis Mystery - Season 2	2011-06-09	5	17	16	21	0.5099
PT Boats: Knights of the Sea	2011-10-28	6	20	19	25	0.5086
Agricultural Simulator 2011: Extended Edition	2011-02-23	24	89	86	110	0.5068
Serious Sam: The Random Encounter	2011-10-24	38	371	381	419	0.4943
PT Boats: South Gambit	2011-10-28	5	12	13	18	0.4875
Garshasp: The Monster Slayer	2011-05-09	6	173	186	192	0.485
Bunch Of Heroes	2011-09-21	2115	202	219	2334	0.48310000000000003
Might & Magic: Heroes VI	2011-10-13	9047	3895	4215	13262	0.4816
Painkiller: Redemption	2011-02-25	33	287	323	356	0.4748
Still Life 2	2011-06-01	37	211	247	284	0.4669
Lume	2011-05-09	36	223	267	303	0.4621
Real Warfare 2: Northern Crusades	2011-11-18	28	49	60	88	0.4618
Dungeons	2011-02-10	1475	321	393	1868	0.45659999999999995
Theatre of War 3: Korea	2011-03-24	20	76	98	118	0.4501
Sword of the Stars II: Enhanced Edition	2011-10-28	1379	398	506	1885	0.44799999999999995
Global Ops: Commando Libya	2011-10-26	26	149	219	245	0.42090000000000005
ArcaniA: Fall of Setarrif	2011-10-24	26	281	409	435	0.4202
Trapped Dead	2011-07-15	1385	297	433	1818	0.41960000000000003
Dungeons - The Dark Lord	2011-09-23	184	102	159	343	0.4112
Ironclads: Schleswig War 1864	2011-06-17	4	8	17	21	0.3875
Dead Mountaineer's Hotel	2011-10-28	10	35	67	77	0.38200000000000006
Ironclads: Anglo Russian War 1866	2011-06-17	5	9	20	25	0.3785
Hacker Evolution Duality	2011-08-15	54	174	335	389	0.3661
A Game of Thrones - Genesis	2011-09-29	742	234	449	1191	0.36469999999999997
Dead Horde	2011-07-27	98	219	432	530	0.3597
Disciples III: Resurrection	2011-10-12	69	86	178	247	0.3582
Death and the Fly	2011-05-24	2	3	10	12	0.35240000000000005
Shadow Harvest: Phantom Ops	2011-04-05	33	38	90	123	0.34390000000000004
Ironclads: Chincha Islands War 1866	2011-06-17	3	3	12	15	0.33020000000000005
APOX	2011-01-20	94	50	127	221	0.3282
Dungeons & Dragons: Daggerdale	2011-06-24	571	134	330	901	0.322
Star Raiders 	2011-05-11	2	6	27	29	0.2919
Airline Tycoon 2	2011-10-26	329	92	457	786	0.21730000000000002
Flatout 3	2011-12-13	47	555	2779	2826	0.1955
Mount & Blade: Warband	2010-03-31	33054	147120	3390	36444	0.9643
STAR WARS™ Empire at War: Gold Pack	2010-05-26	5716	30455	784	6500	0.9538
Fallout: New Vegas	2010-10-19	51038	169903	6245	57283	0.9523
Sid Meier's Civilization V	2010-09-21	91363	183717	7370	98733	0.9496
Batman: Arkham Asylum GOTY Edition	2010-03-26	6739	48359	1837	8576	0.9456
VVVVVV	2010-09-08	2174	8780	339	2513	0.9331
S.T.A.L.K.E.R.: Call of Pripyat	2010-02-11	1359	23316	1181	2540	0.9302
Recettear: An Item Shop's Tale	2010-09-10	2986	6456	261	3247	0.9287000000000001
Super Meat Boy	2010-11-30	5153	29793	1647	6800	0.9278000000000001
Amnesia: The Dark Descent	2010-09-08	5666	28992	1624	7290	0.927
Alien Swarm	2010-07-19	60467	19477	1054	61521	0.9261
Bejeweled 3	2010-12-07	1415	5447	230	1645	0.9254000000000001
Serious Sam Classic: The First Encounter	2010-03-22	158	2549	105	263	0.9175
Beat Hazard	2010-04-15	4123	6797	375	4498	0.9168000000000001
F.E.A.R.	2010-05-21	865	11934	771	1636	0.9138
Serious Sam Classic: The Second Encounter	2010-09-22	112	1534	60	172	0.9120999999999999
Monkey Island 2: Special Edition	2010-07-07	1813	2278	106	1919	0.9117000000000001
Metro 2033	2010-03-16	14743	28600	2214	16957	0.9091
Fallout: New Vegas PCR	2010-10-20	3777	13169	939	4716	0.909
Arma 2: Operation Arrowhead	2010-06-29	19175	20073	1664	20839	0.9025
Victoria II	2010-08-13	3419	15785	1301	4720	0.9013
Singularity	2010-07-01	831	4518	357	1188	0.8937
Just Cause 2	2010-03-23	7547	44665	4488	12035	0.8929
Call of Duty: Black Ops	2010-11-09	63343	29938	2999	66342	0.8911
Total War: NAPOLEON - Definitive Edition	2010-02-25	9935	18865	1841	11776	0.8905
Broken Sword 1 - Shadow of the Templars: Director's Cut	2010-08-26	155	2161	160	315	0.8893000000000001
Shatter	2010-03-08	2761	1138	72	2833	0.8885
Aliens vs. Predator	2010-02-16	3794	15303	1541	5335	0.8867
DeathSpank	2010-10-26	434	756	46	480	0.8835
Lara Croft and the Guardian of Light	2010-09-28	877	3789	355	1232	0.8806
Moonbase Alpha	2010-07-06	1443	11387	1224	2667	0.8795000000000001
Assassin's Creed II	2010-03-05	3617	37549	4444	8061	0.8782
Chime	2010-09-06	2099	675	46	2145	0.8761
Warhammer 40,000: Dawn of War II - Chaos Rising	2010-03-12	8132	2686	259	8391	0.8748
Faerie Solitaire	2010-09-16	2389	2276	224	2613	0.8715
BioShock 2	2010-02-09	4635	11737	1402	6037	0.8706999999999999
Darksiders	2010-09-23	3929	10528	1260	5189	0.8697
Eversion 	2010-06-07	178	1133	102	280	0.8684999999999999
Poker Night at the Inventory	2010-11-22	10146	7996	958	11104	0.8676
Fortix	2010-04-14	190	845	72	262	0.8674
King's Bounty: Crossworlds	2010-09-17	404	1076	98	502	0.8669
Shank	2010-10-26	573	2824	320	893	0.863
Nimbus	2010-10-25	88	227	13	101	0.8603000000000001
Supreme Commander 2	2010-03-02	3730	9856	1329	5059	0.8581000000000001
Tropico 3: Absolute Power	2010-05-17	1947	402	32	1979	0.8578
Flight Control HD	2010-11-18	1266	472	40	1306	0.8573999999999999
RUSH	2010-12-03	3944	1122	124	4068	0.8536
Farm Frenzy 2	2010-02-16	22	98	3	25	0.8534
Pirates, Vikings, & Knights II	2010-02-12	878	4946	681	1559	0.8508
Cossacks: Back to War	2010-09-02	384	2027	257	641	0.8497
Farming Simulator 2011	2010-10-29	674	680	74	748	0.8472
Puzzle Agent	2010-07-07	228	2129	282	510	0.8462999999999999
Nation Red	2010-08-10	6850	2354	316	7166	0.8462000000000001
Back to the Future: Ep 1 - It's About Time	2010-12-23	448	2023	267	715	0.8461
Puzzle Dimension	2010-06-21	43	438	45	88	0.8436
Lost Horizon	2010-09-24	74	382	38	112	0.8431000000000001
Toki Tori	2010-01-29	4511	1802	251	4762	0.8397
Sol Survivor	2010-03-15	4153	365	39	4192	0.8373
Worms Reloaded	2010-08-26	7814	3886	606	8420	0.8361000000000001
MX vs. ATV Reflex	2010-11-26	429	2888	440	869	0.8358
Battlefield: Bad Company™ 2	2010-03-02	21923	30873	5471	27394	0.8347
Riven	2010-08-04	82	949	132	214	0.8318000000000001
Sword of the Stars Complete Collection	2010-06-04	1005	531	67	1072	0.8314
Dragon Age: Origins - Awakening	2010-03-16	9	137	11	20	0.8312999999999999
Dawn of Discovery - Venice	2010-02-25	371	430	52	423	0.8311000000000001
Oddworld: Stranger's Wrath HD	2010-12-20	158	1216	177	335	0.8308
Age of Wonders: Shadow Magic	2010-10-11	123	455	57	180	0.8293
Anno 1404: Venice	2010-02-25	3677	1054	157	3834	0.8267
Puzzler World 	2010-05-28	81	339	42	123	0.8247
The Misadventures of P.B. Winterbottom	2010-04-20	120	385	50	170	0.8233
Jolly Rover	2010-06-07	18	286	35	53	0.8222
4 Elements	2010-07-12	262	633	93	355	0.8207
Farm Frenzy	2010-02-16	11	66	4	15	0.8201
Sonic and SEGA All Stars Racing	2010-03-03	100	2123	364	464	0.8200000000000001
Nancy Drew: Warnings at Waverly Academy	2010-01-13	36	200	23	59	0.8190000000000001
Gemini Lost	2010-05-06	7	38	1	8	0.8181
Zen Bound® 2	2010-11-16	39	480	72	111	0.8144
Farm Frenzy 3	2010-02-16	16	33	1	17	0.8092
Need for Speed: Hot Pursuit	2010-12-14	3005	16230	3462	6467	0.8077
Greed Corp	2010-12-10	850	447	74	924	0.8035
LEGO® Indiana Jones™ 2: The Adventure Continues	2010-02-18	95	1062	199	294	0.8023
NyxQuest	2010-09-27	5	103	12	17	0.8011
The Guild II: Renaissance	2010-07-28	1249	3026	639	1888	0.7981
Arsenal of Democracy	2010-02-24	97	287	49	146	0.7927
Secret of the Magic Crystal	2010-02-03	256	1372	294	550	0.7889
Fantasy Wars	2010-08-06	32	208	35	67	0.7879
Arma 2: British Armed Forces	2010-08-28	43	302	55	98	0.787
Alpha Protocol	2010-06-01	2427	3738	890	3317	0.7834000000000001
Pat & Mat	2010-11-05	25	387	76	101	0.783
Cradle of Rome	2010-02-20	37	41	4	41	0.7813
Puzzle Quest 2	2010-08-12	337	313	61	398	0.7803
Star Wolves	2010-03-03	55	307	62	117	0.7759999999999999
Flotilla	2010-04-20	214	181	34	248	0.7741
Super Laser Racer	2010-02-19	9	82	13	22	0.7712000000000001
Arma 2: Private Military Company	2010-11-30	44	291	61	105	0.7708
Star Ruler	2010-09-20	794	260	54	848	0.77
Nail'd	2010-11-30	147	944	231	378	0.7673000000000001
Eschalon: Book 2	2010-07-12	34	95	17	51	0.7643000000000001
BIT.TRIP BEAT	2010-11-02	4318	673	164	4482	0.7640000000000001
Star Wolves 3: Civil War	2010-03-03	573	483	115	688	0.7628
Archon:Classic	2010-11-01	8	131	26	34	0.7615999999999999
Age of Wonders 2: The Wizard's Throne	2010-09-25	59	231	51	110	0.7608
Dead Rising 2	2010-09-28	2812	4925	1389	4201	0.7599
Season of Mystery : The Cherry Blossom Murders	2010-02-04	69	219	50	119	0.7559
Blue Toad Murder Files - The Mysteries of Little Riddle	2010-12-03	11	87	17	28	0.7536
Zero Gear	2010-01-12	4659	696	186	4845	0.7515999999999999
Farm Frenzy Pizza Party	2010-02-16	9	25	3	12	0.7503000000000001
Age of Wonders	2010-10-11	86	638	172	258	0.7494
Lugaru HD 	2010-10-08	12	391	102	114	0.7478
Swords and Soldiers HD	2010-12-01	1235	738	207	1442	0.7452
Bloody Good Time	2010-10-29	778	776	223	1001	0.7422
Farm Frenzy 3 American Pie	2010-02-16	9	8	0	9	0.7419
Making History II: The War of the World	2010-08-27	346	283	76	422	0.7393000000000001
Oddworld: Munch's Oddysee	2010-12-20	122	685	207	329	0.7333
EVE Online	2010-12-16	10627	22612	7856	18483	0.7313
GridRunner Revolution	2010-02-23	4	55	12	16	0.7308
Blood Bowl: Legendary Edition	2010-10-28	2035	814	263	2298	0.7245
Hotel Dash	2010-05-06	16	66	16	32	0.7243
Grand Theft Auto: Episodes from Liberty City	2010-04-13	3013	7626	2705	5718	0.7234
Medal of Honor(TM) Single Player	2010-10-12	2285	5961	2111	4396	0.7226
UFO: Extraterrestrials Gold	2010-02-17	247	174	53	300	0.7145
The Fish Fillets 2	2010-11-05	25	197	61	86	0.7141
Clones	2010-11-18	1986	281	92	2078	0.7108
Darkest of Days	2010-02-08	177	230	74	251	0.7107
Alien Breed: Impact	2010-06-03	641	1172	421	1062	0.7101000000000001
The Ball	2010-10-26	3337	768	272	3609	0.7090000000000001
Puzzle Bots	2010-10-22	35	121	37	72	0.708
Voodoo Dice	2010-07-15	3	13	2	5	0.7075
X: Beyond the Frontier	2010-10-08	159	238	81	240	0.7027
Lead and Gold - Gangs of the Wild West	2010-04-08	5013	1557	604	5617	0.6986
Tom Clancy's Splinter Cell: Conviction	2010-04-29	3856	2574	1023	4879	0.6973
Alien Breed 3: Descent	2010-11-17	23	368	136	159	0.6948000000000001
The Polynomial	2010-10-15	28	354	131	159	0.6942
AquaNox 2: Revelation	2010-04-20	38	166	59	97	0.6912999999999999
Rocket Knight	2010-05-12	8	104	36	44	0.6881
Chaser	2010-07-16	40	807	325	365	0.6873
X-Tension	2010-10-08	56	83	29	85	0.6829999999999999
Cradle of Persia	2010-02-20	17	7	1	18	0.6815000000000001
Mishap: An Accidental Haunting	2010-02-11	6	13	3	9	0.6793000000000001
Axel & Pixel	2010-10-06	6	60	21	27	0.6769
Victoria: Revolutions	2010-08-20	47	160	63	110	0.6748000000000001
AquaNox	2010-04-20	27	234	95	122	0.6744
The Guild II	2010-06-24	674	540	230	904	0.6741
NecroVisioN: Lost Company	2010-02-19	45	327	137	182	0.6725
Diamond Dan	2010-10-08	6	42	15	21	0.6670999999999999
The Guild II - Pirates of the European Seas	2010-06-24	175	164	68	243	0.6668000000000001
Prince of Persia: The Forgotten Sands	2010-06-08	356	1243	579	935	0.6631999999999999
Alter Ego	2010-08-03	15	180	77	92	0.6627
Alien Breed 2: Assault	2010-09-22	363	630	290	653	0.6611
Swarm Arena	2010-08-19	8	45	17	25	0.6609
Lost Planet 2	2010-10-15	608	1731	833	1441	0.6586
Ion Assault	2010-11-17	267	111	49	316	0.6518
Bob Came in Pieces	2010-01-22	31	78	34	65	0.6491
The Otherside	2010-02-11	5	5	1	6	0.6478
Fitness Dash	2010-05-06	7	10	3	10	0.6476000000000001
Max and the Magic Marker	2010-05-12	12	39	16	28	0.6468
Hacker Evolution	2010-09-14	1831	646	334	2165	0.6392
Plain Sight	2010-04-05	1145	187	92	1237	0.639
Fluttabyes	2010-04-20	6	19	8	14	0.629
Wings of Prey	2010-01-08	2474	411	221	2695	0.6288
Kane & Lynch 2: Dog Days	2010-08-17	289	5192	2967	3256	0.6273
Tidalis	2010-07-16	47	149	78	125	0.6259
Emergency 2012	2010-11-22	38	6	2	40	0.621
Winter Voices	2010-10-29	94	161	89	183	0.6167
Front Mission Evolved	2010-09-28	769	654	393	1162	0.6093000000000001
The UnderGarden	2010-11-10	8	55	31	39	0.6032000000000001
Ziro	2010-05-28	6	21	11	17	0.6017
Grotesque Tactics: Evil Heroes	2010-10-15	381	266	163	544	0.6007
TriJinx	2010-05-06	4	5	2	6	0.5997
DogFighter	2010-06-14	555	262	164	719	0.5964
NightShift Legacy	2010-05-06	4	3	1	5	0.596
Delve Deeper	2010-09-24	259	252	161	420	0.5922
Dark Fall: Lost Souls	2010-04-21	136	145	92	228	0.5903
Mahjong Roadshow	2010-05-06	6	6	3	9	0.5833
Pound of Ground	2010-11-05	17	97	63	80	0.5832
Hacker Evolution - Untold	2010-09-14	2015	235	159	2174	0.5805
Sniper: Ghost Warrior	2010-06-24	1586	4151	3082	4668	0.5688000000000001
Aura: Fate of the Ages	2010-10-04	31	110	80	111	0.5627000000000001
ProtoGalaxy	2010-10-06	14	35	26	40	0.5525
Trainz: Settle & Carlisle	2010-10-01	5	27	20	25	0.5512
Air Forte 	2010-09-29	33	42	34	67	0.5384000000000001
Patrician IV: Steam Special Edition	2010-09-17	140	308	261	401	0.5352
Dark Void	2010-01-19	120	300	256	376	0.5337
Disciples III: Renaissance	2010-07-22	534	245	215	749	0.5275
Romance of Rome	2010-02-20	5	6	5	10	0.5239
Woody Two-Legs Attack of the Zombie Pirates	2010-10-29	7	32	28	35	0.5236999999999999
Tommy Tronic	2010-10-28	15	9	8	23	0.5171
Puzzle Chronicles	2010-04-21	8	22	21	29	0.5079
Ship Simulator Extremes	2010-08-27	229	1062	1028	1257	0.5073
Commander: Conquest of the Americas	2010-07-30	140	83	83	223	0.5
Valerie Porter	2010-05-06	3	6	6	9	0.5
Vancouver 2010: The Official Video Game of the Olympic Winter Games	2010-02-18	5	3	3	8	0.5
Booster Trooper	2010-04-23	29	96	101	130	0.48990000000000006
Numen: Contest of Heroes	2010-06-03	26	86	91	117	0.4888
AlternativA	2010-11-05	36	96	103	139	0.48600000000000004
Dark Void Zero	2010-04-12	63	138	149	212	0.4843
Haunted House	2010-09-29	6	13	15	21	0.4772
Arcadia	2010-12-02	4	37	43	47	0.47250000000000003
Doc Clock: The Toasted Sandwich of Time	2010-10-15	23	84	98	121	0.4696
NightShift Code	2010-05-06	5	3	4	9	0.4668
Hotel Giant 2	2010-01-27	26	114	146	172	0.45
Silent Hunter 5: Battle of the Atlantic	2010-03-04	394	1023	1292	1686	0.4475
Greed: Black Border	2010-01-13	83	127	175	258	0.43479999999999996
Burn Zombie Burn	2010-08-12	20	73	104	124	0.4308
M.U.D. TV	2010-03-31	114	71	102	216	0.4294
Blacklight: Tango Down	2010-07-14	19	145	211	230	0.42310000000000003
Ironclads: High Seas	2010-04-28	5	15	24	29	0.4226
DinerTown Detective Agency	2010-05-06	3	6	11	14	0.41450000000000004
Flight of the Icarus	2010-05-12	42	99	153	195	0.4131
Guardians of Graxia	2010-11-01	42	67	108	150	0.40759999999999996
Dive to the Titanic	2010-12-17	6	29	54	60	0.3891
Trainz: Classic Cabon City	2010-09-01	5	16	32	37	0.385
Turba	2010-06-23	55	49	91	146	0.38380000000000003
World Basketball Manager 2010	2010-04-21	7	40	87	94	0.3579
Future Wars	2010-07-15	32	90	210	242	0.33590000000000003
Dimensity	2010-07-21	5	5	17	22	0.33340000000000003
Power Of Defense	2010-08-04	3	9	30	33	0.3195
Hazen: The Dark Whispers	2010-04-28	4	12	39	43	0.3159
Biozone	2010-05-07	3	5	20	23	0.3125
Ironclads: American Civil War	2010-04-28	6	10	36	42	0.3061
Razor2: Hidden Skies	2010-07-19	12	55	161	173	0.3032
Command and Conquer 4: Tiberian Twilight	2010-03-16	1068	549	2557	3625	0.20550000000000002
Plants vs. Zombies: Game of the Year	2009-05-05	16225	100088	2645	18870	0.9596
LEGO® Star Wars™: The Complete Saga	2009-11-12	2004	19612	676	2680	0.9431
The Elder Scrolls IV: Oblivion 	2009-06-16	6390	38535	1761	8151	0.9376000000000001
The Elder Scrolls IV: Oblivion® Game of the Year Edition Deluxe	2009-06-16	0	38535	1761	1761	0.9376000000000001
Killing Floor	2009-05-14	24107	61129	3247	27354	0.9335
Trine	2009-07-02	2659	13320	577	3236	0.9325
The Elder Scrolls III: Morrowind	2009-06-16	1396	20817	1005	2401	0.9315000000000001
STAR WARS™ Republic Commando	2009-07-08	1267	13169	587	1854	0.9314
Machinarium	2009-10-16	1279	11373	524	1803	0.9289000000000001
Star Wars: Battlefront 2 (Classic, 2005)	2009-07-08	4789	46408	2796	7585	0.9259999999999999
The Secret of Monkey Island: Special Edition	2009-07-15	746	4713	226	972	0.9191
Call of Duty: Modern Warfare 2 (2009)	2009-11-12	22614	47660	3361	25975	0.9175
Fallout 2	2009-08-19	657	10964	673	1330	0.9158
Fallout	2009-08-19	8130	15024	1019	9149	0.9128000000000001
Braid	2009-04-10	947	8397	550	1497	0.9102
Alien Shooter	2009-05-27	1029	3104	165	1194	0.9102
Serious Sam HD: The First Encounter	2009-11-24	1214	6508	438	1652	0.9065000000000001
Zuma's Revenge	2009-09-15	290	1668	89	379	0.902
Everyday Genius: SquareLogic	2009-10-21	33	377	7	40	0.9015000000000001
Evil Genius	2009-06-22	1041	3158	209	1250	0.8998999999999999
Penumbra: Black Plague	2009-01-23	121	2208	137	258	0.8989
Dead Space (2008)	2009-01-09	2305	22528	2084	4389	0.8955
STAR WARS™ Knights of the Old Republic™	2009-09-05	5642	25338	2478	8120	0.892
Dragon Age: Origins	2009-11-06	7089	9525	854	7943	0.8919
Total War: EMPIRE - Definitive Edition	2009-03-04	27559	27412	2719	30278	0.8914
Indiana Jones and the Fate of Atlantis	2009-07-08	144	1087	66	210	0.8897
Company of Heroes: Tales of Valor	2009-04-09	2945	1959	150	3095	0.8861
Torchlight	2009-10-27	6217	5675	520	6737	0.886
Knights of Honor	2009-02-04	550	2012	163	713	0.883
Alien Shooter 2: Reloaded	2009-05-27	1444	2396	204	1648	0.882
Altitude	2009-12-04	4940	1692	145	5085	0.8772
Red Faction: Guerrilla Steam Edition	2009-09-15	5613	6736	726	6339	0.8752
Devil May Cry 4	2009-12-22	501	1910	178	679	0.8732
Majesty: Gold Edition	2009-09-04	132	471	32	164	0.8693000000000001
Warhammer 40,000: Dawn of War II	2009-02-18	18862	9530	1154	20016	0.868
Penumbra: Overture	2009-03-06	213	2842	303	516	0.8679000000000001
The Dig	2009-07-08	143	930	82	225	0.8668000000000001
King's Bounty: The Legend	2009-05-01	862	2522	272	1134	0.8656999999999999
Delta Force: Black Hawk Down	2009-06-18	36	611	49	85	0.8654999999999999
Thrillville: Off the Rails	2009-07-08	48	662	55	103	0.8648
King's Bounty: Armored Princess	2009-11-19	401	939	89	490	0.8622
Darkest Hour: Europe '44-'45	2009-06-09	1083	1839	200	1283	0.8614
Risen	2009-10-02	1382	7243	926	2308	0.861
Men of War	2009-05-06	664	2757	321	985	0.8605
Mini Ninjas	2009-10-09	255	3525	426	681	0.8598
Mirror's Edge	2009-01-14	3805	29294	4151	7956	0.8595999999999999
Sacrifice	2009-08-19	336	511	44	380	0.858
STAR WARS™: Dark Forces	2009-09-16	288	2349	276	564	0.8579000000000001
Resident Evil 5	2009-09-15	2585	29873	4348	6933	0.8568000000000001
Driver: Parallel Lines	2009-02-13	38	845	85	123	0.8564
Overlord II	2009-06-23	1702	3602	460	2162	0.8551000000000001
Anno 1404	2009-06-25	1070	1171	128	1198	0.8551000000000001
Spore: Galactic Adventures	2009-06-23	1517	5215	692	2209	0.8548
Unreal Tournament 3: Black Edition	2009-03-05	1514	3332	440	1954	0.8512000000000001
Delta Force: Land Warrior	2009-06-18	23	260	20	43	0.8501000000000001
Burnout Paradise: The Ultimate Box	2009-03-12	6284	11482	1702	7986	0.8495999999999999
Delta Force: Black Hawk Down - Team Sabre	2009-06-18	52	405	38	90	0.8481000000000001
Delta Force	2009-06-18	21	454	45	66	0.8467
LEGOⓇ Indiana Jones™: The Original Adventures	2009-07-08	177	2308	317	494	0.8438
Musaic Box	2009-03-19	16	228	19	35	0.8426
Armed and Dangerous	2009-07-08	8	231	21	29	0.8379000000000001
Dawn of Discovery	2009-06-30	268	373	41	309	0.8357
Cogs	2009-04-14	4532	759	98	4630	0.8351999999999999
F.E.A.R. 2: Project Origin	2009-02-12	4209	5844	949	5158	0.835
Tales of Monkey Island: Chapter 1 - Launch of the Screaming Narwhal	2009-07-07	294	563	70	364	0.8336
Command and Conquer: Red Alert 3	2009-01-08	2984	10162	1737	4721	0.833
Osmos	2009-08-18	486	1076	155	641	0.8301999999999999
Call of Juarez: Bound in Blood	2009-06-30	1444	2866	467	1911	0.8286
Emerald City Confidential	2009-08-12	9	74	4	13	0.8283
Loom	2009-07-08	18	472	61	79	0.8273
Nancy Drew: Legend of the Crystal Skull 	2009-07-17	27	136	12	39	0.826
Judge Dredd: Dredd vs Death	2009-03-26	164	851	124	288	0.8259000000000001
Tropico	2009-07-24	111	663	93	204	0.8257
Samorost 2	2009-12-11	86	1501	239	325	0.8243
Zeno Clash	2009-04-21	712	2410	405	1117	0.8235
Comanche 4	2009-06-18	20	221	25	45	0.8225
Crayon Physics Deluxe	2009-05-06	615	883	143	758	0.8159000000000001
Tachyon: The Fringe	2009-06-18	13	173	20	33	0.8151999999999999
Tales of Monkey Island: Chapter 3 - Lair of the Leviathan 	2009-09-29	328	90	8	336	0.8135
Command and Conquer: Red Alert 3 - Uprising	2009-10-06	1681	3500	662	2343	0.8131999999999999
Eternal Silence	2009-02-06	457	449	69	526	0.8109000000000001
Joint Operations: Combined Arms	2009-09-29	34	223	30	64	0.8094
Zombie Bowl-O-Rama	2009-10-15	17	337	52	69	0.8055
Dystopia	2009-02-06	387	868	155	542	0.8052
Europa Universalis III	2009-02-04	1315	1566	300	1615	0.8041
Men of War: Red Tide	2009-11-02	77	583	101	178	0.8029999999999999
Tales of Monkey Island: Chapter 2 - The Siege of Spinner Cay 	2009-08-20	136	105	12	148	0.8029000000000001
Tales of Monkey Island: Chapter 5 - Rise of the Pirate God	2009-12-09	194	115	14	208	0.8009999999999999
Spectromancer	2009-02-11	90	226	34	124	0.8001
Hearts of Iron II: Complete	2009-01-23	161	453	78	239	0.7997
Delta Force 2	2009-06-18	22	330	54	76	0.7995000000000001
Death to Spies: Moment of Truth	2009-08-07	60	384	65	125	0.7988
Eschalon: Book 1	2009-02-10	101	274	44	145	0.7979
Shattered Horizon	2009-11-04	1141	401	71	1212	0.7948000000000001
Zombie Shooter	2009-05-27	63	829	165	228	0.7922
AaAaAA!!! - A Reckless Disregard for Gravity	2009-09-03	4253	608	117	4370	0.792
Nancy Drew: The Phantom of Venice	2009-07-17	27	121	17	44	0.7915000000000001
AI War: Fleet Command	2009-10-22	5027	1263	264	5291	0.7911
Wandering Willows	2009-08-12	6	25	1	7	0.7904000000000001
King's Quest Collection	2009-07-23	107	260	45	152	0.7895000000000001
Mahjong Quest	2009-08-24	19	38	3	22	0.7883
Wallace & Gromit Ep 1: Fright of the Bumblebees	2009-03-24	112	158	25	137	0.7878000000000001
The Last Remnant	2009-04-09	1544	3210	737	2281	0.7874
Fallout 3 - Game of the Year Edition	2009-12-17	10401	32060	8075	18476	0.7865000000000001
Prototype	2009-06-10	1570	7823	1899	3469	0.7855
Medal of Honor: Airborne	2009-10-06	777	3770	902	1679	0.7828
Crash Time III	2009-11-25	38	452	91	129	0.7825
BRAINPIPE: A Plunge to Unhumanity	2009-07-06	5	154	26	31	0.7812000000000001
Madballs in...Babo: Invasion	2009-09-17	4017	236	44	4061	0.7801
Freedom Force vs. the 3rd Reich	2009-05-29	89	215	40	129	0.7785
Space Quest Collection	2009-07-23	95	279	55	150	0.7770999999999999
Obulis	2009-03-19	37	637	143	180	0.774
The Void	2009-12-15	289	804	186	475	0.773
Bad Rats	2009-07-20	1529	11669	3121	4650	0.7729
Coil	2009-03-19	7	129	24	31	0.7678
Caster	2009-03-19	3184	3196	843	4027	0.7674
MEVO & the Grooveriders	2009-03-19	7	24	2	9	0.7662000000000001
MiG-29 Fulcrum	2009-06-18	6	68	11	17	0.7643000000000001
Time Gentlemen, Please!	2009-08-25	35	545	130	165	0.7642
Warfare	2009-07-20	12	159	32	44	0.7642
Fallout Tactics	2009-08-19	222	1638	430	652	0.7626999999999999
Project Freedom	2009-10-14	6	143	29	35	0.7611
Far Cry 2	2009-09-23	2420	10496	3051	5471	0.7591
Dark Sector	2009-03-24	31	541	134	165	0.7591
Tom Clancy's EndWar	2009-02-25	160	620	158	318	0.7569
World of Zoo	2009-10-30	34	173	38	72	0.7561
Sherlock Holmes versus Jack the Ripper	2009-12-23	116	737	192	308	0.7559
Drakensang	2009-03-09	124	467	118	242	0.7545000000000001
TimeShift	2009-07-23	205	916	247	452	0.7533
Saints Row 2	2009-01-28	6509	14003	4263	10772	0.7526999999999999
Jewel Quest	2009-08-24	18	35	5	23	0.7524
Roogoo	2009-12-17	21	269	65	86	0.7523000000000001
Hearts of Iron III	2009-08-07	1551	4269	1262	2813	0.7515000000000001
Mightier	2009-03-19	7	34	5	12	0.7493000000000001
Combat Wings: Battle of Britain	2009-10-14	33	529	142	175	0.7477
Nancy Drew Dossier: Resorting to Danger!	2009-11-20	15	71	14	29	0.7476
Need for Speed: SHIFT	2009-10-06	621	2094	618	1239	0.7469
Ceville	2009-02-27	15	135	31	46	0.7461
Coconut Queen	2009-12-17	7	14	1	8	0.7453000000000001
FLOCK!	2009-04-07	45	170	41	86	0.7447
Second Sight	2009-02-13	11	126	29	40	0.7445
Two Worlds: Epic Edition	2009-04-30	9281	3936	1252	10533	0.7390000000000001
Kingpin	2009-08-19	15	282	77	92	0.737
Nancy Drew: The Haunting of Castle Malloy	2009-07-17	28	113	28	56	0.7336
F-16 Multirole Fighter	2009-06-18	10	85	20	30	0.7334999999999999
The Bard's Tale	2009-12-11	322	915	282	604	0.7331000000000001
Amazing Adventures Around the World	2009-04-15	28	56	12	40	0.7331000000000001
ItzaZoo	2009-12-09	9	12	1	10	0.7319
Indiana Jones and the Last Crusade	2009-07-08	18	214	59	77	0.7315
The Path	2009-03-19	83	643	197	280	0.7305
Supreme Ruler 2020: Gold	2009-07-09	221	182	50	271	0.7293000000000001
Virtual Families	2009-05-06	20	43	9	29	0.728
Delta Force: Xtreme	2009-06-18	12	115	30	42	0.7277
Tales of Monkey Island: Chapter 4 - The Trial and Execution of Guybrush Threepwood 	2009-10-30	22	91	23	45	0.7268000000000001
Kuros	2009-09-21	3	11	1	4	0.7242000000000001
Zenerchi	2009-08-12	5	11	1	6	0.7242000000000001
Mystery P.I.: The New York Fortune	2009-01-28	14	27	5	19	0.7238
Delta Force: Task Force Dagger	2009-06-18	19	111	30	49	0.7226
MDK	2009-09-16	9	229	68	77	0.7223
Larva Mortus	2009-03-19	40	560	180	220	0.7216
STAR WARS™: The Force Unleashed™ Ultimate Sith Edition	2009-12-16	1944	6458	2310	4254	0.7212000000000001
Championship Manager 2010	2009-09-11	447	97	26	473	0.721
Harvest: Massive Encounter	2009-01-23	53	113	33	86	0.713
The Wizard's Pen	2009-02-18	9	28	6	15	0.7126
Chains	2009-07-01	26	452	153	179	0.7112
Blueberry Garden	2009-06-10	14	114	34	48	0.7103
Gratuitous Space Battles	2009-11-16	3231	602	210	3441	0.7093
Magnetis	2009-11-05	8	33	8	16	0.7059000000000001
Bionic Commando	2009-07-28	200	1047	384	584	0.7057
Paws & Claws: Pet School	2009-07-17	4	9	1	5	0.7057
Light of Altair	2009-06-04	67	36	9	76	0.7051999999999999
Restaurant Empire II	2009-05-27	47	239	81	128	0.7034
Grand Ages: Rome	2009-03-20	308	509	184	492	0.7018000000000001
Build-A-Lot 3	2009-12-17	9	12	2	11	0.6990999999999999
Elven Legacy	2009-04-07	46	113	38	84	0.6936
Order of War	2009-09-22	170	422	159	329	0.693
Sherlock Holmes: The Awakened (2008)	2009-08-06	85	446	169	254	0.6926000000000001
Wedding Dash 2: Rings Around the World	2009-08-12	17	38	11	28	0.6907
Battlestations: Pacific	2009-05-12	380	1722	713	1093	0.6874
Hammerfight	2009-10-28	636	1318	544	1180	0.6863
Nancy Drew: The White Wolf of Icicle Creek	2009-07-17	38	123	44	82	0.6859000000000001
Mystery P.I.: Lost in Los Angeles	2009-07-27	20	30	9	29	0.6805
Armored Fist 3	2009-06-18	7	51	17	24	0.6801
America's Army 3	2009-06-17	5735	1675	721	6456	0.68
Rise of the Argonauts	2009-01-07	203	510	210	413	0.6796
Port Royale 2	2009-06-16	82	376	156	238	0.6755
Cake Mania	2009-07-17	12	57	20	32	0.6755
Diaper Dash	2009-08-12	5	18	5	10	0.674
Majesty 2	2009-09-17	773	667	293	1066	0.6701
King Arthur - The Role-playing Wargame	2009-11-25	3042	384	165	3207	0.6696
Helldorado	2009-04-30	50	102	40	90	0.6693000000000001
And Yet It Moves	2009-04-02	4148	838	376	4524	0.6678000000000001
Operation Flashpoint: Dragon Rising	2009-10-06	943	1519	711	1654	0.6634000000000001
Clutch	2009-07-17	11	146	62	73	0.6615000000000001
Call of Cthulhu: Dark Corners of the Earth	2009-06-16	87	1925	917	1004	0.6612
Watchmen: The End Is Nigh	2009-03-04	123	335	150	273	0.6611
NecroVisioN	2009-05-20	222	920	435	657	0.6586
Nancy Drew: The Creature of Kapu Cave	2009-07-17	19	78	32	51	0.6584000000000001
Build-A-Lot 4	2009-12-17	12	18	6	18	0.6551
Space Giraffe	2009-03-19	4	52	21	25	0.6542
Midnight Mysteries: The Edgar Allan Poe Conspiracy	2009-09-28	34	112	49	83	0.6534000000000001
Cooking Dash	2009-08-12	14	67	28	42	0.6533
Earthworm Jim 2	2009-11-04	5	69	29	34	0.6529
Chocolatier: Decadence by Design	2009-08-12	18	136	61	79	0.6516
Rogue Warrior	2009-12-01	37	852	417	454	0.6515000000000001
Street Fighter IV	2009-07-07	894	340	161	1055	0.6512000000000001
Escape Rosecliff Island	2009-04-15	157	162	77	234	0.6437
Lucidity	2009-10-07	6	44	19	25	0.6417
Codename: Panzers - Cold War	2009-05-06	102	156	78	180	0.6344
Chronicles of Mystery: The Scorpio Ritual	2009-06-18	9	90	44	53	0.6324000000000001
Alien Shooter: Revisited	2009-05-27	919	409	216	1135	0.6322
Nancy Drew Dossier: Lights, Camera, Curses!	2009-07-17	12	42	20	32	0.6264000000000001
Nancy Drew: Ransom of the Seven Ships 	2009-07-21	20	40	19	39	0.6261
QuantZ	2009-09-03	4	30	14	18	0.624
Smashball	2009-06-18	971	160	85	1056	0.6239
Watchmen: The End Is Nigh Part 2	2009-07-29	33	133	70	103	0.6239
Yumsters! 2: Around the World!	2009-03-19	6	57	29	35	0.6204
ItzaBitza	2009-10-14	11	8	3	14	0.6197
F-22 Lightning 3	2009-06-18	8	99	53	61	0.618
Ankh 3: Battle of the Gods	2009-06-16	5	23	11	16	0.616
Metal Drift	2009-10-22	77	87	47	124	0.6152000000000001
Ankh 2: Heart of Osiris	2009-06-16	12	37	19	31	0.6131000000000001
3D Ultra Minigolf Adventures Deluxe	2009-07-23	16	75	41	57	0.6116
X-Blades	2009-04-30	4840	1905	1175	6015	0.6079
Monster Trucks Nitro	2009-01-29	157	29	16	173	0.5988
Bionic Commando Rearmed	2009-07-28	102	587	376	478	0.5957
Foreign Legion: Buckets of Blood	2009-08-03	14	192	120	134	0.5949
Maelstrom	2009-02-13	65	93	57	122	0.5935
BC Kings	2009-06-16	27	117	73	100	0.5920000000000001
The Graveyard	2009-03-09	12	354	230	242	0.5906
Dangerous High School Girls in Trouble!	2009-02-23	70	121	79	149	0.5837
Yosumin!	2009-05-26	39	122	80	119	0.583
Sherlock Holmes: The Secret of the Silver Earring	2009-08-06	38	305	208	246	0.5801
Ninja Blade	2009-11-19	53	188	132	185	0.5721
Mata Hari	2009-07-29	7	70	49	56	0.5674
Puzzle Kingdoms	2009-04-27	58	170	123	181	0.5657
Delta Force: Xtreme 2	2009-06-18	25	110	83	108	0.5556
Death Track: Resurrection	2009-05-06	12	77	58	70	0.5543
Dawn of Magic 2	2009-09-11	9	53	40	49	0.5521
9th Company - Roots of Terror	2009-12-03	20	115	89	109	0.5509000000000001
Freedom Force	2009-05-29	343	269	215	558	0.5471
Between IGF Demo	2009-03-20	12	25	19	31	0.5465
DinerTown Tycoon	2009-10-02	7	12	9	16	0.5433
Cricket Revolution	2009-10-29	18	69	56	74	0.5399
Flora's Fruit Farm	2009-10-01	19	85	70	89	0.5378000000000001
Nikopol: Secrets of the Immortals	2009-07-30	28	193	161	189	0.5375
East India Company	2009-07-31	72	86	72	144	0.5347
Summer Athletics	2009-04-02	7	22	18	25	0.5337
XIII Century	2009-08-28	10	89	75	85	0.5335
Red Faction II	2009-08-06	84	532	481	565	0.522
STAR WARS™ Starfighter™	2009-07-08	164	309	280	444	0.521
Mayhem Intergalactic	2009-01-22	11	13	12	23	0.5125
Earthworm Jim 3D	2009-11-04	4	53	55	59	0.493
ValveTestApp901147	2009-11-04	0	64	68	68	0.4883
STAR WARS™: The Clone Wars - Republic Heroes™	2009-10-06	72	360	398	470	0.4783
Puzzle Quest: Galactrix	2009-02-24	730	145	164	894	0.4747
Aces of the Galaxy	2009-07-23	7	18	21	28	0.4742
Damnation	2009-05-22	69	192	229	298	0.4632
Paws & Claws: Pampered Pets	2009-07-17	2	2	3	5	0.4583
Time of Shadows	2009-09-11	10	7	11	21	0.4347
Samantha Swift and the Golden Touch	2009-04-29	12	34	52	64	0.4226
Hospital Tycoon	2009-02-13	356	231	340	696	0.41869999999999996
Age of Booty	2009-03-09	53	77	120	173	0.4131
Tunnel Rats 1968	2009-05-15	2	14	25	27	0.4054
Tom Clancy's Splinter Cell: Double Agent	2009-02-13	157	533	839	996	0.4012
Twin Sector	2009-09-16	18	101	171	189	0.3951
Killing Floor Mod: Defence Alliance 2	2009-12-12	617	330	543	1160	0.39390000000000003
SlamIt Pinball: Big Score	2009-02-23	12	42	81	93	0.3786
Drug Wars	2009-03-17	16	13	30	46	0.36560000000000004
Diner Dash: Hometown Hero	2009-08-12	16	70	149	165	0.3552
All Aspect Warfare	2009-08-17	2	3	10	12	0.35240000000000005
Angle of Attack	2009-08-17	2	0	3	5	0.32939999999999997
Sherlock Holmes: The Mystery of The Mummy	2009-08-06	30	114	286	316	0.3204
Sacraboar	2009-11-06	8	16	49	57	0.3181
Painkiller: Resurrection	2009-10-27	10	133	362	372	0.3044
Perimeter 2: New Earth	2009-02-10	23	14	55	78	0.2856
Raycatcher	2009-04-17	3	1	14	17	0.2547
Left 4 Dead	2008-11-17	30616	45550	1763	32379	0.9446
Audiosurf	2008-02-15	5977	10151	442	6419	0.9301
Warhammer 40,000: Dawn of War - Soulstorm	2008-03-05	3283	13549	633	3916	0.9297
Defense Grid: The Awakening	2008-12-08	7534	4485	166	7700	0.9278000000000001
Unreal Tournament 2004	2008-03-17	504	3561	130	634	0.9256000000000001
Unreal Tournament: Game of the Year Edition	2008-03-17	147	3647	147	294	0.9227
Max Payne 2: The Fall of Max Payne	2008-01-04	189	7041	399	588	0.9159
Mass Effect (2007)	2008-12-19	4183	15052	999	5182	0.914
Peggle Nights	2008-10-15	211	1501	59	270	0.9117000000000001
World of Goo	2008-10-13	2045	4970	294	2339	0.9105
X-COM: UFO Defense	2008-09-04	653	3188	177	830	0.9086
Grand Theft Auto: Vice City	2008-01-04	1239	25328	2035	3274	0.9059999999999999
Spore	2008-12-19	5630	46269	3926	9556	0.9056000000000001
Grand Theft Auto: San Andreas	2008-01-04	3387	72249	6468	9855	0.9037999999999999
TrackMania United Forever	2008-04-16	1345	2046	116	1461	0.9020999999999999
Call of Duty: World at War	2008-11-18	4825	40627	3650	8475	0.9009
Oddworld: Abe's Exoddus	2008-08-28	60	1331	72	132	0.898
Mount & Blade	2008-11-04	1918	5395	440	2358	0.8934000000000001
Heroes of Might & Magic V: Tribes of the East	2008-10-10	669	2181	163	832	0.8887999999999999
Overlord: Raising Hell	2008-02-28	1354	1736	123	1477	0.8887999999999999
Synergy	2008-10-03	1139	8129	781	1920	0.8856999999999999
RollerCoaster Tycoon 3: Platinum!	2008-03-12	2800	4548	430	3230	0.8817
Tom Clancy's Ghost Recon	2008-07-15	81	1090	84	165	0.8774
TrackMania Nations Forever	2008-04-16	1466	18822	2233	3699	0.8743000000000001
The Witcher: Enhanced Edition	2008-09-16	12685	64428	8271	20956	0.8729000000000001
Max Payne	2008-01-04	727	10391	1233	1960	0.8704000000000001
Tom Clancy's Rainbow Six 3: Gold Edition	2008-09-25	200	1478	137	337	0.8703000000000001
Brothers in Arms: Hell's Highway	2008-10-08	360	1549	162	522	0.8622
LEGO® Batman™: The Videogame	2008-10-10	1052	7142	906	1958	0.8616
Grand Theft Auto 2	2008-01-04	73	327	26	99	0.8534999999999999
Spore: Creepy & Cute Parts Pack	2008-12-19	528	1484	174	702	0.8527
Strong Bad Episode 1: Homestar Ruiner	2008-12-18	52	357	30	82	0.8523000000000001
IL-2 Sturmovik: 1946	2008-06-13	146	2287	287	433	0.8520000000000001
Penguins Arena: Sedna's World	2008-12-18	391	1150	136	527	0.8486
Unreal Gold	2008-03-17	2607	1973	261	2868	0.8456
Insurgency: Modern Infantry Combat	2008-10-03	2533	2071	279	2812	0.8444
Grand Theft Auto III	2008-01-04	640	11703	1826	2466	0.8442000000000001
Heroes of Might & Magic V	2008-05-13	1720	2759	386	2106	0.8439
Plant Tycoon	2008-05-12	28	140	9	37	0.8423
Aquaria	2008-12-15	99	1237	166	265	0.8386
S.T.A.L.K.E.R.: Clear Sky	2008-09-15	889	14495	2409	3298	0.8384
Tom Clancy's Splinter Cell	2008-04-01	421	2132	310	731	0.8373999999999999
FlatOut: Ultimate Carnage	2008-08-19	168	3731	576	744	0.8368000000000001
Brothers in Arms: Road to Hill 30	2008-05-13	97	1248	171	268	0.8368000000000001
Silent Hunter III	2008-06-13	237	1754	253	490	0.836
Age of Chivalry	2008-10-03	2399	1991	292	2691	0.8358
X-COM: Apocalypse	2008-09-04	111	694	88	199	0.8353
Beyond Good & Evil	2008-05-13	274	2667	407	681	0.8348000000000001
Tom Clancy's Ghost Recon: Desert Siege	2008-07-15	14	97	6	20	0.8326000000000001
Act of War: Direct Action	2008-03-12	37	433	52	89	0.8318000000000001
Bully: Scholarship Edition	2008-10-21	2010	22364	4061	6071	0.8301999999999999
Everyday Shooter	2008-05-08	6	99	7	13	0.8277
Oddworld: Abe's Oddysee	2008-08-28	45049	3478	587	45636	0.8265000000000001
Brothers in Arms: Earned in Blood	2008-10-10	45	661	92	137	0.8264
Prince of Persia: The Sands of Time	2008-11-21	392	2602	431	823	0.8259000000000001
Zombie Panic! Source	2008-10-03	2996	6283	1113	4109	0.8256
Crysis Warhead	2008-09-17	927	2922	500	1427	0.8233
Tom Clancy's Rainbow Six: Vegas 2	2008-04-16	1734	4159	733	2467	0.823
Midnight Club II	2008-01-04	62	775	116	178	0.8220000000000001
Puzzle Quest	2008-01-29	1392	827	125	1517	0.8219
X3: Terran Conflict	2008-10-16	1442	2232	379	1821	0.8216
Assassin's Creed	2008-04-10	1468	13055	2512	3980	0.8201
Sacred Gold	2008-07-09	200	2976	534	734	0.8181
Prince of Persia: Warrior Within	2008-11-21	168	2068	367	535	0.8159000000000001
Empires	2008-07-28	126	833	135	261	0.8150000000000001
Mare Nostrum	2008-10-17	298	159	18	316	0.8146
Sid Meier's Civilization IV: Colonization	2008-09-23	729	920	153	882	0.8137000000000001
Virtual Villagers 3: The Secret City	2008-05-28	21	96	9	30	0.8125
Sam & Max 201: Ice Station Santa	2008-05-16	33	160	20	53	0.8076000000000001
Luxor 3	2008-06-10	16	131	16	32	0.8043000000000001
Far Cry	2008-04-01	1267	6256	1316	2583	0.804
Cold Fear	2008-05-13	19	737	137	156	0.7986
Virtual Villagers 2: The Lost Children	2008-05-12	15	54	5	20	0.7942
Sam & Max 204: Chariots of the Dogs	2008-05-16	13	66	7	20	0.7935
Rayman: Raving Rabbids	2008-06-13	30	880	175	205	0.793
Tom Clancy's Ghost Recon: Island Thunder	2008-07-15	11	97	13	24	0.7893000000000001
Heroes of Might & Magic V: Hammers of Fate	2008-10-10	77	225	38	115	0.7892
Grand Theft Auto	2008-01-04	123	306	55	178	0.7886
Sam & Max 203: Night of the Raving Dead	2008-05-16	14	68	8	22	0.788
Imperium Romanum: Gold Edition	2008-11-25	219	341	63	282	0.7876000000000001
Grand Theft Auto IV: The Complete Edition	2008-12-02	11696	97509	25691	37387	0.7829
Bejeweled Twist	2008-11-18	38	326	63	101	0.7819
Fallout 3	2008-10-28	2653	14441	3678	6331	0.7815000000000001
Trials 2: Second Edition	2008-05-28	224	205	37	261	0.7807
Crysis	2008-09-17	2237	10151	2596	4833	0.7791
DarkStar One	2008-02-14	78	423	90	168	0.775
Children of the Nile	2008-07-08	40	323	67	107	0.7737999999999999
Ninja Reflex: Steamworks Edition	2008-03-21	5	53	7	12	0.7721
Multiwinia	2008-09-19	102	448	99	201	0.7712000000000001
Sam & Max 205: What's New Beelzebub?	2008-05-16	11	61	9	20	0.7685
Act of War: High Treason	2008-03-12	38	359	79	117	0.7684000000000001
Virtual Villagers: A New Home	2008-05-12	19	88	15	34	0.7668
Tom Clancy's Rainbow Six: Vegas	2008-04-09	116	851	213	329	0.763
Prince of Persia	2008-12-10	428	2043	561	989	0.7579000000000001
Prince of Persia: The Two Thrones	2008-11-21	98	1225	327	425	0.7576
Fish Tycoon	2008-05-12	17	67	12	29	0.755
Children of the Nile: Alexandria	2008-09-22	31	116	25	56	0.7501000000000001
Crazy Machines	2008-12-12	43	137	31	74	0.7481
D.I.P.R.I.P. Warm Up	2008-10-03	588	317	81	669	0.7476
Tomb Raider: Underworld	2008-11-21	415	3917	1218	1633	0.7427
Mr. Robot	2008-11-03	8	68	14	22	0.7422
Max Payne (IT)	2008-01-04	17	129	31	48	0.7399
Silent Hunter: Wolves of the Pacific U-Boat Missions	2008-06-13	45	198	52	97	0.7367
Need for Speed: Undercover	2008-12-19	634	5717	1921	2555	0.7317
Hunting Unlimited 2008	2008-01-29	9	48	10	19	0.7316
The Wonderful End of the World	2008-07-17	2454	477	142	2596	0.7315
Sam & Max 202: Moai Better Blues	2008-05-16	17	66	15	32	0.7313
Hinterland	2008-09-30	196	177	49	245	0.7279000000000001
Lumines: Advanced Pack	2008-04-18	5	20	3	8	0.7276
Spectraball	2008-10-20	350	364	112	462	0.7234
7 Wonders II	2008-06-10	38	137	38	76	0.7232
Starscape	2008-11-03	9	67	17	26	0.7195
Gravitron 2	2008-09-30	19	26	5	24	0.7194
Death to Spies	2008-03-12	115	614	206	321	0.7158
GTR Evolution	2008-09-01	516	207	64	580	0.715
Xpand Rally Xtreme	2008-10-08	19	229	72	91	0.7141
Luxor: Quest for the Afterlife	2008-12-16	14	73	20	34	0.7123999999999999
City Life 2008	2008-09-29	41	140	43	84	0.7099
Mystery PI: The Vegas Heist	2008-06-05	12	34	8	20	0.7098000000000001
Depths of Peril	2008-11-26	13	100	30	43	0.7072
Insecticide Part 1	2008-07-01	70	333	118	188	0.7005
Sherlock Holmes: Nemesis	2008-08-07	96	346	133	229	0.6877
18 Wheels of Steel: American Long Haul	2008-01-29	37	330	127	164	0.687
Petz Horsez 2	2008-06-13	24	122	44	68	0.6846
Manhunt	2008-01-04	104	2701	1179	1283	0.6798000000000001
Chaos Theory	2008-05-22	3	10	2	5	0.6793000000000001
Culpa Innata	2008-01-18	7	70	25	32	0.6769
Gumboy Tournament	2008-05-19	43	330	138	181	0.6729
7 Wonders: The Treasures of Seven	2008-11-14	147	91	35	182	0.6705
The Sum of All Fears	2008-10-10	5	27	9	14	0.6657
Silent Hunter: Wolves of the Pacific	2008-06-13	118	589	267	385	0.6635
Unreal II: The Awakening	2008-03-17	76	382	170	246	0.6633
Mahjongg Investigations: Under Suspicion	2008-07-29	7	24	8	15	0.6627
Silverfall: Earth Awakening	2008-07-18	35	57	22	57	0.6623
Arma: Combat Operations	2008-03-12	103	173	77	180	0.6556000000000001
Dracula: Origin	2008-08-07	42	165	77	119	0.647
Frontlines: Fuel of War	2008-02-27	1271	576	291	1562	0.6429
Luxor	2008-06-10	21	63	29	50	0.6376
Europa Universalis: Rome - Gold Edition	2008-12-18	117	149	74	191	0.6352000000000001
Little Farm	2008-06-10	13	77	37	50	0.6334000000000001
STCC: The Game	2008-10-22	59	18	8	67	0.621
Luxor: Amun Rising	2008-06-10	13	17	8	21	0.6125
Mosby's Confederacy	2008-11-19	5	24	13	18	0.5989
RACE 07: Andy Priaulx Crowne Plaza Raceway	2008-06-25	199	47	28	227	0.5922999999999999
Pyroblazer	2008-11-13	3	6	3	6	0.5833
Bone: The Great Cow Race	2008-06-17	10	64	41	51	0.5826
Jack Keane	2008-06-27	341	62	40	381	0.5811000000000001
Tom Clancy's Rainbow Six: Lockdown	2008-05-13	29	211	148	177	0.5728
Pacific Storm	2008-06-24	100	29	19	119	0.5719
Pacific Storm: Allies	2008-08-18	136	117	83	219	0.5678
Tank Universal	2008-08-21	46	253	183	229	0.5674
Crazy Machines 1.5	2008-12-12	1	2	1	2	0.5569
Samantha Swift and the Hidden Roses of Athena	2008-10-31	9	46	34	43	0.555
Exodus from the Earth	2008-10-24	466	116	91	557	0.5483
The Club	2008-02-20	58	84	66	124	0.5468000000000001
X-COM: Enforcer	2008-09-04	28	207	167	195	0.5445000000000001
Legendary	2008-12-01	169	1332	1119	1288	0.5393
Telltale Texas Hold'Em	2008-06-17	14	119	100	114	0.5347999999999999
Project Aftermath	2008-10-03	6	11	9	15	0.53
X-COM: Interceptor	2008-09-04	22	90	78	100	0.5281
Bone: Out from Boneville	2008-06-17	16	98	88	104	0.5213
Sprint Cars: Road to Knoxville	2008-07-29	13	32	29	42	0.5175
Conflict: Denied Ops	2008-02-08	24	185	174	198	0.5127
Space Trader: Merchant Marine	2008-10-23	67	312	320	387	0.49460000000000004
Dr. Daisy: Pet Vet	2008-07-29	3	12	13	16	0.4875
Silent Hill: Homecoming	2008-11-06	79	1137	1227	1306	0.4828
Crazy Machines 2	2008-06-20	223	114	128	351	0.47659999999999997
Brain Spa	2008-10-10	6	4	5	11	0.4722
Hot Dish	2008-07-29	3	14	17	20	0.4687
Desperados 2: Cooper’s Revenge	2008-03-12	21	105	124	145	0.46659999999999996
Ride! Carnival Tycoon	2008-07-29	7	20	27	34	0.44880000000000003
Planet Busters	2008-06-30	2	1	2	4	0.44310000000000005
Discovery! A Seek & Find Adventure	2008-07-29	8	26	36	44	0.4425
Luxor 2	2008-06-10	29	13	20	49	0.43060000000000004
Tycoon City: New York	2008-03-12	15	94	143	158	0.4165
Galactic Bowling	2008-10-21	4	6	11	15	0.41450000000000004
Beijing 2008	2008-08-14	6	0	1	7	0.4058
Midnight Outlaw: 6 Hours to Sun Up	2008-07-29	3	15	32	35	0.3755
Eternity's Child	2008-07-31	3	17	58	61	0.3009
Prison Tycoon 3: Lockdown	2008-01-29	17	25	96	113	0.2757
Portal	2007-10-10	20672	126704	1934	22606	0.9709000000000001
Half-Life 2: Episode Two	2007-10-10	1419	32528	982	2401	0.9503
DOOM (1993)	2007-08-03	309	14056	489	798	0.9403
Peggle Deluxe	2007-03-06	428	5555	173	601	0.9351
Quake	2007-08-03	2874	11220	437	3311	0.9349
Warhammer 40,000: Dawn of War - Dark Crusade	2007-08-07	2259	6937	240	2499	0.9343000000000001
Team Fortress 2	2007-10-10	167951	886744	58942	226893	0.9307
S.T.A.L.K.E.R.: Shadow of Chernobyl	2007-08-31	2308	32622	1907	4215	0.9256000000000001
Sid Meier's Civilization IV: Beyond the Sword	2007-07-24	2636	3552	136	2772	0.924
Deus Ex: Game of the Year Edition	2007-03-29	1102	11852	638	1740	0.9227
BioShock	2007-08-21	2674	27027	1668	4342	0.9218000000000001
Vampire: The Masquerade - Bloodlines	2007-03-22	3251	11235	612	3863	0.9217000000000001
Warhammer 40,000: Dawn of War - Game of the Year Edition	2007-08-07	3241	8236	424	3665	0.9216
Rome: Total War	2007-08-28	4413	14087	812	5225	0.9208
DOOM II	2007-08-03	149	6732	351	500	0.9192
Hitman: Blood Money	2007-03-15	1138	10491	635	1773	0.9161
Quake III Arena	2007-08-03	125	2957	142	267	0.9138
Call of Duty 4: Modern Warfare (2007)	2007-11-12	1796	19064	1323	3119	0.9131999999999999
Company of Heroes - Legacy Edition	2007-07-17	3344	6056	413	3757	0.9051
Overlord	2007-10-26	2303	5269	370	2673	0.9020999999999999
Return to Castle Wolfenstein	2007-08-03	579	6573	481	1060	0.9018
Wolfenstein 3D	2007-08-03	91	2995	197	288	0.8997
FlatOut	2007-02-02	84	3872	317	401	0.8898999999999999
Peggle Extreme	2007-09-11	165	1459	99	264	0.8887
Commander Keen Complete Pack	2007-08-03	101	1263	88	189	0.8852
Heretic: Shadow of the Serpent Riders	2007-08-03	34	840	53	87	0.8837
Quake II	2007-08-03	141	3367	330	471	0.8761
Quake Mission Pack 1: Scourge of Armagon	2007-08-03	14	404	25	39	0.8704999999999999
Rogue Trooper	2007-03-29	59	376	25	84	0.8656999999999999
Company of Heroes: Opposing Fronts	2007-09-27	1426	907	81	1507	0.8656
The Longest Journey	2007-05-01	362	1649	168	530	0.865
DOOM 3	2007-08-03	560	5971	719	1279	0.8648
Commandos: Behind Enemy Lines	2007-03-15	289	2847	341	630	0.8584
X-COM: Terror from the Deep	2007-05-04	126	665	65	191	0.8545
Warhammer 40,000: Dawn of War - Winter Assault	2007-08-07	704	1562	183	887	0.8534
Painkiller: Black Edition	2007-01-24	232	1418	167	399	0.8517
Tomb Raider: Legend	2007-03-29	287	3787	511	798	0.8504
Geometry Wars: Retro Evolved	2007-06-18	75	812	90	165	0.8486
Sid Meier's Civilization IV: Warlords	2007-04-06	402	344	31	433	0.8473
Quake Mission Pack 2: Dissolution of Eternity	2007-08-03	13	301	27	40	0.8447
Railroad Tycoon 2: Platinum	2007-05-04	239	970	122	361	0.841
Arx Fatalis	2007-04-03	93	1468	212	305	0.8338
Sam & Max 101: Culture Shock	2007-06-15	162	438	52	214	0.8329000000000001
Commandos: Beyond the Call of Duty	2007-03-15	77	765	103	180	0.8316
Hexen: Beyond Heretic	2007-08-03	21	508	64	85	0.8307
Stubbs the Zombie in Rebel Without a Pulse	2007-05-17	403	1500	228	631	0.8290000000000001
Commandos 2: Men of Courage	2007-03-15	164	2075	353	517	0.8207
RACE 07	2007-10-15	1199	2133	382	1581	0.8151999999999999
Sam & Max 105: Reality 2.0	2007-06-15	23	83	7	30	0.8136
Final DOOM	2007-08-03	35	1051	179	214	0.8128000000000001
Sam & Max 102: Situation: Comedy	2007-06-15	66	103	10	76	0.8126000000000001
Championship Manager 2007	2007-03-29	64	58	4	68	0.8104000000000001
Hitman 2: Silent Assassin	2007-03-15	530	2664	508	1038	0.8098000000000001
Joint Task Force	2007-03-27	20	222	30	50	0.8089000000000001
Nexus: The Jupiter Incident	2007-07-03	206	747	128	334	0.8077
Dreamfall: The Longest Journey	2007-01-12	71	865	158	229	0.8027
Sam & Max 106: Bright Side of the Moon	2007-06-15	15	79	8	23	0.802
Tomb Raider: Anniversary	2007-06-05	461	4500	955	1416	0.8006000000000001
Sam & Max 104: Abe Lincoln Must Die!	2007-06-15	291	398	69	360	0.7968999999999999
DOOM 3: Resurrection of Evil	2007-08-03	39	784	150	189	0.7961
Wolfenstein 3D: Spear of Destiny	2007-08-03	15	429	76	91	0.7959
Thief: Deadly Shadows	2007-03-29	663	1765	391	1054	0.787
Sam & Max 103: The Mole, the Mob and the Meatball	2007-06-15	32	87	13	45	0.7778
Lost Planet: Extreme Condition	2007-06-26	623	1231	289	912	0.7757
HeXen II	2007-08-03	45	344	71	116	0.7754000000000001
Making History: The Calm & The Storm	2007-03-13	72	479	123	195	0.7526
Quake II: The Reckoning	2007-08-03	11	150	34	45	0.7497
Championship Manager 2008	2007-11-02	123	92	19	142	0.7494
Battlestations: Midway	2007-03-15	175	630	180	355	0.7408
Railroad Tycoon 3	2007-05-04	180	763	227	407	0.7368000000000001
Runaway: A Road Adventure	2007-03-14	140	448	140	280	0.7234999999999999
Venice	2007-06-25	12	19	3	15	0.7221
Jade Empire: Special Edition	2007-02-27	842	1273	432	1274	0.7204
Hexen: Deathkings of the Dark Citadel	2007-08-03	7	121	34	41	0.7193
Rome: Total War - Alexander	2007-08-28	118	579	190	308	0.7187
Master Levels for DOOM II	2007-08-03	20	560	187	207	0.7156
Project: Snowblind	2007-03-29	21	421	138	159	0.7155
Amazing Adventures: The Lost Tomb	2007-12-14	14	52	13	27	0.715
Hitman: Codename 47	2007-03-15	236	2246	831	1067	0.7094
Painkiller Overdose	2007-10-30	60	690	252	312	0.7029000000000001
CivCity: Rome	2007-04-06	118	484	178	296	0.6984
Mystery P.I.: The Lottery Ticket	2007-10-16	12	30	8	20	0.6934
Sid Meier's Railroads!	2007-05-04	1008	1972	823	1831	0.6867
ThreadSpace: Hyperbol	2007-07-12	18	34	11	29	0.6748000000000001
Just Cause	2007-03-15	309	2914	1444	1753	0.6551
Kane & Lynch: Dead Men	2007-12-14	142	2008	1143	1285	0.6251
Commandos 3: Destination Berlin	2007-03-15	54	620	362	416	0.6149
Loki	2007-10-05	48	126	75	123	0.6012
Devil May Cry 3: Special Edition	2007-06-12	145	2117	1385	1530	0.5956
RIP	2007-06-01	13	222	147	160	0.5845
Shadowgrounds: Survivor	2007-11-14	330	432	291	621	0.5841
Quake II: Ground Zero	2007-08-03	10	128	85	95	0.5809000000000001
Silverfall	2007-03-20	81	79	52	133	0.5794
Gish	2007-07-20	89	250	177	266	0.5717
Safecracker: The Ultimate Puzzle Adventure	2007-08-29	104	326	235	339	0.569
Deus Ex: Invisible War	2007-03-29	60	1113	833	893	0.5646
Runaway: The Dream of the Turtle	2007-03-14	41	168	134	175	0.5462
Alpha Prime	2007-11-08	74	758	627	701	0.5418999999999999
Bullet Candy	2007-02-14	5	42	38	43	0.5183
RACE: Caterham Expansion	2007-06-22	3	6	6	9	0.5
Ducati World Championship	2007-09-21	13	86	106	119	0.4586
Genesis Rising	2007-08-06	26	41	105	131	0.3296
Vigil: Blood Bitterness	2007-06-29	9	30	115	124	0.2723
Garry's Mod	2006-11-29	73863	913987	31457	105320	0.9593
Total War: MEDIEVAL II - Definitive Edition	2006-11-15	8453	26387	1128	9581	0.9379000000000001
Half-Life 2: Episode One	2006-06-01	1132	23472	1042	2174	0.9357
FlatOut 2	2006-12-21	397	13441	557	954	0.9342
Insaniquarium! Deluxe	2006-08-30	277	4081	143	420	0.9284
Psychonauts	2006-10-11	4531	14741	741	5272	0.9274
Feeding Frenzy 2: Shipwreck Showdown Deluxe	2006-08-30	96	1461	44	140	0.9187000000000001
Call of Duty	2006-10-14	204	4570	248	452	0.9136
Sid Meier's Pirates!	2006-10-25	1342	5421	330	1672	0.9098999999999999
Zuma Deluxe	2006-08-30	759	2886	156	915	0.9086
Call of Duty 2	2006-10-14	822	7324	491	1313	0.9077
Sid Meier's Civilization IV	2006-10-25	2314	2642	202	2516	0.8898
Dark Messiah of Might & Magic Single Player	2006-10-25	623	8073	738	1361	0.8892
Bejeweled 2 Deluxe	2006-08-30	63	430	22	85	0.8797
Chuzzle Deluxe	2006-08-30	121	751	54	175	0.8752
Uplink	2006-08-23	538	2023	193	731	0.8723000000000001
Sid Meier's Civilization III: Complete	2006-10-25	4600	5432	645	5245	0.8653000000000001
GUN	2006-10-14	154	1428	142	296	0.8649
Pizza Frenzy	2006-08-30	11	150	6	17	0.8608
Dynomite! Deluxe	2006-08-30	55	214	12	67	0.8595999999999999
Ghost Master	2006-12-21	125	1504	181	306	0.8506
SiN Episodes: Emergence	2006-05-10	105	842	93	198	0.8495
DEFCON	2006-09-29	3474	3215	477	3951	0.8395
Call of Duty: United Offensive	2006-10-14	96	1349	189	285	0.8357
Red Orchestra: Ostfront 41-45	2006-03-14	126	1996	300	426	0.8334
The Ship	2006-07-11	3811	5065	837	4648	0.8319
Rocket Mania! Deluxe	2006-08-30	17	67	3	20	0.8304
Disciples II: Rise of the Elves	2006-07-06	103	949	150	253	0.8194
Bejeweled Deluxe	2006-08-30	20	156	17	37	0.8167
Zen of Sudoku	2006-12-14	24	230	31	55	0.8099
Big Money! Deluxe	2006-08-30	19	93	9	28	0.8097
Heroes of Annihilated Empires	2006-11-22	50	516	88	138	0.8028000000000001
Talismania Deluxe	2006-08-30	7	52	4	11	0.8017000000000001
Fleet Command	2006-10-26	37	309	52	89	0.7955
Disciples II: Gallean's Return	2006-07-06	141	1025	224	365	0.7831999999999999
Typer Shark! Deluxe	2006-08-30	53	240	44	97	0.7820999999999999
X2: The Threat	2006-07-21	207	353	72	279	0.7772
Hammer Heads Deluxe	2006-08-30	10	50	6	16	0.7765000000000001
Space Empires IV Deluxe	2006-02-07	69	198	37	106	0.7764
Shadowgrounds	2006-05-08	264	1193	280	544	0.7754000000000001
Heavy Weapon Deluxe	2006-08-30	13	221	45	58	0.7693000000000001
Xpand Rally	2006-08-24	24	336	80	104	0.7576
Iggle Pop! Deluxe	2006-08-30	6	44	7	13	0.7523000000000001
BloodRayne	2006-09-14	188	472	130	318	0.7427
Advent Rising	2006-09-14	206	374	102	308	0.7411
Dangerous Waters	2006-02-07	24	256	77	101	0.7220000000000001
Half-Life Deathmatch: Source	2006-05-01	79	2646	919	998	0.7216
688(I) Hunter/Killer	2006-10-26	19	127	38	57	0.7118000000000001
Vegas: Make It Big	2006-12-21	18	114	38	56	0.6950000000000001
AstroPop Deluxe	2006-08-30	11	64	20	31	0.6931
Sub Command	2006-10-26	14	80	27	41	0.6872
BloodRayne 2	2006-09-14	207	319	124	331	0.685
The Ship Single Player	2006-11-20	270	645	268	538	0.6799
Race: The WTCC Game	2006-11-24	44	137	52	96	0.6785
X3: Reunion	2006-07-21	315	421	173	488	0.6781999999999999
Earth 2160	2006-04-01	9960	878	375	10335	0.6773
RoboBlitz	2006-11-07	7	57	20	27	0.6755
Space Empires V	2006-10-16	137	290	120	257	0.6734
Iron Warriors: T-72 Tank Command	2006-07-26	15	173	104	119	0.6017
Gumboy: Crazy Adventures	2006-12-19	22	61	60	82	0.5032
Shattered Union	2006-10-25	13	71	70	83	0.5027
Poker Superstars II	2006-10-05	9	6	7	16	0.4789
